block_num,validator_id,validator_capital,validator_restaking_factor,total_gas_fee,total_mev_available,block_reward,is_attacker
0,validator_18,96128910041,True,127529001,1381040,128910041,True
1,validator_19,64121972386,True,121044996,927390,121972386,True
2,validator_14,96141416901,True,115480001,25936900,141416901,True
3,validator_15,256141618599,True,136370999,5247600,141618599,True
4,validator_15,256287555151,True,145426002,510550,145936552,True
5,validator_37,64134756300,True,132912000,1844300,134756300,False
6,validator_48,160130734230,True,129421000,1313230,130734230,False
7,validator_27,96074262300,True,71916000,2346300,74262300,False
8,validator_41,64092899300,True,92498000,401300,92899300,False
9,validator_15,256346569851,True,57338000,1676700,59014700,True
10,validator_44,96089216800,True,88784000,432800,89216800,False
11,validator_0,32166798502,True,158512002,8286500,166798502,True
12,validator_45,32066929240,True,51134000,15795240,66929240,False
13,validator_12,96178003233,True,173936003,4067230,178003233,True
14,validator_37,64289859800,True,150236000,4867500,155103500,False
15,validator_28,32142861200,True,140550000,2311200,142861200,False
16,validator_27,96173979300,True,99103000,614000,99717000,False
17,validator_28,32277097570,True,124692000,9544370,134236370,False
18,validator_18,96211224075,True,81152004,1162030,82314034,True
19,validator_15,256475164644,True,127882003,712790,128594793,True
20,validator_31,160186818800,True,184681000,2137800,186818800,False
21,validator_20,32137200877,True,136528997,671880,137200877,True
22,validator_42,32184220940,True,163425000,20795940,184220940,False
23,validator_23,32048351101,True,46948001,1403100,48351101,True
24,validator_36,96087197990,True,85951000,1246990,87197990,False
25,validator_6,32165096922,True,162449002,2647920,165096922,True
26,validator_47,64136954900,True,136151000,803900,136954900,False
27,validator_37,64342353000,True,46328000,6165200,52493200,False
28,validator_27,96224585040,True,48765000,1840740,50605740,False
29,validator_39,32044610220,True,43986000,624220,44610220,False
30,validator_36,96221380130,True,132162000,2020140,134182140,False
31,validator_18,96416850459,True,185696994,19929390,205626384,True
32,validator_27,96385356870,True,159285000,1486830,160771830,False
33,validator_47,64193728790,True,55553000,1220890,56773890,False
34,validator_2,32136653101,True,134777001,1876100,136653101,True
35,validator_38,32120147900,True,119785000,362900,120147900,False
36,validator_48,160239637120,True,106882000,2020890,108902890,False
37,validator_12,96347652829,True,168941996,707600,169649596,True
38,validator_19,64234298906,True,107184000,5142520,112326520,True
39,validator_44,96194591400,True,103532000,1842600,105374600,False
40,validator_32,32148836630,True,140968000,7868630,148836630,False
41,validator_20,32299507959,True,161193002,1114080,162307082,True
42,validator_43,64032058100,True,31669000,389100,32058100,False
43,validator_28,32381891170,True,81785000,23008600,104793600,False
44,validator_22,64215305253,True,213734993,1570260,215305253,True
45,validator_28,32551174670,True,168407000,876500,169283500,False
46,validator_39,32083066290,True,37262000,1194070,38456070,False
47,validator_38,32227098200,True,103891000,3059300,106950300,False
48,validator_31,160394972800,True,207106000,1048000,208154000,False
49,validator_34,256155416780,True,154271000,1145780,155416780,False
50,validator_48,160346736360,True,106352000,747240,107099240,False
51,validator_43,64081998010,True,48666000,1273910,49939910,False
52,validator_27,96429360270,True,41506000,2497400,44003400,False
53,validator_44,96308650600,True,111945000,2114200,114059200,False
54,validator_25,32048004200,True,47488000,516200,48004200,False
55,validator_3,32177654734,True,164511994,13142740,177654734,True
56,validator_20,32446068057,True,145210998,1349100,146560098,True
57,validator_29,32068527600,True,62760000,5767600,68527600,False
58,validator_39,32225495690,True,137093000,5336400,142429400,False
59,validator_46,96179682500,True,161210000,18472500,179682500,False
60,validator_39,32350872690,True,124204000,1173000,125377000,False
61,validator_20,32587875456,True,140073999,1733400,141807399,True
62,validator_5,64144231751,True,142787001,1444750,144231751,True
63,validator_34,256293439080,True,137160000,862300,138022300,False
64,validator_29,32099421390,True,28545000,2348790,30893790,False
65,validator_36,96325356530,True,95681000,8295400,103976400,False
66,validator_49,64121726040,True,120519000,1207040,121726040,False
67,validator_32,32352697530,True,200855000,3005900,203860900,False
68,validator_38,32407906500,True,179397000,1411300,180808300,False
69,validator_23,32112208124,True,45287003,18570020,63857023,True
70,validator_22,64280484957,True,59597004,5582700,65179704,True
71,validator_34,256390068180,True,87589000,9040100,96629100,False
72,validator_17,160073329996,True,71764996,1565000,73329996,True
73,validator_11,32164955798,True,164013998,941800,164955798,True
74,validator_28,32694728700,True,136012000,7542030,143554030,False
75,validator_49,64223087490,True,100628000,733450,101361450,False
76,validator_17,160134268499,True,59856003,1082500,60938503,True
77,validator_28,32825449500,True,128699000,2021800,130720800,False
78,validator_31,160496000800,True,99890000,1138000,101028000,False
79,validator_12,96431421869,True,74305000,9464040,83769040,True
80,validator_10,32161665297,True,143396997,18268300,161665297,True
81,validator_19,64484381908,True,249637002,446000,250083002,True
82,validator_28,32868681300,True,42723000,508800,43231800,False
83,validator_17,160361751901,True,225882002,1601400,227483402,True
84,validator_26,32082845400,True,81714000,1131400,82845400,False
85,validator_35,96100070520,True,98490000,1580520,100070520,False
86,validator_7,64110915329,True,109936999,978330,110915329,True
87,validator_3,32345528226,True,148964992,18908500,167873492,True
88,validator_0,32282506706,True,115093004,615200,115708204,True
89,validator_42,32361284940,True,156906000,20158000,177064000,False
90,validator_1,64135003324,True,134203004,800320,135003324,True
91,validator_2,32296169813,True,158083992,1432720,159516712,True
92,validator_8,32119015299,True,113195999,5819300,119015299,True
93,validator_48,160488354060,True,141093000,524700,141617700,False
94,validator_3,32523263729,True,174638003,3097500,177735503,True
95,validator_40,32108059390,True,106575000,1484390,108059390,False
96,validator_30,64127873920,True,126028000,1845920,127873920,False
97,validator_5,64474020673,True,328360002,1428920,329788922,True
98,validator_41,64221020120,True,126346000,1774820,128120820,False
99,validator_9,32177522740,True,158702000,18820740,177522740,True
100,validator_13,32120192597,True,118679997,1512600,120192597,True
101,validator_36,96432950770,True,105120000,2474240,107594240,False
102,validator_39,32426336690,True,67869000,7595000,75464000,False
103,validator_7,64325423626,True,211829997,2678300,214508297,True
104,validator_43,64313097790,True,225549000,5550780,231099780,False
105,validator_0,32506071148,True,221110992,2453450,223564442,True
106,validator_18,96505554303,True,88038004,665840,88703844,True
107,validator_18,96733595543,True,226920000,1121240,228041240,True
108,validator_34,256530373880,True,129535000,10770700,140305700,False
109,validator_5,64555139912,True,71218999,9900240,81119239,True
110,validator_28,33013759600,True,144766000,312300,145078300,False
111,validator_28,33172508060,True,157678000,1070460,158748460,False
112,validator_46,96257515800,True,76585000,1248300,77833300,False
113,validator_33,32114812400,True,95698000,19114400,114812400,False
114,validator_25,32149736700,True,96300000,5432500,101732500,False
115,validator_0,32669977720,True,149220992,14685580,163906572,True
116,validator_16,32142680602,True,141703002,977600,142680602,True
117,validator_39,32598381620,True,171842000,202930,172044930,False
118,validator_48,160647790500,True,158883000,553440,159436440,False
119,validator_31,160563661300,True,66199000,1461500,67660500,False
120,validator_36,96632384370,True,198068000,1365600,199433600,False
121,validator_38,32534942040,True,125195000,1840540,127035540,False
122,validator_22,64386749756,True,100228999,6035800,106264799,True
123,validator_17,160492093293,True,106546002,23795390,130341392,True
124,validator_7,64446981758,True,121077002,481130,121558132,True
125,validator_34,256611162880,True,79422000,1367000,80789000,False
126,validator_20,32762368796,True,173920000,573340,174493340,True
127,validator_36,96798837370,True,129685000,36768000,166453000,False
128,validator_46,96330330540,True,72584000,230740,72814740,False
129,validator_24,32130560795,True,125350005,5210790,130560795,True
130,validator_48,160773219860,True,125053000,376360,125429360,False
131,validator_15,256631189043,True,155382999,641400,156024399,True
132,validator_9,32346652438,True,167749998,1379700,169129698,True
133,validator_12,96568407008,True,136114999,870140,136985139,True
134,validator_19,64543097209,True,58242001,473300,58715301,True
135,validator_9,32522859939,True,172811001,3396500,176207501,True
136,validator_20,32850897696,True,87476000,1052900,88528900,True
137,validator_36,96848543670,True,49040000,666300,49706300,False
138,validator_35,96207351420,True,98517000,8763900,107280900,False
139,validator_16,32382868179,True,238771997,1415580,240187577,True
140,validator_39,32792947820,True,193720000,846200,194566200,False
141,validator_44,96427989940,True,118906000,433340,119339340,False
142,validator_35,96307325720,True,98931000,1043300,99974300,False
143,validator_26,32146037180,True,62800000,391780,63191780,False
144,validator_34,256722364080,True,110510000,691200,111201200,False
145,validator_14,96250923004,True,101537003,7969100,109506103,True
146,validator_31,160762691080,True,194089000,4940780,199029780,False
147,validator_37,64489107200,True,144263000,2491200,146754200,False
148,validator_44,96566635320,True,136232000,2413380,138645380,False
149,validator_1,64270057627,True,133443003,1611300,135054303,True
150,validator_13,32213547794,True,86255997,7099200,93355197,True
151,validator_5,64662410311,True,104073999,3196400,107270399,True
152,validator_0,32826780753,True,156411003,392030,156803033,True
153,validator_46,96542265480,True,205934000,6000940,211934940,False
154,validator_14,96294853264,True,43218000,712260,43930260,True
155,validator_4,32212748920,True,211209000,1539920,212748920,True
156,validator_34,256844241980,True,121487000,390900,121877900,False
157,validator_8,32161710001,True,42288002,406700,42694702,True
158,validator_34,256949413080,True,105072000,99100,105171100,False
159,validator_41,64340885340,True,118939000,926220,119865220,False
160,validator_37,64557541620,True,68225000,209420,68434420,False
161,validator_12,96655349234,True,84398996,2543230,86942226,True
162,validator_34,257133807480,True,184147000,247400,184394400,False
163,validator_5,64826506353,True,163213002,883040,164096042,True
164,validator_30,64225437420,True,93026000,4537500,97563500,False
165,validator_49,64302827890,True,77572000,2168400,79740400,False
166,validator_31,160886554920,True,123396000,467840,123863840,False
167,validator_23,32257816394,True,144538000,1070270,145608270,True
168,validator_45,32173722040,True,105308000,1484800,106792800,False
169,validator_22,64496000851,True,101102995,8148100,109251095,True
170,validator_17,160548375614,True,55838001,444320,56282321,True
171,validator_42,32512134320,True,142992000,7857380,150849380,False
172,validator_39,32905967020,True,111636000,1383200,113019200,False
173,validator_7,64573084198,True,108073000,18029440,126102440,True
174,validator_31,160980488360,True,75515000,18418440,93933440,False
175,validator_46,96605205610,True,60860000,2080130,62940130,False
176,validator_17,160604291114,True,47560000,8355500,55915500,True
177,validator_16,32586240679,True,201479000,1893500,203372500,True
178,validator_32,32521044330,True,167166000,1180800,168346800,False
179,validator_47,64304049890,True,108792000,1529100,110321100,False
180,validator_35,96408281220,True,99937000,1018500,100955500,False
181,validator_44,96702937100,True,117849000,18452780,136301780,False
182,validator_19,64644264134,True,100572995,593930,101166925,True
183,validator_6,32244331720,True,56799998,22434800,79234798,True
184,validator_43,64407853330,True,93156000,1599540,94755540,False
185,validator_12,96831709513,True,175849999,510280,176360279,True
186,validator_2,32392940210,True,96344997,425400,96770397,True
187,validator_41,64449786840,True,107402000,1499500,108901500,False
188,validator_34,257241088380,True,88866000,18414900,107280900,False
189,validator_10,32223516697,True,60185000,1666400,61851400,True
190,validator_36,96922159950,True,72149000,1467280,73616280,False
191,validator_41,64720855870,True,270404000,665030,271069030,False
192,validator_43,64573716250,True,147660000,18202920,165862920,False
193,validator_41,64810486670,True,89049000,581800,89630800,False
194,validator_11,32277619602,True,93945004,18718800,112663804,True
195,validator_49,64472770790,True,168498000,1444900,169942900,False
196,validator_36,97124393630,True,193975000,8258680,202233680,False
197,validator_39,33025239020,True,110182000,9090000,119272000,False
198,validator_2,32576442713,True,177101003,6401500,183502503,True
199,validator_30,64361374320,True,133949000,1987900,135936900,False
200,validator_24,32271110392,True,138362997,2186600,140549597,True
201,validator_16,32780396887,True,174466008,19690200,194156208,True
202,validator_44,96802781370,True,99111000,733270,99844270,False
203,validator_38,32644203240,True,83317000,25944200,109261200,False
204,validator_27,96551607370,True,120649000,1598100,122247100,False
205,validator_8,32326233297,True,162982996,1540300,164523296,True
206,validator_29,32153009620,True,53002000,586230,53588230,False
207,validator_10,32433591728,True,207036001,3039030,210075031,True
208,validator_35,96476024220,True,59198000,8545000,67743000,False
209,validator_11,32377145222,True,97874000,1651620,99525620,True
210,validator_39,33173121420,True,146179000,1703400,147882400,False
211,validator_28,33374281400,True,199040000,2733340,201773340,False
212,validator_17,160736719948,True,131660004,768830,132428834,True
213,validator_25,32265319300,True,96908000,18674600,115582600,False
214,validator_48,160819747640,True,44964000,1563780,46527780,False
215,validator_15,256717199945,True,85057002,953900,86010902,True
216,validator_33,32359068700,True,242780000,1476300,244256300,False
217,validator_46,96780662850,True,173674000,1783240,175457240,False
218,validator_22,64602373830,True,105164999,1207980,106372979,True
219,validator_49,64601123590,True,127770000,582800,128352800,False
220,validator_24,32476931219,True,204132997,1687830,205820827,True
221,validator_22,64713831782,True,109834992,1622960,111457952,True
222,validator_33,32469663700,True,100989000,9606000,110595000,False
223,validator_6,32374559136,True,128273996,1953420,130227416,True
224,validator_40,32215954490,True,107657000,238100,107895100,False
225,validator_35,96558518620,True,81797000,697400,82494400,False
226,validator_34,257343967880,True,102056000,823500,102879500,False
227,validator_31,161059846060,True,78260000,1097700,79357700,False
228,validator_11,32503226319,True,95849997,30231100,126081097,True
229,validator_42,32609513160,True,96901000,477840,97378840,False
230,validator_19,64788724563,True,144161999,298430,144460429,True
231,validator_7,64645239740,True,71975002,180540,72155542,True
232,validator_9,32650687817,True,126607998,1219880,127827878,True
233,validator_20,32990251376,True,133634000,5719680,139353680,True
234,validator_8,32468127958,True,139238001,2656660,141894661,True
235,validator_32,32692074890,True,170155000,875560,171030560,False
236,validator_25,32433003530,True,166175000,1509230,167684230,False
237,validator_16,32874734308,True,93933001,404420,94337421,True
238,validator_18,96874486744,True,123054001,17837200,140891201,True
239,validator_22,64811009779,True,88085997,9092000,97177997,True
240,validator_36,97309640530,True,184461000,785900,185246900,False
241,validator_34,257469022550,True,117563000,7491670,125054670,False
242,validator_35,96614271160,True,47821000,7931540,55752540,False
243,validator_35,96791178860,True,175438000,1469700,176907700,False
244,validator_23,32497010526,True,216234002,22960130,239194132,True
245,validator_4,32385857021,True,172050001,1058100,173108101,True
246,validator_31,161216970760,True,156209000,915700,157124700,False
247,validator_11,32582862615,True,77752996,1883300,79636296,True
248,validator_27,96713804070,True,161219000,977700,162196700,False
249,validator_44,97065373770,True,261906000,686400,262592400,False
250,validator_43,64743983700,True,167440000,2827450,170267450,False
251,validator_26,32345012480,True,198357000,618300,198975300,False
252,validator_36,97411913930,True,101218000,1055400,102273400,False
253,validator_26,32494280620,True,147830000,1438140,149268140,False
254,validator_41,64954725870,True,121934000,22305200,144239200,False
255,validator_49,64727149190,True,100397000,25628600,126025600,False
256,validator_18,97004448446,True,122436002,7525700,129961702,True
257,validator_0,32938030183,True,110331000,918430,111249430,True
258,validator_46,96889446780,True,108104000,679930,108783930,False
259,validator_34,257629257940,True,152035000,8200390,160235390,False
260,validator_46,97013679180,True,105514000,18718400,124232400,False
261,validator_11,32878903716,True,294338001,1703100,296041101,True
262,validator_31,161327947260,True,109130000,1846500,110976500,False
263,validator_27,96796994210,True,64678000,18512140,83190140,False
264,validator_33,32579749000,True,90565000,19520300,110085300,False
265,validator_12,97091785215,True,241528002,18547700,260075702,True
266,validator_37,64600973440,True,43098000,333820,43431820,False
267,validator_33,32736236530,True,155593000,894530,156487530,False
268,validator_9,32776054456,True,123901999,1464640,125366639,True
269,validator_23,32649035599,True,132778003,19247070,152025073,True
270,validator_29,32315766960,True,161425000,1332340,162757340,False
271,validator_47,64468972890,True,162714000,2209000,164923000,False
272,validator_13,32320700696,True,106120002,1032900,107152902,True
273,validator_6,32498795939,True,123485003,751800,124236803,True
274,validator_36,97489089210,True,75171000,2004280,77175280,False
275,validator_43,64877166800,True,131346000,1837100,133183100,False
276,validator_2,32832184910,True,254111997,1630200,255742197,True
277,validator_17,160799602584,True,54906996,7975640,62882636,True
278,validator_6,32581423135,True,81580996,1046200,82627196,True
279,validator_19,64966318767,True,176318004,1276200,177594204,True
280,validator_15,256900145237,True,166537002,16408290,182945292,True
281,validator_33,32828844930,True,91370000,1238400,92608400,False
282,validator_37,64777415240,True,157826000,18615800,176441800,False
283,validator_23,32748534299,True,81466000,18032700,99498700,True
284,validator_11,33001038318,True,121187002,947600,122134602,True
285,validator_46,97143660180,True,128994000,987000,129981000,False
286,validator_3,32597186423,True,71834994,2087700,73922694,True
287,validator_40,32367020390,True,148603000,2462900,151065900,False
288,validator_6,32681899736,True,98940001,1536600,100476601,True
289,validator_41,65088716370,True,115225000,18765500,133990500,False
290,validator_41,65241621900,True,150384000,2521530,152905530,False
291,validator_42,32822299380,True,211688000,1098220,212786220,False
292,validator_9,32850448982,True,73095996,1298530,74394526,True
293,validator_5,64878900256,True,51628003,765900,52393903,True
294,validator_14,96366982465,True,69592001,2537200,72129201,True
295,validator_5,64985494558,True,105555002,1039300,106594302,True
296,validator_31,161466898860,True,119254000,19697600,138951600,False
297,validator_22,64921562836,True,110086997,466060,110553057,True
298,validator_13,32451951499,True,128819003,2431800,131250803,True
299,validator_38,32803161680,True,157910000,1048440,158958440,False
300,validator_15,257054090738,True,145912001,8033500,153945501,True
301,validator_17,160871597846,True,71324002,671260,71995262,True
302,validator_6,32830854835,True,130236999,18718100,148955099,True
303,validator_6,32912860464,True,81447999,557630,82005629,True
304,validator_46,97265200340,True,120277000,1263160,121540160,False
305,validator_23,32986701078,True,234683999,3482780,238166779,True
306,validator_6,33100953901,True,181360997,6732440,188093437,True
307,validator_27,96916801510,True,118373000,1434300,119807300,False
308,validator_4,32501348498,True,114878997,612480,115491477,True
309,validator_17,161014496480,True,137932994,4965640,142898634,True
310,validator_5,65080371457,True,92887999,1988900,94876899,True
311,validator_11,33085477903,True,83301995,1137590,84439585,True
312,validator_41,65344476400,True,83503000,19351500,102854500,False
313,validator_12,97197020785,True,92185000,13050570,105235570,True
314,validator_47,64573088690,True,103428000,687800,104115800,False
315,validator_7,64787915961,True,142115001,561220,142676221,True
316,validator_30,64423107900,True,53661000,8072580,61733580,False
317,validator_26,32683087320,True,188492000,314700,188806700,False
318,validator_48,160948037240,True,127078000,1211600,128289600,False
319,validator_29,32425321630,True,108245000,1309670,109554670,False
320,validator_6,33177865298,True,75477997,1433400,76911397,True
321,validator_32,32846734890,True,153182000,1478000,154660000,False
322,validator_32,32917850970,True,69630000,1486080,71116080,False
323,validator_0,33046190113,True,89068000,19091930,108159930,True
324,validator_34,257768543130,True,137289000,1996190,139285190,False
325,validator_10,32601387070,True,166389002,1406340,167795342,True
326,validator_15,257105727144,True,49490006,2146400,51636406,True
327,validator_46,97407972360,True,138004000,4768020,142772020,False
328,validator_43,64919310700,True,41343000,800900,42143900,False
329,validator_26,32831488240,True,148215000,185920,148400920,False
330,validator_18,97166077343,True,160421997,1206900,161628897,True
331,validator_19,65135218465,True,160625998,8273700,168899698,True
332,validator_22,65204875633,True,282162997,1149800,283312797,True
333,validator_19,65281882043,True,145838998,824580,146663578,True
334,validator_6,33229629914,True,49824996,1939620,51764616,True
335,validator_32,32976848260,True,40394000,18603290,58997290,False
336,validator_41,65387620640,True,42716000,428240,43144240,False
337,validator_45,32376349340,True,198925000,3702300,202627300,False
338,validator_5,65174953558,True,93799001,783100,94582101,True
339,validator_49,64893259930,True,164370000,1740740,166110740,False
340,validator_46,97574163950,True,164789000,1402590,166191590,False
341,validator_36,97590891010,True,95789000,6012800,101801800,False
342,validator_36,97741713370,True,150168000,654360,150822360,False
343,validator_16,32933008906,True,57672998,601600,58274598,True
344,validator_0,33178465711,True,128456998,3818600,132275598,True
345,validator_37,64896087100,True,115882000,2789860,118671860,False
346,validator_47,64672180290,True,81070000,18021600,99091600,False
347,validator_47,64829961770,True,157288000,493480,157781480,False
348,validator_16,33101460495,True,163014999,5436590,168451589,True
349,validator_37,65104392200,True,189516000,18789100,208305100,False
350,validator_17,161192991883,True,177517003,978400,178495403,True
351,validator_29,32475684130,True,45069000,5293500,50362500,False
352,validator_15,257352146315,True,244572001,1847170,246419171,True
353,validator_40,32487301690,True,111963000,8318300,120281300,False
354,validator_17,161289995526,True,90295003,6708640,97003643,True
355,validator_14,96593913493,True,225743998,1187030,226931028,True
356,validator_21,64235234399,True,233804999,1429400,235234399,True
357,validator_17,161408789531,True,100274005,18520000,118794005,True
358,validator_9,32933333465,True,82500003,384480,82884483,True
359,validator_10,32708033170,True,87912000,18734100,106646100,True
360,validator_25,32614112810,True,178535000,2574280,181109280,False
361,validator_32,33085068000,True,106221000,1998740,108219740,False
362,validator_17,161507270631,True,96537000,1944100,98481100,True
363,validator_18,97289074440,True,122206997,790100,122997097,True
364,validator_36,97833464110,True,90911000,839740,91750740,False
365,validator_28,33558862900,True,176295000,8286500,184581500,False
366,validator_49,64962321530,True,68437000,624600,69061600,False
367,validator_22,65257218638,True,51942005,401000,52343005,True
368,validator_46,97690724870,True,115701000,859920,116560920,False
369,validator_25,32836646810,True,221778000,756000,222534000,False
370,validator_23,33227412030,True,221028002,19682950,240710952,True
371,validator_39,33327169720,True,152770000,1278300,154048300,False
372,validator_1,64358416225,True,87039998,1318600,88358598,True
373,validator_16,33245202124,True,141363999,2377630,143741629,True
374,validator_46,97813158570,True,102673000,19760700,122433700,False
375,validator_2,32913315151,True,79922001,1208240,81130241,True
376,validator_15,257413949985,True,60573000,1230670,61803670,True
377,validator_37,65265136800,True,159611000,1133600,160744600,False
378,validator_48,161025204740,True,75541000,1626500,77167500,False
379,validator_48,161139311340,True,113196000,910600,114106600,False
380,validator_7,64864872441,True,76354000,602480,76956480,True
381,validator_35,96948714260,True,156980000,555400,157535400,False
382,validator_21,64347529716,True,110172997,2122320,112295317,True
383,validator_22,65370821380,True,111247002,2355740,113602742,True
384,validator_48,161302127010,True,160084000,2731670,162815670,False
385,validator_14,96683569496,True,88896003,760000,89656003,True
386,validator_5,65311961161,True,133510003,3497600,137007603,True
387,validator_34,257840642250,True,70386000,1713120,72099120,False
388,validator_17,161653469728,True,143632997,2566100,146199097,True
389,validator_25,32940714920,True,100334000,3734110,104068110,False
390,validator_18,97404382845,True,114553005,755400,115308405,True
391,validator_5,65463423158,True,149526997,1935000,151461997,True
392,validator_45,32435849840,True,59120000,380500,59500500,False
393,validator_7,64900366644,True,34652003,842200,35494203,True
394,validator_32,33129148320,True,42933000,1147320,44080320,False
395,validator_37,65319501400,True,53767000,597600,54364600,False
396,validator_7,65018523092,True,115438008,2718440,118156448,True
397,validator_28,33655272400,True,92927000,3482500,96409500,False
398,validator_31,161682447760,True,213666000,1882900,215548900,False
399,validator_11,33210831948,True,123849005,1505040,125354045,True
400,validator_21,64419834117,True,53992001,18312400,72304401,True
401,validator_41,65455295430,True,57534000,10140790,67674790,False
402,validator_24,32580582825,True,101625006,2026600,103651606,True
403,validator_27,97041700730,True,123850000,1049220,124899220,False
404,validator_21,64585487556,True,163687999,1965440,165653439,True
405,validator_14,96826399392,True,139660996,3168900,142829896,True
406,validator_6,33307742414,True,69237000,8875500,78112500,True
407,validator_23,33313293029,True,66338999,19542000,85880999,True
408,validator_1,64483245661,True,124202006,627430,124829436,True
409,validator_48,161444077710,True,141298000,652700,141950700,False
410,validator_36,97963306410,True,129193000,649300,129842300,False
411,validator_17,161952754218,True,244643000,54641490,299284490,True
412,validator_15,257566565586,True,134517001,18098600,152615601,True
413,validator_23,33385831860,True,70466001,2072830,72538831,True
414,validator_45,32487283840,True,49998000,1436000,51434000,False
415,validator_18,97463249220,True,56707995,2158380,58866375,True
416,validator_3,32716219822,True,118448999,584400,119033399,True
417,validator_18,97642126812,True,174291002,4586590,178877592,True
418,validator_29,32524725750,True,48626000,415620,49041620,False
419,validator_16,33386656527,True,139250003,2204400,141454403,True
420,validator_47,64961802130,True,130967000,873360,131840360,False
421,validator_15,257628622685,True,61558999,498100,62057099,True
422,validator_18,97763246413,True,102390001,18729600,121119601,True
423,validator_10,32873552911,True,153501001,12018740,165519741,True
424,validator_38,32872663510,True,68731000,770830,69501830,False
425,validator_2,33084272151,True,170068000,889000,170957000,True
426,validator_44,97203467570,True,128472000,9621800,138093800,False
427,validator_1,64690699802,True,206137001,1317140,207454141,True
428,validator_31,161920173560,True,236416000,1309800,237725800,False
429,validator_14,96974370974,True,147203002,768580,147971582,True
430,validator_18,97942064380,True,178669997,147970,178817967,True
431,validator_8,32566551557,True,90086999,8336600,98423599,True
432,validator_14,97065406874,True,89382000,1653900,91035900,True
433,validator_48,161562733510,True,116312000,2343800,118655800,False
434,validator_33,32998661450,True,168531000,1285520,169816520,False
435,validator_30,64562190800,True,136406000,2676900,139082900,False
436,validator_45,32568727530,True,80016000,1427690,81443690,False
437,validator_10,33057757712,True,183547001,657800,184204801,True
438,validator_48,161681187110,True,117193000,1260600,118453600,False
439,validator_3,32841639702,True,120065000,5354880,125419880,True
440,validator_40,32620867810,True,128141000,5425120,133566120,False
441,validator_42,32898443460,True,74969000,1175080,76144080,False
442,validator_13,32571135699,True,116783000,2401200,119184200,True
443,validator_17,162069107651,True,114926003,1427430,116353433,True
444,validator_34,257960807890,True,119595000,570640,120165640,False
445,validator_10,33140661653,True,75143001,7760940,82903941,True
446,validator_49,65091360430,True,128294000,744900,129038900,False
447,validator_11,33285343392,True,73443004,1068440,74511444,True
448,validator_4,32656732599,True,146724001,8660100,155384101,True
449,validator_41,65608243950,True,151631000,1317520,152948520,False
450,validator_17,162284683948,True,214977997,598300,215576297,True
451,validator_14,97209443204,True,142006000,2030330,144036330,True
452,validator_22,65493489310,True,121872000,795930,122667930,True
453,validator_41,65680141150,True,70676000,1221200,71897200,False
454,validator_10,33306182654,True,159803001,5718000,165521001,True
455,validator_49,65227227230,True,129594000,6272800,135866800,False
456,validator_47,65074518910,True,111872000,844780,112716780,False
457,validator_17,162414625140,True,127416002,2525190,129941192,True
458,validator_6,33398253556,True,89920002,591140,90511142,True
459,validator_0,33290014342,True,110692001,856630,111548631,True
460,validator_2,33296146181,True,211699000,175030,211874030,True
461,validator_49,65311197430,True,73877000,10093200,83970200,False
462,validator_46,97911285990,True,96929000,1198420,98127420,False
463,validator_27,97195588770,True,153404000,484040,153888040,False
464,validator_47,65181017130,True,105463000,1035220,106498220,False
465,validator_44,97392151370,True,188454000,229800,188683800,False
466,validator_20,33079917050,True,87186004,2479670,89665674,True
467,validator_27,97298383900,True,101290000,1505130,102795130,False
468,validator_46,98099388190,True,186324000,1778200,188102200,False
469,validator_29,32648192150,True,114613000,8853400,123466400,False
470,validator_6,33430063156,True,31605000,204600,31809600,True
471,validator_44,97653287370,True,260486000,650000,261136000,False
472,validator_22,65629090909,True,134654999,946600,135601599,True
473,validator_8,32700820648,True,127278001,6991090,134269091,True
474,validator_47,65328953610,True,146851000,1085480,147936480,False
475,validator_41,66031923500,True,350411000,1371350,351782350,False
476,validator_29,32752406080,True,102183000,2030930,104213930,False
477,validator_29,32888131450,True,134163000,1562370,135725370,False
478,validator_2,33455703272,True,158114001,1443090,159557091,True
479,validator_22,65725266135,True,95137006,1038220,96175226,True
480,validator_29,33021604350,True,132483000,989900,133472900,False
481,validator_14,97333556244,True,119000000,5113040,124113040,True
482,validator_22,65785460040,True,57102005,3091900,60193905,True
483,validator_13,32627299827,True,55677998,486130,56164128,True
484,validator_10,33417070944,True,109574000,1314290,110888290,True
485,validator_33,33140593290,True,129675000,12256840,141931840,False
486,validator_19,65355032443,True,72808000,342400,73150400,True
487,validator_35,97048034060,True,99063000,256800,99319800,False
488,validator_22,66095421817,True,309784997,176780,309961777,True
489,validator_41,66201563060,True,167477000,2162560,169639560,False
490,validator_42,33019266990,True,116446000,4377530,120823530,False
491,validator_25,33075443920,True,132346000,2383000,134729000,False
492,validator_38,32944768280,True,71828000,276770,72104770,False
493,validator_10,33560856048,True,141650004,2135100,143785104,True
494,validator_0,33402231670,True,111416998,800330,112217328,True
495,validator_23,33554855161,True,168725001,298300,169023301,True
496,validator_40,32784986010,True,162372000,1746200,164118200,False
497,validator_33,33244760430,True,102932000,1235140,104167140,False
498,validator_39,33474241020,True,144928000,2143300,147071300,False
499,validator_31,162186425580,True,264543000,1709020,266252020,False
500,validator_18,96128910041,True,127529001,1381040,128910041,True
501,validator_19,64121972386,True,121044996,927390,121972386,True
502,validator_14,96141416901,True,115480001,25936900,141416901,True
503,validator_15,256141618599,True,136370999,5247600,141618599,True
504,validator_15,256287555151,True,145426002,510550,145936552,True
505,validator_37,64134756300,True,132912000,1844300,134756300,False
506,validator_48,160130734230,True,129421000,1313230,130734230,False
507,validator_27,96074262300,True,71916000,2346300,74262300,False
508,validator_41,64092899300,True,92498000,401300,92899300,False
509,validator_15,256346569851,True,57338000,1676700,59014700,True
510,validator_44,96089216800,True,88784000,432800,89216800,False
511,validator_0,32166798502,True,158512002,8286500,166798502,True
512,validator_45,32066929240,True,51134000,15795240,66929240,False
513,validator_12,96178003233,True,173936003,4067230,178003233,True
514,validator_37,64289859800,True,150236000,4867500,155103500,False
515,validator_28,32142861200,True,140550000,2311200,142861200,False
516,validator_27,96173979300,True,99103000,614000,99717000,False
517,validator_28,32277097570,True,124692000,9544370,134236370,False
518,validator_18,96211224075,True,81152004,1162030,82314034,True
519,validator_15,256475164644,True,127882003,712790,128594793,True
520,validator_31,160186818800,True,184681000,2137800,186818800,False
521,validator_20,32137200877,True,136528997,671880,137200877,True
522,validator_42,32184220940,True,163425000,20795940,184220940,False
523,validator_23,32048351101,True,46948001,1403100,48351101,True
524,validator_36,96087197990,True,85951000,1246990,87197990,False
525,validator_6,32165096922,True,162449002,2647920,165096922,True
526,validator_47,64136954900,True,136151000,803900,136954900,False
527,validator_37,64342353000,True,46328000,6165200,52493200,False
528,validator_27,96224585040,True,48765000,1840740,50605740,False
529,validator_39,32044610220,True,43986000,624220,44610220,False
530,validator_36,96221380130,True,132162000,2020140,134182140,False
531,validator_18,96416850459,True,185696994,19929390,205626384,True
532,validator_27,96385356870,True,159285000,1486830,160771830,False
533,validator_47,64193728790,True,55553000,1220890,56773890,False
534,validator_2,32136653101,True,134777001,1876100,136653101,True
535,validator_38,32120147900,True,119785000,362900,120147900,False
536,validator_48,160239637120,True,106882000,2020890,108902890,False
537,validator_12,96347652829,True,168941996,707600,169649596,True
538,validator_19,64234298906,True,107184000,5142520,112326520,True
539,validator_44,96194591400,True,103532000,1842600,105374600,False
540,validator_32,32148836630,True,140968000,7868630,148836630,False
541,validator_20,32299507959,True,161193002,1114080,162307082,True
542,validator_43,64032058100,True,31669000,389100,32058100,False
543,validator_28,32381891170,True,81785000,23008600,104793600,False
544,validator_22,64215305253,True,213734993,1570260,215305253,True
545,validator_28,32551174670,True,168407000,876500,169283500,False
546,validator_39,32083066290,True,37262000,1194070,38456070,False
547,validator_38,32227098200,True,103891000,3059300,106950300,False
548,validator_31,160394972800,True,207106000,1048000,208154000,False
549,validator_34,256155416780,True,154271000,1145780,155416780,False
550,validator_48,160346736360,True,106352000,747240,107099240,False
551,validator_43,64081998010,True,48666000,1273910,49939910,False
552,validator_27,96429360270,True,41506000,2497400,44003400,False
553,validator_44,96308650600,True,111945000,2114200,114059200,False
554,validator_25,32048004200,True,47488000,516200,48004200,False
555,validator_3,32177654734,True,164511994,13142740,177654734,True
556,validator_20,32446068057,True,145210998,1349100,146560098,True
557,validator_29,32068527600,True,62760000,5767600,68527600,False
558,validator_39,32225495690,True,137093000,5336400,142429400,False
559,validator_46,96179682500,True,161210000,18472500,179682500,False
560,validator_39,32350872690,True,124204000,1173000,125377000,False
561,validator_20,32587875456,True,140073999,1733400,141807399,True
562,validator_5,64144231751,True,142787001,1444750,144231751,True
563,validator_34,256293439080,True,137160000,862300,138022300,False
564,validator_29,32099421390,True,28545000,2348790,30893790,False
565,validator_36,96325356530,True,95681000,8295400,103976400,False
566,validator_49,64121726040,True,120519000,1207040,121726040,False
567,validator_32,32352697530,True,200855000,3005900,203860900,False
568,validator_38,32407906500,True,179397000,1411300,180808300,False
569,validator_23,32112208124,True,45287003,18570020,63857023,True
570,validator_22,64280484957,True,59597004,5582700,65179704,True
571,validator_34,256390068180,True,87589000,9040100,96629100,False
572,validator_17,160073329996,True,71764996,1565000,73329996,True
573,validator_11,32164955798,True,164013998,941800,164955798,True
574,validator_28,32694728700,True,136012000,7542030,143554030,False
575,validator_49,64223087490,True,100628000,733450,101361450,False
576,validator_17,160134268499,True,59856003,1082500,60938503,True
577,validator_28,32825449500,True,128699000,2021800,130720800,False
578,validator_31,160496000800,True,99890000,1138000,101028000,False
579,validator_12,96431421869,True,74305000,9464040,83769040,True
580,validator_10,32161665297,True,143396997,18268300,161665297,True
581,validator_19,64484381908,True,249637002,446000,250083002,True
582,validator_28,32868681300,True,42723000,508800,43231800,False
583,validator_17,160361751901,True,225882002,1601400,227483402,True
584,validator_26,32082845400,True,81714000,1131400,82845400,False
585,validator_35,96100070520,True,98490000,1580520,100070520,False
586,validator_7,64110915329,True,109936999,978330,110915329,True
587,validator_3,32345528226,True,148964992,18908500,167873492,True
588,validator_0,32282506706,True,115093004,615200,115708204,True
589,validator_42,32361284940,True,156906000,20158000,177064000,False
590,validator_1,64135003324,True,134203004,800320,135003324,True
591,validator_2,32296169813,True,158083992,1432720,159516712,True
592,validator_8,32119015299,True,113195999,5819300,119015299,True
593,validator_48,160488354060,True,141093000,524700,141617700,False
594,validator_3,32523263729,True,174638003,3097500,177735503,True
595,validator_40,32108059390,True,106575000,1484390,108059390,False
596,validator_30,64127873920,True,126028000,1845920,127873920,False
597,validator_5,64474020673,True,328360002,1428920,329788922,True
598,validator_41,64221020120,True,126346000,1774820,128120820,False
599,validator_9,32177522740,True,158702000,18820740,177522740,True
600,validator_13,32120192597,True,118679997,1512600,120192597,True
601,validator_36,96432950770,True,105120000,2474240,107594240,False
602,validator_39,32426336690,True,67869000,7595000,75464000,False
603,validator_7,64325423626,True,211829997,2678300,214508297,True
604,validator_43,64313097790,True,225549000,5550780,231099780,False
605,validator_0,32506071148,True,221110992,2453450,223564442,True
606,validator_18,96505554303,True,88038004,665840,88703844,True
607,validator_18,96733595543,True,226920000,1121240,228041240,True
608,validator_34,256530373880,True,129535000,10770700,140305700,False
609,validator_5,64555139912,True,71218999,9900240,81119239,True
610,validator_28,33013759600,True,144766000,312300,145078300,False
611,validator_28,33172508060,True,157678000,1070460,158748460,False
612,validator_46,96257515800,True,76585000,1248300,77833300,False
613,validator_33,32114812400,True,95698000,19114400,114812400,False
614,validator_25,32149736700,True,96300000,5432500,101732500,False
615,validator_0,32669977720,True,149220992,14685580,163906572,True
616,validator_16,32142680602,True,141703002,977600,142680602,True
617,validator_39,32598381620,True,171842000,202930,172044930,False
618,validator_48,160647790500,True,158883000,553440,159436440,False
619,validator_31,160563661300,True,66199000,1461500,67660500,False
620,validator_36,96632384370,True,198068000,1365600,199433600,False
621,validator_38,32534942040,True,125195000,1840540,127035540,False
622,validator_22,64386749756,True,100228999,6035800,106264799,True
623,validator_17,160492093293,True,106546002,23795390,130341392,True
624,validator_7,64446981758,True,121077002,481130,121558132,True
625,validator_34,256611162880,True,79422000,1367000,80789000,False
626,validator_20,32762368796,True,173920000,573340,174493340,True
627,validator_36,96798837370,True,129685000,36768000,166453000,False
628,validator_46,96330330540,True,72584000,230740,72814740,False
629,validator_24,32130560795,True,125350005,5210790,130560795,True
630,validator_48,160773219860,True,125053000,376360,125429360,False
631,validator_15,256631189043,True,155382999,641400,156024399,True
632,validator_9,32346652438,True,167749998,1379700,169129698,True
633,validator_12,96568407008,True,136114999,870140,136985139,True
634,validator_19,64543097209,True,58242001,473300,58715301,True
635,validator_9,32522859939,True,172811001,3396500,176207501,True
636,validator_20,32850897696,True,87476000,1052900,88528900,True
637,validator_36,96848543670,True,49040000,666300,49706300,False
638,validator_35,96207351420,True,98517000,8763900,107280900,False
639,validator_16,32382868179,True,238771997,1415580,240187577,True
640,validator_39,32792947820,True,193720000,846200,194566200,False
641,validator_44,96427989940,True,118906000,433340,119339340,False
642,validator_35,96307325720,True,98931000,1043300,99974300,False
643,validator_26,32146037180,True,62800000,391780,63191780,False
644,validator_34,256722364080,True,110510000,691200,111201200,False
645,validator_14,96250923004,True,101537003,7969100,109506103,True
646,validator_31,160762691080,True,194089000,4940780,199029780,False
647,validator_37,64489107200,True,144263000,2491200,146754200,False
648,validator_44,96566635320,True,136232000,2413380,138645380,False
649,validator_1,64270057627,True,133443003,1611300,135054303,True
650,validator_13,32213547794,True,86255997,7099200,93355197,True
651,validator_5,64662410311,True,104073999,3196400,107270399,True
652,validator_0,32826780753,True,156411003,392030,156803033,True
653,validator_46,96542265480,True,205934000,6000940,211934940,False
654,validator_14,96294853264,True,43218000,712260,43930260,True
655,validator_4,32212748920,True,211209000,1539920,212748920,True
656,validator_34,256844241980,True,121487000,390900,121877900,False
657,validator_8,32161710001,True,42288002,406700,42694702,True
658,validator_34,256949413080,True,105072000,99100,105171100,False
659,validator_41,64340885340,True,118939000,926220,119865220,False
660,validator_37,64557541620,True,68225000,209420,68434420,False
661,validator_12,96655349234,True,84398996,2543230,86942226,True
662,validator_34,257133807480,True,184147000,247400,184394400,False
663,validator_5,64826506353,True,163213002,883040,164096042,True
664,validator_30,64225437420,True,93026000,4537500,97563500,False
665,validator_49,64302827890,True,77572000,2168400,79740400,False
666,validator_31,160886554920,True,123396000,467840,123863840,False
667,validator_23,32257816394,True,144538000,1070270,145608270,True
668,validator_45,32173722040,True,105308000,1484800,106792800,False
669,validator_22,64496000851,True,101102995,8148100,109251095,True
670,validator_17,160548375614,True,55838001,444320,56282321,True
671,validator_42,32512134320,True,142992000,7857380,150849380,False
672,validator_39,32905967020,True,111636000,1383200,113019200,False
673,validator_7,64573084198,True,108073000,18029440,126102440,True
674,validator_31,160980488360,True,75515000,18418440,93933440,False
675,validator_46,96605205610,True,60860000,2080130,62940130,False
676,validator_17,160604291114,True,47560000,8355500,55915500,True
677,validator_16,32586240679,True,201479000,1893500,203372500,True
678,validator_32,32521044330,True,167166000,1180800,168346800,False
679,validator_47,64304049890,True,108792000,1529100,110321100,False
680,validator_35,96408281220,True,99937000,1018500,100955500,False
681,validator_44,96702937100,True,117849000,18452780,136301780,False
682,validator_19,64644264134,True,100572995,593930,101166925,True
683,validator_6,32244331720,True,56799998,22434800,79234798,True
684,validator_43,64407853330,True,93156000,1599540,94755540,False
685,validator_12,96831709513,True,175849999,510280,176360279,True
686,validator_2,32392940210,True,96344997,425400,96770397,True
687,validator_41,64449786840,True,107402000,1499500,108901500,False
688,validator_34,257241088380,True,88866000,18414900,107280900,False
689,validator_10,32223516697,True,60185000,1666400,61851400,True
690,validator_36,96922159950,True,72149000,1467280,73616280,False
691,validator_41,64720855870,True,270404000,665030,271069030,False
692,validator_43,64573716250,True,147660000,18202920,165862920,False
693,validator_41,64810486670,True,89049000,581800,89630800,False
694,validator_11,32277619602,True,93945004,18718800,112663804,True
695,validator_49,64472770790,True,168498000,1444900,169942900,False
696,validator_36,97124393630,True,193975000,8258680,202233680,False
697,validator_39,33025239020,True,110182000,9090000,119272000,False
698,validator_2,32576442713,True,177101003,6401500,183502503,True
699,validator_30,64361374320,True,133949000,1987900,135936900,False
700,validator_24,32271110392,True,138362997,2186600,140549597,True
701,validator_16,32780396887,True,174466008,19690200,194156208,True
702,validator_44,96802781370,True,99111000,733270,99844270,False
703,validator_38,32644203240,True,83317000,25944200,109261200,False
704,validator_27,96551607370,True,120649000,1598100,122247100,False
705,validator_8,32326233297,True,162982996,1540300,164523296,True
706,validator_29,32153009620,True,53002000,586230,53588230,False
707,validator_10,32433591728,True,207036001,3039030,210075031,True
708,validator_35,96476024220,True,59198000,8545000,67743000,False
709,validator_11,32377145222,True,97874000,1651620,99525620,True
710,validator_39,33173121420,True,146179000,1703400,147882400,False
711,validator_28,33374281400,True,199040000,2733340,201773340,False
712,validator_17,160736719948,True,131660004,768830,132428834,True
713,validator_25,32265319300,True,96908000,18674600,115582600,False
714,validator_48,160819747640,True,44964000,1563780,46527780,False
715,validator_15,256717199945,True,85057002,953900,86010902,True
716,validator_33,32359068700,True,242780000,1476300,244256300,False
717,validator_46,96780662850,True,173674000,1783240,175457240,False
718,validator_22,64602373830,True,105164999,1207980,106372979,True
719,validator_49,64601123590,True,127770000,582800,128352800,False
720,validator_24,32476931219,True,204132997,1687830,205820827,True
721,validator_22,64713831782,True,109834992,1622960,111457952,True
722,validator_33,32469663700,True,100989000,9606000,110595000,False
723,validator_6,32374559136,True,128273996,1953420,130227416,True
724,validator_40,32215954490,True,107657000,238100,107895100,False
725,validator_35,96558518620,True,81797000,697400,82494400,False
726,validator_34,257343967880,True,102056000,823500,102879500,False
727,validator_31,161059846060,True,78260000,1097700,79357700,False
728,validator_11,32503226319,True,95849997,30231100,126081097,True
729,validator_42,32609513160,True,96901000,477840,97378840,False
730,validator_19,64788724563,True,144161999,298430,144460429,True
731,validator_7,64645239740,True,71975002,180540,72155542,True
732,validator_9,32650687817,True,126607998,1219880,127827878,True
733,validator_20,32990251376,True,133634000,5719680,139353680,True
734,validator_8,32468127958,True,139238001,2656660,141894661,True
735,validator_32,32692074890,True,170155000,875560,171030560,False
736,validator_25,32433003530,True,166175000,1509230,167684230,False
737,validator_16,32874734308,True,93933001,404420,94337421,True
738,validator_18,96874486744,True,123054001,17837200,140891201,True
739,validator_22,64811009779,True,88085997,9092000,97177997,True
740,validator_36,97309640530,True,184461000,785900,185246900,False
741,validator_34,257469022550,True,117563000,7491670,125054670,False
742,validator_35,96614271160,True,47821000,7931540,55752540,False
743,validator_35,96791178860,True,175438000,1469700,176907700,False
744,validator_23,32497010526,True,216234002,22960130,239194132,True
745,validator_4,32385857021,True,172050001,1058100,173108101,True
746,validator_31,161216970760,True,156209000,915700,157124700,False
747,validator_11,32582862615,True,77752996,1883300,79636296,True
748,validator_27,96713804070,True,161219000,977700,162196700,False
749,validator_44,97065373770,True,261906000,686400,262592400,False
750,validator_43,64743983700,True,167440000,2827450,170267450,False
751,validator_26,32345012480,True,198357000,618300,198975300,False
752,validator_36,97411913930,True,101218000,1055400,102273400,False
753,validator_26,32494280620,True,147830000,1438140,149268140,False
754,validator_41,64954725870,True,121934000,22305200,144239200,False
755,validator_49,64727149190,True,100397000,25628600,126025600,False
756,validator_18,97004448446,True,122436002,7525700,129961702,True
757,validator_0,32938030183,True,110331000,918430,111249430,True
758,validator_46,96889446780,True,108104000,679930,108783930,False
759,validator_34,257629257940,True,152035000,8200390,160235390,False
760,validator_46,97013679180,True,105514000,18718400,124232400,False
761,validator_11,32878903716,True,294338001,1703100,296041101,True
762,validator_31,161327947260,True,109130000,1846500,110976500,False
763,validator_27,96796994210,True,64678000,18512140,83190140,False
764,validator_33,32579749000,True,90565000,19520300,110085300,False
765,validator_12,97091785215,True,241528002,18547700,260075702,True
766,validator_37,64600973440,True,43098000,333820,43431820,False
767,validator_33,32736236530,True,155593000,894530,156487530,False
768,validator_9,32776054456,True,123901999,1464640,125366639,True
769,validator_23,32649035599,True,132778003,19247070,152025073,True
770,validator_29,32315766960,True,161425000,1332340,162757340,False
771,validator_47,64468972890,True,162714000,2209000,164923000,False
772,validator_13,32320700696,True,106120002,1032900,107152902,True
773,validator_6,32498795939,True,123485003,751800,124236803,True
774,validator_36,97489089210,True,75171000,2004280,77175280,False
775,validator_43,64877166800,True,131346000,1837100,133183100,False
776,validator_2,32832184910,True,254111997,1630200,255742197,True
777,validator_17,160799602584,True,54906996,7975640,62882636,True
778,validator_6,32581423135,True,81580996,1046200,82627196,True
779,validator_19,64966318767,True,176318004,1276200,177594204,True
780,validator_15,256900145237,True,166537002,16408290,182945292,True
781,validator_33,32828844930,True,91370000,1238400,92608400,False
782,validator_37,64777415240,True,157826000,18615800,176441800,False
783,validator_23,32748534299,True,81466000,18032700,99498700,True
784,validator_11,33001038318,True,121187002,947600,122134602,True
785,validator_46,97143660180,True,128994000,987000,129981000,False
786,validator_3,32597186423,True,71834994,2087700,73922694,True
787,validator_40,32367020390,True,148603000,2462900,151065900,False
788,validator_6,32681899736,True,98940001,1536600,100476601,True
789,validator_41,65088716370,True,115225000,18765500,133990500,False
790,validator_41,65241621900,True,150384000,2521530,152905530,False
791,validator_42,32822299380,True,211688000,1098220,212786220,False
792,validator_9,32850448982,True,73095996,1298530,74394526,True
793,validator_5,64878900256,True,51628003,765900,52393903,True
794,validator_14,96366982465,True,69592001,2537200,72129201,True
795,validator_5,64985494558,True,105555002,1039300,106594302,True
796,validator_31,161466898860,True,119254000,19697600,138951600,False
797,validator_22,64921562836,True,110086997,466060,110553057,True
798,validator_13,32451951499,True,128819003,2431800,131250803,True
799,validator_38,32803161680,True,157910000,1048440,158958440,False
800,validator_15,257054090738,True,145912001,8033500,153945501,True
801,validator_17,160871597846,True,71324002,671260,71995262,True
802,validator_6,32830854835,True,130236999,18718100,148955099,True
803,validator_6,32912860464,True,81447999,557630,82005629,True
804,validator_46,97265200340,True,120277000,1263160,121540160,False
805,validator_23,32986701078,True,234683999,3482780,238166779,True
806,validator_6,33100953901,True,181360997,6732440,188093437,True
807,validator_27,96916801510,True,118373000,1434300,119807300,False
808,validator_4,32501348498,True,114878997,612480,115491477,True
809,validator_17,161014496480,True,137932994,4965640,142898634,True
810,validator_5,65080371457,True,92887999,1988900,94876899,True
811,validator_11,33085477903,True,83301995,1137590,84439585,True
812,validator_41,65344476400,True,83503000,19351500,102854500,False
813,validator_12,97197020785,True,92185000,13050570,105235570,True
814,validator_47,64573088690,True,103428000,687800,104115800,False
815,validator_7,64787915961,True,142115001,561220,142676221,True
816,validator_30,64423107900,True,53661000,8072580,61733580,False
817,validator_26,32683087320,True,188492000,314700,188806700,False
818,validator_48,160948037240,True,127078000,1211600,128289600,False
819,validator_29,32425321630,True,108245000,1309670,109554670,False
820,validator_6,33177865298,True,75477997,1433400,76911397,True
821,validator_32,32846734890,True,153182000,1478000,154660000,False
822,validator_32,32917850970,True,69630000,1486080,71116080,False
823,validator_0,33046190113,True,89068000,19091930,108159930,True
824,validator_34,257768543130,True,137289000,1996190,139285190,False
825,validator_10,32601387070,True,166389002,1406340,167795342,True
826,validator_15,257105727144,True,49490006,2146400,51636406,True
827,validator_46,97407972360,True,138004000,4768020,142772020,False
828,validator_43,64919310700,True,41343000,800900,42143900,False
829,validator_26,32831488240,True,148215000,185920,148400920,False
830,validator_18,97166077343,True,160421997,1206900,161628897,True
831,validator_19,65135218465,True,160625998,8273700,168899698,True
832,validator_22,65204875633,True,282162997,1149800,283312797,True
833,validator_19,65281882043,True,145838998,824580,146663578,True
834,validator_6,33229629914,True,49824996,1939620,51764616,True
835,validator_32,32976848260,True,40394000,18603290,58997290,False
836,validator_41,65387620640,True,42716000,428240,43144240,False
837,validator_45,32376349340,True,198925000,3702300,202627300,False
838,validator_5,65174953558,True,93799001,783100,94582101,True
839,validator_49,64893259930,True,164370000,1740740,166110740,False
840,validator_46,97574163950,True,164789000,1402590,166191590,False
841,validator_36,97590891010,True,95789000,6012800,101801800,False
842,validator_36,97741713370,True,150168000,654360,150822360,False
843,validator_16,32933008906,True,57672998,601600,58274598,True
844,validator_0,33178465711,True,128456998,3818600,132275598,True
845,validator_37,64896087100,True,115882000,2789860,118671860,False
846,validator_47,64672180290,True,81070000,18021600,99091600,False
847,validator_47,64829961770,True,157288000,493480,157781480,False
848,validator_16,33101460495,True,163014999,5436590,168451589,True
849,validator_37,65104392200,True,189516000,18789100,208305100,False
850,validator_17,161192991883,True,177517003,978400,178495403,True
851,validator_29,32475684130,True,45069000,5293500,50362500,False
852,validator_15,257352146315,True,244572001,1847170,246419171,True
853,validator_40,32487301690,True,111963000,8318300,120281300,False
854,validator_17,161289995526,True,90295003,6708640,97003643,True
855,validator_14,96593913493,True,225743998,1187030,226931028,True
856,validator_21,64235234399,True,233804999,1429400,235234399,True
857,validator_17,161408789531,True,100274005,18520000,118794005,True
858,validator_9,32933333465,True,82500003,384480,82884483,True
859,validator_10,32708033170,True,87912000,18734100,106646100,True
860,validator_25,32614112810,True,178535000,2574280,181109280,False
861,validator_32,33085068000,True,106221000,1998740,108219740,False
862,validator_17,161507270631,True,96537000,1944100,98481100,True
863,validator_18,97289074440,True,122206997,790100,122997097,True
864,validator_36,97833464110,True,90911000,839740,91750740,False
865,validator_28,33558862900,True,176295000,8286500,184581500,False
866,validator_49,64962321530,True,68437000,624600,69061600,False
867,validator_22,65257218638,True,51942005,401000,52343005,True
868,validator_46,97690724870,True,115701000,859920,116560920,False
869,validator_25,32836646810,True,221778000,756000,222534000,False
870,validator_23,33227412030,True,221028002,19682950,240710952,True
871,validator_39,33327169720,True,152770000,1278300,154048300,False
872,validator_1,64358416225,True,87039998,1318600,88358598,True
873,validator_16,33245202124,True,141363999,2377630,143741629,True
874,validator_46,97813158570,True,102673000,19760700,122433700,False
875,validator_2,32913315151,True,79922001,1208240,81130241,True
876,validator_15,257413949985,True,60573000,1230670,61803670,True
877,validator_37,65265136800,True,159611000,1133600,160744600,False
878,validator_48,161025204740,True,75541000,1626500,77167500,False
879,validator_48,161139311340,True,113196000,910600,114106600,False
880,validator_7,64864872441,True,76354000,602480,76956480,True
881,validator_35,96948714260,True,156980000,555400,157535400,False
882,validator_21,64347529716,True,110172997,2122320,112295317,True
883,validator_22,65370821380,True,111247002,2355740,113602742,True
884,validator_48,161302127010,True,160084000,2731670,162815670,False
885,validator_14,96683569496,True,88896003,760000,89656003,True
886,validator_5,65311961161,True,133510003,3497600,137007603,True
887,validator_34,257840642250,True,70386000,1713120,72099120,False
888,validator_17,161653469728,True,143632997,2566100,146199097,True
889,validator_25,32940714920,True,100334000,3734110,104068110,False
890,validator_18,97404382845,True,114553005,755400,115308405,True
891,validator_5,65463423158,True,149526997,1935000,151461997,True
892,validator_45,32435849840,True,59120000,380500,59500500,False
893,validator_7,64900366644,True,34652003,842200,35494203,True
894,validator_32,33129148320,True,42933000,1147320,44080320,False
895,validator_37,65319501400,True,53767000,597600,54364600,False
896,validator_7,65018523092,True,115438008,2718440,118156448,True
897,validator_28,33655272400,True,92927000,3482500,96409500,False
898,validator_31,161682447760,True,213666000,1882900,215548900,False
899,validator_11,33210831948,True,123849005,1505040,125354045,True
900,validator_21,64419834117,True,53992001,18312400,72304401,True
901,validator_41,65455295430,True,57534000,10140790,67674790,False
902,validator_24,32580582825,True,101625006,2026600,103651606,True
903,validator_27,97041700730,True,123850000,1049220,124899220,False
904,validator_21,64585487556,True,163687999,1965440,165653439,True
905,validator_14,96826399392,True,139660996,3168900,142829896,True
906,validator_6,33307742414,True,69237000,8875500,78112500,True
907,validator_23,33313293029,True,66338999,19542000,85880999,True
908,validator_1,64483245661,True,124202006,627430,124829436,True
909,validator_48,161444077710,True,141298000,652700,141950700,False
910,validator_36,97963306410,True,129193000,649300,129842300,False
911,validator_17,161952754218,True,244643000,54641490,299284490,True
912,validator_15,257566565586,True,134517001,18098600,152615601,True
913,validator_23,33385831860,True,70466001,2072830,72538831,True
914,validator_45,32487283840,True,49998000,1436000,51434000,False
915,validator_18,97463249220,True,56707995,2158380,58866375,True
916,validator_3,32716219822,True,118448999,584400,119033399,True
917,validator_18,97642126812,True,174291002,4586590,178877592,True
918,validator_29,32524725750,True,48626000,415620,49041620,False
919,validator_16,33386656527,True,139250003,2204400,141454403,True
920,validator_47,64961802130,True,130967000,873360,131840360,False
921,validator_15,257628622685,True,61558999,498100,62057099,True
922,validator_18,97763246413,True,102390001,18729600,121119601,True
923,validator_10,32873552911,True,153501001,12018740,165519741,True
924,validator_38,32872663510,True,68731000,770830,69501830,False
925,validator_2,33084272151,True,170068000,889000,170957000,True
926,validator_44,97203467570,True,128472000,9621800,138093800,False
927,validator_1,64690699802,True,206137001,1317140,207454141,True
928,validator_31,161920173560,True,236416000,1309800,237725800,False
929,validator_14,96974370974,True,147203002,768580,147971582,True
930,validator_18,97942064380,True,178669997,147970,178817967,True
931,validator_8,32566551557,True,90086999,8336600,98423599,True
932,validator_14,97065406874,True,89382000,1653900,91035900,True
933,validator_48,161562733510,True,116312000,2343800,118655800,False
934,validator_33,32998661450,True,168531000,1285520,169816520,False
935,validator_30,64562190800,True,136406000,2676900,139082900,False
936,validator_45,32568727530,True,80016000,1427690,81443690,False
937,validator_10,33057757712,True,183547001,657800,184204801,True
938,validator_48,161681187110,True,117193000,1260600,118453600,False
939,validator_3,32841639702,True,120065000,5354880,125419880,True
940,validator_40,32620867810,True,128141000,5425120,133566120,False
941,validator_42,32898443460,True,74969000,1175080,76144080,False
942,validator_13,32571135699,True,116783000,2401200,119184200,True
943,validator_17,162069107651,True,114926003,1427430,116353433,True
944,validator_34,257960807890,True,119595000,570640,120165640,False
945,validator_10,33140661653,True,75143001,7760940,82903941,True
946,validator_49,65091360430,True,128294000,744900,129038900,False
947,validator_11,33285343392,True,73443004,1068440,74511444,True
948,validator_4,32656732599,True,146724001,8660100,155384101,True
949,validator_41,65608243950,True,151631000,1317520,152948520,False
950,validator_17,162284683948,True,214977997,598300,215576297,True
951,validator_14,97209443204,True,142006000,2030330,144036330,True
952,validator_22,65493489310,True,121872000,795930,122667930,True
953,validator_41,65680141150,True,70676000,1221200,71897200,False
954,validator_10,33306182654,True,159803001,5718000,165521001,True
955,validator_49,65227227230,True,129594000,6272800,135866800,False
956,validator_47,65074518910,True,111872000,844780,112716780,False
957,validator_17,162414625140,True,127416002,2525190,129941192,True
958,validator_6,33398253556,True,89920002,591140,90511142,True
959,validator_0,33290014342,True,110692001,856630,111548631,True
960,validator_2,33296146181,True,211699000,175030,211874030,True
961,validator_49,65311197430,True,73877000,10093200,83970200,False
962,validator_46,97911285990,True,96929000,1198420,98127420,False
963,validator_27,97195588770,True,153404000,484040,153888040,False
964,validator_47,65181017130,True,105463000,1035220,106498220,False
965,validator_44,97392151370,True,188454000,229800,188683800,False
966,validator_20,33079917050,True,87186004,2479670,89665674,True
967,validator_27,97298383900,True,101290000,1505130,102795130,False
968,validator_46,98099388190,True,186324000,1778200,188102200,False
969,validator_29,32648192150,True,114613000,8853400,123466400,False
970,validator_6,33430063156,True,31605000,204600,31809600,True
971,validator_44,97653287370,True,260486000,650000,261136000,False
972,validator_22,65629090909,True,134654999,946600,135601599,True
973,validator_8,32700820648,True,127278001,6991090,134269091,True
974,validator_47,65328953610,True,146851000,1085480,147936480,False
975,validator_41,66031923500,True,350411000,1371350,351782350,False
976,validator_29,32752406080,True,102183000,2030930,104213930,False
977,validator_29,32888131450,True,134163000,1562370,135725370,False
978,validator_2,33455703272,True,158114001,1443090,159557091,True
979,validator_22,65725266135,True,95137006,1038220,96175226,True
980,validator_29,33021604350,True,132483000,989900,133472900,False
981,validator_14,97333556244,True,119000000,5113040,124113040,True
982,validator_22,65785460040,True,57102005,3091900,60193905,True
983,validator_13,32627299827,True,55677998,486130,56164128,True
984,validator_10,33417070944,True,109574000,1314290,110888290,True
985,validator_33,33140593290,True,129675000,12256840,141931840,False
986,validator_19,65355032443,True,72808000,342400,73150400,True
987,validator_35,97048034060,True,99063000,256800,99319800,False
988,validator_22,66095421817,True,309784997,176780,309961777,True
989,validator_41,66201563060,True,167477000,2162560,169639560,False
990,validator_42,33019266990,True,116446000,4377530,120823530,False
991,validator_25,33075443920,True,132346000,2383000,134729000,False
992,validator_38,32944768280,True,71828000,276770,72104770,False
993,validator_10,33560856048,True,141650004,2135100,143785104,True
994,validator_0,33402231670,True,111416998,800330,112217328,True
995,validator_23,33554855161,True,168725001,298300,169023301,True
996,validator_40,32784986010,True,162372000,1746200,164118200,False
997,validator_33,33244760430,True,102932000,1235140,104167140,False
998,validator_39,33474241020,True,144928000,2143300,147071300,False
999,validator_31,162186425580,True,264543000,1709020,266252020,False
1000,validator_18,96128910041,True,127529001,1381040,128910041,True
1001,validator_19,64121972386,True,121044996,927390,121972386,True
1002,validator_14,96141416901,True,115480001,25936900,141416901,True
1003,validator_15,256141618599,True,136370999,5247600,141618599,True
1004,validator_15,256287555151,True,145426002,510550,145936552,True
1005,validator_37,64134756300,True,132912000,1844300,134756300,False
1006,validator_48,160130734230,True,129421000,1313230,130734230,False
1007,validator_27,96074262300,True,71916000,2346300,74262300,False
1008,validator_41,64092899300,True,92498000,401300,92899300,False
1009,validator_15,256346569851,True,57338000,1676700,59014700,True
1010,validator_44,96089216800,True,88784000,432800,89216800,False
1011,validator_0,32166798502,True,158512002,8286500,166798502,True
1012,validator_45,32066929240,True,51134000,15795240,66929240,False
1013,validator_12,96178003233,True,173936003,4067230,178003233,True
1014,validator_37,64289859800,True,150236000,4867500,155103500,False
1015,validator_28,32142861200,True,140550000,2311200,142861200,False
1016,validator_27,96173979300,True,99103000,614000,99717000,False
1017,validator_28,32277097570,True,124692000,9544370,134236370,False
1018,validator_18,96211224075,True,81152004,1162030,82314034,True
1019,validator_15,256475164644,True,127882003,712790,128594793,True
1020,validator_31,160186818800,True,184681000,2137800,186818800,False
1021,validator_20,32137200877,True,136528997,671880,137200877,True
1022,validator_42,32184220940,True,163425000,20795940,184220940,False
1023,validator_23,32048351101,True,46948001,1403100,48351101,True
1024,validator_36,96087197990,True,85951000,1246990,87197990,False
1025,validator_6,32165096922,True,162449002,2647920,165096922,True
1026,validator_47,64136954900,True,136151000,803900,136954900,False
1027,validator_37,64342353000,True,46328000,6165200,52493200,False
1028,validator_27,96224585040,True,48765000,1840740,50605740,False
1029,validator_39,32044610220,True,43986000,624220,44610220,False
1030,validator_36,96221380130,True,132162000,2020140,134182140,False
1031,validator_18,96416850459,True,185696994,19929390,205626384,True
1032,validator_27,96385356870,True,159285000,1486830,160771830,False
1033,validator_47,64193728790,True,55553000,1220890,56773890,False
1034,validator_2,32136653101,True,134777001,1876100,136653101,True
1035,validator_38,32120147900,True,119785000,362900,120147900,False
1036,validator_48,160239637120,True,106882000,2020890,108902890,False
1037,validator_12,96347652829,True,168941996,707600,169649596,True
1038,validator_19,64234298906,True,107184000,5142520,112326520,True
1039,validator_44,96194591400,True,103532000,1842600,105374600,False
1040,validator_32,32148836630,True,140968000,7868630,148836630,False
1041,validator_20,32299507959,True,161193002,1114080,162307082,True
1042,validator_43,64032058100,True,31669000,389100,32058100,False
1043,validator_28,32381891170,True,81785000,23008600,104793600,False
1044,validator_22,64215305253,True,213734993,1570260,215305253,True
1045,validator_28,32551174670,True,168407000,876500,169283500,False
1046,validator_39,32083066290,True,37262000,1194070,38456070,False
1047,validator_38,32227098200,True,103891000,3059300,106950300,False
1048,validator_31,160394972800,True,207106000,1048000,208154000,False
1049,validator_34,256155416780,True,154271000,1145780,155416780,False
1050,validator_48,160346736360,True,106352000,747240,107099240,False
1051,validator_43,64081998010,True,48666000,1273910,49939910,False
1052,validator_27,96429360270,True,41506000,2497400,44003400,False
1053,validator_44,96308650600,True,111945000,2114200,114059200,False
1054,validator_25,32048004200,True,47488000,516200,48004200,False
1055,validator_3,32177654734,True,164511994,13142740,177654734,True
1056,validator_20,32446068057,True,145210998,1349100,146560098,True
1057,validator_29,32068527600,True,62760000,5767600,68527600,False
1058,validator_39,32225495690,True,137093000,5336400,142429400,False
1059,validator_46,96179682500,True,161210000,18472500,179682500,False
1060,validator_39,32350872690,True,124204000,1173000,125377000,False
1061,validator_20,32587875456,True,140073999,1733400,141807399,True
1062,validator_5,64144231751,True,142787001,1444750,144231751,True
1063,validator_34,256293439080,True,137160000,862300,138022300,False
1064,validator_29,32099421390,True,28545000,2348790,30893790,False
1065,validator_36,96325356530,True,95681000,8295400,103976400,False
1066,validator_49,64121726040,True,120519000,1207040,121726040,False
1067,validator_32,32352697530,True,200855000,3005900,203860900,False
1068,validator_38,32407906500,True,179397000,1411300,180808300,False
1069,validator_23,32112208124,True,45287003,18570020,63857023,True
1070,validator_22,64280484957,True,59597004,5582700,65179704,True
1071,validator_34,256390068180,True,87589000,9040100,96629100,False
1072,validator_17,160073329996,True,71764996,1565000,73329996,True
1073,validator_11,32164955798,True,164013998,941800,164955798,True
1074,validator_28,32694728700,True,136012000,7542030,143554030,False
1075,validator_49,64223087490,True,100628000,733450,101361450,False
1076,validator_17,160134268499,True,59856003,1082500,60938503,True
1077,validator_28,32825449500,True,128699000,2021800,130720800,False
1078,validator_31,160496000800,True,99890000,1138000,101028000,False
1079,validator_12,96431421869,True,74305000,9464040,83769040,True
1080,validator_10,32161665297,True,143396997,18268300,161665297,True
1081,validator_19,64484381908,True,249637002,446000,250083002,True
1082,validator_28,32868681300,True,42723000,508800,43231800,False
1083,validator_17,160361751901,True,225882002,1601400,227483402,True
1084,validator_26,32082845400,True,81714000,1131400,82845400,False
1085,validator_35,96100070520,True,98490000,1580520,100070520,False
1086,validator_7,64110915329,True,109936999,978330,110915329,True
1087,validator_3,32345528226,True,148964992,18908500,167873492,True
1088,validator_0,32282506706,True,115093004,615200,115708204,True
1089,validator_42,32361284940,True,156906000,20158000,177064000,False
1090,validator_1,64135003324,True,134203004,800320,135003324,True
1091,validator_2,32296169813,True,158083992,1432720,159516712,True
1092,validator_8,32119015299,True,113195999,5819300,119015299,True
1093,validator_48,160488354060,True,141093000,524700,141617700,False
1094,validator_3,32523263729,True,174638003,3097500,177735503,True
1095,validator_40,32108059390,True,106575000,1484390,108059390,False
1096,validator_30,64127873920,True,126028000,1845920,127873920,False
1097,validator_5,64474020673,True,328360002,1428920,329788922,True
1098,validator_41,64221020120,True,126346000,1774820,128120820,False
1099,validator_9,32177522740,True,158702000,18820740,177522740,True
1100,validator_13,32120192597,True,118679997,1512600,120192597,True
1101,validator_36,96432950770,True,105120000,2474240,107594240,False
1102,validator_39,32426336690,True,67869000,7595000,75464000,False
1103,validator_7,64325423626,True,211829997,2678300,214508297,True
1104,validator_43,64313097790,True,225549000,5550780,231099780,False
1105,validator_0,32506071148,True,221110992,2453450,223564442,True
1106,validator_18,96505554303,True,88038004,665840,88703844,True
1107,validator_18,96733595543,True,226920000,1121240,228041240,True
1108,validator_34,256530373880,True,129535000,10770700,140305700,False
1109,validator_5,64555139912,True,71218999,9900240,81119239,True
1110,validator_28,33013759600,True,144766000,312300,145078300,False
1111,validator_28,33172508060,True,157678000,1070460,158748460,False
1112,validator_46,96257515800,True,76585000,1248300,77833300,False
1113,validator_33,32114812400,True,95698000,19114400,114812400,False
1114,validator_25,32149736700,True,96300000,5432500,101732500,False
1115,validator_0,32669977720,True,149220992,14685580,163906572,True
1116,validator_16,32142680602,True,141703002,977600,142680602,True
1117,validator_39,32598381620,True,171842000,202930,172044930,False
1118,validator_48,160647790500,True,158883000,553440,159436440,False
1119,validator_31,160563661300,True,66199000,1461500,67660500,False
1120,validator_36,96632384370,True,198068000,1365600,199433600,False
1121,validator_38,32534942040,True,125195000,1840540,127035540,False
1122,validator_22,64386749756,True,100228999,6035800,106264799,True
1123,validator_17,160492093293,True,106546002,23795390,130341392,True
1124,validator_7,64446981758,True,121077002,481130,121558132,True
1125,validator_34,256611162880,True,79422000,1367000,80789000,False
1126,validator_20,32762368796,True,173920000,573340,174493340,True
1127,validator_36,96798837370,True,129685000,36768000,166453000,False
1128,validator_46,96330330540,True,72584000,230740,72814740,False
1129,validator_24,32130560795,True,125350005,5210790,130560795,True
1130,validator_48,160773219860,True,125053000,376360,125429360,False
1131,validator_15,256631189043,True,155382999,641400,156024399,True
1132,validator_9,32346652438,True,167749998,1379700,169129698,True
1133,validator_12,96568407008,True,136114999,870140,136985139,True
1134,validator_19,64543097209,True,58242001,473300,58715301,True
1135,validator_9,32522859939,True,172811001,3396500,176207501,True
1136,validator_20,32850897696,True,87476000,1052900,88528900,True
1137,validator_36,96848543670,True,49040000,666300,49706300,False
1138,validator_35,96207351420,True,98517000,8763900,107280900,False
1139,validator_16,32382868179,True,238771997,1415580,240187577,True
1140,validator_39,32792947820,True,193720000,846200,194566200,False
1141,validator_44,96427989940,True,118906000,433340,119339340,False
1142,validator_35,96307325720,True,98931000,1043300,99974300,False
1143,validator_26,32146037180,True,62800000,391780,63191780,False
1144,validator_34,256722364080,True,110510000,691200,111201200,False
1145,validator_14,96250923004,True,101537003,7969100,109506103,True
1146,validator_31,160762691080,True,194089000,4940780,199029780,False
1147,validator_37,64489107200,True,144263000,2491200,146754200,False
1148,validator_44,96566635320,True,136232000,2413380,138645380,False
1149,validator_1,64270057627,True,133443003,1611300,135054303,True
1150,validator_13,32213547794,True,86255997,7099200,93355197,True
1151,validator_5,64662410311,True,104073999,3196400,107270399,True
1152,validator_0,32826780753,True,156411003,392030,156803033,True
1153,validator_46,96542265480,True,205934000,6000940,211934940,False
1154,validator_14,96294853264,True,43218000,712260,43930260,True
1155,validator_4,32212748920,True,211209000,1539920,212748920,True
1156,validator_34,256844241980,True,121487000,390900,121877900,False
1157,validator_8,32161710001,True,42288002,406700,42694702,True
1158,validator_34,256949413080,True,105072000,99100,105171100,False
1159,validator_41,64340885340,True,118939000,926220,119865220,False
1160,validator_37,64557541620,True,68225000,209420,68434420,False
1161,validator_12,96655349234,True,84398996,2543230,86942226,True
1162,validator_34,257133807480,True,184147000,247400,184394400,False
1163,validator_5,64826506353,True,163213002,883040,164096042,True
1164,validator_30,64225437420,True,93026000,4537500,97563500,False
1165,validator_49,64302827890,True,77572000,2168400,79740400,False
1166,validator_31,160886554920,True,123396000,467840,123863840,False
1167,validator_23,32257816394,True,144538000,1070270,145608270,True
1168,validator_45,32173722040,True,105308000,1484800,106792800,False
1169,validator_22,64496000851,True,101102995,8148100,109251095,True
1170,validator_17,160548375614,True,55838001,444320,56282321,True
1171,validator_42,32512134320,True,142992000,7857380,150849380,False
1172,validator_39,32905967020,True,111636000,1383200,113019200,False
1173,validator_7,64573084198,True,108073000,18029440,126102440,True
1174,validator_31,160980488360,True,75515000,18418440,93933440,False
1175,validator_46,96605205610,True,60860000,2080130,62940130,False
1176,validator_17,160604291114,True,47560000,8355500,55915500,True
1177,validator_16,32586240679,True,201479000,1893500,203372500,True
1178,validator_32,32521044330,True,167166000,1180800,168346800,False
1179,validator_47,64304049890,True,108792000,1529100,110321100,False
1180,validator_35,96408281220,True,99937000,1018500,100955500,False
1181,validator_44,96702937100,True,117849000,18452780,136301780,False
1182,validator_19,64644264134,True,100572995,593930,101166925,True
1183,validator_6,32244331720,True,56799998,22434800,79234798,True
1184,validator_43,64407853330,True,93156000,1599540,94755540,False
1185,validator_12,96831709513,True,175849999,510280,176360279,True
1186,validator_2,32392940210,True,96344997,425400,96770397,True
1187,validator_41,64449786840,True,107402000,1499500,108901500,False
1188,validator_34,257241088380,True,88866000,18414900,107280900,False
1189,validator_10,32223516697,True,60185000,1666400,61851400,True
1190,validator_36,96922159950,True,72149000,1467280,73616280,False
1191,validator_41,64720855870,True,270404000,665030,271069030,False
1192,validator_43,64573716250,True,147660000,18202920,165862920,False
1193,validator_41,64810486670,True,89049000,581800,89630800,False
1194,validator_11,32277619602,True,93945004,18718800,112663804,True
1195,validator_49,64472770790,True,168498000,1444900,169942900,False
1196,validator_36,97124393630,True,193975000,8258680,202233680,False
1197,validator_39,33025239020,True,110182000,9090000,119272000,False
1198,validator_2,32576442713,True,177101003,6401500,183502503,True
1199,validator_30,64361374320,True,133949000,1987900,135936900,False
1200,validator_24,32271110392,True,138362997,2186600,140549597,True
1201,validator_16,32780396887,True,174466008,19690200,194156208,True
1202,validator_44,96802781370,True,99111000,733270,99844270,False
1203,validator_38,32644203240,True,83317000,25944200,109261200,False
1204,validator_27,96551607370,True,120649000,1598100,122247100,False
1205,validator_8,32326233297,True,162982996,1540300,164523296,True
1206,validator_29,32153009620,True,53002000,586230,53588230,False
1207,validator_10,32433591728,True,207036001,3039030,210075031,True
1208,validator_35,96476024220,True,59198000,8545000,67743000,False
1209,validator_11,32377145222,True,97874000,1651620,99525620,True
1210,validator_39,33173121420,True,146179000,1703400,147882400,False
1211,validator_28,33374281400,True,199040000,2733340,201773340,False
1212,validator_17,160736719948,True,131660004,768830,132428834,True
1213,validator_25,32265319300,True,96908000,18674600,115582600,False
1214,validator_48,160819747640,True,44964000,1563780,46527780,False
1215,validator_15,256717199945,True,85057002,953900,86010902,True
1216,validator_33,32359068700,True,242780000,1476300,244256300,False
1217,validator_46,96780662850,True,173674000,1783240,175457240,False
1218,validator_22,64602373830,True,105164999,1207980,106372979,True
1219,validator_49,64601123590,True,127770000,582800,128352800,False
1220,validator_24,32476931219,True,204132997,1687830,205820827,True
1221,validator_22,64713831782,True,109834992,1622960,111457952,True
1222,validator_33,32469663700,True,100989000,9606000,110595000,False
1223,validator_6,32374559136,True,128273996,1953420,130227416,True
1224,validator_40,32215954490,True,107657000,238100,107895100,False
1225,validator_35,96558518620,True,81797000,697400,82494400,False
1226,validator_34,257343967880,True,102056000,823500,102879500,False
1227,validator_31,161059846060,True,78260000,1097700,79357700,False
1228,validator_11,32503226319,True,95849997,30231100,126081097,True
1229,validator_42,32609513160,True,96901000,477840,97378840,False
1230,validator_19,64788724563,True,144161999,298430,144460429,True
1231,validator_7,64645239740,True,71975002,180540,72155542,True
1232,validator_9,32650687817,True,126607998,1219880,127827878,True
1233,validator_20,32990251376,True,133634000,5719680,139353680,True
1234,validator_8,32468127958,True,139238001,2656660,141894661,True
1235,validator_32,32692074890,True,170155000,875560,171030560,False
1236,validator_25,32433003530,True,166175000,1509230,167684230,False
1237,validator_16,32874734308,True,93933001,404420,94337421,True
1238,validator_18,96874486744,True,123054001,17837200,140891201,True
1239,validator_22,64811009779,True,88085997,9092000,97177997,True
1240,validator_36,97309640530,True,184461000,785900,185246900,False
1241,validator_34,257469022550,True,117563000,7491670,125054670,False
1242,validator_35,96614271160,True,47821000,7931540,55752540,False
1243,validator_35,96791178860,True,175438000,1469700,176907700,False
1244,validator_23,32497010526,True,216234002,22960130,239194132,True
1245,validator_4,32385857021,True,172050001,1058100,173108101,True
1246,validator_31,161216970760,True,156209000,915700,157124700,False
1247,validator_11,32582862615,True,77752996,1883300,79636296,True
1248,validator_27,96713804070,True,161219000,977700,162196700,False
1249,validator_44,97065373770,True,261906000,686400,262592400,False
1250,validator_43,64743983700,True,167440000,2827450,170267450,False
1251,validator_26,32345012480,True,198357000,618300,198975300,False
1252,validator_36,97411913930,True,101218000,1055400,102273400,False
1253,validator_26,32494280620,True,147830000,1438140,149268140,False
1254,validator_41,64954725870,True,121934000,22305200,144239200,False
1255,validator_49,64727149190,True,100397000,25628600,126025600,False
1256,validator_18,97004448446,True,122436002,7525700,129961702,True
1257,validator_0,32938030183,True,110331000,918430,111249430,True
1258,validator_46,96889446780,True,108104000,679930,108783930,False
1259,validator_34,257629257940,True,152035000,8200390,160235390,False
1260,validator_46,97013679180,True,105514000,18718400,124232400,False
1261,validator_11,32878903716,True,294338001,1703100,296041101,True
1262,validator_31,161327947260,True,109130000,1846500,110976500,False
1263,validator_27,96796994210,True,64678000,18512140,83190140,False
1264,validator_33,32579749000,True,90565000,19520300,110085300,False
1265,validator_12,97091785215,True,241528002,18547700,260075702,True
1266,validator_37,64600973440,True,43098000,333820,43431820,False
1267,validator_33,32736236530,True,155593000,894530,156487530,False
1268,validator_9,32776054456,True,123901999,1464640,125366639,True
1269,validator_23,32649035599,True,132778003,19247070,152025073,True
1270,validator_29,32315766960,True,161425000,1332340,162757340,False
1271,validator_47,64468972890,True,162714000,2209000,164923000,False
1272,validator_13,32320700696,True,106120002,1032900,107152902,True
1273,validator_6,32498795939,True,123485003,751800,124236803,True
1274,validator_36,97489089210,True,75171000,2004280,77175280,False
1275,validator_43,64877166800,True,131346000,1837100,133183100,False
1276,validator_2,32832184910,True,254111997,1630200,255742197,True
1277,validator_17,160799602584,True,54906996,7975640,62882636,True
1278,validator_6,32581423135,True,81580996,1046200,82627196,True
1279,validator_19,64966318767,True,176318004,1276200,177594204,True
1280,validator_15,256900145237,True,166537002,16408290,182945292,True
1281,validator_33,32828844930,True,91370000,1238400,92608400,False
1282,validator_37,64777415240,True,157826000,18615800,176441800,False
1283,validator_23,32748534299,True,81466000,18032700,99498700,True
1284,validator_11,33001038318,True,121187002,947600,122134602,True
1285,validator_46,97143660180,True,128994000,987000,129981000,False
1286,validator_3,32597186423,True,71834994,2087700,73922694,True
1287,validator_40,32367020390,True,148603000,2462900,151065900,False
1288,validator_6,32681899736,True,98940001,1536600,100476601,True
1289,validator_41,65088716370,True,115225000,18765500,133990500,False
1290,validator_41,65241621900,True,150384000,2521530,152905530,False
1291,validator_42,32822299380,True,211688000,1098220,212786220,False
1292,validator_9,32850448982,True,73095996,1298530,74394526,True
1293,validator_5,64878900256,True,51628003,765900,52393903,True
1294,validator_14,96366982465,True,69592001,2537200,72129201,True
1295,validator_5,64985494558,True,105555002,1039300,106594302,True
1296,validator_31,161466898860,True,119254000,19697600,138951600,False
1297,validator_22,64921562836,True,110086997,466060,110553057,True
1298,validator_13,32451951499,True,128819003,2431800,131250803,True
1299,validator_38,32803161680,True,157910000,1048440,158958440,False
1300,validator_15,257054090738,True,145912001,8033500,153945501,True
1301,validator_17,160871597846,True,71324002,671260,71995262,True
1302,validator_6,32830854835,True,130236999,18718100,148955099,True
1303,validator_6,32912860464,True,81447999,557630,82005629,True
1304,validator_46,97265200340,True,120277000,1263160,121540160,False
1305,validator_23,32986701078,True,234683999,3482780,238166779,True
1306,validator_6,33100953901,True,181360997,6732440,188093437,True
1307,validator_27,96916801510,True,118373000,1434300,119807300,False
1308,validator_4,32501348498,True,114878997,612480,115491477,True
1309,validator_17,161014496480,True,137932994,4965640,142898634,True
1310,validator_5,65080371457,True,92887999,1988900,94876899,True
1311,validator_11,33085477903,True,83301995,1137590,84439585,True
1312,validator_41,65344476400,True,83503000,19351500,102854500,False
1313,validator_12,97197020785,True,92185000,13050570,105235570,True
1314,validator_47,64573088690,True,103428000,687800,104115800,False
1315,validator_7,64787915961,True,142115001,561220,142676221,True
1316,validator_30,64423107900,True,53661000,8072580,61733580,False
1317,validator_26,32683087320,True,188492000,314700,188806700,False
1318,validator_48,160948037240,True,127078000,1211600,128289600,False
1319,validator_29,32425321630,True,108245000,1309670,109554670,False
1320,validator_6,33177865298,True,75477997,1433400,76911397,True
1321,validator_32,32846734890,True,153182000,1478000,154660000,False
1322,validator_32,32917850970,True,69630000,1486080,71116080,False
1323,validator_0,33046190113,True,89068000,19091930,108159930,True
1324,validator_34,257768543130,True,137289000,1996190,139285190,False
1325,validator_10,32601387070,True,166389002,1406340,167795342,True
1326,validator_15,257105727144,True,49490006,2146400,51636406,True
1327,validator_46,97407972360,True,138004000,4768020,142772020,False
1328,validator_43,64919310700,True,41343000,800900,42143900,False
1329,validator_26,32831488240,True,148215000,185920,148400920,False
1330,validator_18,97166077343,True,160421997,1206900,161628897,True
1331,validator_19,65135218465,True,160625998,8273700,168899698,True
1332,validator_22,65204875633,True,282162997,1149800,283312797,True
1333,validator_19,65281882043,True,145838998,824580,146663578,True
1334,validator_6,33229629914,True,49824996,1939620,51764616,True
1335,validator_32,32976848260,True,40394000,18603290,58997290,False
1336,validator_41,65387620640,True,42716000,428240,43144240,False
1337,validator_45,32376349340,True,198925000,3702300,202627300,False
1338,validator_5,65174953558,True,93799001,783100,94582101,True
1339,validator_49,64893259930,True,164370000,1740740,166110740,False
1340,validator_46,97574163950,True,164789000,1402590,166191590,False
1341,validator_36,97590891010,True,95789000,6012800,101801800,False
1342,validator_36,97741713370,True,150168000,654360,150822360,False
1343,validator_16,32933008906,True,57672998,601600,58274598,True
1344,validator_0,33178465711,True,128456998,3818600,132275598,True
1345,validator_37,64896087100,True,115882000,2789860,118671860,False
1346,validator_47,64672180290,True,81070000,18021600,99091600,False
1347,validator_47,64829961770,True,157288000,493480,157781480,False
1348,validator_16,33101460495,True,163014999,5436590,168451589,True
1349,validator_37,65104392200,True,189516000,18789100,208305100,False
1350,validator_17,161192991883,True,177517003,978400,178495403,True
1351,validator_29,32475684130,True,45069000,5293500,50362500,False
1352,validator_15,257352146315,True,244572001,1847170,246419171,True
1353,validator_40,32487301690,True,111963000,8318300,120281300,False
1354,validator_17,161289995526,True,90295003,6708640,97003643,True
1355,validator_14,96593913493,True,225743998,1187030,226931028,True
1356,validator_21,64235234399,True,233804999,1429400,235234399,True
1357,validator_17,161408789531,True,100274005,18520000,118794005,True
1358,validator_9,32933333465,True,82500003,384480,82884483,True
1359,validator_10,32708033170,True,87912000,18734100,106646100,True
1360,validator_25,32614112810,True,178535000,2574280,181109280,False
1361,validator_32,33085068000,True,106221000,1998740,108219740,False
1362,validator_17,161507270631,True,96537000,1944100,98481100,True
1363,validator_18,97289074440,True,122206997,790100,122997097,True
1364,validator_36,97833464110,True,90911000,839740,91750740,False
1365,validator_28,33558862900,True,176295000,8286500,184581500,False
1366,validator_49,64962321530,True,68437000,624600,69061600,False
1367,validator_22,65257218638,True,51942005,401000,52343005,True
1368,validator_46,97690724870,True,115701000,859920,116560920,False
1369,validator_25,32836646810,True,221778000,756000,222534000,False
1370,validator_23,33227412030,True,221028002,19682950,240710952,True
1371,validator_39,33327169720,True,152770000,1278300,154048300,False
1372,validator_1,64358416225,True,87039998,1318600,88358598,True
1373,validator_16,33245202124,True,141363999,2377630,143741629,True
1374,validator_46,97813158570,True,102673000,19760700,122433700,False
1375,validator_2,32913315151,True,79922001,1208240,81130241,True
1376,validator_15,257413949985,True,60573000,1230670,61803670,True
1377,validator_37,65265136800,True,159611000,1133600,160744600,False
1378,validator_48,161025204740,True,75541000,1626500,77167500,False
1379,validator_48,161139311340,True,113196000,910600,114106600,False
1380,validator_7,64864872441,True,76354000,602480,76956480,True
1381,validator_35,96948714260,True,156980000,555400,157535400,False
1382,validator_21,64347529716,True,110172997,2122320,112295317,True
1383,validator_22,65370821380,True,111247002,2355740,113602742,True
1384,validator_48,161302127010,True,160084000,2731670,162815670,False
1385,validator_14,96683569496,True,88896003,760000,89656003,True
1386,validator_5,65311961161,True,133510003,3497600,137007603,True
1387,validator_34,257840642250,True,70386000,1713120,72099120,False
1388,validator_17,161653469728,True,143632997,2566100,146199097,True
1389,validator_25,32940714920,True,100334000,3734110,104068110,False
1390,validator_18,97404382845,True,114553005,755400,115308405,True
1391,validator_5,65463423158,True,149526997,1935000,151461997,True
1392,validator_45,32435849840,True,59120000,380500,59500500,False
1393,validator_7,64900366644,True,34652003,842200,35494203,True
1394,validator_32,33129148320,True,42933000,1147320,44080320,False
1395,validator_37,65319501400,True,53767000,597600,54364600,False
1396,validator_7,65018523092,True,115438008,2718440,118156448,True
1397,validator_28,33655272400,True,92927000,3482500,96409500,False
1398,validator_31,161682447760,True,213666000,1882900,215548900,False
1399,validator_11,33210831948,True,123849005,1505040,125354045,True
1400,validator_21,64419834117,True,53992001,18312400,72304401,True
1401,validator_41,65455295430,True,57534000,10140790,67674790,False
1402,validator_24,32580582825,True,101625006,2026600,103651606,True
1403,validator_27,97041700730,True,123850000,1049220,124899220,False
1404,validator_21,64585487556,True,163687999,1965440,165653439,True
1405,validator_14,96826399392,True,139660996,3168900,142829896,True
1406,validator_6,33307742414,True,69237000,8875500,78112500,True
1407,validator_23,33313293029,True,66338999,19542000,85880999,True
1408,validator_1,64483245661,True,124202006,627430,124829436,True
1409,validator_48,161444077710,True,141298000,652700,141950700,False
1410,validator_36,97963306410,True,129193000,649300,129842300,False
1411,validator_17,161952754218,True,244643000,54641490,299284490,True
1412,validator_15,257566565586,True,134517001,18098600,152615601,True
1413,validator_23,33385831860,True,70466001,2072830,72538831,True
1414,validator_45,32487283840,True,49998000,1436000,51434000,False
1415,validator_18,97463249220,True,56707995,2158380,58866375,True
1416,validator_3,32716219822,True,118448999,584400,119033399,True
1417,validator_18,97642126812,True,174291002,4586590,178877592,True
1418,validator_29,32524725750,True,48626000,415620,49041620,False
1419,validator_16,33386656527,True,139250003,2204400,141454403,True
1420,validator_47,64961802130,True,130967000,873360,131840360,False
1421,validator_15,257628622685,True,61558999,498100,62057099,True
1422,validator_18,97763246413,True,102390001,18729600,121119601,True
1423,validator_10,32873552911,True,153501001,12018740,165519741,True
1424,validator_38,32872663510,True,68731000,770830,69501830,False
1425,validator_2,33084272151,True,170068000,889000,170957000,True
1426,validator_44,97203467570,True,128472000,9621800,138093800,False
1427,validator_1,64690699802,True,206137001,1317140,207454141,True
1428,validator_31,161920173560,True,236416000,1309800,237725800,False
1429,validator_14,96974370974,True,147203002,768580,147971582,True
1430,validator_18,97942064380,True,178669997,147970,178817967,True
1431,validator_8,32566551557,True,90086999,8336600,98423599,True
1432,validator_14,97065406874,True,89382000,1653900,91035900,True
1433,validator_48,161562733510,True,116312000,2343800,118655800,False
1434,validator_33,32998661450,True,168531000,1285520,169816520,False
1435,validator_30,64562190800,True,136406000,2676900,139082900,False
1436,validator_45,32568727530,True,80016000,1427690,81443690,False
1437,validator_10,33057757712,True,183547001,657800,184204801,True
1438,validator_48,161681187110,True,117193000,1260600,118453600,False
1439,validator_3,32841639702,True,120065000,5354880,125419880,True
1440,validator_40,32620867810,True,128141000,5425120,133566120,False
1441,validator_42,32898443460,True,74969000,1175080,76144080,False
1442,validator_13,32571135699,True,116783000,2401200,119184200,True
1443,validator_17,162069107651,True,114926003,1427430,116353433,True
1444,validator_34,257960807890,True,119595000,570640,120165640,False
1445,validator_10,33140661653,True,75143001,7760940,82903941,True
1446,validator_49,65091360430,True,128294000,744900,129038900,False
1447,validator_11,33285343392,True,73443004,1068440,74511444,True
1448,validator_4,32656732599,True,146724001,8660100,155384101,True
1449,validator_41,65608243950,True,151631000,1317520,152948520,False
1450,validator_17,162284683948,True,214977997,598300,215576297,True
1451,validator_14,97209443204,True,142006000,2030330,144036330,True
1452,validator_22,65493489310,True,121872000,795930,122667930,True
1453,validator_41,65680141150,True,70676000,1221200,71897200,False
1454,validator_10,33306182654,True,159803001,5718000,165521001,True
1455,validator_49,65227227230,True,129594000,6272800,135866800,False
1456,validator_47,65074518910,True,111872000,844780,112716780,False
1457,validator_17,162414625140,True,127416002,2525190,129941192,True
1458,validator_6,33398253556,True,89920002,591140,90511142,True
1459,validator_0,33290014342,True,110692001,856630,111548631,True
1460,validator_2,33296146181,True,211699000,175030,211874030,True
1461,validator_49,65311197430,True,73877000,10093200,83970200,False
1462,validator_46,97911285990,True,96929000,1198420,98127420,False
1463,validator_27,97195588770,True,153404000,484040,153888040,False
1464,validator_47,65181017130,True,105463000,1035220,106498220,False
1465,validator_44,97392151370,True,188454000,229800,188683800,False
1466,validator_20,33079917050,True,87186004,2479670,89665674,True
1467,validator_27,97298383900,True,101290000,1505130,102795130,False
1468,validator_46,98099388190,True,186324000,1778200,188102200,False
1469,validator_29,32648192150,True,114613000,8853400,123466400,False
1470,validator_6,33430063156,True,31605000,204600,31809600,True
1471,validator_44,97653287370,True,260486000,650000,261136000,False
1472,validator_22,65629090909,True,134654999,946600,135601599,True
1473,validator_8,32700820648,True,127278001,6991090,134269091,True
1474,validator_47,65328953610,True,146851000,1085480,147936480,False
1475,validator_41,66031923500,True,350411000,1371350,351782350,False
1476,validator_29,32752406080,True,102183000,2030930,104213930,False
1477,validator_29,32888131450,True,134163000,1562370,135725370,False
1478,validator_2,33455703272,True,158114001,1443090,159557091,True
1479,validator_22,65725266135,True,95137006,1038220,96175226,True
1480,validator_29,33021604350,True,132483000,989900,133472900,False
1481,validator_14,97333556244,True,119000000,5113040,124113040,True
1482,validator_22,65785460040,True,57102005,3091900,60193905,True
1483,validator_13,32627299827,True,55677998,486130,56164128,True
1484,validator_10,33417070944,True,109574000,1314290,110888290,True
1485,validator_33,33140593290,True,129675000,12256840,141931840,False
1486,validator_19,65355032443,True,72808000,342400,73150400,True
1487,validator_35,97048034060,True,99063000,256800,99319800,False
1488,validator_22,66095421817,True,309784997,176780,309961777,True
1489,validator_41,66201563060,True,167477000,2162560,169639560,False
1490,validator_42,33019266990,True,116446000,4377530,120823530,False
1491,validator_25,33075443920,True,132346000,2383000,134729000,False
1492,validator_38,32944768280,True,71828000,276770,72104770,False
1493,validator_10,33560856048,True,141650004,2135100,143785104,True
1494,validator_0,33402231670,True,111416998,800330,112217328,True
1495,validator_23,33554855161,True,168725001,298300,169023301,True
1496,validator_40,32784986010,True,162372000,1746200,164118200,False
1497,validator_33,33244760430,True,102932000,1235140,104167140,False
1498,validator_39,33474241020,True,144928000,2143300,147071300,False
1499,validator_31,162186425580,True,264543000,1709020,266252020,False
1500,validator_18,96128910041,True,127529001,1381040,128910041,True
1501,validator_19,64121972386,True,121044996,927390,121972386,True
1502,validator_14,96141416901,True,115480001,25936900,141416901,True
1503,validator_15,256141618599,True,136370999,5247600,141618599,True
1504,validator_15,256287555151,True,145426002,510550,145936552,True
1505,validator_37,64134756300,True,132912000,1844300,134756300,False
1506,validator_48,160130734230,True,129421000,1313230,130734230,False
1507,validator_27,96074262300,True,71916000,2346300,74262300,False
1508,validator_41,64092899300,True,92498000,401300,92899300,False
1509,validator_15,256346569851,True,57338000,1676700,59014700,True
1510,validator_44,96089216800,True,88784000,432800,89216800,False
1511,validator_0,32166798502,True,158512002,8286500,166798502,True
1512,validator_45,32066929240,True,51134000,15795240,66929240,False
1513,validator_12,96178003233,True,173936003,4067230,178003233,True
1514,validator_37,64289859800,True,150236000,4867500,155103500,False
1515,validator_28,32142861200,True,140550000,2311200,142861200,False
1516,validator_27,96173979300,True,99103000,614000,99717000,False
1517,validator_28,32277097570,True,124692000,9544370,134236370,False
1518,validator_18,96211224075,True,81152004,1162030,82314034,True
1519,validator_15,256475164644,True,127882003,712790,128594793,True
1520,validator_31,160186818800,True,184681000,2137800,186818800,False
1521,validator_20,32137200877,True,136528997,671880,137200877,True
1522,validator_42,32184220940,True,163425000,20795940,184220940,False
1523,validator_23,32048351101,True,46948001,1403100,48351101,True
1524,validator_36,96087197990,True,85951000,1246990,87197990,False
1525,validator_6,32165096922,True,162449002,2647920,165096922,True
1526,validator_47,64136954900,True,136151000,803900,136954900,False
1527,validator_37,64342353000,True,46328000,6165200,52493200,False
1528,validator_27,96224585040,True,48765000,1840740,50605740,False
1529,validator_39,32044610220,True,43986000,624220,44610220,False
1530,validator_36,96221380130,True,132162000,2020140,134182140,False
1531,validator_18,96416850459,True,185696994,19929390,205626384,True
1532,validator_27,96385356870,True,159285000,1486830,160771830,False
1533,validator_47,64193728790,True,55553000,1220890,56773890,False
1534,validator_2,32136653101,True,134777001,1876100,136653101,True
1535,validator_38,32120147900,True,119785000,362900,120147900,False
1536,validator_48,160239637120,True,106882000,2020890,108902890,False
1537,validator_12,96347652829,True,168941996,707600,169649596,True
1538,validator_19,64234298906,True,107184000,5142520,112326520,True
1539,validator_44,96194591400,True,103532000,1842600,105374600,False
1540,validator_32,32148836630,True,140968000,7868630,148836630,False
1541,validator_20,32299507959,True,161193002,1114080,162307082,True
1542,validator_43,64032058100,True,31669000,389100,32058100,False
1543,validator_28,32381891170,True,81785000,23008600,104793600,False
1544,validator_22,64215305253,True,213734993,1570260,215305253,True
1545,validator_28,32551174670,True,168407000,876500,169283500,False
1546,validator_39,32083066290,True,37262000,1194070,38456070,False
1547,validator_38,32227098200,True,103891000,3059300,106950300,False
1548,validator_31,160394972800,True,207106000,1048000,208154000,False
1549,validator_34,256155416780,True,154271000,1145780,155416780,False
1550,validator_48,160346736360,True,106352000,747240,107099240,False
1551,validator_43,64081998010,True,48666000,1273910,49939910,False
1552,validator_27,96429360270,True,41506000,2497400,44003400,False
1553,validator_44,96308650600,True,111945000,2114200,114059200,False
1554,validator_25,32048004200,True,47488000,516200,48004200,False
1555,validator_3,32177654734,True,164511994,13142740,177654734,True
1556,validator_20,32446068057,True,145210998,1349100,146560098,True
1557,validator_29,32068527600,True,62760000,5767600,68527600,False
1558,validator_39,32225495690,True,137093000,5336400,142429400,False
1559,validator_46,96179682500,True,161210000,18472500,179682500,False
1560,validator_39,32350872690,True,124204000,1173000,125377000,False
1561,validator_20,32587875456,True,140073999,1733400,141807399,True
1562,validator_5,64144231751,True,142787001,1444750,144231751,True
1563,validator_34,256293439080,True,137160000,862300,138022300,False
1564,validator_29,32099421390,True,28545000,2348790,30893790,False
1565,validator_36,96325356530,True,95681000,8295400,103976400,False
1566,validator_49,64121726040,True,120519000,1207040,121726040,False
1567,validator_32,32352697530,True,200855000,3005900,203860900,False
1568,validator_38,32407906500,True,179397000,1411300,180808300,False
1569,validator_23,32112208124,True,45287003,18570020,63857023,True
1570,validator_22,64280484957,True,59597004,5582700,65179704,True
1571,validator_34,256390068180,True,87589000,9040100,96629100,False
1572,validator_17,160073329996,True,71764996,1565000,73329996,True
1573,validator_11,32164955798,True,164013998,941800,164955798,True
1574,validator_28,32694728700,True,136012000,7542030,143554030,False
1575,validator_49,64223087490,True,100628000,733450,101361450,False
1576,validator_17,160134268499,True,59856003,1082500,60938503,True
1577,validator_28,32825449500,True,128699000,2021800,130720800,False
1578,validator_31,160496000800,True,99890000,1138000,101028000,False
1579,validator_12,96431421869,True,74305000,9464040,83769040,True
1580,validator_10,32161665297,True,143396997,18268300,161665297,True
1581,validator_19,64484381908,True,249637002,446000,250083002,True
1582,validator_28,32868681300,True,42723000,508800,43231800,False
1583,validator_17,160361751901,True,225882002,1601400,227483402,True
1584,validator_26,32082845400,True,81714000,1131400,82845400,False
1585,validator_35,96100070520,True,98490000,1580520,100070520,False
1586,validator_7,64110915329,True,109936999,978330,110915329,True
1587,validator_3,32345528226,True,148964992,18908500,167873492,True
1588,validator_0,32282506706,True,115093004,615200,115708204,True
1589,validator_42,32361284940,True,156906000,20158000,177064000,False
1590,validator_1,64135003324,True,134203004,800320,135003324,True
1591,validator_2,32296169813,True,158083992,1432720,159516712,True
1592,validator_8,32119015299,True,113195999,5819300,119015299,True
1593,validator_48,160488354060,True,141093000,524700,141617700,False
1594,validator_3,32523263729,True,174638003,3097500,177735503,True
1595,validator_40,32108059390,True,106575000,1484390,108059390,False
1596,validator_30,64127873920,True,126028000,1845920,127873920,False
1597,validator_5,64474020673,True,328360002,1428920,329788922,True
1598,validator_41,64221020120,True,126346000,1774820,128120820,False
1599,validator_9,32177522740,True,158702000,18820740,177522740,True
1600,validator_13,32120192597,True,118679997,1512600,120192597,True
1601,validator_36,96432950770,True,105120000,2474240,107594240,False
1602,validator_39,32426336690,True,67869000,7595000,75464000,False
1603,validator_7,64325423626,True,211829997,2678300,214508297,True
1604,validator_43,64313097790,True,225549000,5550780,231099780,False
1605,validator_0,32506071148,True,221110992,2453450,223564442,True
1606,validator_18,96505554303,True,88038004,665840,88703844,True
1607,validator_18,96733595543,True,226920000,1121240,228041240,True
1608,validator_34,256530373880,True,129535000,10770700,140305700,False
1609,validator_5,64555139912,True,71218999,9900240,81119239,True
1610,validator_28,33013759600,True,144766000,312300,145078300,False
1611,validator_28,33172508060,True,157678000,1070460,158748460,False
1612,validator_46,96257515800,True,76585000,1248300,77833300,False
1613,validator_33,32114812400,True,95698000,19114400,114812400,False
1614,validator_25,32149736700,True,96300000,5432500,101732500,False
1615,validator_0,32669977720,True,149220992,14685580,163906572,True
1616,validator_16,32142680602,True,141703002,977600,142680602,True
1617,validator_39,32598381620,True,171842000,202930,172044930,False
1618,validator_48,160647790500,True,158883000,553440,159436440,False
1619,validator_31,160563661300,True,66199000,1461500,67660500,False
1620,validator_36,96632384370,True,198068000,1365600,199433600,False
1621,validator_38,32534942040,True,125195000,1840540,127035540,False
1622,validator_22,64386749756,True,100228999,6035800,106264799,True
1623,validator_17,160492093293,True,106546002,23795390,130341392,True
1624,validator_7,64446981758,True,121077002,481130,121558132,True
1625,validator_34,256611162880,True,79422000,1367000,80789000,False
1626,validator_20,32762368796,True,173920000,573340,174493340,True
1627,validator_36,96798837370,True,129685000,36768000,166453000,False
1628,validator_46,96330330540,True,72584000,230740,72814740,False
1629,validator_24,32130560795,True,125350005,5210790,130560795,True
1630,validator_48,160773219860,True,125053000,376360,125429360,False
1631,validator_15,256631189043,True,155382999,641400,156024399,True
1632,validator_9,32346652438,True,167749998,1379700,169129698,True
1633,validator_12,96568407008,True,136114999,870140,136985139,True
1634,validator_19,64543097209,True,58242001,473300,58715301,True
1635,validator_9,32522859939,True,172811001,3396500,176207501,True
1636,validator_20,32850897696,True,87476000,1052900,88528900,True
1637,validator_36,96848543670,True,49040000,666300,49706300,False
1638,validator_35,96207351420,True,98517000,8763900,107280900,False
1639,validator_16,32382868179,True,238771997,1415580,240187577,True
1640,validator_39,32792947820,True,193720000,846200,194566200,False
1641,validator_44,96427989940,True,118906000,433340,119339340,False
1642,validator_35,96307325720,True,98931000,1043300,99974300,False
1643,validator_26,32146037180,True,62800000,391780,63191780,False
1644,validator_34,256722364080,True,110510000,691200,111201200,False
1645,validator_14,96250923004,True,101537003,7969100,109506103,True
1646,validator_31,160762691080,True,194089000,4940780,199029780,False
1647,validator_37,64489107200,True,144263000,2491200,146754200,False
1648,validator_44,96566635320,True,136232000,2413380,138645380,False
1649,validator_1,64270057627,True,133443003,1611300,135054303,True
1650,validator_13,32213547794,True,86255997,7099200,93355197,True
1651,validator_5,64662410311,True,104073999,3196400,107270399,True
1652,validator_0,32826780753,True,156411003,392030,156803033,True
1653,validator_46,96542265480,True,205934000,6000940,211934940,False
1654,validator_14,96294853264,True,43218000,712260,43930260,True
1655,validator_4,32212748920,True,211209000,1539920,212748920,True
1656,validator_34,256844241980,True,121487000,390900,121877900,False
1657,validator_8,32161710001,True,42288002,406700,42694702,True
1658,validator_34,256949413080,True,105072000,99100,105171100,False
1659,validator_41,64340885340,True,118939000,926220,119865220,False
1660,validator_37,64557541620,True,68225000,209420,68434420,False
1661,validator_12,96655349234,True,84398996,2543230,86942226,True
1662,validator_34,257133807480,True,184147000,247400,184394400,False
1663,validator_5,64826506353,True,163213002,883040,164096042,True
1664,validator_30,64225437420,True,93026000,4537500,97563500,False
1665,validator_49,64302827890,True,77572000,2168400,79740400,False
1666,validator_31,160886554920,True,123396000,467840,123863840,False
1667,validator_23,32257816394,True,144538000,1070270,145608270,True
1668,validator_45,32173722040,True,105308000,1484800,106792800,False
1669,validator_22,64496000851,True,101102995,8148100,109251095,True
1670,validator_17,160548375614,True,55838001,444320,56282321,True
1671,validator_42,32512134320,True,142992000,7857380,150849380,False
1672,validator_39,32905967020,True,111636000,1383200,113019200,False
1673,validator_7,64573084198,True,108073000,18029440,126102440,True
1674,validator_31,160980488360,True,75515000,18418440,93933440,False
1675,validator_46,96605205610,True,60860000,2080130,62940130,False
1676,validator_17,160604291114,True,47560000,8355500,55915500,True
1677,validator_16,32586240679,True,201479000,1893500,203372500,True
1678,validator_32,32521044330,True,167166000,1180800,168346800,False
1679,validator_47,64304049890,True,108792000,1529100,110321100,False
1680,validator_35,96408281220,True,99937000,1018500,100955500,False
1681,validator_44,96702937100,True,117849000,18452780,136301780,False
1682,validator_19,64644264134,True,100572995,593930,101166925,True
1683,validator_6,32244331720,True,56799998,22434800,79234798,True
1684,validator_43,64407853330,True,93156000,1599540,94755540,False
1685,validator_12,96831709513,True,175849999,510280,176360279,True
1686,validator_2,32392940210,True,96344997,425400,96770397,True
1687,validator_41,64449786840,True,107402000,1499500,108901500,False
1688,validator_34,257241088380,True,88866000,18414900,107280900,False
1689,validator_10,32223516697,True,60185000,1666400,61851400,True
1690,validator_36,96922159950,True,72149000,1467280,73616280,False
1691,validator_41,64720855870,True,270404000,665030,271069030,False
1692,validator_43,64573716250,True,147660000,18202920,165862920,False
1693,validator_41,64810486670,True,89049000,581800,89630800,False
1694,validator_11,32277619602,True,93945004,18718800,112663804,True
1695,validator_49,64472770790,True,168498000,1444900,169942900,False
1696,validator_36,97124393630,True,193975000,8258680,202233680,False
1697,validator_39,33025239020,True,110182000,9090000,119272000,False
1698,validator_2,32576442713,True,177101003,6401500,183502503,True
1699,validator_30,64361374320,True,133949000,1987900,135936900,False
1700,validator_24,32271110392,True,138362997,2186600,140549597,True
1701,validator_16,32780396887,True,174466008,19690200,194156208,True
1702,validator_44,96802781370,True,99111000,733270,99844270,False
1703,validator_38,32644203240,True,83317000,25944200,109261200,False
1704,validator_27,96551607370,True,120649000,1598100,122247100,False
1705,validator_8,32326233297,True,162982996,1540300,164523296,True
1706,validator_29,32153009620,True,53002000,586230,53588230,False
1707,validator_10,32433591728,True,207036001,3039030,210075031,True
1708,validator_35,96476024220,True,59198000,8545000,67743000,False
1709,validator_11,32377145222,True,97874000,1651620,99525620,True
1710,validator_39,33173121420,True,146179000,1703400,147882400,False
1711,validator_28,33374281400,True,199040000,2733340,201773340,False
1712,validator_17,160736719948,True,131660004,768830,132428834,True
1713,validator_25,32265319300,True,96908000,18674600,115582600,False
1714,validator_48,160819747640,True,44964000,1563780,46527780,False
1715,validator_15,256717199945,True,85057002,953900,86010902,True
1716,validator_33,32359068700,True,242780000,1476300,244256300,False
1717,validator_46,96780662850,True,173674000,1783240,175457240,False
1718,validator_22,64602373830,True,105164999,1207980,106372979,True
1719,validator_49,64601123590,True,127770000,582800,128352800,False
1720,validator_24,32476931219,True,204132997,1687830,205820827,True
1721,validator_22,64713831782,True,109834992,1622960,111457952,True
1722,validator_33,32469663700,True,100989000,9606000,110595000,False
1723,validator_6,32374559136,True,128273996,1953420,130227416,True
1724,validator_40,32215954490,True,107657000,238100,107895100,False
1725,validator_35,96558518620,True,81797000,697400,82494400,False
1726,validator_34,257343967880,True,102056000,823500,102879500,False
1727,validator_31,161059846060,True,78260000,1097700,79357700,False
1728,validator_11,32503226319,True,95849997,30231100,126081097,True
1729,validator_42,32609513160,True,96901000,477840,97378840,False
1730,validator_19,64788724563,True,144161999,298430,144460429,True
1731,validator_7,64645239740,True,71975002,180540,72155542,True
1732,validator_9,32650687817,True,126607998,1219880,127827878,True
1733,validator_20,32990251376,True,133634000,5719680,139353680,True
1734,validator_8,32468127958,True,139238001,2656660,141894661,True
1735,validator_32,32692074890,True,170155000,875560,171030560,False
1736,validator_25,32433003530,True,166175000,1509230,167684230,False
1737,validator_16,32874734308,True,93933001,404420,94337421,True
1738,validator_18,96874486744,True,123054001,17837200,140891201,True
1739,validator_22,64811009779,True,88085997,9092000,97177997,True
1740,validator_36,97309640530,True,184461000,785900,185246900,False
1741,validator_34,257469022550,True,117563000,7491670,125054670,False
1742,validator_35,96614271160,True,47821000,7931540,55752540,False
1743,validator_35,96791178860,True,175438000,1469700,176907700,False
1744,validator_23,32497010526,True,216234002,22960130,239194132,True
1745,validator_4,32385857021,True,172050001,1058100,173108101,True
1746,validator_31,161216970760,True,156209000,915700,157124700,False
1747,validator_11,32582862615,True,77752996,1883300,79636296,True
1748,validator_27,96713804070,True,161219000,977700,162196700,False
1749,validator_44,97065373770,True,261906000,686400,262592400,False
1750,validator_43,64743983700,True,167440000,2827450,170267450,False
1751,validator_26,32345012480,True,198357000,618300,198975300,False
1752,validator_36,97411913930,True,101218000,1055400,102273400,False
1753,validator_26,32494280620,True,147830000,1438140,149268140,False
1754,validator_41,64954725870,True,121934000,22305200,144239200,False
1755,validator_49,64727149190,True,100397000,25628600,126025600,False
1756,validator_18,97004448446,True,122436002,7525700,129961702,True
1757,validator_0,32938030183,True,110331000,918430,111249430,True
1758,validator_46,96889446780,True,108104000,679930,108783930,False
1759,validator_34,257629257940,True,152035000,8200390,160235390,False
1760,validator_46,97013679180,True,105514000,18718400,124232400,False
1761,validator_11,32878903716,True,294338001,1703100,296041101,True
1762,validator_31,161327947260,True,109130000,1846500,110976500,False
1763,validator_27,96796994210,True,64678000,18512140,83190140,False
1764,validator_33,32579749000,True,90565000,19520300,110085300,False
1765,validator_12,97091785215,True,241528002,18547700,260075702,True
1766,validator_37,64600973440,True,43098000,333820,43431820,False
1767,validator_33,32736236530,True,155593000,894530,156487530,False
1768,validator_9,32776054456,True,123901999,1464640,125366639,True
1769,validator_23,32649035599,True,132778003,19247070,152025073,True
1770,validator_29,32315766960,True,161425000,1332340,162757340,False
1771,validator_47,64468972890,True,162714000,2209000,164923000,False
1772,validator_13,32320700696,True,106120002,1032900,107152902,True
1773,validator_6,32498795939,True,123485003,751800,124236803,True
1774,validator_36,97489089210,True,75171000,2004280,77175280,False
1775,validator_43,64877166800,True,131346000,1837100,133183100,False
1776,validator_2,32832184910,True,254111997,1630200,255742197,True
1777,validator_17,160799602584,True,54906996,7975640,62882636,True
1778,validator_6,32581423135,True,81580996,1046200,82627196,True
1779,validator_19,64966318767,True,176318004,1276200,177594204,True
1780,validator_15,256900145237,True,166537002,16408290,182945292,True
1781,validator_33,32828844930,True,91370000,1238400,92608400,False
1782,validator_37,64777415240,True,157826000,18615800,176441800,False
1783,validator_23,32748534299,True,81466000,18032700,99498700,True
1784,validator_11,33001038318,True,121187002,947600,122134602,True
1785,validator_46,97143660180,True,128994000,987000,129981000,False
1786,validator_3,32597186423,True,71834994,2087700,73922694,True
1787,validator_40,32367020390,True,148603000,2462900,151065900,False
1788,validator_6,32681899736,True,98940001,1536600,100476601,True
1789,validator_41,65088716370,True,115225000,18765500,133990500,False
1790,validator_41,65241621900,True,150384000,2521530,152905530,False
1791,validator_42,32822299380,True,211688000,1098220,212786220,False
1792,validator_9,32850448982,True,73095996,1298530,74394526,True
1793,validator_5,64878900256,True,51628003,765900,52393903,True
1794,validator_14,96366982465,True,69592001,2537200,72129201,True
1795,validator_5,64985494558,True,105555002,1039300,106594302,True
1796,validator_31,161466898860,True,119254000,19697600,138951600,False
1797,validator_22,64921562836,True,110086997,466060,110553057,True
1798,validator_13,32451951499,True,128819003,2431800,131250803,True
1799,validator_38,32803161680,True,157910000,1048440,158958440,False
1800,validator_15,257054090738,True,145912001,8033500,153945501,True
1801,validator_17,160871597846,True,71324002,671260,71995262,True
1802,validator_6,32830854835,True,130236999,18718100,148955099,True
1803,validator_6,32912860464,True,81447999,557630,82005629,True
1804,validator_46,97265200340,True,120277000,1263160,121540160,False
1805,validator_23,32986701078,True,234683999,3482780,238166779,True
1806,validator_6,33100953901,True,181360997,6732440,188093437,True
1807,validator_27,96916801510,True,118373000,1434300,119807300,False
1808,validator_4,32501348498,True,114878997,612480,115491477,True
1809,validator_17,161014496480,True,137932994,4965640,142898634,True
1810,validator_5,65080371457,True,92887999,1988900,94876899,True
1811,validator_11,33085477903,True,83301995,1137590,84439585,True
1812,validator_41,65344476400,True,83503000,19351500,102854500,False
1813,validator_12,97197020785,True,92185000,13050570,105235570,True
1814,validator_47,64573088690,True,103428000,687800,104115800,False
1815,validator_7,64787915961,True,142115001,561220,142676221,True
1816,validator_30,64423107900,True,53661000,8072580,61733580,False
1817,validator_26,32683087320,True,188492000,314700,188806700,False
1818,validator_48,160948037240,True,127078000,1211600,128289600,False
1819,validator_29,32425321630,True,108245000,1309670,109554670,False
1820,validator_6,33177865298,True,75477997,1433400,76911397,True
1821,validator_32,32846734890,True,153182000,1478000,154660000,False
1822,validator_32,32917850970,True,69630000,1486080,71116080,False
1823,validator_0,33046190113,True,89068000,19091930,108159930,True
1824,validator_34,257768543130,True,137289000,1996190,139285190,False
1825,validator_10,32601387070,True,166389002,1406340,167795342,True
1826,validator_15,257105727144,True,49490006,2146400,51636406,True
1827,validator_46,97407972360,True,138004000,4768020,142772020,False
1828,validator_43,64919310700,True,41343000,800900,42143900,False
1829,validator_26,32831488240,True,148215000,185920,148400920,False
1830,validator_18,97166077343,True,160421997,1206900,161628897,True
1831,validator_19,65135218465,True,160625998,8273700,168899698,True
1832,validator_22,65204875633,True,282162997,1149800,283312797,True
1833,validator_19,65281882043,True,145838998,824580,146663578,True
1834,validator_6,33229629914,True,49824996,1939620,51764616,True
1835,validator_32,32976848260,True,40394000,18603290,58997290,False
1836,validator_41,65387620640,True,42716000,428240,43144240,False
1837,validator_45,32376349340,True,198925000,3702300,202627300,False
1838,validator_5,65174953558,True,93799001,783100,94582101,True
1839,validator_49,64893259930,True,164370000,1740740,166110740,False
1840,validator_46,97574163950,True,164789000,1402590,166191590,False
1841,validator_36,97590891010,True,95789000,6012800,101801800,False
1842,validator_36,97741713370,True,150168000,654360,150822360,False
1843,validator_16,32933008906,True,57672998,601600,58274598,True
1844,validator_0,33178465711,True,128456998,3818600,132275598,True
1845,validator_37,64896087100,True,115882000,2789860,118671860,False
1846,validator_47,64672180290,True,81070000,18021600,99091600,False
1847,validator_47,64829961770,True,157288000,493480,157781480,False
1848,validator_16,33101460495,True,163014999,5436590,168451589,True
1849,validator_37,65104392200,True,189516000,18789100,208305100,False
1850,validator_17,161192991883,True,177517003,978400,178495403,True
1851,validator_29,32475684130,True,45069000,5293500,50362500,False
1852,validator_15,257352146315,True,244572001,1847170,246419171,True
1853,validator_40,32487301690,True,111963000,8318300,120281300,False
1854,validator_17,161289995526,True,90295003,6708640,97003643,True
1855,validator_14,96593913493,True,225743998,1187030,226931028,True
1856,validator_21,64235234399,True,233804999,1429400,235234399,True
1857,validator_17,161408789531,True,100274005,18520000,118794005,True
1858,validator_9,32933333465,True,82500003,384480,82884483,True
1859,validator_10,32708033170,True,87912000,18734100,106646100,True
1860,validator_25,32614112810,True,178535000,2574280,181109280,False
1861,validator_32,33085068000,True,106221000,1998740,108219740,False
1862,validator_17,161507270631,True,96537000,1944100,98481100,True
1863,validator_18,97289074440,True,122206997,790100,122997097,True
1864,validator_36,97833464110,True,90911000,839740,91750740,False
1865,validator_28,33558862900,True,176295000,8286500,184581500,False
1866,validator_49,64962321530,True,68437000,624600,69061600,False
1867,validator_22,65257218638,True,51942005,401000,52343005,True
1868,validator_46,97690724870,True,115701000,859920,116560920,False
1869,validator_25,32836646810,True,221778000,756000,222534000,False
1870,validator_23,33227412030,True,221028002,19682950,240710952,True
1871,validator_39,33327169720,True,152770000,1278300,154048300,False
1872,validator_1,64358416225,True,87039998,1318600,88358598,True
1873,validator_16,33245202124,True,141363999,2377630,143741629,True
1874,validator_46,97813158570,True,102673000,19760700,122433700,False
1875,validator_2,32913315151,True,79922001,1208240,81130241,True
1876,validator_15,257413949985,True,60573000,1230670,61803670,True
1877,validator_37,65265136800,True,159611000,1133600,160744600,False
1878,validator_48,161025204740,True,75541000,1626500,77167500,False
1879,validator_48,161139311340,True,113196000,910600,114106600,False
1880,validator_7,64864872441,True,76354000,602480,76956480,True
1881,validator_35,96948714260,True,156980000,555400,157535400,False
1882,validator_21,64347529716,True,110172997,2122320,112295317,True
1883,validator_22,65370821380,True,111247002,2355740,113602742,True
1884,validator_48,161302127010,True,160084000,2731670,162815670,False
1885,validator_14,96683569496,True,88896003,760000,89656003,True
1886,validator_5,65311961161,True,133510003,3497600,137007603,True
1887,validator_34,257840642250,True,70386000,1713120,72099120,False
1888,validator_17,161653469728,True,143632997,2566100,146199097,True
1889,validator_25,32940714920,True,100334000,3734110,104068110,False
1890,validator_18,97404382845,True,114553005,755400,115308405,True
1891,validator_5,65463423158,True,149526997,1935000,151461997,True
1892,validator_45,32435849840,True,59120000,380500,59500500,False
1893,validator_7,64900366644,True,34652003,842200,35494203,True
1894,validator_32,33129148320,True,42933000,1147320,44080320,False
1895,validator_37,65319501400,True,53767000,597600,54364600,False
1896,validator_7,65018523092,True,115438008,2718440,118156448,True
1897,validator_28,33655272400,True,92927000,3482500,96409500,False
1898,validator_31,161682447760,True,213666000,1882900,215548900,False
1899,validator_11,33210831948,True,123849005,1505040,125354045,True
1900,validator_21,64419834117,True,53992001,18312400,72304401,True
1901,validator_41,65455295430,True,57534000,10140790,67674790,False
1902,validator_24,32580582825,True,101625006,2026600,103651606,True
1903,validator_27,97041700730,True,123850000,1049220,124899220,False
1904,validator_21,64585487556,True,163687999,1965440,165653439,True
1905,validator_14,96826399392,True,139660996,3168900,142829896,True
1906,validator_6,33307742414,True,69237000,8875500,78112500,True
1907,validator_23,33313293029,True,66338999,19542000,85880999,True
1908,validator_1,64483245661,True,124202006,627430,124829436,True
1909,validator_48,161444077710,True,141298000,652700,141950700,False
1910,validator_36,97963306410,True,129193000,649300,129842300,False
1911,validator_17,161952754218,True,244643000,54641490,299284490,True
1912,validator_15,257566565586,True,134517001,18098600,152615601,True
1913,validator_23,33385831860,True,70466001,2072830,72538831,True
1914,validator_45,32487283840,True,49998000,1436000,51434000,False
1915,validator_18,97463249220,True,56707995,2158380,58866375,True
1916,validator_3,32716219822,True,118448999,584400,119033399,True
1917,validator_18,97642126812,True,174291002,4586590,178877592,True
1918,validator_29,32524725750,True,48626000,415620,49041620,False
1919,validator_16,33386656527,True,139250003,2204400,141454403,True
1920,validator_47,64961802130,True,130967000,873360,131840360,False
1921,validator_15,257628622685,True,61558999,498100,62057099,True
1922,validator_18,97763246413,True,102390001,18729600,121119601,True
1923,validator_10,32873552911,True,153501001,12018740,165519741,True
1924,validator_38,32872663510,True,68731000,770830,69501830,False
1925,validator_2,33084272151,True,170068000,889000,170957000,True
1926,validator_44,97203467570,True,128472000,9621800,138093800,False
1927,validator_1,64690699802,True,206137001,1317140,207454141,True
1928,validator_31,161920173560,True,236416000,1309800,237725800,False
1929,validator_14,96974370974,True,147203002,768580,147971582,True
1930,validator_18,97942064380,True,178669997,147970,178817967,True
1931,validator_8,32566551557,True,90086999,8336600,98423599,True
1932,validator_14,97065406874,True,89382000,1653900,91035900,True
1933,validator_48,161562733510,True,116312000,2343800,118655800,False
1934,validator_33,32998661450,True,168531000,1285520,169816520,False
1935,validator_30,64562190800,True,136406000,2676900,139082900,False
1936,validator_45,32568727530,True,80016000,1427690,81443690,False
1937,validator_10,33057757712,True,183547001,657800,184204801,True
1938,validator_48,161681187110,True,117193000,1260600,118453600,False
1939,validator_3,32841639702,True,120065000,5354880,125419880,True
1940,validator_40,32620867810,True,128141000,5425120,133566120,False
1941,validator_42,32898443460,True,74969000,1175080,76144080,False
1942,validator_13,32571135699,True,116783000,2401200,119184200,True
1943,validator_17,162069107651,True,114926003,1427430,116353433,True
1944,validator_34,257960807890,True,119595000,570640,120165640,False
1945,validator_10,33140661653,True,75143001,7760940,82903941,True
1946,validator_49,65091360430,True,128294000,744900,129038900,False
1947,validator_11,33285343392,True,73443004,1068440,74511444,True
1948,validator_4,32656732599,True,146724001,8660100,155384101,True
1949,validator_41,65608243950,True,151631000,1317520,152948520,False
1950,validator_17,162284683948,True,214977997,598300,215576297,True
1951,validator_14,97209443204,True,142006000,2030330,144036330,True
1952,validator_22,65493489310,True,121872000,795930,122667930,True
1953,validator_41,65680141150,True,70676000,1221200,71897200,False
1954,validator_10,33306182654,True,159803001,5718000,165521001,True
1955,validator_49,65227227230,True,129594000,6272800,135866800,False
1956,validator_47,65074518910,True,111872000,844780,112716780,False
1957,validator_17,162414625140,True,127416002,2525190,129941192,True
1958,validator_6,33398253556,True,89920002,591140,90511142,True
1959,validator_0,33290014342,True,110692001,856630,111548631,True
1960,validator_2,33296146181,True,211699000,175030,211874030,True
1961,validator_49,65311197430,True,73877000,10093200,83970200,False
1962,validator_46,97911285990,True,96929000,1198420,98127420,False
1963,validator_27,97195588770,True,153404000,484040,153888040,False
1964,validator_47,65181017130,True,105463000,1035220,106498220,False
1965,validator_44,97392151370,True,188454000,229800,188683800,False
1966,validator_20,33079917050,True,87186004,2479670,89665674,True
1967,validator_27,97298383900,True,101290000,1505130,102795130,False
1968,validator_46,98099388190,True,186324000,1778200,188102200,False
1969,validator_29,32648192150,True,114613000,8853400,123466400,False
1970,validator_6,33430063156,True,31605000,204600,31809600,True
1971,validator_44,97653287370,True,260486000,650000,261136000,False
1972,validator_22,65629090909,True,134654999,946600,135601599,True
1973,validator_8,32700820648,True,127278001,6991090,134269091,True
1974,validator_47,65328953610,True,146851000,1085480,147936480,False
1975,validator_41,66031923500,True,350411000,1371350,351782350,False
1976,validator_29,32752406080,True,102183000,2030930,104213930,False
1977,validator_29,32888131450,True,134163000,1562370,135725370,False
1978,validator_2,33455703272,True,158114001,1443090,159557091,True
1979,validator_22,65725266135,True,95137006,1038220,96175226,True
1980,validator_29,33021604350,True,132483000,989900,133472900,False
1981,validator_14,97333556244,True,119000000,5113040,124113040,True
1982,validator_22,65785460040,True,57102005,3091900,60193905,True
1983,validator_13,32627299827,True,55677998,486130,56164128,True
1984,validator_10,33417070944,True,109574000,1314290,110888290,True
1985,validator_33,33140593290,True,129675000,12256840,141931840,False
1986,validator_19,65355032443,True,72808000,342400,73150400,True
1987,validator_35,97048034060,True,99063000,256800,99319800,False
1988,validator_22,66095421817,True,309784997,176780,309961777,True
1989,validator_41,66201563060,True,167477000,2162560,169639560,False
1990,validator_42,33019266990,True,116446000,4377530,120823530,False
1991,validator_25,33075443920,True,132346000,2383000,134729000,False
1992,validator_38,32944768280,True,71828000,276770,72104770,False
1993,validator_10,33560856048,True,141650004,2135100,143785104,True
1994,validator_0,33402231670,True,111416998,800330,112217328,True
1995,validator_23,33554855161,True,168725001,298300,169023301,True
1996,validator_40,32784986010,True,162372000,1746200,164118200,False
1997,validator_33,33244760430,True,102932000,1235140,104167140,False
1998,validator_39,33474241020,True,144928000,2143300,147071300,False
1999,validator_31,162186425580,True,264543000,1709020,266252020,False
2000,validator_18,96128910041,True,127529001,1381040,128910041,True
2001,validator_19,64121972386,True,121044996,927390,121972386,True
2002,validator_14,96141416901,True,115480001,25936900,141416901,True
2003,validator_15,256141618599,True,136370999,5247600,141618599,True
2004,validator_15,256287555151,True,145426002,510550,145936552,True
2005,validator_37,64134756300,True,132912000,1844300,134756300,False
2006,validator_48,160130734230,True,129421000,1313230,130734230,False
2007,validator_27,96074262300,True,71916000,2346300,74262300,False
2008,validator_41,64092899300,True,92498000,401300,92899300,False
2009,validator_15,256346569851,True,57338000,1676700,59014700,True
2010,validator_44,96089216800,True,88784000,432800,89216800,False
2011,validator_0,32166798502,True,158512002,8286500,166798502,True
2012,validator_45,32066929240,True,51134000,15795240,66929240,False
2013,validator_12,96178003233,True,173936003,4067230,178003233,True
2014,validator_37,64289859800,True,150236000,4867500,155103500,False
2015,validator_28,32142861200,True,140550000,2311200,142861200,False
2016,validator_27,96173979300,True,99103000,614000,99717000,False
2017,validator_28,32277097570,True,124692000,9544370,134236370,False
2018,validator_18,96211224075,True,81152004,1162030,82314034,True
2019,validator_15,256475164644,True,127882003,712790,128594793,True
2020,validator_31,160186818800,True,184681000,2137800,186818800,False
2021,validator_20,32137200877,True,136528997,671880,137200877,True
2022,validator_42,32184220940,True,163425000,20795940,184220940,False
2023,validator_23,32048351101,True,46948001,1403100,48351101,True
2024,validator_36,96087197990,True,85951000,1246990,87197990,False
2025,validator_6,32165096922,True,162449002,2647920,165096922,True
2026,validator_47,64136954900,True,136151000,803900,136954900,False
2027,validator_37,64342353000,True,46328000,6165200,52493200,False
2028,validator_27,96224585040,True,48765000,1840740,50605740,False
2029,validator_39,32044610220,True,43986000,624220,44610220,False
2030,validator_36,96221380130,True,132162000,2020140,134182140,False
2031,validator_18,96416850459,True,185696994,19929390,205626384,True
2032,validator_27,96385356870,True,159285000,1486830,160771830,False
2033,validator_47,64193728790,True,55553000,1220890,56773890,False
2034,validator_2,32136653101,True,134777001,1876100,136653101,True
2035,validator_38,32120147900,True,119785000,362900,120147900,False
2036,validator_48,160239637120,True,106882000,2020890,108902890,False
2037,validator_12,96347652829,True,168941996,707600,169649596,True
2038,validator_19,64234298906,True,107184000,5142520,112326520,True
2039,validator_44,96194591400,True,103532000,1842600,105374600,False
2040,validator_32,32148836630,True,140968000,7868630,148836630,False
2041,validator_20,32299507959,True,161193002,1114080,162307082,True
2042,validator_43,64032058100,True,31669000,389100,32058100,False
2043,validator_28,32381891170,True,81785000,23008600,104793600,False
2044,validator_22,64215305253,True,213734993,1570260,215305253,True
2045,validator_28,32551174670,True,168407000,876500,169283500,False
2046,validator_39,32083066290,True,37262000,1194070,38456070,False
2047,validator_38,32227098200,True,103891000,3059300,106950300,False
2048,validator_31,160394972800,True,207106000,1048000,208154000,False
2049,validator_34,256155416780,True,154271000,1145780,155416780,False
2050,validator_48,160346736360,True,106352000,747240,107099240,False
2051,validator_43,64081998010,True,48666000,1273910,49939910,False
2052,validator_27,96429360270,True,41506000,2497400,44003400,False
2053,validator_44,96308650600,True,111945000,2114200,114059200,False
2054,validator_25,32048004200,True,47488000,516200,48004200,False
2055,validator_3,32177654734,True,164511994,13142740,177654734,True
2056,validator_20,32446068057,True,145210998,1349100,146560098,True
2057,validator_29,32068527600,True,62760000,5767600,68527600,False
2058,validator_39,32225495690,True,137093000,5336400,142429400,False
2059,validator_46,96179682500,True,161210000,18472500,179682500,False
2060,validator_39,32350872690,True,124204000,1173000,125377000,False
2061,validator_20,32587875456,True,140073999,1733400,141807399,True
2062,validator_5,64144231751,True,142787001,1444750,144231751,True
2063,validator_34,256293439080,True,137160000,862300,138022300,False
2064,validator_29,32099421390,True,28545000,2348790,30893790,False
2065,validator_36,96325356530,True,95681000,8295400,103976400,False
2066,validator_49,64121726040,True,120519000,1207040,121726040,False
2067,validator_32,32352697530,True,200855000,3005900,203860900,False
2068,validator_38,32407906500,True,179397000,1411300,180808300,False
2069,validator_23,32112208124,True,45287003,18570020,63857023,True
2070,validator_22,64280484957,True,59597004,5582700,65179704,True
2071,validator_34,256390068180,True,87589000,9040100,96629100,False
2072,validator_17,160073329996,True,71764996,1565000,73329996,True
2073,validator_11,32164955798,True,164013998,941800,164955798,True
2074,validator_28,32694728700,True,136012000,7542030,143554030,False
2075,validator_49,64223087490,True,100628000,733450,101361450,False
2076,validator_17,160134268499,True,59856003,1082500,60938503,True
2077,validator_28,32825449500,True,128699000,2021800,130720800,False
2078,validator_31,160496000800,True,99890000,1138000,101028000,False
2079,validator_12,96431421869,True,74305000,9464040,83769040,True
2080,validator_10,32161665297,True,143396997,18268300,161665297,True
2081,validator_19,64484381908,True,249637002,446000,250083002,True
2082,validator_28,32868681300,True,42723000,508800,43231800,False
2083,validator_17,160361751901,True,225882002,1601400,227483402,True
2084,validator_26,32082845400,True,81714000,1131400,82845400,False
2085,validator_35,96100070520,True,98490000,1580520,100070520,False
2086,validator_7,64110915329,True,109936999,978330,110915329,True
2087,validator_3,32345528226,True,148964992,18908500,167873492,True
2088,validator_0,32282506706,True,115093004,615200,115708204,True
2089,validator_42,32361284940,True,156906000,20158000,177064000,False
2090,validator_1,64135003324,True,134203004,800320,135003324,True
2091,validator_2,32296169813,True,158083992,1432720,159516712,True
2092,validator_8,32119015299,True,113195999,5819300,119015299,True
2093,validator_48,160488354060,True,141093000,524700,141617700,False
2094,validator_3,32523263729,True,174638003,3097500,177735503,True
2095,validator_40,32108059390,True,106575000,1484390,108059390,False
2096,validator_30,64127873920,True,126028000,1845920,127873920,False
2097,validator_5,64474020673,True,328360002,1428920,329788922,True
2098,validator_41,64221020120,True,126346000,1774820,128120820,False
2099,validator_9,32177522740,True,158702000,18820740,177522740,True
2100,validator_13,32120192597,True,118679997,1512600,120192597,True
2101,validator_36,96432950770,True,105120000,2474240,107594240,False
2102,validator_39,32426336690,True,67869000,7595000,75464000,False
2103,validator_7,64325423626,True,211829997,2678300,214508297,True
2104,validator_43,64313097790,True,225549000,5550780,231099780,False
2105,validator_0,32506071148,True,221110992,2453450,223564442,True
2106,validator_18,96505554303,True,88038004,665840,88703844,True
2107,validator_18,96733595543,True,226920000,1121240,228041240,True
2108,validator_34,256530373880,True,129535000,10770700,140305700,False
2109,validator_5,64555139912,True,71218999,9900240,81119239,True
2110,validator_28,33013759600,True,144766000,312300,145078300,False
2111,validator_28,33172508060,True,157678000,1070460,158748460,False
2112,validator_46,96257515800,True,76585000,1248300,77833300,False
2113,validator_33,32114812400,True,95698000,19114400,114812400,False
2114,validator_25,32149736700,True,96300000,5432500,101732500,False
2115,validator_0,32669977720,True,149220992,14685580,163906572,True
2116,validator_16,32142680602,True,141703002,977600,142680602,True
2117,validator_39,32598381620,True,171842000,202930,172044930,False
2118,validator_48,160647790500,True,158883000,553440,159436440,False
2119,validator_31,160563661300,True,66199000,1461500,67660500,False
2120,validator_36,96632384370,True,198068000,1365600,199433600,False
2121,validator_38,32534942040,True,125195000,1840540,127035540,False
2122,validator_22,64386749756,True,100228999,6035800,106264799,True
2123,validator_17,160492093293,True,106546002,23795390,130341392,True
2124,validator_7,64446981758,True,121077002,481130,121558132,True
2125,validator_34,256611162880,True,79422000,1367000,80789000,False
2126,validator_20,32762368796,True,173920000,573340,174493340,True
2127,validator_36,96798837370,True,129685000,36768000,166453000,False
2128,validator_46,96330330540,True,72584000,230740,72814740,False
2129,validator_24,32130560795,True,125350005,5210790,130560795,True
2130,validator_48,160773219860,True,125053000,376360,125429360,False
2131,validator_15,256631189043,True,155382999,641400,156024399,True
2132,validator_9,32346652438,True,167749998,1379700,169129698,True
2133,validator_12,96568407008,True,136114999,870140,136985139,True
2134,validator_19,64543097209,True,58242001,473300,58715301,True
2135,validator_9,32522859939,True,172811001,3396500,176207501,True
2136,validator_20,32850897696,True,87476000,1052900,88528900,True
2137,validator_36,96848543670,True,49040000,666300,49706300,False
2138,validator_35,96207351420,True,98517000,8763900,107280900,False
2139,validator_16,32382868179,True,238771997,1415580,240187577,True
2140,validator_39,32792947820,True,193720000,846200,194566200,False
2141,validator_44,96427989940,True,118906000,433340,119339340,False
2142,validator_35,96307325720,True,98931000,1043300,99974300,False
2143,validator_26,32146037180,True,62800000,391780,63191780,False
2144,validator_34,256722364080,True,110510000,691200,111201200,False
2145,validator_14,96250923004,True,101537003,7969100,109506103,True
2146,validator_31,160762691080,True,194089000,4940780,199029780,False
2147,validator_37,64489107200,True,144263000,2491200,146754200,False
2148,validator_44,96566635320,True,136232000,2413380,138645380,False
2149,validator_1,64270057627,True,133443003,1611300,135054303,True
2150,validator_13,32213547794,True,86255997,7099200,93355197,True
2151,validator_5,64662410311,True,104073999,3196400,107270399,True
2152,validator_0,32826780753,True,156411003,392030,156803033,True
2153,validator_46,96542265480,True,205934000,6000940,211934940,False
2154,validator_14,96294853264,True,43218000,712260,43930260,True
2155,validator_4,32212748920,True,211209000,1539920,212748920,True
2156,validator_34,256844241980,True,121487000,390900,121877900,False
2157,validator_8,32161710001,True,42288002,406700,42694702,True
2158,validator_34,256949413080,True,105072000,99100,105171100,False
2159,validator_41,64340885340,True,118939000,926220,119865220,False
2160,validator_37,64557541620,True,68225000,209420,68434420,False
2161,validator_12,96655349234,True,84398996,2543230,86942226,True
2162,validator_34,257133807480,True,184147000,247400,184394400,False
2163,validator_5,64826506353,True,163213002,883040,164096042,True
2164,validator_30,64225437420,True,93026000,4537500,97563500,False
2165,validator_49,64302827890,True,77572000,2168400,79740400,False
2166,validator_31,160886554920,True,123396000,467840,123863840,False
2167,validator_23,32257816394,True,144538000,1070270,145608270,True
2168,validator_45,32173722040,True,105308000,1484800,106792800,False
2169,validator_22,64496000851,True,101102995,8148100,109251095,True
2170,validator_17,160548375614,True,55838001,444320,56282321,True
2171,validator_42,32512134320,True,142992000,7857380,150849380,False
2172,validator_39,32905967020,True,111636000,1383200,113019200,False
2173,validator_7,64573084198,True,108073000,18029440,126102440,True
2174,validator_31,160980488360,True,75515000,18418440,93933440,False
2175,validator_46,96605205610,True,60860000,2080130,62940130,False
2176,validator_17,160604291114,True,47560000,8355500,55915500,True
2177,validator_16,32586240679,True,201479000,1893500,203372500,True
2178,validator_32,32521044330,True,167166000,1180800,168346800,False
2179,validator_47,64304049890,True,108792000,1529100,110321100,False
2180,validator_35,96408281220,True,99937000,1018500,100955500,False
2181,validator_44,96702937100,True,117849000,18452780,136301780,False
2182,validator_19,64644264134,True,100572995,593930,101166925,True
2183,validator_6,32244331720,True,56799998,22434800,79234798,True
2184,validator_43,64407853330,True,93156000,1599540,94755540,False
2185,validator_12,96831709513,True,175849999,510280,176360279,True
2186,validator_2,32392940210,True,96344997,425400,96770397,True
2187,validator_41,64449786840,True,107402000,1499500,108901500,False
2188,validator_34,257241088380,True,88866000,18414900,107280900,False
2189,validator_10,32223516697,True,60185000,1666400,61851400,True
2190,validator_36,96922159950,True,72149000,1467280,73616280,False
2191,validator_41,64720855870,True,270404000,665030,271069030,False
2192,validator_43,64573716250,True,147660000,18202920,165862920,False
2193,validator_41,64810486670,True,89049000,581800,89630800,False
2194,validator_11,32277619602,True,93945004,18718800,112663804,True
2195,validator_49,64472770790,True,168498000,1444900,169942900,False
2196,validator_36,97124393630,True,193975000,8258680,202233680,False
2197,validator_39,33025239020,True,110182000,9090000,119272000,False
2198,validator_2,32576442713,True,177101003,6401500,183502503,True
2199,validator_30,64361374320,True,133949000,1987900,135936900,False
2200,validator_24,32271110392,True,138362997,2186600,140549597,True
2201,validator_16,32780396887,True,174466008,19690200,194156208,True
2202,validator_44,96802781370,True,99111000,733270,99844270,False
2203,validator_38,32644203240,True,83317000,25944200,109261200,False
2204,validator_27,96551607370,True,120649000,1598100,122247100,False
2205,validator_8,32326233297,True,162982996,1540300,164523296,True
2206,validator_29,32153009620,True,53002000,586230,53588230,False
2207,validator_10,32433591728,True,207036001,3039030,210075031,True
2208,validator_35,96476024220,True,59198000,8545000,67743000,False
2209,validator_11,32377145222,True,97874000,1651620,99525620,True
2210,validator_39,33173121420,True,146179000,1703400,147882400,False
2211,validator_28,33374281400,True,199040000,2733340,201773340,False
2212,validator_17,160736719948,True,131660004,768830,132428834,True
2213,validator_25,32265319300,True,96908000,18674600,115582600,False
2214,validator_48,160819747640,True,44964000,1563780,46527780,False
2215,validator_15,256717199945,True,85057002,953900,86010902,True
2216,validator_33,32359068700,True,242780000,1476300,244256300,False
2217,validator_46,96780662850,True,173674000,1783240,175457240,False
2218,validator_22,64602373830,True,105164999,1207980,106372979,True
2219,validator_49,64601123590,True,127770000,582800,128352800,False
2220,validator_24,32476931219,True,204132997,1687830,205820827,True
2221,validator_22,64713831782,True,109834992,1622960,111457952,True
2222,validator_33,32469663700,True,100989000,9606000,110595000,False
2223,validator_6,32374559136,True,128273996,1953420,130227416,True
2224,validator_40,32215954490,True,107657000,238100,107895100,False
2225,validator_35,96558518620,True,81797000,697400,82494400,False
2226,validator_34,257343967880,True,102056000,823500,102879500,False
2227,validator_31,161059846060,True,78260000,1097700,79357700,False
2228,validator_11,32503226319,True,95849997,30231100,126081097,True
2229,validator_42,32609513160,True,96901000,477840,97378840,False
2230,validator_19,64788724563,True,144161999,298430,144460429,True
2231,validator_7,64645239740,True,71975002,180540,72155542,True
2232,validator_9,32650687817,True,126607998,1219880,127827878,True
2233,validator_20,32990251376,True,133634000,5719680,139353680,True
2234,validator_8,32468127958,True,139238001,2656660,141894661,True
2235,validator_32,32692074890,True,170155000,875560,171030560,False
2236,validator_25,32433003530,True,166175000,1509230,167684230,False
2237,validator_16,32874734308,True,93933001,404420,94337421,True
2238,validator_18,96874486744,True,123054001,17837200,140891201,True
2239,validator_22,64811009779,True,88085997,9092000,97177997,True
2240,validator_36,97309640530,True,184461000,785900,185246900,False
2241,validator_34,257469022550,True,117563000,7491670,125054670,False
2242,validator_35,96614271160,True,47821000,7931540,55752540,False
2243,validator_35,96791178860,True,175438000,1469700,176907700,False
2244,validator_23,32497010526,True,216234002,22960130,239194132,True
2245,validator_4,32385857021,True,172050001,1058100,173108101,True
2246,validator_31,161216970760,True,156209000,915700,157124700,False
2247,validator_11,32582862615,True,77752996,1883300,79636296,True
2248,validator_27,96713804070,True,161219000,977700,162196700,False
2249,validator_44,97065373770,True,261906000,686400,262592400,False
2250,validator_43,64743983700,True,167440000,2827450,170267450,False
2251,validator_26,32345012480,True,198357000,618300,198975300,False
2252,validator_36,97411913930,True,101218000,1055400,102273400,False
2253,validator_26,32494280620,True,147830000,1438140,149268140,False
2254,validator_41,64954725870,True,121934000,22305200,144239200,False
2255,validator_49,64727149190,True,100397000,25628600,126025600,False
2256,validator_18,97004448446,True,122436002,7525700,129961702,True
2257,validator_0,32938030183,True,110331000,918430,111249430,True
2258,validator_46,96889446780,True,108104000,679930,108783930,False
2259,validator_34,257629257940,True,152035000,8200390,160235390,False
2260,validator_46,97013679180,True,105514000,18718400,124232400,False
2261,validator_11,32878903716,True,294338001,1703100,296041101,True
2262,validator_31,161327947260,True,109130000,1846500,110976500,False
2263,validator_27,96796994210,True,64678000,18512140,83190140,False
2264,validator_33,32579749000,True,90565000,19520300,110085300,False
2265,validator_12,97091785215,True,241528002,18547700,260075702,True
2266,validator_37,64600973440,True,43098000,333820,43431820,False
2267,validator_33,32736236530,True,155593000,894530,156487530,False
2268,validator_9,32776054456,True,123901999,1464640,125366639,True
2269,validator_23,32649035599,True,132778003,19247070,152025073,True
2270,validator_29,32315766960,True,161425000,1332340,162757340,False
2271,validator_47,64468972890,True,162714000,2209000,164923000,False
2272,validator_13,32320700696,True,106120002,1032900,107152902,True
2273,validator_6,32498795939,True,123485003,751800,124236803,True
2274,validator_36,97489089210,True,75171000,2004280,77175280,False
2275,validator_43,64877166800,True,131346000,1837100,133183100,False
2276,validator_2,32832184910,True,254111997,1630200,255742197,True
2277,validator_17,160799602584,True,54906996,7975640,62882636,True
2278,validator_6,32581423135,True,81580996,1046200,82627196,True
2279,validator_19,64966318767,True,176318004,1276200,177594204,True
2280,validator_15,256900145237,True,166537002,16408290,182945292,True
2281,validator_33,32828844930,True,91370000,1238400,92608400,False
2282,validator_37,64777415240,True,157826000,18615800,176441800,False
2283,validator_23,32748534299,True,81466000,18032700,99498700,True
2284,validator_11,33001038318,True,121187002,947600,122134602,True
2285,validator_46,97143660180,True,128994000,987000,129981000,False
2286,validator_3,32597186423,True,71834994,2087700,73922694,True
2287,validator_40,32367020390,True,148603000,2462900,151065900,False
2288,validator_6,32681899736,True,98940001,1536600,100476601,True
2289,validator_41,65088716370,True,115225000,18765500,133990500,False
2290,validator_41,65241621900,True,150384000,2521530,152905530,False
2291,validator_42,32822299380,True,211688000,1098220,212786220,False
2292,validator_9,32850448982,True,73095996,1298530,74394526,True
2293,validator_5,64878900256,True,51628003,765900,52393903,True
2294,validator_14,96366982465,True,69592001,2537200,72129201,True
2295,validator_5,64985494558,True,105555002,1039300,106594302,True
2296,validator_31,161466898860,True,119254000,19697600,138951600,False
2297,validator_22,64921562836,True,110086997,466060,110553057,True
2298,validator_13,32451951499,True,128819003,2431800,131250803,True
2299,validator_38,32803161680,True,157910000,1048440,158958440,False
2300,validator_15,257054090738,True,145912001,8033500,153945501,True
2301,validator_17,160871597846,True,71324002,671260,71995262,True
2302,validator_6,32830854835,True,130236999,18718100,148955099,True
2303,validator_6,32912860464,True,81447999,557630,82005629,True
2304,validator_46,97265200340,True,120277000,1263160,121540160,False
2305,validator_23,32986701078,True,234683999,3482780,238166779,True
2306,validator_6,33100953901,True,181360997,6732440,188093437,True
2307,validator_27,96916801510,True,118373000,1434300,119807300,False
2308,validator_4,32501348498,True,114878997,612480,115491477,True
2309,validator_17,161014496480,True,137932994,4965640,142898634,True
2310,validator_5,65080371457,True,92887999,1988900,94876899,True
2311,validator_11,33085477903,True,83301995,1137590,84439585,True
2312,validator_41,65344476400,True,83503000,19351500,102854500,False
2313,validator_12,97197020785,True,92185000,13050570,105235570,True
2314,validator_47,64573088690,True,103428000,687800,104115800,False
2315,validator_7,64787915961,True,142115001,561220,142676221,True
2316,validator_30,64423107900,True,53661000,8072580,61733580,False
2317,validator_26,32683087320,True,188492000,314700,188806700,False
2318,validator_48,160948037240,True,127078000,1211600,128289600,False
2319,validator_29,32425321630,True,108245000,1309670,109554670,False
2320,validator_6,33177865298,True,75477997,1433400,76911397,True
2321,validator_32,32846734890,True,153182000,1478000,154660000,False
2322,validator_32,32917850970,True,69630000,1486080,71116080,False
2323,validator_0,33046190113,True,89068000,19091930,108159930,True
2324,validator_34,257768543130,True,137289000,1996190,139285190,False
2325,validator_10,32601387070,True,166389002,1406340,167795342,True
2326,validator_15,257105727144,True,49490006,2146400,51636406,True
2327,validator_46,97407972360,True,138004000,4768020,142772020,False
2328,validator_43,64919310700,True,41343000,800900,42143900,False
2329,validator_26,32831488240,True,148215000,185920,148400920,False
2330,validator_18,97166077343,True,160421997,1206900,161628897,True
2331,validator_19,65135218465,True,160625998,8273700,168899698,True
2332,validator_22,65204875633,True,282162997,1149800,283312797,True
2333,validator_19,65281882043,True,145838998,824580,146663578,True
2334,validator_6,33229629914,True,49824996,1939620,51764616,True
2335,validator_32,32976848260,True,40394000,18603290,58997290,False
2336,validator_41,65387620640,True,42716000,428240,43144240,False
2337,validator_45,32376349340,True,198925000,3702300,202627300,False
2338,validator_5,65174953558,True,93799001,783100,94582101,True
2339,validator_49,64893259930,True,164370000,1740740,166110740,False
2340,validator_46,97574163950,True,164789000,1402590,166191590,False
2341,validator_36,97590891010,True,95789000,6012800,101801800,False
2342,validator_36,97741713370,True,150168000,654360,150822360,False
2343,validator_16,32933008906,True,57672998,601600,58274598,True
2344,validator_0,33178465711,True,128456998,3818600,132275598,True
2345,validator_37,64896087100,True,115882000,2789860,118671860,False
2346,validator_47,64672180290,True,81070000,18021600,99091600,False
2347,validator_47,64829961770,True,157288000,493480,157781480,False
2348,validator_16,33101460495,True,163014999,5436590,168451589,True
2349,validator_37,65104392200,True,189516000,18789100,208305100,False
2350,validator_17,161192991883,True,177517003,978400,178495403,True
2351,validator_29,32475684130,True,45069000,5293500,50362500,False
2352,validator_15,257352146315,True,244572001,1847170,246419171,True
2353,validator_40,32487301690,True,111963000,8318300,120281300,False
2354,validator_17,161289995526,True,90295003,6708640,97003643,True
2355,validator_14,96593913493,True,225743998,1187030,226931028,True
2356,validator_21,64235234399,True,233804999,1429400,235234399,True
2357,validator_17,161408789531,True,100274005,18520000,118794005,True
2358,validator_9,32933333465,True,82500003,384480,82884483,True
2359,validator_10,32708033170,True,87912000,18734100,106646100,True
2360,validator_25,32614112810,True,178535000,2574280,181109280,False
2361,validator_32,33085068000,True,106221000,1998740,108219740,False
2362,validator_17,161507270631,True,96537000,1944100,98481100,True
2363,validator_18,97289074440,True,122206997,790100,122997097,True
2364,validator_36,97833464110,True,90911000,839740,91750740,False
2365,validator_28,33558862900,True,176295000,8286500,184581500,False
2366,validator_49,64962321530,True,68437000,624600,69061600,False
2367,validator_22,65257218638,True,51942005,401000,52343005,True
2368,validator_46,97690724870,True,115701000,859920,116560920,False
2369,validator_25,32836646810,True,221778000,756000,222534000,False
2370,validator_23,33227412030,True,221028002,19682950,240710952,True
2371,validator_39,33327169720,True,152770000,1278300,154048300,False
2372,validator_1,64358416225,True,87039998,1318600,88358598,True
2373,validator_16,33245202124,True,141363999,2377630,143741629,True
2374,validator_46,97813158570,True,102673000,19760700,122433700,False
2375,validator_2,32913315151,True,79922001,1208240,81130241,True
2376,validator_15,257413949985,True,60573000,1230670,61803670,True
2377,validator_37,65265136800,True,159611000,1133600,160744600,False
2378,validator_48,161025204740,True,75541000,1626500,77167500,False
2379,validator_48,161139311340,True,113196000,910600,114106600,False
2380,validator_7,64864872441,True,76354000,602480,76956480,True
2381,validator_35,96948714260,True,156980000,555400,157535400,False
2382,validator_21,64347529716,True,110172997,2122320,112295317,True
2383,validator_22,65370821380,True,111247002,2355740,113602742,True
2384,validator_48,161302127010,True,160084000,2731670,162815670,False
2385,validator_14,96683569496,True,88896003,760000,89656003,True
2386,validator_5,65311961161,True,133510003,3497600,137007603,True
2387,validator_34,257840642250,True,70386000,1713120,72099120,False
2388,validator_17,161653469728,True,143632997,2566100,146199097,True
2389,validator_25,32940714920,True,100334000,3734110,104068110,False
2390,validator_18,97404382845,True,114553005,755400,115308405,True
2391,validator_5,65463423158,True,149526997,1935000,151461997,True
2392,validator_45,32435849840,True,59120000,380500,59500500,False
2393,validator_7,64900366644,True,34652003,842200,35494203,True
2394,validator_32,33129148320,True,42933000,1147320,44080320,False
2395,validator_37,65319501400,True,53767000,597600,54364600,False
2396,validator_7,65018523092,True,115438008,2718440,118156448,True
2397,validator_28,33655272400,True,92927000,3482500,96409500,False
2398,validator_31,161682447760,True,213666000,1882900,215548900,False
2399,validator_11,33210831948,True,123849005,1505040,125354045,True
2400,validator_21,64419834117,True,53992001,18312400,72304401,True
2401,validator_41,65455295430,True,57534000,10140790,67674790,False
2402,validator_24,32580582825,True,101625006,2026600,103651606,True
2403,validator_27,97041700730,True,123850000,1049220,124899220,False
2404,validator_21,64585487556,True,163687999,1965440,165653439,True
2405,validator_14,96826399392,True,139660996,3168900,142829896,True
2406,validator_6,33307742414,True,69237000,8875500,78112500,True
2407,validator_23,33313293029,True,66338999,19542000,85880999,True
2408,validator_1,64483245661,True,124202006,627430,124829436,True
2409,validator_48,161444077710,True,141298000,652700,141950700,False
2410,validator_36,97963306410,True,129193000,649300,129842300,False
2411,validator_17,161952754218,True,244643000,54641490,299284490,True
2412,validator_15,257566565586,True,134517001,18098600,152615601,True
2413,validator_23,33385831860,True,70466001,2072830,72538831,True
2414,validator_45,32487283840,True,49998000,1436000,51434000,False
2415,validator_18,97463249220,True,56707995,2158380,58866375,True
2416,validator_3,32716219822,True,118448999,584400,119033399,True
2417,validator_18,97642126812,True,174291002,4586590,178877592,True
2418,validator_29,32524725750,True,48626000,415620,49041620,False
2419,validator_16,33386656527,True,139250003,2204400,141454403,True
2420,validator_47,64961802130,True,130967000,873360,131840360,False
2421,validator_15,257628622685,True,61558999,498100,62057099,True
2422,validator_18,97763246413,True,102390001,18729600,121119601,True
2423,validator_10,32873552911,True,153501001,12018740,165519741,True
2424,validator_38,32872663510,True,68731000,770830,69501830,False
2425,validator_2,33084272151,True,170068000,889000,170957000,True
2426,validator_44,97203467570,True,128472000,9621800,138093800,False
2427,validator_1,64690699802,True,206137001,1317140,207454141,True
2428,validator_31,161920173560,True,236416000,1309800,237725800,False
2429,validator_14,96974370974,True,147203002,768580,147971582,True
2430,validator_18,97942064380,True,178669997,147970,178817967,True
2431,validator_8,32566551557,True,90086999,8336600,98423599,True
2432,validator_14,97065406874,True,89382000,1653900,91035900,True
2433,validator_48,161562733510,True,116312000,2343800,118655800,False
2434,validator_33,32998661450,True,168531000,1285520,169816520,False
2435,validator_30,64562190800,True,136406000,2676900,139082900,False
2436,validator_45,32568727530,True,80016000,1427690,81443690,False
2437,validator_10,33057757712,True,183547001,657800,184204801,True
2438,validator_48,161681187110,True,117193000,1260600,118453600,False
2439,validator_3,32841639702,True,120065000,5354880,125419880,True
2440,validator_40,32620867810,True,128141000,5425120,133566120,False
2441,validator_42,32898443460,True,74969000,1175080,76144080,False
2442,validator_13,32571135699,True,116783000,2401200,119184200,True
2443,validator_17,162069107651,True,114926003,1427430,116353433,True
2444,validator_34,257960807890,True,119595000,570640,120165640,False
2445,validator_10,33140661653,True,75143001,7760940,82903941,True
2446,validator_49,65091360430,True,128294000,744900,129038900,False
2447,validator_11,33285343392,True,73443004,1068440,74511444,True
2448,validator_4,32656732599,True,146724001,8660100,155384101,True
2449,validator_41,65608243950,True,151631000,1317520,152948520,False
2450,validator_17,162284683948,True,214977997,598300,215576297,True
2451,validator_14,97209443204,True,142006000,2030330,144036330,True
2452,validator_22,65493489310,True,121872000,795930,122667930,True
2453,validator_41,65680141150,True,70676000,1221200,71897200,False
2454,validator_10,33306182654,True,159803001,5718000,165521001,True
2455,validator_49,65227227230,True,129594000,6272800,135866800,False
2456,validator_47,65074518910,True,111872000,844780,112716780,False
2457,validator_17,162414625140,True,127416002,2525190,129941192,True
2458,validator_6,33398253556,True,89920002,591140,90511142,True
2459,validator_0,33290014342,True,110692001,856630,111548631,True
2460,validator_2,33296146181,True,211699000,175030,211874030,True
2461,validator_49,65311197430,True,73877000,10093200,83970200,False
2462,validator_46,97911285990,True,96929000,1198420,98127420,False
2463,validator_27,97195588770,True,153404000,484040,153888040,False
2464,validator_47,65181017130,True,105463000,1035220,106498220,False
2465,validator_44,97392151370,True,188454000,229800,188683800,False
2466,validator_20,33079917050,True,87186004,2479670,89665674,True
2467,validator_27,97298383900,True,101290000,1505130,102795130,False
2468,validator_46,98099388190,True,186324000,1778200,188102200,False
2469,validator_29,32648192150,True,114613000,8853400,123466400,False
2470,validator_6,33430063156,True,31605000,204600,31809600,True
2471,validator_44,97653287370,True,260486000,650000,261136000,False
2472,validator_22,65629090909,True,134654999,946600,135601599,True
2473,validator_8,32700820648,True,127278001,6991090,134269091,True
2474,validator_47,65328953610,True,146851000,1085480,147936480,False
2475,validator_41,66031923500,True,350411000,1371350,351782350,False
2476,validator_29,32752406080,True,102183000,2030930,104213930,False
2477,validator_29,32888131450,True,134163000,1562370,135725370,False
2478,validator_2,33455703272,True,158114001,1443090,159557091,True
2479,validator_22,65725266135,True,95137006,1038220,96175226,True
2480,validator_29,33021604350,True,132483000,989900,133472900,False
2481,validator_14,97333556244,True,119000000,5113040,124113040,True
2482,validator_22,65785460040,True,57102005,3091900,60193905,True
2483,validator_13,32627299827,True,55677998,486130,56164128,True
2484,validator_10,33417070944,True,109574000,1314290,110888290,True
2485,validator_33,33140593290,True,129675000,12256840,141931840,False
2486,validator_19,65355032443,True,72808000,342400,73150400,True
2487,validator_35,97048034060,True,99063000,256800,99319800,False
2488,validator_22,66095421817,True,309784997,176780,309961777,True
2489,validator_41,66201563060,True,167477000,2162560,169639560,False
2490,validator_42,33019266990,True,116446000,4377530,120823530,False
2491,validator_25,33075443920,True,132346000,2383000,134729000,False
2492,validator_38,32944768280,True,71828000,276770,72104770,False
2493,validator_10,33560856048,True,141650004,2135100,143785104,True
2494,validator_0,33402231670,True,111416998,800330,112217328,True
2495,validator_23,33554855161,True,168725001,298300,169023301,True
2496,validator_40,32784986010,True,162372000,1746200,164118200,False
2497,validator_33,33244760430,True,102932000,1235140,104167140,False
2498,validator_39,33474241020,True,144928000,2143300,147071300,False
2499,validator_31,162186425580,True,264543000,1709020,266252020,False
2500,validator_18,96128910041,True,127529001,1381040,128910041,True
2501,validator_19,64121972386,True,121044996,927390,121972386,True
2502,validator_14,96141416901,True,115480001,25936900,141416901,True
2503,validator_15,256141618599,True,136370999,5247600,141618599,True
2504,validator_15,256287555151,True,145426002,510550,145936552,True
2505,validator_37,64134756300,True,132912000,1844300,134756300,False
2506,validator_48,160130734230,True,129421000,1313230,130734230,False
2507,validator_27,96074262300,True,71916000,2346300,74262300,False
2508,validator_41,64092899300,True,92498000,401300,92899300,False
2509,validator_15,256346569851,True,57338000,1676700,59014700,True
2510,validator_44,96089216800,True,88784000,432800,89216800,False
2511,validator_0,32166798502,True,158512002,8286500,166798502,True
2512,validator_45,32066929240,True,51134000,15795240,66929240,False
2513,validator_12,96178003233,True,173936003,4067230,178003233,True
2514,validator_37,64289859800,True,150236000,4867500,155103500,False
2515,validator_28,32142861200,True,140550000,2311200,142861200,False
2516,validator_27,96173979300,True,99103000,614000,99717000,False
2517,validator_28,32277097570,True,124692000,9544370,134236370,False
2518,validator_18,96211224075,True,81152004,1162030,82314034,True
2519,validator_15,256475164644,True,127882003,712790,128594793,True
2520,validator_31,160186818800,True,184681000,2137800,186818800,False
2521,validator_20,32137200877,True,136528997,671880,137200877,True
2522,validator_42,32184220940,True,163425000,20795940,184220940,False
2523,validator_23,32048351101,True,46948001,1403100,48351101,True
2524,validator_36,96087197990,True,85951000,1246990,87197990,False
2525,validator_6,32165096922,True,162449002,2647920,165096922,True
2526,validator_47,64136954900,True,136151000,803900,136954900,False
2527,validator_37,64342353000,True,46328000,6165200,52493200,False
2528,validator_27,96224585040,True,48765000,1840740,50605740,False
2529,validator_39,32044610220,True,43986000,624220,44610220,False
2530,validator_36,96221380130,True,132162000,2020140,134182140,False
2531,validator_18,96416850459,True,185696994,19929390,205626384,True
2532,validator_27,96385356870,True,159285000,1486830,160771830,False
2533,validator_47,64193728790,True,55553000,1220890,56773890,False
2534,validator_2,32136653101,True,134777001,1876100,136653101,True
2535,validator_38,32120147900,True,119785000,362900,120147900,False
2536,validator_48,160239637120,True,106882000,2020890,108902890,False
2537,validator_12,96347652829,True,168941996,707600,169649596,True
2538,validator_19,64234298906,True,107184000,5142520,112326520,True
2539,validator_44,96194591400,True,103532000,1842600,105374600,False
2540,validator_32,32148836630,True,140968000,7868630,148836630,False
2541,validator_20,32299507959,True,161193002,1114080,162307082,True
2542,validator_43,64032058100,True,31669000,389100,32058100,False
2543,validator_28,32381891170,True,81785000,23008600,104793600,False
2544,validator_22,64215305253,True,213734993,1570260,215305253,True
2545,validator_28,32551174670,True,168407000,876500,169283500,False
2546,validator_39,32083066290,True,37262000,1194070,38456070,False
2547,validator_38,32227098200,True,103891000,3059300,106950300,False
2548,validator_31,160394972800,True,207106000,1048000,208154000,False
2549,validator_34,256155416780,True,154271000,1145780,155416780,False
2550,validator_48,160346736360,True,106352000,747240,107099240,False
2551,validator_43,64081998010,True,48666000,1273910,49939910,False
2552,validator_27,96429360270,True,41506000,2497400,44003400,False
2553,validator_44,96308650600,True,111945000,2114200,114059200,False
2554,validator_25,32048004200,True,47488000,516200,48004200,False
2555,validator_3,32177654734,True,164511994,13142740,177654734,True
2556,validator_20,32446068057,True,145210998,1349100,146560098,True
2557,validator_29,32068527600,True,62760000,5767600,68527600,False
2558,validator_39,32225495690,True,137093000,5336400,142429400,False
2559,validator_46,96179682500,True,161210000,18472500,179682500,False
2560,validator_39,32350872690,True,124204000,1173000,125377000,False
2561,validator_20,32587875456,True,140073999,1733400,141807399,True
2562,validator_5,64144231751,True,142787001,1444750,144231751,True
2563,validator_34,256293439080,True,137160000,862300,138022300,False
2564,validator_29,32099421390,True,28545000,2348790,30893790,False
2565,validator_36,96325356530,True,95681000,8295400,103976400,False
2566,validator_49,64121726040,True,120519000,1207040,121726040,False
2567,validator_32,32352697530,True,200855000,3005900,203860900,False
2568,validator_38,32407906500,True,179397000,1411300,180808300,False
2569,validator_23,32112208124,True,45287003,18570020,63857023,True
2570,validator_22,64280484957,True,59597004,5582700,65179704,True
2571,validator_34,256390068180,True,87589000,9040100,96629100,False
2572,validator_17,160073329996,True,71764996,1565000,73329996,True
2573,validator_11,32164955798,True,164013998,941800,164955798,True
2574,validator_28,32694728700,True,136012000,7542030,143554030,False
2575,validator_49,64223087490,True,100628000,733450,101361450,False
2576,validator_17,160134268499,True,59856003,1082500,60938503,True
2577,validator_28,32825449500,True,128699000,2021800,130720800,False
2578,validator_31,160496000800,True,99890000,1138000,101028000,False
2579,validator_12,96431421869,True,74305000,9464040,83769040,True
2580,validator_10,32161665297,True,143396997,18268300,161665297,True
2581,validator_19,64484381908,True,249637002,446000,250083002,True
2582,validator_28,32868681300,True,42723000,508800,43231800,False
2583,validator_17,160361751901,True,225882002,1601400,227483402,True
2584,validator_26,32082845400,True,81714000,1131400,82845400,False
2585,validator_35,96100070520,True,98490000,1580520,100070520,False
2586,validator_7,64110915329,True,109936999,978330,110915329,True
2587,validator_3,32345528226,True,148964992,18908500,167873492,True
2588,validator_0,32282506706,True,115093004,615200,115708204,True
2589,validator_42,32361284940,True,156906000,20158000,177064000,False
2590,validator_1,64135003324,True,134203004,800320,135003324,True
2591,validator_2,32296169813,True,158083992,1432720,159516712,True
2592,validator_8,32119015299,True,113195999,5819300,119015299,True
2593,validator_48,160488354060,True,141093000,524700,141617700,False
2594,validator_3,32523263729,True,174638003,3097500,177735503,True
2595,validator_40,32108059390,True,106575000,1484390,108059390,False
2596,validator_30,64127873920,True,126028000,1845920,127873920,False
2597,validator_5,64474020673,True,328360002,1428920,329788922,True
2598,validator_41,64221020120,True,126346000,1774820,128120820,False
2599,validator_9,32177522740,True,158702000,18820740,177522740,True
2600,validator_13,32120192597,True,118679997,1512600,120192597,True
2601,validator_36,96432950770,True,105120000,2474240,107594240,False
2602,validator_39,32426336690,True,67869000,7595000,75464000,False
2603,validator_7,64325423626,True,211829997,2678300,214508297,True
2604,validator_43,64313097790,True,225549000,5550780,231099780,False
2605,validator_0,32506071148,True,221110992,2453450,223564442,True
2606,validator_18,96505554303,True,88038004,665840,88703844,True
2607,validator_18,96733595543,True,226920000,1121240,228041240,True
2608,validator_34,256530373880,True,129535000,10770700,140305700,False
2609,validator_5,64555139912,True,71218999,9900240,81119239,True
2610,validator_28,33013759600,True,144766000,312300,145078300,False
2611,validator_28,33172508060,True,157678000,1070460,158748460,False
2612,validator_46,96257515800,True,76585000,1248300,77833300,False
2613,validator_33,32114812400,True,95698000,19114400,114812400,False
2614,validator_25,32149736700,True,96300000,5432500,101732500,False
2615,validator_0,32669977720,True,149220992,14685580,163906572,True
2616,validator_16,32142680602,True,141703002,977600,142680602,True
2617,validator_39,32598381620,True,171842000,202930,172044930,False
2618,validator_48,160647790500,True,158883000,553440,159436440,False
2619,validator_31,160563661300,True,66199000,1461500,67660500,False
2620,validator_36,96632384370,True,198068000,1365600,199433600,False
2621,validator_38,32534942040,True,125195000,1840540,127035540,False
2622,validator_22,64386749756,True,100228999,6035800,106264799,True
2623,validator_17,160492093293,True,106546002,23795390,130341392,True
2624,validator_7,64446981758,True,121077002,481130,121558132,True
2625,validator_34,256611162880,True,79422000,1367000,80789000,False
2626,validator_20,32762368796,True,173920000,573340,174493340,True
2627,validator_36,96798837370,True,129685000,36768000,166453000,False
2628,validator_46,96330330540,True,72584000,230740,72814740,False
2629,validator_24,32130560795,True,125350005,5210790,130560795,True
2630,validator_48,160773219860,True,125053000,376360,125429360,False
2631,validator_15,256631189043,True,155382999,641400,156024399,True
2632,validator_9,32346652438,True,167749998,1379700,169129698,True
2633,validator_12,96568407008,True,136114999,870140,136985139,True
2634,validator_19,64543097209,True,58242001,473300,58715301,True
2635,validator_9,32522859939,True,172811001,3396500,176207501,True
2636,validator_20,32850897696,True,87476000,1052900,88528900,True
2637,validator_36,96848543670,True,49040000,666300,49706300,False
2638,validator_35,96207351420,True,98517000,8763900,107280900,False
2639,validator_16,32382868179,True,238771997,1415580,240187577,True
2640,validator_39,32792947820,True,193720000,846200,194566200,False
2641,validator_44,96427989940,True,118906000,433340,119339340,False
2642,validator_35,96307325720,True,98931000,1043300,99974300,False
2643,validator_26,32146037180,True,62800000,391780,63191780,False
2644,validator_34,256722364080,True,110510000,691200,111201200,False
2645,validator_14,96250923004,True,101537003,7969100,109506103,True
2646,validator_31,160762691080,True,194089000,4940780,199029780,False
2647,validator_37,64489107200,True,144263000,2491200,146754200,False
2648,validator_44,96566635320,True,136232000,2413380,138645380,False
2649,validator_1,64270057627,True,133443003,1611300,135054303,True
2650,validator_13,32213547794,True,86255997,7099200,93355197,True
2651,validator_5,64662410311,True,104073999,3196400,107270399,True
2652,validator_0,32826780753,True,156411003,392030,156803033,True
2653,validator_46,96542265480,True,205934000,6000940,211934940,False
2654,validator_14,96294853264,True,43218000,712260,43930260,True
2655,validator_4,32212748920,True,211209000,1539920,212748920,True
2656,validator_34,256844241980,True,121487000,390900,121877900,False
2657,validator_8,32161710001,True,42288002,406700,42694702,True
2658,validator_34,256949413080,True,105072000,99100,105171100,False
2659,validator_41,64340885340,True,118939000,926220,119865220,False
2660,validator_37,64557541620,True,68225000,209420,68434420,False
2661,validator_12,96655349234,True,84398996,2543230,86942226,True
2662,validator_34,257133807480,True,184147000,247400,184394400,False
2663,validator_5,64826506353,True,163213002,883040,164096042,True
2664,validator_30,64225437420,True,93026000,4537500,97563500,False
2665,validator_49,64302827890,True,77572000,2168400,79740400,False
2666,validator_31,160886554920,True,123396000,467840,123863840,False
2667,validator_23,32257816394,True,144538000,1070270,145608270,True
2668,validator_45,32173722040,True,105308000,1484800,106792800,False
2669,validator_22,64496000851,True,101102995,8148100,109251095,True
2670,validator_17,160548375614,True,55838001,444320,56282321,True
2671,validator_42,32512134320,True,142992000,7857380,150849380,False
2672,validator_39,32905967020,True,111636000,1383200,113019200,False
2673,validator_7,64573084198,True,108073000,18029440,126102440,True
2674,validator_31,160980488360,True,75515000,18418440,93933440,False
2675,validator_46,96605205610,True,60860000,2080130,62940130,False
2676,validator_17,160604291114,True,47560000,8355500,55915500,True
2677,validator_16,32586240679,True,201479000,1893500,203372500,True
2678,validator_32,32521044330,True,167166000,1180800,168346800,False
2679,validator_47,64304049890,True,108792000,1529100,110321100,False
2680,validator_35,96408281220,True,99937000,1018500,100955500,False
2681,validator_44,96702937100,True,117849000,18452780,136301780,False
2682,validator_19,64644264134,True,100572995,593930,101166925,True
2683,validator_6,32244331720,True,56799998,22434800,79234798,True
2684,validator_43,64407853330,True,93156000,1599540,94755540,False
2685,validator_12,96831709513,True,175849999,510280,176360279,True
2686,validator_2,32392940210,True,96344997,425400,96770397,True
2687,validator_41,64449786840,True,107402000,1499500,108901500,False
2688,validator_34,257241088380,True,88866000,18414900,107280900,False
2689,validator_10,32223516697,True,60185000,1666400,61851400,True
2690,validator_36,96922159950,True,72149000,1467280,73616280,False
2691,validator_41,64720855870,True,270404000,665030,271069030,False
2692,validator_43,64573716250,True,147660000,18202920,165862920,False
2693,validator_41,64810486670,True,89049000,581800,89630800,False
2694,validator_11,32277619602,True,93945004,18718800,112663804,True
2695,validator_49,64472770790,True,168498000,1444900,169942900,False
2696,validator_36,97124393630,True,193975000,8258680,202233680,False
2697,validator_39,33025239020,True,110182000,9090000,119272000,False
2698,validator_2,32576442713,True,177101003,6401500,183502503,True
2699,validator_30,64361374320,True,133949000,1987900,135936900,False
2700,validator_24,32271110392,True,138362997,2186600,140549597,True
2701,validator_16,32780396887,True,174466008,19690200,194156208,True
2702,validator_44,96802781370,True,99111000,733270,99844270,False
2703,validator_38,32644203240,True,83317000,25944200,109261200,False
2704,validator_27,96551607370,True,120649000,1598100,122247100,False
2705,validator_8,32326233297,True,162982996,1540300,164523296,True
2706,validator_29,32153009620,True,53002000,586230,53588230,False
2707,validator_10,32433591728,True,207036001,3039030,210075031,True
2708,validator_35,96476024220,True,59198000,8545000,67743000,False
2709,validator_11,32377145222,True,97874000,1651620,99525620,True
2710,validator_39,33173121420,True,146179000,1703400,147882400,False
2711,validator_28,33374281400,True,199040000,2733340,201773340,False
2712,validator_17,160736719948,True,131660004,768830,132428834,True
2713,validator_25,32265319300,True,96908000,18674600,115582600,False
2714,validator_48,160819747640,True,44964000,1563780,46527780,False
2715,validator_15,256717199945,True,85057002,953900,86010902,True
2716,validator_33,32359068700,True,242780000,1476300,244256300,False
2717,validator_46,96780662850,True,173674000,1783240,175457240,False
2718,validator_22,64602373830,True,105164999,1207980,106372979,True
2719,validator_49,64601123590,True,127770000,582800,128352800,False
2720,validator_24,32476931219,True,204132997,1687830,205820827,True
2721,validator_22,64713831782,True,109834992,1622960,111457952,True
2722,validator_33,32469663700,True,100989000,9606000,110595000,False
2723,validator_6,32374559136,True,128273996,1953420,130227416,True
2724,validator_40,32215954490,True,107657000,238100,107895100,False
2725,validator_35,96558518620,True,81797000,697400,82494400,False
2726,validator_34,257343967880,True,102056000,823500,102879500,False
2727,validator_31,161059846060,True,78260000,1097700,79357700,False
2728,validator_11,32503226319,True,95849997,30231100,126081097,True
2729,validator_42,32609513160,True,96901000,477840,97378840,False
2730,validator_19,64788724563,True,144161999,298430,144460429,True
2731,validator_7,64645239740,True,71975002,180540,72155542,True
2732,validator_9,32650687817,True,126607998,1219880,127827878,True
2733,validator_20,32990251376,True,133634000,5719680,139353680,True
2734,validator_8,32468127958,True,139238001,2656660,141894661,True
2735,validator_32,32692074890,True,170155000,875560,171030560,False
2736,validator_25,32433003530,True,166175000,1509230,167684230,False
2737,validator_16,32874734308,True,93933001,404420,94337421,True
2738,validator_18,96874486744,True,123054001,17837200,140891201,True
2739,validator_22,64811009779,True,88085997,9092000,97177997,True
2740,validator_36,97309640530,True,184461000,785900,185246900,False
2741,validator_34,257469022550,True,117563000,7491670,125054670,False
2742,validator_35,96614271160,True,47821000,7931540,55752540,False
2743,validator_35,96791178860,True,175438000,1469700,176907700,False
2744,validator_23,32497010526,True,216234002,22960130,239194132,True
2745,validator_4,32385857021,True,172050001,1058100,173108101,True
2746,validator_31,161216970760,True,156209000,915700,157124700,False
2747,validator_11,32582862615,True,77752996,1883300,79636296,True
2748,validator_27,96713804070,True,161219000,977700,162196700,False
2749,validator_44,97065373770,True,261906000,686400,262592400,False
2750,validator_43,64743983700,True,167440000,2827450,170267450,False
2751,validator_26,32345012480,True,198357000,618300,198975300,False
2752,validator_36,97411913930,True,101218000,1055400,102273400,False
2753,validator_26,32494280620,True,147830000,1438140,149268140,False
2754,validator_41,64954725870,True,121934000,22305200,144239200,False
2755,validator_49,64727149190,True,100397000,25628600,126025600,False
2756,validator_18,97004448446,True,122436002,7525700,129961702,True
2757,validator_0,32938030183,True,110331000,918430,111249430,True
2758,validator_46,96889446780,True,108104000,679930,108783930,False
2759,validator_34,257629257940,True,152035000,8200390,160235390,False
2760,validator_46,97013679180,True,105514000,18718400,124232400,False
2761,validator_11,32878903716,True,294338001,1703100,296041101,True
2762,validator_31,161327947260,True,109130000,1846500,110976500,False
2763,validator_27,96796994210,True,64678000,18512140,83190140,False
2764,validator_33,32579749000,True,90565000,19520300,110085300,False
2765,validator_12,97091785215,True,241528002,18547700,260075702,True
2766,validator_37,64600973440,True,43098000,333820,43431820,False
2767,validator_33,32736236530,True,155593000,894530,156487530,False
2768,validator_9,32776054456,True,123901999,1464640,125366639,True
2769,validator_23,32649035599,True,132778003,19247070,152025073,True
2770,validator_29,32315766960,True,161425000,1332340,162757340,False
2771,validator_47,64468972890,True,162714000,2209000,164923000,False
2772,validator_13,32320700696,True,106120002,1032900,107152902,True
2773,validator_6,32498795939,True,123485003,751800,124236803,True
2774,validator_36,97489089210,True,75171000,2004280,77175280,False
2775,validator_43,64877166800,True,131346000,1837100,133183100,False
2776,validator_2,32832184910,True,254111997,1630200,255742197,True
2777,validator_17,160799602584,True,54906996,7975640,62882636,True
2778,validator_6,32581423135,True,81580996,1046200,82627196,True
2779,validator_19,64966318767,True,176318004,1276200,177594204,True
2780,validator_15,256900145237,True,166537002,16408290,182945292,True
2781,validator_33,32828844930,True,91370000,1238400,92608400,False
2782,validator_37,64777415240,True,157826000,18615800,176441800,False
2783,validator_23,32748534299,True,81466000,18032700,99498700,True
2784,validator_11,33001038318,True,121187002,947600,122134602,True
2785,validator_46,97143660180,True,128994000,987000,129981000,False
2786,validator_3,32597186423,True,71834994,2087700,73922694,True
2787,validator_40,32367020390,True,148603000,2462900,151065900,False
2788,validator_6,32681899736,True,98940001,1536600,100476601,True
2789,validator_41,65088716370,True,115225000,18765500,133990500,False
2790,validator_41,65241621900,True,150384000,2521530,152905530,False
2791,validator_42,32822299380,True,211688000,1098220,212786220,False
2792,validator_9,32850448982,True,73095996,1298530,74394526,True
2793,validator_5,64878900256,True,51628003,765900,52393903,True
2794,validator_14,96366982465,True,69592001,2537200,72129201,True
2795,validator_5,64985494558,True,105555002,1039300,106594302,True
2796,validator_31,161466898860,True,119254000,19697600,138951600,False
2797,validator_22,64921562836,True,110086997,466060,110553057,True
2798,validator_13,32451951499,True,128819003,2431800,131250803,True
2799,validator_38,32803161680,True,157910000,1048440,158958440,False
2800,validator_15,257054090738,True,145912001,8033500,153945501,True
2801,validator_17,160871597846,True,71324002,671260,71995262,True
2802,validator_6,32830854835,True,130236999,18718100,148955099,True
2803,validator_6,32912860464,True,81447999,557630,82005629,True
2804,validator_46,97265200340,True,120277000,1263160,121540160,False
2805,validator_23,32986701078,True,234683999,3482780,238166779,True
2806,validator_6,33100953901,True,181360997,6732440,188093437,True
2807,validator_27,96916801510,True,118373000,1434300,119807300,False
2808,validator_4,32501348498,True,114878997,612480,115491477,True
2809,validator_17,161014496480,True,137932994,4965640,142898634,True
2810,validator_5,65080371457,True,92887999,1988900,94876899,True
2811,validator_11,33085477903,True,83301995,1137590,84439585,True
2812,validator_41,65344476400,True,83503000,19351500,102854500,False
2813,validator_12,97197020785,True,92185000,13050570,105235570,True
2814,validator_47,64573088690,True,103428000,687800,104115800,False
2815,validator_7,64787915961,True,142115001,561220,142676221,True
2816,validator_30,64423107900,True,53661000,8072580,61733580,False
2817,validator_26,32683087320,True,188492000,314700,188806700,False
2818,validator_48,160948037240,True,127078000,1211600,128289600,False
2819,validator_29,32425321630,True,108245000,1309670,109554670,False
2820,validator_6,33177865298,True,75477997,1433400,76911397,True
2821,validator_32,32846734890,True,153182000,1478000,154660000,False
2822,validator_32,32917850970,True,69630000,1486080,71116080,False
2823,validator_0,33046190113,True,89068000,19091930,108159930,True
2824,validator_34,257768543130,True,137289000,1996190,139285190,False
2825,validator_10,32601387070,True,166389002,1406340,167795342,True
2826,validator_15,257105727144,True,49490006,2146400,51636406,True
2827,validator_46,97407972360,True,138004000,4768020,142772020,False
2828,validator_43,64919310700,True,41343000,800900,42143900,False
2829,validator_26,32831488240,True,148215000,185920,148400920,False
2830,validator_18,97166077343,True,160421997,1206900,161628897,True
2831,validator_19,65135218465,True,160625998,8273700,168899698,True
2832,validator_22,65204875633,True,282162997,1149800,283312797,True
2833,validator_19,65281882043,True,145838998,824580,146663578,True
2834,validator_6,33229629914,True,49824996,1939620,51764616,True
2835,validator_32,32976848260,True,40394000,18603290,58997290,False
2836,validator_41,65387620640,True,42716000,428240,43144240,False
2837,validator_45,32376349340,True,198925000,3702300,202627300,False
2838,validator_5,65174953558,True,93799001,783100,94582101,True
2839,validator_49,64893259930,True,164370000,1740740,166110740,False
2840,validator_46,97574163950,True,164789000,1402590,166191590,False
2841,validator_36,97590891010,True,95789000,6012800,101801800,False
2842,validator_36,97741713370,True,150168000,654360,150822360,False
2843,validator_16,32933008906,True,57672998,601600,58274598,True
2844,validator_0,33178465711,True,128456998,3818600,132275598,True
2845,validator_37,64896087100,True,115882000,2789860,118671860,False
2846,validator_47,64672180290,True,81070000,18021600,99091600,False
2847,validator_47,64829961770,True,157288000,493480,157781480,False
2848,validator_16,33101460495,True,163014999,5436590,168451589,True
2849,validator_37,65104392200,True,189516000,18789100,208305100,False
2850,validator_17,161192991883,True,177517003,978400,178495403,True
2851,validator_29,32475684130,True,45069000,5293500,50362500,False
2852,validator_15,257352146315,True,244572001,1847170,246419171,True
2853,validator_40,32487301690,True,111963000,8318300,120281300,False
2854,validator_17,161289995526,True,90295003,6708640,97003643,True
2855,validator_14,96593913493,True,225743998,1187030,226931028,True
2856,validator_21,64235234399,True,233804999,1429400,235234399,True
2857,validator_17,161408789531,True,100274005,18520000,118794005,True
2858,validator_9,32933333465,True,82500003,384480,82884483,True
2859,validator_10,32708033170,True,87912000,18734100,106646100,True
2860,validator_25,32614112810,True,178535000,2574280,181109280,False
2861,validator_32,33085068000,True,106221000,1998740,108219740,False
2862,validator_17,161507270631,True,96537000,1944100,98481100,True
2863,validator_18,97289074440,True,122206997,790100,122997097,True
2864,validator_36,97833464110,True,90911000,839740,91750740,False
2865,validator_28,33558862900,True,176295000,8286500,184581500,False
2866,validator_49,64962321530,True,68437000,624600,69061600,False
2867,validator_22,65257218638,True,51942005,401000,52343005,True
2868,validator_46,97690724870,True,115701000,859920,116560920,False
2869,validator_25,32836646810,True,221778000,756000,222534000,False
2870,validator_23,33227412030,True,221028002,19682950,240710952,True
2871,validator_39,33327169720,True,152770000,1278300,154048300,False
2872,validator_1,64358416225,True,87039998,1318600,88358598,True
2873,validator_16,33245202124,True,141363999,2377630,143741629,True
2874,validator_46,97813158570,True,102673000,19760700,122433700,False
2875,validator_2,32913315151,True,79922001,1208240,81130241,True
2876,validator_15,257413949985,True,60573000,1230670,61803670,True
2877,validator_37,65265136800,True,159611000,1133600,160744600,False
2878,validator_48,161025204740,True,75541000,1626500,77167500,False
2879,validator_48,161139311340,True,113196000,910600,114106600,False
2880,validator_7,64864872441,True,76354000,602480,76956480,True
2881,validator_35,96948714260,True,156980000,555400,157535400,False
2882,validator_21,64347529716,True,110172997,2122320,112295317,True
2883,validator_22,65370821380,True,111247002,2355740,113602742,True
2884,validator_48,161302127010,True,160084000,2731670,162815670,False
2885,validator_14,96683569496,True,88896003,760000,89656003,True
2886,validator_5,65311961161,True,133510003,3497600,137007603,True
2887,validator_34,257840642250,True,70386000,1713120,72099120,False
2888,validator_17,161653469728,True,143632997,2566100,146199097,True
2889,validator_25,32940714920,True,100334000,3734110,104068110,False
2890,validator_18,97404382845,True,114553005,755400,115308405,True
2891,validator_5,65463423158,True,149526997,1935000,151461997,True
2892,validator_45,32435849840,True,59120000,380500,59500500,False
2893,validator_7,64900366644,True,34652003,842200,35494203,True
2894,validator_32,33129148320,True,42933000,1147320,44080320,False
2895,validator_37,65319501400,True,53767000,597600,54364600,False
2896,validator_7,65018523092,True,115438008,2718440,118156448,True
2897,validator_28,33655272400,True,92927000,3482500,96409500,False
2898,validator_31,161682447760,True,213666000,1882900,215548900,False
2899,validator_11,33210831948,True,123849005,1505040,125354045,True
2900,validator_21,64419834117,True,53992001,18312400,72304401,True
2901,validator_41,65455295430,True,57534000,10140790,67674790,False
2902,validator_24,32580582825,True,101625006,2026600,103651606,True
2903,validator_27,97041700730,True,123850000,1049220,124899220,False
2904,validator_21,64585487556,True,163687999,1965440,165653439,True
2905,validator_14,96826399392,True,139660996,3168900,142829896,True
2906,validator_6,33307742414,True,69237000,8875500,78112500,True
2907,validator_23,33313293029,True,66338999,19542000,85880999,True
2908,validator_1,64483245661,True,124202006,627430,124829436,True
2909,validator_48,161444077710,True,141298000,652700,141950700,False
2910,validator_36,97963306410,True,129193000,649300,129842300,False
2911,validator_17,161952754218,True,244643000,54641490,299284490,True
2912,validator_15,257566565586,True,134517001,18098600,152615601,True
2913,validator_23,33385831860,True,70466001,2072830,72538831,True
2914,validator_45,32487283840,True,49998000,1436000,51434000,False
2915,validator_18,97463249220,True,56707995,2158380,58866375,True
2916,validator_3,32716219822,True,118448999,584400,119033399,True
2917,validator_18,97642126812,True,174291002,4586590,178877592,True
2918,validator_29,32524725750,True,48626000,415620,49041620,False
2919,validator_16,33386656527,True,139250003,2204400,141454403,True
2920,validator_47,64961802130,True,130967000,873360,131840360,False
2921,validator_15,257628622685,True,61558999,498100,62057099,True
2922,validator_18,97763246413,True,102390001,18729600,121119601,True
2923,validator_10,32873552911,True,153501001,12018740,165519741,True
2924,validator_38,32872663510,True,68731000,770830,69501830,False
2925,validator_2,33084272151,True,170068000,889000,170957000,True
2926,validator_44,97203467570,True,128472000,9621800,138093800,False
2927,validator_1,64690699802,True,206137001,1317140,207454141,True
2928,validator_31,161920173560,True,236416000,1309800,237725800,False
2929,validator_14,96974370974,True,147203002,768580,147971582,True
2930,validator_18,97942064380,True,178669997,147970,178817967,True
2931,validator_8,32566551557,True,90086999,8336600,98423599,True
2932,validator_14,97065406874,True,89382000,1653900,91035900,True
2933,validator_48,161562733510,True,116312000,2343800,118655800,False
2934,validator_33,32998661450,True,168531000,1285520,169816520,False
2935,validator_30,64562190800,True,136406000,2676900,139082900,False
2936,validator_45,32568727530,True,80016000,1427690,81443690,False
2937,validator_10,33057757712,True,183547001,657800,184204801,True
2938,validator_48,161681187110,True,117193000,1260600,118453600,False
2939,validator_3,32841639702,True,120065000,5354880,125419880,True
2940,validator_40,32620867810,True,128141000,5425120,133566120,False
2941,validator_42,32898443460,True,74969000,1175080,76144080,False
2942,validator_13,32571135699,True,116783000,2401200,119184200,True
2943,validator_17,162069107651,True,114926003,1427430,116353433,True
2944,validator_34,257960807890,True,119595000,570640,120165640,False
2945,validator_10,33140661653,True,75143001,7760940,82903941,True
2946,validator_49,65091360430,True,128294000,744900,129038900,False
2947,validator_11,33285343392,True,73443004,1068440,74511444,True
2948,validator_4,32656732599,True,146724001,8660100,155384101,True
2949,validator_41,65608243950,True,151631000,1317520,152948520,False
2950,validator_17,162284683948,True,214977997,598300,215576297,True
2951,validator_14,97209443204,True,142006000,2030330,144036330,True
2952,validator_22,65493489310,True,121872000,795930,122667930,True
2953,validator_41,65680141150,True,70676000,1221200,71897200,False
2954,validator_10,33306182654,True,159803001,5718000,165521001,True
2955,validator_49,65227227230,True,129594000,6272800,135866800,False
2956,validator_47,65074518910,True,111872000,844780,112716780,False
2957,validator_17,162414625140,True,127416002,2525190,129941192,True
2958,validator_6,33398253556,True,89920002,591140,90511142,True
2959,validator_0,33290014342,True,110692001,856630,111548631,True
2960,validator_2,33296146181,True,211699000,175030,211874030,True
2961,validator_49,65311197430,True,73877000,10093200,83970200,False
2962,validator_46,97911285990,True,96929000,1198420,98127420,False
2963,validator_27,97195588770,True,153404000,484040,153888040,False
2964,validator_47,65181017130,True,105463000,1035220,106498220,False
2965,validator_44,97392151370,True,188454000,229800,188683800,False
2966,validator_20,33079917050,True,87186004,2479670,89665674,True
2967,validator_27,97298383900,True,101290000,1505130,102795130,False
2968,validator_46,98099388190,True,186324000,1778200,188102200,False
2969,validator_29,32648192150,True,114613000,8853400,123466400,False
2970,validator_6,33430063156,True,31605000,204600,31809600,True
2971,validator_44,97653287370,True,260486000,650000,261136000,False
2972,validator_22,65629090909,True,134654999,946600,135601599,True
2973,validator_8,32700820648,True,127278001,6991090,134269091,True
2974,validator_47,65328953610,True,146851000,1085480,147936480,False
2975,validator_41,66031923500,True,350411000,1371350,351782350,False
2976,validator_29,32752406080,True,102183000,2030930,104213930,False
2977,validator_29,32888131450,True,134163000,1562370,135725370,False
2978,validator_2,33455703272,True,158114001,1443090,159557091,True
2979,validator_22,65725266135,True,95137006,1038220,96175226,True
2980,validator_29,33021604350,True,132483000,989900,133472900,False
2981,validator_14,97333556244,True,119000000,5113040,124113040,True
2982,validator_22,65785460040,True,57102005,3091900,60193905,True
2983,validator_13,32627299827,True,55677998,486130,56164128,True
2984,validator_10,33417070944,True,109574000,1314290,110888290,True
2985,validator_33,33140593290,True,129675000,12256840,141931840,False
2986,validator_19,65355032443,True,72808000,342400,73150400,True
2987,validator_35,97048034060,True,99063000,256800,99319800,False
2988,validator_22,66095421817,True,309784997,176780,309961777,True
2989,validator_41,66201563060,True,167477000,2162560,169639560,False
2990,validator_42,33019266990,True,116446000,4377530,120823530,False
2991,validator_25,33075443920,True,132346000,2383000,134729000,False
2992,validator_38,32944768280,True,71828000,276770,72104770,False
2993,validator_10,33560856048,True,141650004,2135100,143785104,True
2994,validator_0,33402231670,True,111416998,800330,112217328,True
2995,validator_23,33554855161,True,168725001,298300,169023301,True
2996,validator_40,32784986010,True,162372000,1746200,164118200,False
2997,validator_33,33244760430,True,102932000,1235140,104167140,False
2998,validator_39,33474241020,True,144928000,2143300,147071300,False
2999,validator_31,162186425580,True,264543000,1709020,266252020,False
3000,validator_18,96128910041,True,127529001,1381040,128910041,True
3001,validator_19,64121972386,True,121044996,927390,121972386,True
3002,validator_14,96141416901,True,115480001,25936900,141416901,True
3003,validator_15,256141618599,True,136370999,5247600,141618599,True
3004,validator_15,256287555151,True,145426002,510550,145936552,True
3005,validator_37,64134756300,True,132912000,1844300,134756300,False
3006,validator_48,160130734230,True,129421000,1313230,130734230,False
3007,validator_27,96074262300,True,71916000,2346300,74262300,False
3008,validator_41,64092899300,True,92498000,401300,92899300,False
3009,validator_15,256346569851,True,57338000,1676700,59014700,True
3010,validator_44,96089216800,True,88784000,432800,89216800,False
3011,validator_0,32166798502,True,158512002,8286500,166798502,True
3012,validator_45,32066929240,True,51134000,15795240,66929240,False
3013,validator_12,96178003233,True,173936003,4067230,178003233,True
3014,validator_37,64289859800,True,150236000,4867500,155103500,False
3015,validator_28,32142861200,True,140550000,2311200,142861200,False
3016,validator_27,96173979300,True,99103000,614000,99717000,False
3017,validator_28,32277097570,True,124692000,9544370,134236370,False
3018,validator_18,96211224075,True,81152004,1162030,82314034,True
3019,validator_15,256475164644,True,127882003,712790,128594793,True
3020,validator_31,160186818800,True,184681000,2137800,186818800,False
3021,validator_20,32137200877,True,136528997,671880,137200877,True
3022,validator_42,32184220940,True,163425000,20795940,184220940,False
3023,validator_23,32048351101,True,46948001,1403100,48351101,True
3024,validator_36,96087197990,True,85951000,1246990,87197990,False
3025,validator_6,32165096922,True,162449002,2647920,165096922,True
3026,validator_47,64136954900,True,136151000,803900,136954900,False
3027,validator_37,64342353000,True,46328000,6165200,52493200,False
3028,validator_27,96224585040,True,48765000,1840740,50605740,False
3029,validator_39,32044610220,True,43986000,624220,44610220,False
3030,validator_36,96221380130,True,132162000,2020140,134182140,False
3031,validator_18,96416850459,True,185696994,19929390,205626384,True
3032,validator_27,96385356870,True,159285000,1486830,160771830,False
3033,validator_47,64193728790,True,55553000,1220890,56773890,False
3034,validator_2,32136653101,True,134777001,1876100,136653101,True
3035,validator_38,32120147900,True,119785000,362900,120147900,False
3036,validator_48,160239637120,True,106882000,2020890,108902890,False
3037,validator_12,96347652829,True,168941996,707600,169649596,True
3038,validator_19,64234298906,True,107184000,5142520,112326520,True
3039,validator_44,96194591400,True,103532000,1842600,105374600,False
3040,validator_32,32148836630,True,140968000,7868630,148836630,False
3041,validator_20,32299507959,True,161193002,1114080,162307082,True
3042,validator_43,64032058100,True,31669000,389100,32058100,False
3043,validator_28,32381891170,True,81785000,23008600,104793600,False
3044,validator_22,64215305253,True,213734993,1570260,215305253,True
3045,validator_28,32551174670,True,168407000,876500,169283500,False
3046,validator_39,32083066290,True,37262000,1194070,38456070,False
3047,validator_38,32227098200,True,103891000,3059300,106950300,False
3048,validator_31,160394972800,True,207106000,1048000,208154000,False
3049,validator_34,256155416780,True,154271000,1145780,155416780,False
3050,validator_48,160346736360,True,106352000,747240,107099240,False
3051,validator_43,64081998010,True,48666000,1273910,49939910,False
3052,validator_27,96429360270,True,41506000,2497400,44003400,False
3053,validator_44,96308650600,True,111945000,2114200,114059200,False
3054,validator_25,32048004200,True,47488000,516200,48004200,False
3055,validator_3,32177654734,True,164511994,13142740,177654734,True
3056,validator_20,32446068057,True,145210998,1349100,146560098,True
3057,validator_29,32068527600,True,62760000,5767600,68527600,False
3058,validator_39,32225495690,True,137093000,5336400,142429400,False
3059,validator_46,96179682500,True,161210000,18472500,179682500,False
3060,validator_39,32350872690,True,124204000,1173000,125377000,False
3061,validator_20,32587875456,True,140073999,1733400,141807399,True
3062,validator_5,64144231751,True,142787001,1444750,144231751,True
3063,validator_34,256293439080,True,137160000,862300,138022300,False
3064,validator_29,32099421390,True,28545000,2348790,30893790,False
3065,validator_36,96325356530,True,95681000,8295400,103976400,False
3066,validator_49,64121726040,True,120519000,1207040,121726040,False
3067,validator_32,32352697530,True,200855000,3005900,203860900,False
3068,validator_38,32407906500,True,179397000,1411300,180808300,False
3069,validator_23,32112208124,True,45287003,18570020,63857023,True
3070,validator_22,64280484957,True,59597004,5582700,65179704,True
3071,validator_34,256390068180,True,87589000,9040100,96629100,False
3072,validator_17,160073329996,True,71764996,1565000,73329996,True
3073,validator_11,32164955798,True,164013998,941800,164955798,True
3074,validator_28,32694728700,True,136012000,7542030,143554030,False
3075,validator_49,64223087490,True,100628000,733450,101361450,False
3076,validator_17,160134268499,True,59856003,1082500,60938503,True
3077,validator_28,32825449500,True,128699000,2021800,130720800,False
3078,validator_31,160496000800,True,99890000,1138000,101028000,False
3079,validator_12,96431421869,True,74305000,9464040,83769040,True
3080,validator_10,32161665297,True,143396997,18268300,161665297,True
3081,validator_19,64484381908,True,249637002,446000,250083002,True
3082,validator_28,32868681300,True,42723000,508800,43231800,False
3083,validator_17,160361751901,True,225882002,1601400,227483402,True
3084,validator_26,32082845400,True,81714000,1131400,82845400,False
3085,validator_35,96100070520,True,98490000,1580520,100070520,False
3086,validator_7,64110915329,True,109936999,978330,110915329,True
3087,validator_3,32345528226,True,148964992,18908500,167873492,True
3088,validator_0,32282506706,True,115093004,615200,115708204,True
3089,validator_42,32361284940,True,156906000,20158000,177064000,False
3090,validator_1,64135003324,True,134203004,800320,135003324,True
3091,validator_2,32296169813,True,158083992,1432720,159516712,True
3092,validator_8,32119015299,True,113195999,5819300,119015299,True
3093,validator_48,160488354060,True,141093000,524700,141617700,False
3094,validator_3,32523263729,True,174638003,3097500,177735503,True
3095,validator_40,32108059390,True,106575000,1484390,108059390,False
3096,validator_30,64127873920,True,126028000,1845920,127873920,False
3097,validator_5,64474020673,True,328360002,1428920,329788922,True
3098,validator_41,64221020120,True,126346000,1774820,128120820,False
3099,validator_9,32177522740,True,158702000,18820740,177522740,True
3100,validator_13,32120192597,True,118679997,1512600,120192597,True
3101,validator_36,96432950770,True,105120000,2474240,107594240,False
3102,validator_39,32426336690,True,67869000,7595000,75464000,False
3103,validator_7,64325423626,True,211829997,2678300,214508297,True
3104,validator_43,64313097790,True,225549000,5550780,231099780,False
3105,validator_0,32506071148,True,221110992,2453450,223564442,True
3106,validator_18,96505554303,True,88038004,665840,88703844,True
3107,validator_18,96733595543,True,226920000,1121240,228041240,True
3108,validator_34,256530373880,True,129535000,10770700,140305700,False
3109,validator_5,64555139912,True,71218999,9900240,81119239,True
3110,validator_28,33013759600,True,144766000,312300,145078300,False
3111,validator_28,33172508060,True,157678000,1070460,158748460,False
3112,validator_46,96257515800,True,76585000,1248300,77833300,False
3113,validator_33,32114812400,True,95698000,19114400,114812400,False
3114,validator_25,32149736700,True,96300000,5432500,101732500,False
3115,validator_0,32669977720,True,149220992,14685580,163906572,True
3116,validator_16,32142680602,True,141703002,977600,142680602,True
3117,validator_39,32598381620,True,171842000,202930,172044930,False
3118,validator_48,160647790500,True,158883000,553440,159436440,False
3119,validator_31,160563661300,True,66199000,1461500,67660500,False
3120,validator_36,96632384370,True,198068000,1365600,199433600,False
3121,validator_38,32534942040,True,125195000,1840540,127035540,False
3122,validator_22,64386749756,True,100228999,6035800,106264799,True
3123,validator_17,160492093293,True,106546002,23795390,130341392,True
3124,validator_7,64446981758,True,121077002,481130,121558132,True
3125,validator_34,256611162880,True,79422000,1367000,80789000,False
3126,validator_20,32762368796,True,173920000,573340,174493340,True
3127,validator_36,96798837370,True,129685000,36768000,166453000,False
3128,validator_46,96330330540,True,72584000,230740,72814740,False
3129,validator_24,32130560795,True,125350005,5210790,130560795,True
3130,validator_48,160773219860,True,125053000,376360,125429360,False
3131,validator_15,256631189043,True,155382999,641400,156024399,True
3132,validator_9,32346652438,True,167749998,1379700,169129698,True
3133,validator_12,96568407008,True,136114999,870140,136985139,True
3134,validator_19,64543097209,True,58242001,473300,58715301,True
3135,validator_9,32522859939,True,172811001,3396500,176207501,True
3136,validator_20,32850897696,True,87476000,1052900,88528900,True
3137,validator_36,96848543670,True,49040000,666300,49706300,False
3138,validator_35,96207351420,True,98517000,8763900,107280900,False
3139,validator_16,32382868179,True,238771997,1415580,240187577,True
3140,validator_39,32792947820,True,193720000,846200,194566200,False
3141,validator_44,96427989940,True,118906000,433340,119339340,False
3142,validator_35,96307325720,True,98931000,1043300,99974300,False
3143,validator_26,32146037180,True,62800000,391780,63191780,False
3144,validator_34,256722364080,True,110510000,691200,111201200,False
3145,validator_14,96250923004,True,101537003,7969100,109506103,True
3146,validator_31,160762691080,True,194089000,4940780,199029780,False
3147,validator_37,64489107200,True,144263000,2491200,146754200,False
3148,validator_44,96566635320,True,136232000,2413380,138645380,False
3149,validator_1,64270057627,True,133443003,1611300,135054303,True
3150,validator_13,32213547794,True,86255997,7099200,93355197,True
3151,validator_5,64662410311,True,104073999,3196400,107270399,True
3152,validator_0,32826780753,True,156411003,392030,156803033,True
3153,validator_46,96542265480,True,205934000,6000940,211934940,False
3154,validator_14,96294853264,True,43218000,712260,43930260,True
3155,validator_4,32212748920,True,211209000,1539920,212748920,True
3156,validator_34,256844241980,True,121487000,390900,121877900,False
3157,validator_8,32161710001,True,42288002,406700,42694702,True
3158,validator_34,256949413080,True,105072000,99100,105171100,False
3159,validator_41,64340885340,True,118939000,926220,119865220,False
3160,validator_37,64557541620,True,68225000,209420,68434420,False
3161,validator_12,96655349234,True,84398996,2543230,86942226,True
3162,validator_34,257133807480,True,184147000,247400,184394400,False
3163,validator_5,64826506353,True,163213002,883040,164096042,True
3164,validator_30,64225437420,True,93026000,4537500,97563500,False
3165,validator_49,64302827890,True,77572000,2168400,79740400,False
3166,validator_31,160886554920,True,123396000,467840,123863840,False
3167,validator_23,32257816394,True,144538000,1070270,145608270,True
3168,validator_45,32173722040,True,105308000,1484800,106792800,False
3169,validator_22,64496000851,True,101102995,8148100,109251095,True
3170,validator_17,160548375614,True,55838001,444320,56282321,True
3171,validator_42,32512134320,True,142992000,7857380,150849380,False
3172,validator_39,32905967020,True,111636000,1383200,113019200,False
3173,validator_7,64573084198,True,108073000,18029440,126102440,True
3174,validator_31,160980488360,True,75515000,18418440,93933440,False
3175,validator_46,96605205610,True,60860000,2080130,62940130,False
3176,validator_17,160604291114,True,47560000,8355500,55915500,True
3177,validator_16,32586240679,True,201479000,1893500,203372500,True
3178,validator_32,32521044330,True,167166000,1180800,168346800,False
3179,validator_47,64304049890,True,108792000,1529100,110321100,False
3180,validator_35,96408281220,True,99937000,1018500,100955500,False
3181,validator_44,96702937100,True,117849000,18452780,136301780,False
3182,validator_19,64644264134,True,100572995,593930,101166925,True
3183,validator_6,32244331720,True,56799998,22434800,79234798,True
3184,validator_43,64407853330,True,93156000,1599540,94755540,False
3185,validator_12,96831709513,True,175849999,510280,176360279,True
3186,validator_2,32392940210,True,96344997,425400,96770397,True
3187,validator_41,64449786840,True,107402000,1499500,108901500,False
3188,validator_34,257241088380,True,88866000,18414900,107280900,False
3189,validator_10,32223516697,True,60185000,1666400,61851400,True
3190,validator_36,96922159950,True,72149000,1467280,73616280,False
3191,validator_41,64720855870,True,270404000,665030,271069030,False
3192,validator_43,64573716250,True,147660000,18202920,165862920,False
3193,validator_41,64810486670,True,89049000,581800,89630800,False
3194,validator_11,32277619602,True,93945004,18718800,112663804,True
3195,validator_49,64472770790,True,168498000,1444900,169942900,False
3196,validator_36,97124393630,True,193975000,8258680,202233680,False
3197,validator_39,33025239020,True,110182000,9090000,119272000,False
3198,validator_2,32576442713,True,177101003,6401500,183502503,True
3199,validator_30,64361374320,True,133949000,1987900,135936900,False
3200,validator_24,32271110392,True,138362997,2186600,140549597,True
3201,validator_16,32780396887,True,174466008,19690200,194156208,True
3202,validator_44,96802781370,True,99111000,733270,99844270,False
3203,validator_38,32644203240,True,83317000,25944200,109261200,False
3204,validator_27,96551607370,True,120649000,1598100,122247100,False
3205,validator_8,32326233297,True,162982996,1540300,164523296,True
3206,validator_29,32153009620,True,53002000,586230,53588230,False
3207,validator_10,32433591728,True,207036001,3039030,210075031,True
3208,validator_35,96476024220,True,59198000,8545000,67743000,False
3209,validator_11,32377145222,True,97874000,1651620,99525620,True
3210,validator_39,33173121420,True,146179000,1703400,147882400,False
3211,validator_28,33374281400,True,199040000,2733340,201773340,False
3212,validator_17,160736719948,True,131660004,768830,132428834,True
3213,validator_25,32265319300,True,96908000,18674600,115582600,False
3214,validator_48,160819747640,True,44964000,1563780,46527780,False
3215,validator_15,256717199945,True,85057002,953900,86010902,True
3216,validator_33,32359068700,True,242780000,1476300,244256300,False
3217,validator_46,96780662850,True,173674000,1783240,175457240,False
3218,validator_22,64602373830,True,105164999,1207980,106372979,True
3219,validator_49,64601123590,True,127770000,582800,128352800,False
3220,validator_24,32476931219,True,204132997,1687830,205820827,True
3221,validator_22,64713831782,True,109834992,1622960,111457952,True
3222,validator_33,32469663700,True,100989000,9606000,110595000,False
3223,validator_6,32374559136,True,128273996,1953420,130227416,True
3224,validator_40,32215954490,True,107657000,238100,107895100,False
3225,validator_35,96558518620,True,81797000,697400,82494400,False
3226,validator_34,257343967880,True,102056000,823500,102879500,False
3227,validator_31,161059846060,True,78260000,1097700,79357700,False
3228,validator_11,32503226319,True,95849997,30231100,126081097,True
3229,validator_42,32609513160,True,96901000,477840,97378840,False
3230,validator_19,64788724563,True,144161999,298430,144460429,True
3231,validator_7,64645239740,True,71975002,180540,72155542,True
3232,validator_9,32650687817,True,126607998,1219880,127827878,True
3233,validator_20,32990251376,True,133634000,5719680,139353680,True
3234,validator_8,32468127958,True,139238001,2656660,141894661,True
3235,validator_32,32692074890,True,170155000,875560,171030560,False
3236,validator_25,32433003530,True,166175000,1509230,167684230,False
3237,validator_16,32874734308,True,93933001,404420,94337421,True
3238,validator_18,96874486744,True,123054001,17837200,140891201,True
3239,validator_22,64811009779,True,88085997,9092000,97177997,True
3240,validator_36,97309640530,True,184461000,785900,185246900,False
3241,validator_34,257469022550,True,117563000,7491670,125054670,False
3242,validator_35,96614271160,True,47821000,7931540,55752540,False
3243,validator_35,96791178860,True,175438000,1469700,176907700,False
3244,validator_23,32497010526,True,216234002,22960130,239194132,True
3245,validator_4,32385857021,True,172050001,1058100,173108101,True
3246,validator_31,161216970760,True,156209000,915700,157124700,False
3247,validator_11,32582862615,True,77752996,1883300,79636296,True
3248,validator_27,96713804070,True,161219000,977700,162196700,False
3249,validator_44,97065373770,True,261906000,686400,262592400,False
3250,validator_43,64743983700,True,167440000,2827450,170267450,False
3251,validator_26,32345012480,True,198357000,618300,198975300,False
3252,validator_36,97411913930,True,101218000,1055400,102273400,False
3253,validator_26,32494280620,True,147830000,1438140,149268140,False
3254,validator_41,64954725870,True,121934000,22305200,144239200,False
3255,validator_49,64727149190,True,100397000,25628600,126025600,False
3256,validator_18,97004448446,True,122436002,7525700,129961702,True
3257,validator_0,32938030183,True,110331000,918430,111249430,True
3258,validator_46,96889446780,True,108104000,679930,108783930,False
3259,validator_34,257629257940,True,152035000,8200390,160235390,False
3260,validator_46,97013679180,True,105514000,18718400,124232400,False
3261,validator_11,32878903716,True,294338001,1703100,296041101,True
3262,validator_31,161327947260,True,109130000,1846500,110976500,False
3263,validator_27,96796994210,True,64678000,18512140,83190140,False
3264,validator_33,32579749000,True,90565000,19520300,110085300,False
3265,validator_12,97091785215,True,241528002,18547700,260075702,True
3266,validator_37,64600973440,True,43098000,333820,43431820,False
3267,validator_33,32736236530,True,155593000,894530,156487530,False
3268,validator_9,32776054456,True,123901999,1464640,125366639,True
3269,validator_23,32649035599,True,132778003,19247070,152025073,True
3270,validator_29,32315766960,True,161425000,1332340,162757340,False
3271,validator_47,64468972890,True,162714000,2209000,164923000,False
3272,validator_13,32320700696,True,106120002,1032900,107152902,True
3273,validator_6,32498795939,True,123485003,751800,124236803,True
3274,validator_36,97489089210,True,75171000,2004280,77175280,False
3275,validator_43,64877166800,True,131346000,1837100,133183100,False
3276,validator_2,32832184910,True,254111997,1630200,255742197,True
3277,validator_17,160799602584,True,54906996,7975640,62882636,True
3278,validator_6,32581423135,True,81580996,1046200,82627196,True
3279,validator_19,64966318767,True,176318004,1276200,177594204,True
3280,validator_15,256900145237,True,166537002,16408290,182945292,True
3281,validator_33,32828844930,True,91370000,1238400,92608400,False
3282,validator_37,64777415240,True,157826000,18615800,176441800,False
3283,validator_23,32748534299,True,81466000,18032700,99498700,True
3284,validator_11,33001038318,True,121187002,947600,122134602,True
3285,validator_46,97143660180,True,128994000,987000,129981000,False
3286,validator_3,32597186423,True,71834994,2087700,73922694,True
3287,validator_40,32367020390,True,148603000,2462900,151065900,False
3288,validator_6,32681899736,True,98940001,1536600,100476601,True
3289,validator_41,65088716370,True,115225000,18765500,133990500,False
3290,validator_41,65241621900,True,150384000,2521530,152905530,False
3291,validator_42,32822299380,True,211688000,1098220,212786220,False
3292,validator_9,32850448982,True,73095996,1298530,74394526,True
3293,validator_5,64878900256,True,51628003,765900,52393903,True
3294,validator_14,96366982465,True,69592001,2537200,72129201,True
3295,validator_5,64985494558,True,105555002,1039300,106594302,True
3296,validator_31,161466898860,True,119254000,19697600,138951600,False
3297,validator_22,64921562836,True,110086997,466060,110553057,True
3298,validator_13,32451951499,True,128819003,2431800,131250803,True
3299,validator_38,32803161680,True,157910000,1048440,158958440,False
3300,validator_15,257054090738,True,145912001,8033500,153945501,True
3301,validator_17,160871597846,True,71324002,671260,71995262,True
3302,validator_6,32830854835,True,130236999,18718100,148955099,True
3303,validator_6,32912860464,True,81447999,557630,82005629,True
3304,validator_46,97265200340,True,120277000,1263160,121540160,False
3305,validator_23,32986701078,True,234683999,3482780,238166779,True
3306,validator_6,33100953901,True,181360997,6732440,188093437,True
3307,validator_27,96916801510,True,118373000,1434300,119807300,False
3308,validator_4,32501348498,True,114878997,612480,115491477,True
3309,validator_17,161014496480,True,137932994,4965640,142898634,True
3310,validator_5,65080371457,True,92887999,1988900,94876899,True
3311,validator_11,33085477903,True,83301995,1137590,84439585,True
3312,validator_41,65344476400,True,83503000,19351500,102854500,False
3313,validator_12,97197020785,True,92185000,13050570,105235570,True
3314,validator_47,64573088690,True,103428000,687800,104115800,False
3315,validator_7,64787915961,True,142115001,561220,142676221,True
3316,validator_30,64423107900,True,53661000,8072580,61733580,False
3317,validator_26,32683087320,True,188492000,314700,188806700,False
3318,validator_48,160948037240,True,127078000,1211600,128289600,False
3319,validator_29,32425321630,True,108245000,1309670,109554670,False
3320,validator_6,33177865298,True,75477997,1433400,76911397,True
3321,validator_32,32846734890,True,153182000,1478000,154660000,False
3322,validator_32,32917850970,True,69630000,1486080,71116080,False
3323,validator_0,33046190113,True,89068000,19091930,108159930,True
3324,validator_34,257768543130,True,137289000,1996190,139285190,False
3325,validator_10,32601387070,True,166389002,1406340,167795342,True
3326,validator_15,257105727144,True,49490006,2146400,51636406,True
3327,validator_46,97407972360,True,138004000,4768020,142772020,False
3328,validator_43,64919310700,True,41343000,800900,42143900,False
3329,validator_26,32831488240,True,148215000,185920,148400920,False
3330,validator_18,97166077343,True,160421997,1206900,161628897,True
3331,validator_19,65135218465,True,160625998,8273700,168899698,True
3332,validator_22,65204875633,True,282162997,1149800,283312797,True
3333,validator_19,65281882043,True,145838998,824580,146663578,True
3334,validator_6,33229629914,True,49824996,1939620,51764616,True
3335,validator_32,32976848260,True,40394000,18603290,58997290,False
3336,validator_41,65387620640,True,42716000,428240,43144240,False
3337,validator_45,32376349340,True,198925000,3702300,202627300,False
3338,validator_5,65174953558,True,93799001,783100,94582101,True
3339,validator_49,64893259930,True,164370000,1740740,166110740,False
3340,validator_46,97574163950,True,164789000,1402590,166191590,False
3341,validator_36,97590891010,True,95789000,6012800,101801800,False
3342,validator_36,97741713370,True,150168000,654360,150822360,False
3343,validator_16,32933008906,True,57672998,601600,58274598,True
3344,validator_0,33178465711,True,128456998,3818600,132275598,True
3345,validator_37,64896087100,True,115882000,2789860,118671860,False
3346,validator_47,64672180290,True,81070000,18021600,99091600,False
3347,validator_47,64829961770,True,157288000,493480,157781480,False
3348,validator_16,33101460495,True,163014999,5436590,168451589,True
3349,validator_37,65104392200,True,189516000,18789100,208305100,False
3350,validator_17,161192991883,True,177517003,978400,178495403,True
3351,validator_29,32475684130,True,45069000,5293500,50362500,False
3352,validator_15,257352146315,True,244572001,1847170,246419171,True
3353,validator_40,32487301690,True,111963000,8318300,120281300,False
3354,validator_17,161289995526,True,90295003,6708640,97003643,True
3355,validator_14,96593913493,True,225743998,1187030,226931028,True
3356,validator_21,64235234399,True,233804999,1429400,235234399,True
3357,validator_17,161408789531,True,100274005,18520000,118794005,True
3358,validator_9,32933333465,True,82500003,384480,82884483,True
3359,validator_10,32708033170,True,87912000,18734100,106646100,True
3360,validator_25,32614112810,True,178535000,2574280,181109280,False
3361,validator_32,33085068000,True,106221000,1998740,108219740,False
3362,validator_17,161507270631,True,96537000,1944100,98481100,True
3363,validator_18,97289074440,True,122206997,790100,122997097,True
3364,validator_36,97833464110,True,90911000,839740,91750740,False
3365,validator_28,33558862900,True,176295000,8286500,184581500,False
3366,validator_49,64962321530,True,68437000,624600,69061600,False
3367,validator_22,65257218638,True,51942005,401000,52343005,True
3368,validator_46,97690724870,True,115701000,859920,116560920,False
3369,validator_25,32836646810,True,221778000,756000,222534000,False
3370,validator_23,33227412030,True,221028002,19682950,240710952,True
3371,validator_39,33327169720,True,152770000,1278300,154048300,False
3372,validator_1,64358416225,True,87039998,1318600,88358598,True
3373,validator_16,33245202124,True,141363999,2377630,143741629,True
3374,validator_46,97813158570,True,102673000,19760700,122433700,False
3375,validator_2,32913315151,True,79922001,1208240,81130241,True
3376,validator_15,257413949985,True,60573000,1230670,61803670,True
3377,validator_37,65265136800,True,159611000,1133600,160744600,False
3378,validator_48,161025204740,True,75541000,1626500,77167500,False
3379,validator_48,161139311340,True,113196000,910600,114106600,False
3380,validator_7,64864872441,True,76354000,602480,76956480,True
3381,validator_35,96948714260,True,156980000,555400,157535400,False
3382,validator_21,64347529716,True,110172997,2122320,112295317,True
3383,validator_22,65370821380,True,111247002,2355740,113602742,True
3384,validator_48,161302127010,True,160084000,2731670,162815670,False
3385,validator_14,96683569496,True,88896003,760000,89656003,True
3386,validator_5,65311961161,True,133510003,3497600,137007603,True
3387,validator_34,257840642250,True,70386000,1713120,72099120,False
3388,validator_17,161653469728,True,143632997,2566100,146199097,True
3389,validator_25,32940714920,True,100334000,3734110,104068110,False
3390,validator_18,97404382845,True,114553005,755400,115308405,True
3391,validator_5,65463423158,True,149526997,1935000,151461997,True
3392,validator_45,32435849840,True,59120000,380500,59500500,False
3393,validator_7,64900366644,True,34652003,842200,35494203,True
3394,validator_32,33129148320,True,42933000,1147320,44080320,False
3395,validator_37,65319501400,True,53767000,597600,54364600,False
3396,validator_7,65018523092,True,115438008,2718440,118156448,True
3397,validator_28,33655272400,True,92927000,3482500,96409500,False
3398,validator_31,161682447760,True,213666000,1882900,215548900,False
3399,validator_11,33210831948,True,123849005,1505040,125354045,True
3400,validator_21,64419834117,True,53992001,18312400,72304401,True
3401,validator_41,65455295430,True,57534000,10140790,67674790,False
3402,validator_24,32580582825,True,101625006,2026600,103651606,True
3403,validator_27,97041700730,True,123850000,1049220,124899220,False
3404,validator_21,64585487556,True,163687999,1965440,165653439,True
3405,validator_14,96826399392,True,139660996,3168900,142829896,True
3406,validator_6,33307742414,True,69237000,8875500,78112500,True
3407,validator_23,33313293029,True,66338999,19542000,85880999,True
3408,validator_1,64483245661,True,124202006,627430,124829436,True
3409,validator_48,161444077710,True,141298000,652700,141950700,False
3410,validator_36,97963306410,True,129193000,649300,129842300,False
3411,validator_17,161952754218,True,244643000,54641490,299284490,True
3412,validator_15,257566565586,True,134517001,18098600,152615601,True
3413,validator_23,33385831860,True,70466001,2072830,72538831,True
3414,validator_45,32487283840,True,49998000,1436000,51434000,False
3415,validator_18,97463249220,True,56707995,2158380,58866375,True
3416,validator_3,32716219822,True,118448999,584400,119033399,True
3417,validator_18,97642126812,True,174291002,4586590,178877592,True
3418,validator_29,32524725750,True,48626000,415620,49041620,False
3419,validator_16,33386656527,True,139250003,2204400,141454403,True
3420,validator_47,64961802130,True,130967000,873360,131840360,False
3421,validator_15,257628622685,True,61558999,498100,62057099,True
3422,validator_18,97763246413,True,102390001,18729600,121119601,True
3423,validator_10,32873552911,True,153501001,12018740,165519741,True
3424,validator_38,32872663510,True,68731000,770830,69501830,False
3425,validator_2,33084272151,True,170068000,889000,170957000,True
3426,validator_44,97203467570,True,128472000,9621800,138093800,False
3427,validator_1,64690699802,True,206137001,1317140,207454141,True
3428,validator_31,161920173560,True,236416000,1309800,237725800,False
3429,validator_14,96974370974,True,147203002,768580,147971582,True
3430,validator_18,97942064380,True,178669997,147970,178817967,True
3431,validator_8,32566551557,True,90086999,8336600,98423599,True
3432,validator_14,97065406874,True,89382000,1653900,91035900,True
3433,validator_48,161562733510,True,116312000,2343800,118655800,False
3434,validator_33,32998661450,True,168531000,1285520,169816520,False
3435,validator_30,64562190800,True,136406000,2676900,139082900,False
3436,validator_45,32568727530,True,80016000,1427690,81443690,False
3437,validator_10,33057757712,True,183547001,657800,184204801,True
3438,validator_48,161681187110,True,117193000,1260600,118453600,False
3439,validator_3,32841639702,True,120065000,5354880,125419880,True
3440,validator_40,32620867810,True,128141000,5425120,133566120,False
3441,validator_42,32898443460,True,74969000,1175080,76144080,False
3442,validator_13,32571135699,True,116783000,2401200,119184200,True
3443,validator_17,162069107651,True,114926003,1427430,116353433,True
3444,validator_34,257960807890,True,119595000,570640,120165640,False
3445,validator_10,33140661653,True,75143001,7760940,82903941,True
3446,validator_49,65091360430,True,128294000,744900,129038900,False
3447,validator_11,33285343392,True,73443004,1068440,74511444,True
3448,validator_4,32656732599,True,146724001,8660100,155384101,True
3449,validator_41,65608243950,True,151631000,1317520,152948520,False
3450,validator_17,162284683948,True,214977997,598300,215576297,True
3451,validator_14,97209443204,True,142006000,2030330,144036330,True
3452,validator_22,65493489310,True,121872000,795930,122667930,True
3453,validator_41,65680141150,True,70676000,1221200,71897200,False
3454,validator_10,33306182654,True,159803001,5718000,165521001,True
3455,validator_49,65227227230,True,129594000,6272800,135866800,False
3456,validator_47,65074518910,True,111872000,844780,112716780,False
3457,validator_17,162414625140,True,127416002,2525190,129941192,True
3458,validator_6,33398253556,True,89920002,591140,90511142,True
3459,validator_0,33290014342,True,110692001,856630,111548631,True
3460,validator_2,33296146181,True,211699000,175030,211874030,True
3461,validator_49,65311197430,True,73877000,10093200,83970200,False
3462,validator_46,97911285990,True,96929000,1198420,98127420,False
3463,validator_27,97195588770,True,153404000,484040,153888040,False
3464,validator_47,65181017130,True,105463000,1035220,106498220,False
3465,validator_44,97392151370,True,188454000,229800,188683800,False
3466,validator_20,33079917050,True,87186004,2479670,89665674,True
3467,validator_27,97298383900,True,101290000,1505130,102795130,False
3468,validator_46,98099388190,True,186324000,1778200,188102200,False
3469,validator_29,32648192150,True,114613000,8853400,123466400,False
3470,validator_6,33430063156,True,31605000,204600,31809600,True
3471,validator_44,97653287370,True,260486000,650000,261136000,False
3472,validator_22,65629090909,True,134654999,946600,135601599,True
3473,validator_8,32700820648,True,127278001,6991090,134269091,True
3474,validator_47,65328953610,True,146851000,1085480,147936480,False
3475,validator_41,66031923500,True,350411000,1371350,351782350,False
3476,validator_29,32752406080,True,102183000,2030930,104213930,False
3477,validator_29,32888131450,True,134163000,1562370,135725370,False
3478,validator_2,33455703272,True,158114001,1443090,159557091,True
3479,validator_22,65725266135,True,95137006,1038220,96175226,True
3480,validator_29,33021604350,True,132483000,989900,133472900,False
3481,validator_14,97333556244,True,119000000,5113040,124113040,True
3482,validator_22,65785460040,True,57102005,3091900,60193905,True
3483,validator_13,32627299827,True,55677998,486130,56164128,True
3484,validator_10,33417070944,True,109574000,1314290,110888290,True
3485,validator_33,33140593290,True,129675000,12256840,141931840,False
3486,validator_19,65355032443,True,72808000,342400,73150400,True
3487,validator_35,97048034060,True,99063000,256800,99319800,False
3488,validator_22,66095421817,True,309784997,176780,309961777,True
3489,validator_41,66201563060,True,167477000,2162560,169639560,False
3490,validator_42,33019266990,True,116446000,4377530,120823530,False
3491,validator_25,33075443920,True,132346000,2383000,134729000,False
3492,validator_38,32944768280,True,71828000,276770,72104770,False
3493,validator_10,33560856048,True,141650004,2135100,143785104,True
3494,validator_0,33402231670,True,111416998,800330,112217328,True
3495,validator_23,33554855161,True,168725001,298300,169023301,True
3496,validator_40,32784986010,True,162372000,1746200,164118200,False
3497,validator_33,33244760430,True,102932000,1235140,104167140,False
3498,validator_39,33474241020,True,144928000,2143300,147071300,False
3499,validator_31,162186425580,True,264543000,1709020,266252020,False
3500,validator_18,96128910041,True,127529001,1381040,128910041,True
3501,validator_19,64121972386,True,121044996,927390,121972386,True
3502,validator_14,96141416901,True,115480001,25936900,141416901,True
3503,validator_15,256141618599,True,136370999,5247600,141618599,True
3504,validator_15,256287555151,True,145426002,510550,145936552,True
3505,validator_37,64134756300,True,132912000,1844300,134756300,False
3506,validator_48,160130734230,True,129421000,1313230,130734230,False
3507,validator_27,96074262300,True,71916000,2346300,74262300,False
3508,validator_41,64092899300,True,92498000,401300,92899300,False
3509,validator_15,256346569851,True,57338000,1676700,59014700,True
3510,validator_44,96089216800,True,88784000,432800,89216800,False
3511,validator_0,32166798502,True,158512002,8286500,166798502,True
3512,validator_45,32066929240,True,51134000,15795240,66929240,False
3513,validator_12,96178003233,True,173936003,4067230,178003233,True
3514,validator_37,64289859800,True,150236000,4867500,155103500,False
3515,validator_28,32142861200,True,140550000,2311200,142861200,False
3516,validator_27,96173979300,True,99103000,614000,99717000,False
3517,validator_28,32277097570,True,124692000,9544370,134236370,False
3518,validator_18,96211224075,True,81152004,1162030,82314034,True
3519,validator_15,256475164644,True,127882003,712790,128594793,True
3520,validator_31,160186818800,True,184681000,2137800,186818800,False
3521,validator_20,32137200877,True,136528997,671880,137200877,True
3522,validator_42,32184220940,True,163425000,20795940,184220940,False
3523,validator_23,32048351101,True,46948001,1403100,48351101,True
3524,validator_36,96087197990,True,85951000,1246990,87197990,False
3525,validator_6,32165096922,True,162449002,2647920,165096922,True
3526,validator_47,64136954900,True,136151000,803900,136954900,False
3527,validator_37,64342353000,True,46328000,6165200,52493200,False
3528,validator_27,96224585040,True,48765000,1840740,50605740,False
3529,validator_39,32044610220,True,43986000,624220,44610220,False
3530,validator_36,96221380130,True,132162000,2020140,134182140,False
3531,validator_18,96416850459,True,185696994,19929390,205626384,True
3532,validator_27,96385356870,True,159285000,1486830,160771830,False
3533,validator_47,64193728790,True,55553000,1220890,56773890,False
3534,validator_2,32136653101,True,134777001,1876100,136653101,True
3535,validator_38,32120147900,True,119785000,362900,120147900,False
3536,validator_48,160239637120,True,106882000,2020890,108902890,False
3537,validator_12,96347652829,True,168941996,707600,169649596,True
3538,validator_19,64234298906,True,107184000,5142520,112326520,True
3539,validator_44,96194591400,True,103532000,1842600,105374600,False
3540,validator_32,32148836630,True,140968000,7868630,148836630,False
3541,validator_20,32299507959,True,161193002,1114080,162307082,True
3542,validator_43,64032058100,True,31669000,389100,32058100,False
3543,validator_28,32381891170,True,81785000,23008600,104793600,False
3544,validator_22,64215305253,True,213734993,1570260,215305253,True
3545,validator_28,32551174670,True,168407000,876500,169283500,False
3546,validator_39,32083066290,True,37262000,1194070,38456070,False
3547,validator_38,32227098200,True,103891000,3059300,106950300,False
3548,validator_31,160394972800,True,207106000,1048000,208154000,False
3549,validator_34,256155416780,True,154271000,1145780,155416780,False
3550,validator_48,160346736360,True,106352000,747240,107099240,False
3551,validator_43,64081998010,True,48666000,1273910,49939910,False
3552,validator_27,96429360270,True,41506000,2497400,44003400,False
3553,validator_44,96308650600,True,111945000,2114200,114059200,False
3554,validator_25,32048004200,True,47488000,516200,48004200,False
3555,validator_3,32177654734,True,164511994,13142740,177654734,True
3556,validator_20,32446068057,True,145210998,1349100,146560098,True
3557,validator_29,32068527600,True,62760000,5767600,68527600,False
3558,validator_39,32225495690,True,137093000,5336400,142429400,False
3559,validator_46,96179682500,True,161210000,18472500,179682500,False
3560,validator_39,32350872690,True,124204000,1173000,125377000,False
3561,validator_20,32587875456,True,140073999,1733400,141807399,True
3562,validator_5,64144231751,True,142787001,1444750,144231751,True
3563,validator_34,256293439080,True,137160000,862300,138022300,False
3564,validator_29,32099421390,True,28545000,2348790,30893790,False
3565,validator_36,96325356530,True,95681000,8295400,103976400,False
3566,validator_49,64121726040,True,120519000,1207040,121726040,False
3567,validator_32,32352697530,True,200855000,3005900,203860900,False
3568,validator_38,32407906500,True,179397000,1411300,180808300,False
3569,validator_23,32112208124,True,45287003,18570020,63857023,True
3570,validator_22,64280484957,True,59597004,5582700,65179704,True
3571,validator_34,256390068180,True,87589000,9040100,96629100,False
3572,validator_17,160073329996,True,71764996,1565000,73329996,True
3573,validator_11,32164955798,True,164013998,941800,164955798,True
3574,validator_28,32694728700,True,136012000,7542030,143554030,False
3575,validator_49,64223087490,True,100628000,733450,101361450,False
3576,validator_17,160134268499,True,59856003,1082500,60938503,True
3577,validator_28,32825449500,True,128699000,2021800,130720800,False
3578,validator_31,160496000800,True,99890000,1138000,101028000,False
3579,validator_12,96431421869,True,74305000,9464040,83769040,True
3580,validator_10,32161665297,True,143396997,18268300,161665297,True
3581,validator_19,64484381908,True,249637002,446000,250083002,True
3582,validator_28,32868681300,True,42723000,508800,43231800,False
3583,validator_17,160361751901,True,225882002,1601400,227483402,True
3584,validator_26,32082845400,True,81714000,1131400,82845400,False
3585,validator_35,96100070520,True,98490000,1580520,100070520,False
3586,validator_7,64110915329,True,109936999,978330,110915329,True
3587,validator_3,32345528226,True,148964992,18908500,167873492,True
3588,validator_0,32282506706,True,115093004,615200,115708204,True
3589,validator_42,32361284940,True,156906000,20158000,177064000,False
3590,validator_1,64135003324,True,134203004,800320,135003324,True
3591,validator_2,32296169813,True,158083992,1432720,159516712,True
3592,validator_8,32119015299,True,113195999,5819300,119015299,True
3593,validator_48,160488354060,True,141093000,524700,141617700,False
3594,validator_3,32523263729,True,174638003,3097500,177735503,True
3595,validator_40,32108059390,True,106575000,1484390,108059390,False
3596,validator_30,64127873920,True,126028000,1845920,127873920,False
3597,validator_5,64474020673,True,328360002,1428920,329788922,True
3598,validator_41,64221020120,True,126346000,1774820,128120820,False
3599,validator_9,32177522740,True,158702000,18820740,177522740,True
3600,validator_13,32120192597,True,118679997,1512600,120192597,True
3601,validator_36,96432950770,True,105120000,2474240,107594240,False
3602,validator_39,32426336690,True,67869000,7595000,75464000,False
3603,validator_7,64325423626,True,211829997,2678300,214508297,True
3604,validator_43,64313097790,True,225549000,5550780,231099780,False
3605,validator_0,32506071148,True,221110992,2453450,223564442,True
3606,validator_18,96505554303,True,88038004,665840,88703844,True
3607,validator_18,96733595543,True,226920000,1121240,228041240,True
3608,validator_34,256530373880,True,129535000,10770700,140305700,False
3609,validator_5,64555139912,True,71218999,9900240,81119239,True
3610,validator_28,33013759600,True,144766000,312300,145078300,False
3611,validator_28,33172508060,True,157678000,1070460,158748460,False
3612,validator_46,96257515800,True,76585000,1248300,77833300,False
3613,validator_33,32114812400,True,95698000,19114400,114812400,False
3614,validator_25,32149736700,True,96300000,5432500,101732500,False
3615,validator_0,32669977720,True,149220992,14685580,163906572,True
3616,validator_16,32142680602,True,141703002,977600,142680602,True
3617,validator_39,32598381620,True,171842000,202930,172044930,False
3618,validator_48,160647790500,True,158883000,553440,159436440,False
3619,validator_31,160563661300,True,66199000,1461500,67660500,False
3620,validator_36,96632384370,True,198068000,1365600,199433600,False
3621,validator_38,32534942040,True,125195000,1840540,127035540,False
3622,validator_22,64386749756,True,100228999,6035800,106264799,True
3623,validator_17,160492093293,True,106546002,23795390,130341392,True
3624,validator_7,64446981758,True,121077002,481130,121558132,True
3625,validator_34,256611162880,True,79422000,1367000,80789000,False
3626,validator_20,32762368796,True,173920000,573340,174493340,True
3627,validator_36,96798837370,True,129685000,36768000,166453000,False
3628,validator_46,96330330540,True,72584000,230740,72814740,False
3629,validator_24,32130560795,True,125350005,5210790,130560795,True
3630,validator_48,160773219860,True,125053000,376360,125429360,False
3631,validator_15,256631189043,True,155382999,641400,156024399,True
3632,validator_9,32346652438,True,167749998,1379700,169129698,True
3633,validator_12,96568407008,True,136114999,870140,136985139,True
3634,validator_19,64543097209,True,58242001,473300,58715301,True
3635,validator_9,32522859939,True,172811001,3396500,176207501,True
3636,validator_20,32850897696,True,87476000,1052900,88528900,True
3637,validator_36,96848543670,True,49040000,666300,49706300,False
3638,validator_35,96207351420,True,98517000,8763900,107280900,False
3639,validator_16,32382868179,True,238771997,1415580,240187577,True
3640,validator_39,32792947820,True,193720000,846200,194566200,False
3641,validator_44,96427989940,True,118906000,433340,119339340,False
3642,validator_35,96307325720,True,98931000,1043300,99974300,False
3643,validator_26,32146037180,True,62800000,391780,63191780,False
3644,validator_34,256722364080,True,110510000,691200,111201200,False
3645,validator_14,96250923004,True,101537003,7969100,109506103,True
3646,validator_31,160762691080,True,194089000,4940780,199029780,False
3647,validator_37,64489107200,True,144263000,2491200,146754200,False
3648,validator_44,96566635320,True,136232000,2413380,138645380,False
3649,validator_1,64270057627,True,133443003,1611300,135054303,True
3650,validator_13,32213547794,True,86255997,7099200,93355197,True
3651,validator_5,64662410311,True,104073999,3196400,107270399,True
3652,validator_0,32826780753,True,156411003,392030,156803033,True
3653,validator_46,96542265480,True,205934000,6000940,211934940,False
3654,validator_14,96294853264,True,43218000,712260,43930260,True
3655,validator_4,32212748920,True,211209000,1539920,212748920,True
3656,validator_34,256844241980,True,121487000,390900,121877900,False
3657,validator_8,32161710001,True,42288002,406700,42694702,True
3658,validator_34,256949413080,True,105072000,99100,105171100,False
3659,validator_41,64340885340,True,118939000,926220,119865220,False
3660,validator_37,64557541620,True,68225000,209420,68434420,False
3661,validator_12,96655349234,True,84398996,2543230,86942226,True
3662,validator_34,257133807480,True,184147000,247400,184394400,False
3663,validator_5,64826506353,True,163213002,883040,164096042,True
3664,validator_30,64225437420,True,93026000,4537500,97563500,False
3665,validator_49,64302827890,True,77572000,2168400,79740400,False
3666,validator_31,160886554920,True,123396000,467840,123863840,False
3667,validator_23,32257816394,True,144538000,1070270,145608270,True
3668,validator_45,32173722040,True,105308000,1484800,106792800,False
3669,validator_22,64496000851,True,101102995,8148100,109251095,True
3670,validator_17,160548375614,True,55838001,444320,56282321,True
3671,validator_42,32512134320,True,142992000,7857380,150849380,False
3672,validator_39,32905967020,True,111636000,1383200,113019200,False
3673,validator_7,64573084198,True,108073000,18029440,126102440,True
3674,validator_31,160980488360,True,75515000,18418440,93933440,False
3675,validator_46,96605205610,True,60860000,2080130,62940130,False
3676,validator_17,160604291114,True,47560000,8355500,55915500,True
3677,validator_16,32586240679,True,201479000,1893500,203372500,True
3678,validator_32,32521044330,True,167166000,1180800,168346800,False
3679,validator_47,64304049890,True,108792000,1529100,110321100,False
3680,validator_35,96408281220,True,99937000,1018500,100955500,False
3681,validator_44,96702937100,True,117849000,18452780,136301780,False
3682,validator_19,64644264134,True,100572995,593930,101166925,True
3683,validator_6,32244331720,True,56799998,22434800,79234798,True
3684,validator_43,64407853330,True,93156000,1599540,94755540,False
3685,validator_12,96831709513,True,175849999,510280,176360279,True
3686,validator_2,32392940210,True,96344997,425400,96770397,True
3687,validator_41,64449786840,True,107402000,1499500,108901500,False
3688,validator_34,257241088380,True,88866000,18414900,107280900,False
3689,validator_10,32223516697,True,60185000,1666400,61851400,True
3690,validator_36,96922159950,True,72149000,1467280,73616280,False
3691,validator_41,64720855870,True,270404000,665030,271069030,False
3692,validator_43,64573716250,True,147660000,18202920,165862920,False
3693,validator_41,64810486670,True,89049000,581800,89630800,False
3694,validator_11,32277619602,True,93945004,18718800,112663804,True
3695,validator_49,64472770790,True,168498000,1444900,169942900,False
3696,validator_36,97124393630,True,193975000,8258680,202233680,False
3697,validator_39,33025239020,True,110182000,9090000,119272000,False
3698,validator_2,32576442713,True,177101003,6401500,183502503,True
3699,validator_30,64361374320,True,133949000,1987900,135936900,False
3700,validator_24,32271110392,True,138362997,2186600,140549597,True
3701,validator_16,32780396887,True,174466008,19690200,194156208,True
3702,validator_44,96802781370,True,99111000,733270,99844270,False
3703,validator_38,32644203240,True,83317000,25944200,109261200,False
3704,validator_27,96551607370,True,120649000,1598100,122247100,False
3705,validator_8,32326233297,True,162982996,1540300,164523296,True
3706,validator_29,32153009620,True,53002000,586230,53588230,False
3707,validator_10,32433591728,True,207036001,3039030,210075031,True
3708,validator_35,96476024220,True,59198000,8545000,67743000,False
3709,validator_11,32377145222,True,97874000,1651620,99525620,True
3710,validator_39,33173121420,True,146179000,1703400,147882400,False
3711,validator_28,33374281400,True,199040000,2733340,201773340,False
3712,validator_17,160736719948,True,131660004,768830,132428834,True
3713,validator_25,32265319300,True,96908000,18674600,115582600,False
3714,validator_48,160819747640,True,44964000,1563780,46527780,False
3715,validator_15,256717199945,True,85057002,953900,86010902,True
3716,validator_33,32359068700,True,242780000,1476300,244256300,False
3717,validator_46,96780662850,True,173674000,1783240,175457240,False
3718,validator_22,64602373830,True,105164999,1207980,106372979,True
3719,validator_49,64601123590,True,127770000,582800,128352800,False
3720,validator_24,32476931219,True,204132997,1687830,205820827,True
3721,validator_22,64713831782,True,109834992,1622960,111457952,True
3722,validator_33,32469663700,True,100989000,9606000,110595000,False
3723,validator_6,32374559136,True,128273996,1953420,130227416,True
3724,validator_40,32215954490,True,107657000,238100,107895100,False
3725,validator_35,96558518620,True,81797000,697400,82494400,False
3726,validator_34,257343967880,True,102056000,823500,102879500,False
3727,validator_31,161059846060,True,78260000,1097700,79357700,False
3728,validator_11,32503226319,True,95849997,30231100,126081097,True
3729,validator_42,32609513160,True,96901000,477840,97378840,False
3730,validator_19,64788724563,True,144161999,298430,144460429,True
3731,validator_7,64645239740,True,71975002,180540,72155542,True
3732,validator_9,32650687817,True,126607998,1219880,127827878,True
3733,validator_20,32990251376,True,133634000,5719680,139353680,True
3734,validator_8,32468127958,True,139238001,2656660,141894661,True
3735,validator_32,32692074890,True,170155000,875560,171030560,False
3736,validator_25,32433003530,True,166175000,1509230,167684230,False
3737,validator_16,32874734308,True,93933001,404420,94337421,True
3738,validator_18,96874486744,True,123054001,17837200,140891201,True
3739,validator_22,64811009779,True,88085997,9092000,97177997,True
3740,validator_36,97309640530,True,184461000,785900,185246900,False
3741,validator_34,257469022550,True,117563000,7491670,125054670,False
3742,validator_35,96614271160,True,47821000,7931540,55752540,False
3743,validator_35,96791178860,True,175438000,1469700,176907700,False
3744,validator_23,32497010526,True,216234002,22960130,239194132,True
3745,validator_4,32385857021,True,172050001,1058100,173108101,True
3746,validator_31,161216970760,True,156209000,915700,157124700,False
3747,validator_11,32582862615,True,77752996,1883300,79636296,True
3748,validator_27,96713804070,True,161219000,977700,162196700,False
3749,validator_44,97065373770,True,261906000,686400,262592400,False
3750,validator_43,64743983700,True,167440000,2827450,170267450,False
3751,validator_26,32345012480,True,198357000,618300,198975300,False
3752,validator_36,97411913930,True,101218000,1055400,102273400,False
3753,validator_26,32494280620,True,147830000,1438140,149268140,False
3754,validator_41,64954725870,True,121934000,22305200,144239200,False
3755,validator_49,64727149190,True,100397000,25628600,126025600,False
3756,validator_18,97004448446,True,122436002,7525700,129961702,True
3757,validator_0,32938030183,True,110331000,918430,111249430,True
3758,validator_46,96889446780,True,108104000,679930,108783930,False
3759,validator_34,257629257940,True,152035000,8200390,160235390,False
3760,validator_46,97013679180,True,105514000,18718400,124232400,False
3761,validator_11,32878903716,True,294338001,1703100,296041101,True
3762,validator_31,161327947260,True,109130000,1846500,110976500,False
3763,validator_27,96796994210,True,64678000,18512140,83190140,False
3764,validator_33,32579749000,True,90565000,19520300,110085300,False
3765,validator_12,97091785215,True,241528002,18547700,260075702,True
3766,validator_37,64600973440,True,43098000,333820,43431820,False
3767,validator_33,32736236530,True,155593000,894530,156487530,False
3768,validator_9,32776054456,True,123901999,1464640,125366639,True
3769,validator_23,32649035599,True,132778003,19247070,152025073,True
3770,validator_29,32315766960,True,161425000,1332340,162757340,False
3771,validator_47,64468972890,True,162714000,2209000,164923000,False
3772,validator_13,32320700696,True,106120002,1032900,107152902,True
3773,validator_6,32498795939,True,123485003,751800,124236803,True
3774,validator_36,97489089210,True,75171000,2004280,77175280,False
3775,validator_43,64877166800,True,131346000,1837100,133183100,False
3776,validator_2,32832184910,True,254111997,1630200,255742197,True
3777,validator_17,160799602584,True,54906996,7975640,62882636,True
3778,validator_6,32581423135,True,81580996,1046200,82627196,True
3779,validator_19,64966318767,True,176318004,1276200,177594204,True
3780,validator_15,256900145237,True,166537002,16408290,182945292,True
3781,validator_33,32828844930,True,91370000,1238400,92608400,False
3782,validator_37,64777415240,True,157826000,18615800,176441800,False
3783,validator_23,32748534299,True,81466000,18032700,99498700,True
3784,validator_11,33001038318,True,121187002,947600,122134602,True
3785,validator_46,97143660180,True,128994000,987000,129981000,False
3786,validator_3,32597186423,True,71834994,2087700,73922694,True
3787,validator_40,32367020390,True,148603000,2462900,151065900,False
3788,validator_6,32681899736,True,98940001,1536600,100476601,True
3789,validator_41,65088716370,True,115225000,18765500,133990500,False
3790,validator_41,65241621900,True,150384000,2521530,152905530,False
3791,validator_42,32822299380,True,211688000,1098220,212786220,False
3792,validator_9,32850448982,True,73095996,1298530,74394526,True
3793,validator_5,64878900256,True,51628003,765900,52393903,True
3794,validator_14,96366982465,True,69592001,2537200,72129201,True
3795,validator_5,64985494558,True,105555002,1039300,106594302,True
3796,validator_31,161466898860,True,119254000,19697600,138951600,False
3797,validator_22,64921562836,True,110086997,466060,110553057,True
3798,validator_13,32451951499,True,128819003,2431800,131250803,True
3799,validator_38,32803161680,True,157910000,1048440,158958440,False
3800,validator_15,257054090738,True,145912001,8033500,153945501,True
3801,validator_17,160871597846,True,71324002,671260,71995262,True
3802,validator_6,32830854835,True,130236999,18718100,148955099,True
3803,validator_6,32912860464,True,81447999,557630,82005629,True
3804,validator_46,97265200340,True,120277000,1263160,121540160,False
3805,validator_23,32986701078,True,234683999,3482780,238166779,True
3806,validator_6,33100953901,True,181360997,6732440,188093437,True
3807,validator_27,96916801510,True,118373000,1434300,119807300,False
3808,validator_4,32501348498,True,114878997,612480,115491477,True
3809,validator_17,161014496480,True,137932994,4965640,142898634,True
3810,validator_5,65080371457,True,92887999,1988900,94876899,True
3811,validator_11,33085477903,True,83301995,1137590,84439585,True
3812,validator_41,65344476400,True,83503000,19351500,102854500,False
3813,validator_12,97197020785,True,92185000,13050570,105235570,True
3814,validator_47,64573088690,True,103428000,687800,104115800,False
3815,validator_7,64787915961,True,142115001,561220,142676221,True
3816,validator_30,64423107900,True,53661000,8072580,61733580,False
3817,validator_26,32683087320,True,188492000,314700,188806700,False
3818,validator_48,160948037240,True,127078000,1211600,128289600,False
3819,validator_29,32425321630,True,108245000,1309670,109554670,False
3820,validator_6,33177865298,True,75477997,1433400,76911397,True
3821,validator_32,32846734890,True,153182000,1478000,154660000,False
3822,validator_32,32917850970,True,69630000,1486080,71116080,False
3823,validator_0,33046190113,True,89068000,19091930,108159930,True
3824,validator_34,257768543130,True,137289000,1996190,139285190,False
3825,validator_10,32601387070,True,166389002,1406340,167795342,True
3826,validator_15,257105727144,True,49490006,2146400,51636406,True
3827,validator_46,97407972360,True,138004000,4768020,142772020,False
3828,validator_43,64919310700,True,41343000,800900,42143900,False
3829,validator_26,32831488240,True,148215000,185920,148400920,False
3830,validator_18,97166077343,True,160421997,1206900,161628897,True
3831,validator_19,65135218465,True,160625998,8273700,168899698,True
3832,validator_22,65204875633,True,282162997,1149800,283312797,True
3833,validator_19,65281882043,True,145838998,824580,146663578,True
3834,validator_6,33229629914,True,49824996,1939620,51764616,True
3835,validator_32,32976848260,True,40394000,18603290,58997290,False
3836,validator_41,65387620640,True,42716000,428240,43144240,False
3837,validator_45,32376349340,True,198925000,3702300,202627300,False
3838,validator_5,65174953558,True,93799001,783100,94582101,True
3839,validator_49,64893259930,True,164370000,1740740,166110740,False
3840,validator_46,97574163950,True,164789000,1402590,166191590,False
3841,validator_36,97590891010,True,95789000,6012800,101801800,False
3842,validator_36,97741713370,True,150168000,654360,150822360,False
3843,validator_16,32933008906,True,57672998,601600,58274598,True
3844,validator_0,33178465711,True,128456998,3818600,132275598,True
3845,validator_37,64896087100,True,115882000,2789860,118671860,False
3846,validator_47,64672180290,True,81070000,18021600,99091600,False
3847,validator_47,64829961770,True,157288000,493480,157781480,False
3848,validator_16,33101460495,True,163014999,5436590,168451589,True
3849,validator_37,65104392200,True,189516000,18789100,208305100,False
3850,validator_17,161192991883,True,177517003,978400,178495403,True
3851,validator_29,32475684130,True,45069000,5293500,50362500,False
3852,validator_15,257352146315,True,244572001,1847170,246419171,True
3853,validator_40,32487301690,True,111963000,8318300,120281300,False
3854,validator_17,161289995526,True,90295003,6708640,97003643,True
3855,validator_14,96593913493,True,225743998,1187030,226931028,True
3856,validator_21,64235234399,True,233804999,1429400,235234399,True
3857,validator_17,161408789531,True,100274005,18520000,118794005,True
3858,validator_9,32933333465,True,82500003,384480,82884483,True
3859,validator_10,32708033170,True,87912000,18734100,106646100,True
3860,validator_25,32614112810,True,178535000,2574280,181109280,False
3861,validator_32,33085068000,True,106221000,1998740,108219740,False
3862,validator_17,161507270631,True,96537000,1944100,98481100,True
3863,validator_18,97289074440,True,122206997,790100,122997097,True
3864,validator_36,97833464110,True,90911000,839740,91750740,False
3865,validator_28,33558862900,True,176295000,8286500,184581500,False
3866,validator_49,64962321530,True,68437000,624600,69061600,False
3867,validator_22,65257218638,True,51942005,401000,52343005,True
3868,validator_46,97690724870,True,115701000,859920,116560920,False
3869,validator_25,32836646810,True,221778000,756000,222534000,False
3870,validator_23,33227412030,True,221028002,19682950,240710952,True
3871,validator_39,33327169720,True,152770000,1278300,154048300,False
3872,validator_1,64358416225,True,87039998,1318600,88358598,True
3873,validator_16,33245202124,True,141363999,2377630,143741629,True
3874,validator_46,97813158570,True,102673000,19760700,122433700,False
3875,validator_2,32913315151,True,79922001,1208240,81130241,True
3876,validator_15,257413949985,True,60573000,1230670,61803670,True
3877,validator_37,65265136800,True,159611000,1133600,160744600,False
3878,validator_48,161025204740,True,75541000,1626500,77167500,False
3879,validator_48,161139311340,True,113196000,910600,114106600,False
3880,validator_7,64864872441,True,76354000,602480,76956480,True
3881,validator_35,96948714260,True,156980000,555400,157535400,False
3882,validator_21,64347529716,True,110172997,2122320,112295317,True
3883,validator_22,65370821380,True,111247002,2355740,113602742,True
3884,validator_48,161302127010,True,160084000,2731670,162815670,False
3885,validator_14,96683569496,True,88896003,760000,89656003,True
3886,validator_5,65311961161,True,133510003,3497600,137007603,True
3887,validator_34,257840642250,True,70386000,1713120,72099120,False
3888,validator_17,161653469728,True,143632997,2566100,146199097,True
3889,validator_25,32940714920,True,100334000,3734110,104068110,False
3890,validator_18,97404382845,True,114553005,755400,115308405,True
3891,validator_5,65463423158,True,149526997,1935000,151461997,True
3892,validator_45,32435849840,True,59120000,380500,59500500,False
3893,validator_7,64900366644,True,34652003,842200,35494203,True
3894,validator_32,33129148320,True,42933000,1147320,44080320,False
3895,validator_37,65319501400,True,53767000,597600,54364600,False
3896,validator_7,65018523092,True,115438008,2718440,118156448,True
3897,validator_28,33655272400,True,92927000,3482500,96409500,False
3898,validator_31,161682447760,True,213666000,1882900,215548900,False
3899,validator_11,33210831948,True,123849005,1505040,125354045,True
3900,validator_21,64419834117,True,53992001,18312400,72304401,True
3901,validator_41,65455295430,True,57534000,10140790,67674790,False
3902,validator_24,32580582825,True,101625006,2026600,103651606,True
3903,validator_27,97041700730,True,123850000,1049220,124899220,False
3904,validator_21,64585487556,True,163687999,1965440,165653439,True
3905,validator_14,96826399392,True,139660996,3168900,142829896,True
3906,validator_6,33307742414,True,69237000,8875500,78112500,True
3907,validator_23,33313293029,True,66338999,19542000,85880999,True
3908,validator_1,64483245661,True,124202006,627430,124829436,True
3909,validator_48,161444077710,True,141298000,652700,141950700,False
3910,validator_36,97963306410,True,129193000,649300,129842300,False
3911,validator_17,161952754218,True,244643000,54641490,299284490,True
3912,validator_15,257566565586,True,134517001,18098600,152615601,True
3913,validator_23,33385831860,True,70466001,2072830,72538831,True
3914,validator_45,32487283840,True,49998000,1436000,51434000,False
3915,validator_18,97463249220,True,56707995,2158380,58866375,True
3916,validator_3,32716219822,True,118448999,584400,119033399,True
3917,validator_18,97642126812,True,174291002,4586590,178877592,True
3918,validator_29,32524725750,True,48626000,415620,49041620,False
3919,validator_16,33386656527,True,139250003,2204400,141454403,True
3920,validator_47,64961802130,True,130967000,873360,131840360,False
3921,validator_15,257628622685,True,61558999,498100,62057099,True
3922,validator_18,97763246413,True,102390001,18729600,121119601,True
3923,validator_10,32873552911,True,153501001,12018740,165519741,True
3924,validator_38,32872663510,True,68731000,770830,69501830,False
3925,validator_2,33084272151,True,170068000,889000,170957000,True
3926,validator_44,97203467570,True,128472000,9621800,138093800,False
3927,validator_1,64690699802,True,206137001,1317140,207454141,True
3928,validator_31,161920173560,True,236416000,1309800,237725800,False
3929,validator_14,96974370974,True,147203002,768580,147971582,True
3930,validator_18,97942064380,True,178669997,147970,178817967,True
3931,validator_8,32566551557,True,90086999,8336600,98423599,True
3932,validator_14,97065406874,True,89382000,1653900,91035900,True
3933,validator_48,161562733510,True,116312000,2343800,118655800,False
3934,validator_33,32998661450,True,168531000,1285520,169816520,False
3935,validator_30,64562190800,True,136406000,2676900,139082900,False
3936,validator_45,32568727530,True,80016000,1427690,81443690,False
3937,validator_10,33057757712,True,183547001,657800,184204801,True
3938,validator_48,161681187110,True,117193000,1260600,118453600,False
3939,validator_3,32841639702,True,120065000,5354880,125419880,True
3940,validator_40,32620867810,True,128141000,5425120,133566120,False
3941,validator_42,32898443460,True,74969000,1175080,76144080,False
3942,validator_13,32571135699,True,116783000,2401200,119184200,True
3943,validator_17,162069107651,True,114926003,1427430,116353433,True
3944,validator_34,257960807890,True,119595000,570640,120165640,False
3945,validator_10,33140661653,True,75143001,7760940,82903941,True
3946,validator_49,65091360430,True,128294000,744900,129038900,False
3947,validator_11,33285343392,True,73443004,1068440,74511444,True
3948,validator_4,32656732599,True,146724001,8660100,155384101,True
3949,validator_41,65608243950,True,151631000,1317520,152948520,False
3950,validator_17,162284683948,True,214977997,598300,215576297,True
3951,validator_14,97209443204,True,142006000,2030330,144036330,True
3952,validator_22,65493489310,True,121872000,795930,122667930,True
3953,validator_41,65680141150,True,70676000,1221200,71897200,False
3954,validator_10,33306182654,True,159803001,5718000,165521001,True
3955,validator_49,65227227230,True,129594000,6272800,135866800,False
3956,validator_47,65074518910,True,111872000,844780,112716780,False
3957,validator_17,162414625140,True,127416002,2525190,129941192,True
3958,validator_6,33398253556,True,89920002,591140,90511142,True
3959,validator_0,33290014342,True,110692001,856630,111548631,True
3960,validator_2,33296146181,True,211699000,175030,211874030,True
3961,validator_49,65311197430,True,73877000,10093200,83970200,False
3962,validator_46,97911285990,True,96929000,1198420,98127420,False
3963,validator_27,97195588770,True,153404000,484040,153888040,False
3964,validator_47,65181017130,True,105463000,1035220,106498220,False
3965,validator_44,97392151370,True,188454000,229800,188683800,False
3966,validator_20,33079917050,True,87186004,2479670,89665674,True
3967,validator_27,97298383900,True,101290000,1505130,102795130,False
3968,validator_46,98099388190,True,186324000,1778200,188102200,False
3969,validator_29,32648192150,True,114613000,8853400,123466400,False
3970,validator_6,33430063156,True,31605000,204600,31809600,True
3971,validator_44,97653287370,True,260486000,650000,261136000,False
3972,validator_22,65629090909,True,134654999,946600,135601599,True
3973,validator_8,32700820648,True,127278001,6991090,134269091,True
3974,validator_47,65328953610,True,146851000,1085480,147936480,False
3975,validator_41,66031923500,True,350411000,1371350,351782350,False
3976,validator_29,32752406080,True,102183000,2030930,104213930,False
3977,validator_29,32888131450,True,134163000,1562370,135725370,False
3978,validator_2,33455703272,True,158114001,1443090,159557091,True
3979,validator_22,65725266135,True,95137006,1038220,96175226,True
3980,validator_29,33021604350,True,132483000,989900,133472900,False
3981,validator_14,97333556244,True,119000000,5113040,124113040,True
3982,validator_22,65785460040,True,57102005,3091900,60193905,True
3983,validator_13,32627299827,True,55677998,486130,56164128,True
3984,validator_10,33417070944,True,109574000,1314290,110888290,True
3985,validator_33,33140593290,True,129675000,12256840,141931840,False
3986,validator_19,65355032443,True,72808000,342400,73150400,True
3987,validator_35,97048034060,True,99063000,256800,99319800,False
3988,validator_22,66095421817,True,309784997,176780,309961777,True
3989,validator_41,66201563060,True,167477000,2162560,169639560,False
3990,validator_42,33019266990,True,116446000,4377530,120823530,False
3991,validator_25,33075443920,True,132346000,2383000,134729000,False
3992,validator_38,32944768280,True,71828000,276770,72104770,False
3993,validator_10,33560856048,True,141650004,2135100,143785104,True
3994,validator_0,33402231670,True,111416998,800330,112217328,True
3995,validator_23,33554855161,True,168725001,298300,169023301,True
3996,validator_40,32784986010,True,162372000,1746200,164118200,False
3997,validator_33,33244760430,True,102932000,1235140,104167140,False
3998,validator_39,33474241020,True,144928000,2143300,147071300,False
3999,validator_31,162186425580,True,264543000,1709020,266252020,False
4000,validator_18,96128910041,True,127529001,1381040,128910041,True
4001,validator_19,64121972386,True,121044996,927390,121972386,True
4002,validator_14,96141416901,True,115480001,25936900,141416901,True
4003,validator_15,256141618599,True,136370999,5247600,141618599,True
4004,validator_15,256287555151,True,145426002,510550,145936552,True
4005,validator_37,64134756300,True,132912000,1844300,134756300,False
4006,validator_48,160130734230,True,129421000,1313230,130734230,False
4007,validator_27,96074262300,True,71916000,2346300,74262300,False
4008,validator_41,64092899300,True,92498000,401300,92899300,False
4009,validator_15,256346569851,True,57338000,1676700,59014700,True
4010,validator_44,96089216800,True,88784000,432800,89216800,False
4011,validator_0,32166798502,True,158512002,8286500,166798502,True
4012,validator_45,32066929240,True,51134000,15795240,66929240,False
4013,validator_12,96178003233,True,173936003,4067230,178003233,True
4014,validator_37,64289859800,True,150236000,4867500,155103500,False
4015,validator_28,32142861200,True,140550000,2311200,142861200,False
4016,validator_27,96173979300,True,99103000,614000,99717000,False
4017,validator_28,32277097570,True,124692000,9544370,134236370,False
4018,validator_18,96211224075,True,81152004,1162030,82314034,True
4019,validator_15,256475164644,True,127882003,712790,128594793,True
4020,validator_31,160186818800,True,184681000,2137800,186818800,False
4021,validator_20,32137200877,True,136528997,671880,137200877,True
4022,validator_42,32184220940,True,163425000,20795940,184220940,False
4023,validator_23,32048351101,True,46948001,1403100,48351101,True
4024,validator_36,96087197990,True,85951000,1246990,87197990,False
4025,validator_6,32165096922,True,162449002,2647920,165096922,True
4026,validator_47,64136954900,True,136151000,803900,136954900,False
4027,validator_37,64342353000,True,46328000,6165200,52493200,False
4028,validator_27,96224585040,True,48765000,1840740,50605740,False
4029,validator_39,32044610220,True,43986000,624220,44610220,False
4030,validator_36,96221380130,True,132162000,2020140,134182140,False
4031,validator_18,96416850459,True,185696994,19929390,205626384,True
4032,validator_27,96385356870,True,159285000,1486830,160771830,False
4033,validator_47,64193728790,True,55553000,1220890,56773890,False
4034,validator_2,32136653101,True,134777001,1876100,136653101,True
4035,validator_38,32120147900,True,119785000,362900,120147900,False
4036,validator_48,160239637120,True,106882000,2020890,108902890,False
4037,validator_12,96347652829,True,168941996,707600,169649596,True
4038,validator_19,64234298906,True,107184000,5142520,112326520,True
4039,validator_44,96194591400,True,103532000,1842600,105374600,False
4040,validator_32,32148836630,True,140968000,7868630,148836630,False
4041,validator_20,32299507959,True,161193002,1114080,162307082,True
4042,validator_43,64032058100,True,31669000,389100,32058100,False
4043,validator_28,32381891170,True,81785000,23008600,104793600,False
4044,validator_22,64215305253,True,213734993,1570260,215305253,True
4045,validator_28,32551174670,True,168407000,876500,169283500,False
4046,validator_39,32083066290,True,37262000,1194070,38456070,False
4047,validator_38,32227098200,True,103891000,3059300,106950300,False
4048,validator_31,160394972800,True,207106000,1048000,208154000,False
4049,validator_34,256155416780,True,154271000,1145780,155416780,False
4050,validator_48,160346736360,True,106352000,747240,107099240,False
4051,validator_43,64081998010,True,48666000,1273910,49939910,False
4052,validator_27,96429360270,True,41506000,2497400,44003400,False
4053,validator_44,96308650600,True,111945000,2114200,114059200,False
4054,validator_25,32048004200,True,47488000,516200,48004200,False
4055,validator_3,32177654734,True,164511994,13142740,177654734,True
4056,validator_20,32446068057,True,145210998,1349100,146560098,True
4057,validator_29,32068527600,True,62760000,5767600,68527600,False
4058,validator_39,32225495690,True,137093000,5336400,142429400,False
4059,validator_46,96179682500,True,161210000,18472500,179682500,False
4060,validator_39,32350872690,True,124204000,1173000,125377000,False
4061,validator_20,32587875456,True,140073999,1733400,141807399,True
4062,validator_5,64144231751,True,142787001,1444750,144231751,True
4063,validator_34,256293439080,True,137160000,862300,138022300,False
4064,validator_29,32099421390,True,28545000,2348790,30893790,False
4065,validator_36,96325356530,True,95681000,8295400,103976400,False
4066,validator_49,64121726040,True,120519000,1207040,121726040,False
4067,validator_32,32352697530,True,200855000,3005900,203860900,False
4068,validator_38,32407906500,True,179397000,1411300,180808300,False
4069,validator_23,32112208124,True,45287003,18570020,63857023,True
4070,validator_22,64280484957,True,59597004,5582700,65179704,True
4071,validator_34,256390068180,True,87589000,9040100,96629100,False
4072,validator_17,160073329996,True,71764996,1565000,73329996,True
4073,validator_11,32164955798,True,164013998,941800,164955798,True
4074,validator_28,32694728700,True,136012000,7542030,143554030,False
4075,validator_49,64223087490,True,100628000,733450,101361450,False
4076,validator_17,160134268499,True,59856003,1082500,60938503,True
4077,validator_28,32825449500,True,128699000,2021800,130720800,False
4078,validator_31,160496000800,True,99890000,1138000,101028000,False
4079,validator_12,96431421869,True,74305000,9464040,83769040,True
4080,validator_10,32161665297,True,143396997,18268300,161665297,True
4081,validator_19,64484381908,True,249637002,446000,250083002,True
4082,validator_28,32868681300,True,42723000,508800,43231800,False
4083,validator_17,160361751901,True,225882002,1601400,227483402,True
4084,validator_26,32082845400,True,81714000,1131400,82845400,False
4085,validator_35,96100070520,True,98490000,1580520,100070520,False
4086,validator_7,64110915329,True,109936999,978330,110915329,True
4087,validator_3,32345528226,True,148964992,18908500,167873492,True
4088,validator_0,32282506706,True,115093004,615200,115708204,True
4089,validator_42,32361284940,True,156906000,20158000,177064000,False
4090,validator_1,64135003324,True,134203004,800320,135003324,True
4091,validator_2,32296169813,True,158083992,1432720,159516712,True
4092,validator_8,32119015299,True,113195999,5819300,119015299,True
4093,validator_48,160488354060,True,141093000,524700,141617700,False
4094,validator_3,32523263729,True,174638003,3097500,177735503,True
4095,validator_40,32108059390,True,106575000,1484390,108059390,False
4096,validator_30,64127873920,True,126028000,1845920,127873920,False
4097,validator_5,64474020673,True,328360002,1428920,329788922,True
4098,validator_41,64221020120,True,126346000,1774820,128120820,False
4099,validator_9,32177522740,True,158702000,18820740,177522740,True
4100,validator_13,32120192597,True,118679997,1512600,120192597,True
4101,validator_36,96432950770,True,105120000,2474240,107594240,False
4102,validator_39,32426336690,True,67869000,7595000,75464000,False
4103,validator_7,64325423626,True,211829997,2678300,214508297,True
4104,validator_43,64313097790,True,225549000,5550780,231099780,False
4105,validator_0,32506071148,True,221110992,2453450,223564442,True
4106,validator_18,96505554303,True,88038004,665840,88703844,True
4107,validator_18,96733595543,True,226920000,1121240,228041240,True
4108,validator_34,256530373880,True,129535000,10770700,140305700,False
4109,validator_5,64555139912,True,71218999,9900240,81119239,True
4110,validator_28,33013759600,True,144766000,312300,145078300,False
4111,validator_28,33172508060,True,157678000,1070460,158748460,False
4112,validator_46,96257515800,True,76585000,1248300,77833300,False
4113,validator_33,32114812400,True,95698000,19114400,114812400,False
4114,validator_25,32149736700,True,96300000,5432500,101732500,False
4115,validator_0,32669977720,True,149220992,14685580,163906572,True
4116,validator_16,32142680602,True,141703002,977600,142680602,True
4117,validator_39,32598381620,True,171842000,202930,172044930,False
4118,validator_48,160647790500,True,158883000,553440,159436440,False
4119,validator_31,160563661300,True,66199000,1461500,67660500,False
4120,validator_36,96632384370,True,198068000,1365600,199433600,False
4121,validator_38,32534942040,True,125195000,1840540,127035540,False
4122,validator_22,64386749756,True,100228999,6035800,106264799,True
4123,validator_17,160492093293,True,106546002,23795390,130341392,True
4124,validator_7,64446981758,True,121077002,481130,121558132,True
4125,validator_34,256611162880,True,79422000,1367000,80789000,False
4126,validator_20,32762368796,True,173920000,573340,174493340,True
4127,validator_36,96798837370,True,129685000,36768000,166453000,False
4128,validator_46,96330330540,True,72584000,230740,72814740,False
4129,validator_24,32130560795,True,125350005,5210790,130560795,True
4130,validator_48,160773219860,True,125053000,376360,125429360,False
4131,validator_15,256631189043,True,155382999,641400,156024399,True
4132,validator_9,32346652438,True,167749998,1379700,169129698,True
4133,validator_12,96568407008,True,136114999,870140,136985139,True
4134,validator_19,64543097209,True,58242001,473300,58715301,True
4135,validator_9,32522859939,True,172811001,3396500,176207501,True
4136,validator_20,32850897696,True,87476000,1052900,88528900,True
4137,validator_36,96848543670,True,49040000,666300,49706300,False
4138,validator_35,96207351420,True,98517000,8763900,107280900,False
4139,validator_16,32382868179,True,238771997,1415580,240187577,True
4140,validator_39,32792947820,True,193720000,846200,194566200,False
4141,validator_44,96427989940,True,118906000,433340,119339340,False
4142,validator_35,96307325720,True,98931000,1043300,99974300,False
4143,validator_26,32146037180,True,62800000,391780,63191780,False
4144,validator_34,256722364080,True,110510000,691200,111201200,False
4145,validator_14,96250923004,True,101537003,7969100,109506103,True
4146,validator_31,160762691080,True,194089000,4940780,199029780,False
4147,validator_37,64489107200,True,144263000,2491200,146754200,False
4148,validator_44,96566635320,True,136232000,2413380,138645380,False
4149,validator_1,64270057627,True,133443003,1611300,135054303,True
4150,validator_13,32213547794,True,86255997,7099200,93355197,True
4151,validator_5,64662410311,True,104073999,3196400,107270399,True
4152,validator_0,32826780753,True,156411003,392030,156803033,True
4153,validator_46,96542265480,True,205934000,6000940,211934940,False
4154,validator_14,96294853264,True,43218000,712260,43930260,True
4155,validator_4,32212748920,True,211209000,1539920,212748920,True
4156,validator_34,256844241980,True,121487000,390900,121877900,False
4157,validator_8,32161710001,True,42288002,406700,42694702,True
4158,validator_34,256949413080,True,105072000,99100,105171100,False
4159,validator_41,64340885340,True,118939000,926220,119865220,False
4160,validator_37,64557541620,True,68225000,209420,68434420,False
4161,validator_12,96655349234,True,84398996,2543230,86942226,True
4162,validator_34,257133807480,True,184147000,247400,184394400,False
4163,validator_5,64826506353,True,163213002,883040,164096042,True
4164,validator_30,64225437420,True,93026000,4537500,97563500,False
4165,validator_49,64302827890,True,77572000,2168400,79740400,False
4166,validator_31,160886554920,True,123396000,467840,123863840,False
4167,validator_23,32257816394,True,144538000,1070270,145608270,True
4168,validator_45,32173722040,True,105308000,1484800,106792800,False
4169,validator_22,64496000851,True,101102995,8148100,109251095,True
4170,validator_17,160548375614,True,55838001,444320,56282321,True
4171,validator_42,32512134320,True,142992000,7857380,150849380,False
4172,validator_39,32905967020,True,111636000,1383200,113019200,False
4173,validator_7,64573084198,True,108073000,18029440,126102440,True
4174,validator_31,160980488360,True,75515000,18418440,93933440,False
4175,validator_46,96605205610,True,60860000,2080130,62940130,False
4176,validator_17,160604291114,True,47560000,8355500,55915500,True
4177,validator_16,32586240679,True,201479000,1893500,203372500,True
4178,validator_32,32521044330,True,167166000,1180800,168346800,False
4179,validator_47,64304049890,True,108792000,1529100,110321100,False
4180,validator_35,96408281220,True,99937000,1018500,100955500,False
4181,validator_44,96702937100,True,117849000,18452780,136301780,False
4182,validator_19,64644264134,True,100572995,593930,101166925,True
4183,validator_6,32244331720,True,56799998,22434800,79234798,True
4184,validator_43,64407853330,True,93156000,1599540,94755540,False
4185,validator_12,96831709513,True,175849999,510280,176360279,True
4186,validator_2,32392940210,True,96344997,425400,96770397,True
4187,validator_41,64449786840,True,107402000,1499500,108901500,False
4188,validator_34,257241088380,True,88866000,18414900,107280900,False
4189,validator_10,32223516697,True,60185000,1666400,61851400,True
4190,validator_36,96922159950,True,72149000,1467280,73616280,False
4191,validator_41,64720855870,True,270404000,665030,271069030,False
4192,validator_43,64573716250,True,147660000,18202920,165862920,False
4193,validator_41,64810486670,True,89049000,581800,89630800,False
4194,validator_11,32277619602,True,93945004,18718800,112663804,True
4195,validator_49,64472770790,True,168498000,1444900,169942900,False
4196,validator_36,97124393630,True,193975000,8258680,202233680,False
4197,validator_39,33025239020,True,110182000,9090000,119272000,False
4198,validator_2,32576442713,True,177101003,6401500,183502503,True
4199,validator_30,64361374320,True,133949000,1987900,135936900,False
4200,validator_24,32271110392,True,138362997,2186600,140549597,True
4201,validator_16,32780396887,True,174466008,19690200,194156208,True
4202,validator_44,96802781370,True,99111000,733270,99844270,False
4203,validator_38,32644203240,True,83317000,25944200,109261200,False
4204,validator_27,96551607370,True,120649000,1598100,122247100,False
4205,validator_8,32326233297,True,162982996,1540300,164523296,True
4206,validator_29,32153009620,True,53002000,586230,53588230,False
4207,validator_10,32433591728,True,207036001,3039030,210075031,True
4208,validator_35,96476024220,True,59198000,8545000,67743000,False
4209,validator_11,32377145222,True,97874000,1651620,99525620,True
4210,validator_39,33173121420,True,146179000,1703400,147882400,False
4211,validator_28,33374281400,True,199040000,2733340,201773340,False
4212,validator_17,160736719948,True,131660004,768830,132428834,True
4213,validator_25,32265319300,True,96908000,18674600,115582600,False
4214,validator_48,160819747640,True,44964000,1563780,46527780,False
4215,validator_15,256717199945,True,85057002,953900,86010902,True
4216,validator_33,32359068700,True,242780000,1476300,244256300,False
4217,validator_46,96780662850,True,173674000,1783240,175457240,False
4218,validator_22,64602373830,True,105164999,1207980,106372979,True
4219,validator_49,64601123590,True,127770000,582800,128352800,False
4220,validator_24,32476931219,True,204132997,1687830,205820827,True
4221,validator_22,64713831782,True,109834992,1622960,111457952,True
4222,validator_33,32469663700,True,100989000,9606000,110595000,False
4223,validator_6,32374559136,True,128273996,1953420,130227416,True
4224,validator_40,32215954490,True,107657000,238100,107895100,False
4225,validator_35,96558518620,True,81797000,697400,82494400,False
4226,validator_34,257343967880,True,102056000,823500,102879500,False
4227,validator_31,161059846060,True,78260000,1097700,79357700,False
4228,validator_11,32503226319,True,95849997,30231100,126081097,True
4229,validator_42,32609513160,True,96901000,477840,97378840,False
4230,validator_19,64788724563,True,144161999,298430,144460429,True
4231,validator_7,64645239740,True,71975002,180540,72155542,True
4232,validator_9,32650687817,True,126607998,1219880,127827878,True
4233,validator_20,32990251376,True,133634000,5719680,139353680,True
4234,validator_8,32468127958,True,139238001,2656660,141894661,True
4235,validator_32,32692074890,True,170155000,875560,171030560,False
4236,validator_25,32433003530,True,166175000,1509230,167684230,False
4237,validator_16,32874734308,True,93933001,404420,94337421,True
4238,validator_18,96874486744,True,123054001,17837200,140891201,True
4239,validator_22,64811009779,True,88085997,9092000,97177997,True
4240,validator_36,97309640530,True,184461000,785900,185246900,False
4241,validator_34,257469022550,True,117563000,7491670,125054670,False
4242,validator_35,96614271160,True,47821000,7931540,55752540,False
4243,validator_35,96791178860,True,175438000,1469700,176907700,False
4244,validator_23,32497010526,True,216234002,22960130,239194132,True
4245,validator_4,32385857021,True,172050001,1058100,173108101,True
4246,validator_31,161216970760,True,156209000,915700,157124700,False
4247,validator_11,32582862615,True,77752996,1883300,79636296,True
4248,validator_27,96713804070,True,161219000,977700,162196700,False
4249,validator_44,97065373770,True,261906000,686400,262592400,False
4250,validator_43,64743983700,True,167440000,2827450,170267450,False
4251,validator_26,32345012480,True,198357000,618300,198975300,False
4252,validator_36,97411913930,True,101218000,1055400,102273400,False
4253,validator_26,32494280620,True,147830000,1438140,149268140,False
4254,validator_41,64954725870,True,121934000,22305200,144239200,False
4255,validator_49,64727149190,True,100397000,25628600,126025600,False
4256,validator_18,97004448446,True,122436002,7525700,129961702,True
4257,validator_0,32938030183,True,110331000,918430,111249430,True
4258,validator_46,96889446780,True,108104000,679930,108783930,False
4259,validator_34,257629257940,True,152035000,8200390,160235390,False
4260,validator_46,97013679180,True,105514000,18718400,124232400,False
4261,validator_11,32878903716,True,294338001,1703100,296041101,True
4262,validator_31,161327947260,True,109130000,1846500,110976500,False
4263,validator_27,96796994210,True,64678000,18512140,83190140,False
4264,validator_33,32579749000,True,90565000,19520300,110085300,False
4265,validator_12,97091785215,True,241528002,18547700,260075702,True
4266,validator_37,64600973440,True,43098000,333820,43431820,False
4267,validator_33,32736236530,True,155593000,894530,156487530,False
4268,validator_9,32776054456,True,123901999,1464640,125366639,True
4269,validator_23,32649035599,True,132778003,19247070,152025073,True
4270,validator_29,32315766960,True,161425000,1332340,162757340,False
4271,validator_47,64468972890,True,162714000,2209000,164923000,False
4272,validator_13,32320700696,True,106120002,1032900,107152902,True
4273,validator_6,32498795939,True,123485003,751800,124236803,True
4274,validator_36,97489089210,True,75171000,2004280,77175280,False
4275,validator_43,64877166800,True,131346000,1837100,133183100,False
4276,validator_2,32832184910,True,254111997,1630200,255742197,True
4277,validator_17,160799602584,True,54906996,7975640,62882636,True
4278,validator_6,32581423135,True,81580996,1046200,82627196,True
4279,validator_19,64966318767,True,176318004,1276200,177594204,True
4280,validator_15,256900145237,True,166537002,16408290,182945292,True
4281,validator_33,32828844930,True,91370000,1238400,92608400,False
4282,validator_37,64777415240,True,157826000,18615800,176441800,False
4283,validator_23,32748534299,True,81466000,18032700,99498700,True
4284,validator_11,33001038318,True,121187002,947600,122134602,True
4285,validator_46,97143660180,True,128994000,987000,129981000,False
4286,validator_3,32597186423,True,71834994,2087700,73922694,True
4287,validator_40,32367020390,True,148603000,2462900,151065900,False
4288,validator_6,32681899736,True,98940001,1536600,100476601,True
4289,validator_41,65088716370,True,115225000,18765500,133990500,False
4290,validator_41,65241621900,True,150384000,2521530,152905530,False
4291,validator_42,32822299380,True,211688000,1098220,212786220,False
4292,validator_9,32850448982,True,73095996,1298530,74394526,True
4293,validator_5,64878900256,True,51628003,765900,52393903,True
4294,validator_14,96366982465,True,69592001,2537200,72129201,True
4295,validator_5,64985494558,True,105555002,1039300,106594302,True
4296,validator_31,161466898860,True,119254000,19697600,138951600,False
4297,validator_22,64921562836,True,110086997,466060,110553057,True
4298,validator_13,32451951499,True,128819003,2431800,131250803,True
4299,validator_38,32803161680,True,157910000,1048440,158958440,False
4300,validator_15,257054090738,True,145912001,8033500,153945501,True
4301,validator_17,160871597846,True,71324002,671260,71995262,True
4302,validator_6,32830854835,True,130236999,18718100,148955099,True
4303,validator_6,32912860464,True,81447999,557630,82005629,True
4304,validator_46,97265200340,True,120277000,1263160,121540160,False
4305,validator_23,32986701078,True,234683999,3482780,238166779,True
4306,validator_6,33100953901,True,181360997,6732440,188093437,True
4307,validator_27,96916801510,True,118373000,1434300,119807300,False
4308,validator_4,32501348498,True,114878997,612480,115491477,True
4309,validator_17,161014496480,True,137932994,4965640,142898634,True
4310,validator_5,65080371457,True,92887999,1988900,94876899,True
4311,validator_11,33085477903,True,83301995,1137590,84439585,True
4312,validator_41,65344476400,True,83503000,19351500,102854500,False
4313,validator_12,97197020785,True,92185000,13050570,105235570,True
4314,validator_47,64573088690,True,103428000,687800,104115800,False
4315,validator_7,64787915961,True,142115001,561220,142676221,True
4316,validator_30,64423107900,True,53661000,8072580,61733580,False
4317,validator_26,32683087320,True,188492000,314700,188806700,False
4318,validator_48,160948037240,True,127078000,1211600,128289600,False
4319,validator_29,32425321630,True,108245000,1309670,109554670,False
4320,validator_6,33177865298,True,75477997,1433400,76911397,True
4321,validator_32,32846734890,True,153182000,1478000,154660000,False
4322,validator_32,32917850970,True,69630000,1486080,71116080,False
4323,validator_0,33046190113,True,89068000,19091930,108159930,True
4324,validator_34,257768543130,True,137289000,1996190,139285190,False
4325,validator_10,32601387070,True,166389002,1406340,167795342,True
4326,validator_15,257105727144,True,49490006,2146400,51636406,True
4327,validator_46,97407972360,True,138004000,4768020,142772020,False
4328,validator_43,64919310700,True,41343000,800900,42143900,False
4329,validator_26,32831488240,True,148215000,185920,148400920,False
4330,validator_18,97166077343,True,160421997,1206900,161628897,True
4331,validator_19,65135218465,True,160625998,8273700,168899698,True
4332,validator_22,65204875633,True,282162997,1149800,283312797,True
4333,validator_19,65281882043,True,145838998,824580,146663578,True
4334,validator_6,33229629914,True,49824996,1939620,51764616,True
4335,validator_32,32976848260,True,40394000,18603290,58997290,False
4336,validator_41,65387620640,True,42716000,428240,43144240,False
4337,validator_45,32376349340,True,198925000,3702300,202627300,False
4338,validator_5,65174953558,True,93799001,783100,94582101,True
4339,validator_49,64893259930,True,164370000,1740740,166110740,False
4340,validator_46,97574163950,True,164789000,1402590,166191590,False
4341,validator_36,97590891010,True,95789000,6012800,101801800,False
4342,validator_36,97741713370,True,150168000,654360,150822360,False
4343,validator_16,32933008906,True,57672998,601600,58274598,True
4344,validator_0,33178465711,True,128456998,3818600,132275598,True
4345,validator_37,64896087100,True,115882000,2789860,118671860,False
4346,validator_47,64672180290,True,81070000,18021600,99091600,False
4347,validator_47,64829961770,True,157288000,493480,157781480,False
4348,validator_16,33101460495,True,163014999,5436590,168451589,True
4349,validator_37,65104392200,True,189516000,18789100,208305100,False
4350,validator_17,161192991883,True,177517003,978400,178495403,True
4351,validator_29,32475684130,True,45069000,5293500,50362500,False
4352,validator_15,257352146315,True,244572001,1847170,246419171,True
4353,validator_40,32487301690,True,111963000,8318300,120281300,False
4354,validator_17,161289995526,True,90295003,6708640,97003643,True
4355,validator_14,96593913493,True,225743998,1187030,226931028,True
4356,validator_21,64235234399,True,233804999,1429400,235234399,True
4357,validator_17,161408789531,True,100274005,18520000,118794005,True
4358,validator_9,32933333465,True,82500003,384480,82884483,True
4359,validator_10,32708033170,True,87912000,18734100,106646100,True
4360,validator_25,32614112810,True,178535000,2574280,181109280,False
4361,validator_32,33085068000,True,106221000,1998740,108219740,False
4362,validator_17,161507270631,True,96537000,1944100,98481100,True
4363,validator_18,97289074440,True,122206997,790100,122997097,True
4364,validator_36,97833464110,True,90911000,839740,91750740,False
4365,validator_28,33558862900,True,176295000,8286500,184581500,False
4366,validator_49,64962321530,True,68437000,624600,69061600,False
4367,validator_22,65257218638,True,51942005,401000,52343005,True
4368,validator_46,97690724870,True,115701000,859920,116560920,False
4369,validator_25,32836646810,True,221778000,756000,222534000,False
4370,validator_23,33227412030,True,221028002,19682950,240710952,True
4371,validator_39,33327169720,True,152770000,1278300,154048300,False
4372,validator_1,64358416225,True,87039998,1318600,88358598,True
4373,validator_16,33245202124,True,141363999,2377630,143741629,True
4374,validator_46,97813158570,True,102673000,19760700,122433700,False
4375,validator_2,32913315151,True,79922001,1208240,81130241,True
4376,validator_15,257413949985,True,60573000,1230670,61803670,True
4377,validator_37,65265136800,True,159611000,1133600,160744600,False
4378,validator_48,161025204740,True,75541000,1626500,77167500,False
4379,validator_48,161139311340,True,113196000,910600,114106600,False
4380,validator_7,64864872441,True,76354000,602480,76956480,True
4381,validator_35,96948714260,True,156980000,555400,157535400,False
4382,validator_21,64347529716,True,110172997,2122320,112295317,True
4383,validator_22,65370821380,True,111247002,2355740,113602742,True
4384,validator_48,161302127010,True,160084000,2731670,162815670,False
4385,validator_14,96683569496,True,88896003,760000,89656003,True
4386,validator_5,65311961161,True,133510003,3497600,137007603,True
4387,validator_34,257840642250,True,70386000,1713120,72099120,False
4388,validator_17,161653469728,True,143632997,2566100,146199097,True
4389,validator_25,32940714920,True,100334000,3734110,104068110,False
4390,validator_18,97404382845,True,114553005,755400,115308405,True
4391,validator_5,65463423158,True,149526997,1935000,151461997,True
4392,validator_45,32435849840,True,59120000,380500,59500500,False
4393,validator_7,64900366644,True,34652003,842200,35494203,True
4394,validator_32,33129148320,True,42933000,1147320,44080320,False
4395,validator_37,65319501400,True,53767000,597600,54364600,False
4396,validator_7,65018523092,True,115438008,2718440,118156448,True
4397,validator_28,33655272400,True,92927000,3482500,96409500,False
4398,validator_31,161682447760,True,213666000,1882900,215548900,False
4399,validator_11,33210831948,True,123849005,1505040,125354045,True
4400,validator_21,64419834117,True,53992001,18312400,72304401,True
4401,validator_41,65455295430,True,57534000,10140790,67674790,False
4402,validator_24,32580582825,True,101625006,2026600,103651606,True
4403,validator_27,97041700730,True,123850000,1049220,124899220,False
4404,validator_21,64585487556,True,163687999,1965440,165653439,True
4405,validator_14,96826399392,True,139660996,3168900,142829896,True
4406,validator_6,33307742414,True,69237000,8875500,78112500,True
4407,validator_23,33313293029,True,66338999,19542000,85880999,True
4408,validator_1,64483245661,True,124202006,627430,124829436,True
4409,validator_48,161444077710,True,141298000,652700,141950700,False
4410,validator_36,97963306410,True,129193000,649300,129842300,False
4411,validator_17,161952754218,True,244643000,54641490,299284490,True
4412,validator_15,257566565586,True,134517001,18098600,152615601,True
4413,validator_23,33385831860,True,70466001,2072830,72538831,True
4414,validator_45,32487283840,True,49998000,1436000,51434000,False
4415,validator_18,97463249220,True,56707995,2158380,58866375,True
4416,validator_3,32716219822,True,118448999,584400,119033399,True
4417,validator_18,97642126812,True,174291002,4586590,178877592,True
4418,validator_29,32524725750,True,48626000,415620,49041620,False
4419,validator_16,33386656527,True,139250003,2204400,141454403,True
4420,validator_47,64961802130,True,130967000,873360,131840360,False
4421,validator_15,257628622685,True,61558999,498100,62057099,True
4422,validator_18,97763246413,True,102390001,18729600,121119601,True
4423,validator_10,32873552911,True,153501001,12018740,165519741,True
4424,validator_38,32872663510,True,68731000,770830,69501830,False
4425,validator_2,33084272151,True,170068000,889000,170957000,True
4426,validator_44,97203467570,True,128472000,9621800,138093800,False
4427,validator_1,64690699802,True,206137001,1317140,207454141,True
4428,validator_31,161920173560,True,236416000,1309800,237725800,False
4429,validator_14,96974370974,True,147203002,768580,147971582,True
4430,validator_18,97942064380,True,178669997,147970,178817967,True
4431,validator_8,32566551557,True,90086999,8336600,98423599,True
4432,validator_14,97065406874,True,89382000,1653900,91035900,True
4433,validator_48,161562733510,True,116312000,2343800,118655800,False
4434,validator_33,32998661450,True,168531000,1285520,169816520,False
4435,validator_30,64562190800,True,136406000,2676900,139082900,False
4436,validator_45,32568727530,True,80016000,1427690,81443690,False
4437,validator_10,33057757712,True,183547001,657800,184204801,True
4438,validator_48,161681187110,True,117193000,1260600,118453600,False
4439,validator_3,32841639702,True,120065000,5354880,125419880,True
4440,validator_40,32620867810,True,128141000,5425120,133566120,False
4441,validator_42,32898443460,True,74969000,1175080,76144080,False
4442,validator_13,32571135699,True,116783000,2401200,119184200,True
4443,validator_17,162069107651,True,114926003,1427430,116353433,True
4444,validator_34,257960807890,True,119595000,570640,120165640,False
4445,validator_10,33140661653,True,75143001,7760940,82903941,True
4446,validator_49,65091360430,True,128294000,744900,129038900,False
4447,validator_11,33285343392,True,73443004,1068440,74511444,True
4448,validator_4,32656732599,True,146724001,8660100,155384101,True
4449,validator_41,65608243950,True,151631000,1317520,152948520,False
4450,validator_17,162284683948,True,214977997,598300,215576297,True
4451,validator_14,97209443204,True,142006000,2030330,144036330,True
4452,validator_22,65493489310,True,121872000,795930,122667930,True
4453,validator_41,65680141150,True,70676000,1221200,71897200,False
4454,validator_10,33306182654,True,159803001,5718000,165521001,True
4455,validator_49,65227227230,True,129594000,6272800,135866800,False
4456,validator_47,65074518910,True,111872000,844780,112716780,False
4457,validator_17,162414625140,True,127416002,2525190,129941192,True
4458,validator_6,33398253556,True,89920002,591140,90511142,True
4459,validator_0,33290014342,True,110692001,856630,111548631,True
4460,validator_2,33296146181,True,211699000,175030,211874030,True
4461,validator_49,65311197430,True,73877000,10093200,83970200,False
4462,validator_46,97911285990,True,96929000,1198420,98127420,False
4463,validator_27,97195588770,True,153404000,484040,153888040,False
4464,validator_47,65181017130,True,105463000,1035220,106498220,False
4465,validator_44,97392151370,True,188454000,229800,188683800,False
4466,validator_20,33079917050,True,87186004,2479670,89665674,True
4467,validator_27,97298383900,True,101290000,1505130,102795130,False
4468,validator_46,98099388190,True,186324000,1778200,188102200,False
4469,validator_29,32648192150,True,114613000,8853400,123466400,False
4470,validator_6,33430063156,True,31605000,204600,31809600,True
4471,validator_44,97653287370,True,260486000,650000,261136000,False
4472,validator_22,65629090909,True,134654999,946600,135601599,True
4473,validator_8,32700820648,True,127278001,6991090,134269091,True
4474,validator_47,65328953610,True,146851000,1085480,147936480,False
4475,validator_41,66031923500,True,350411000,1371350,351782350,False
4476,validator_29,32752406080,True,102183000,2030930,104213930,False
4477,validator_29,32888131450,True,134163000,1562370,135725370,False
4478,validator_2,33455703272,True,158114001,1443090,159557091,True
4479,validator_22,65725266135,True,95137006,1038220,96175226,True
4480,validator_29,33021604350,True,132483000,989900,133472900,False
4481,validator_14,97333556244,True,119000000,5113040,124113040,True
4482,validator_22,65785460040,True,57102005,3091900,60193905,True
4483,validator_13,32627299827,True,55677998,486130,56164128,True
4484,validator_10,33417070944,True,109574000,1314290,110888290,True
4485,validator_33,33140593290,True,129675000,12256840,141931840,False
4486,validator_19,65355032443,True,72808000,342400,73150400,True
4487,validator_35,97048034060,True,99063000,256800,99319800,False
4488,validator_22,66095421817,True,309784997,176780,309961777,True
4489,validator_41,66201563060,True,167477000,2162560,169639560,False
4490,validator_42,33019266990,True,116446000,4377530,120823530,False
4491,validator_25,33075443920,True,132346000,2383000,134729000,False
4492,validator_38,32944768280,True,71828000,276770,72104770,False
4493,validator_10,33560856048,True,141650004,2135100,143785104,True
4494,validator_0,33402231670,True,111416998,800330,112217328,True
4495,validator_23,33554855161,True,168725001,298300,169023301,True
4496,validator_40,32784986010,True,162372000,1746200,164118200,False
4497,validator_33,33244760430,True,102932000,1235140,104167140,False
4498,validator_39,33474241020,True,144928000,2143300,147071300,False
4499,validator_31,162186425580,True,264543000,1709020,266252020,False
4500,validator_18,96128910041,True,127529001,1381040,128910041,True
4501,validator_19,64121972386,True,121044996,927390,121972386,True
4502,validator_14,96141416901,True,115480001,25936900,141416901,True
4503,validator_15,256141618599,True,136370999,5247600,141618599,True
4504,validator_15,256287555151,True,145426002,510550,145936552,True
4505,validator_37,64134756300,True,132912000,1844300,134756300,False
4506,validator_48,160130734230,True,129421000,1313230,130734230,False
4507,validator_27,96074262300,True,71916000,2346300,74262300,False
4508,validator_41,64092899300,True,92498000,401300,92899300,False
4509,validator_15,256346569851,True,57338000,1676700,59014700,True
4510,validator_44,96089216800,True,88784000,432800,89216800,False
4511,validator_0,32166798502,True,158512002,8286500,166798502,True
4512,validator_45,32066929240,True,51134000,15795240,66929240,False
4513,validator_12,96178003233,True,173936003,4067230,178003233,True
4514,validator_37,64289859800,True,150236000,4867500,155103500,False
4515,validator_28,32142861200,True,140550000,2311200,142861200,False
4516,validator_27,96173979300,True,99103000,614000,99717000,False
4517,validator_28,32277097570,True,124692000,9544370,134236370,False
4518,validator_18,96211224075,True,81152004,1162030,82314034,True
4519,validator_15,256475164644,True,127882003,712790,128594793,True
4520,validator_31,160186818800,True,184681000,2137800,186818800,False
4521,validator_20,32137200877,True,136528997,671880,137200877,True
4522,validator_42,32184220940,True,163425000,20795940,184220940,False
4523,validator_23,32048351101,True,46948001,1403100,48351101,True
4524,validator_36,96087197990,True,85951000,1246990,87197990,False
4525,validator_6,32165096922,True,162449002,2647920,165096922,True
4526,validator_47,64136954900,True,136151000,803900,136954900,False
4527,validator_37,64342353000,True,46328000,6165200,52493200,False
4528,validator_27,96224585040,True,48765000,1840740,50605740,False
4529,validator_39,32044610220,True,43986000,624220,44610220,False
4530,validator_36,96221380130,True,132162000,2020140,134182140,False
4531,validator_18,96416850459,True,185696994,19929390,205626384,True
4532,validator_27,96385356870,True,159285000,1486830,160771830,False
4533,validator_47,64193728790,True,55553000,1220890,56773890,False
4534,validator_2,32136653101,True,134777001,1876100,136653101,True
4535,validator_38,32120147900,True,119785000,362900,120147900,False
4536,validator_48,160239637120,True,106882000,2020890,108902890,False
4537,validator_12,96347652829,True,168941996,707600,169649596,True
4538,validator_19,64234298906,True,107184000,5142520,112326520,True
4539,validator_44,96194591400,True,103532000,1842600,105374600,False
4540,validator_32,32148836630,True,140968000,7868630,148836630,False
4541,validator_20,32299507959,True,161193002,1114080,162307082,True
4542,validator_43,64032058100,True,31669000,389100,32058100,False
4543,validator_28,32381891170,True,81785000,23008600,104793600,False
4544,validator_22,64215305253,True,213734993,1570260,215305253,True
4545,validator_28,32551174670,True,168407000,876500,169283500,False
4546,validator_39,32083066290,True,37262000,1194070,38456070,False
4547,validator_38,32227098200,True,103891000,3059300,106950300,False
4548,validator_31,160394972800,True,207106000,1048000,208154000,False
4549,validator_34,256155416780,True,154271000,1145780,155416780,False
4550,validator_48,160346736360,True,106352000,747240,107099240,False
4551,validator_43,64081998010,True,48666000,1273910,49939910,False
4552,validator_27,96429360270,True,41506000,2497400,44003400,False
4553,validator_44,96308650600,True,111945000,2114200,114059200,False
4554,validator_25,32048004200,True,47488000,516200,48004200,False
4555,validator_3,32177654734,True,164511994,13142740,177654734,True
4556,validator_20,32446068057,True,145210998,1349100,146560098,True
4557,validator_29,32068527600,True,62760000,5767600,68527600,False
4558,validator_39,32225495690,True,137093000,5336400,142429400,False
4559,validator_46,96179682500,True,161210000,18472500,179682500,False
4560,validator_39,32350872690,True,124204000,1173000,125377000,False
4561,validator_20,32587875456,True,140073999,1733400,141807399,True
4562,validator_5,64144231751,True,142787001,1444750,144231751,True
4563,validator_34,256293439080,True,137160000,862300,138022300,False
4564,validator_29,32099421390,True,28545000,2348790,30893790,False
4565,validator_36,96325356530,True,95681000,8295400,103976400,False
4566,validator_49,64121726040,True,120519000,1207040,121726040,False
4567,validator_32,32352697530,True,200855000,3005900,203860900,False
4568,validator_38,32407906500,True,179397000,1411300,180808300,False
4569,validator_23,32112208124,True,45287003,18570020,63857023,True
4570,validator_22,64280484957,True,59597004,5582700,65179704,True
4571,validator_34,256390068180,True,87589000,9040100,96629100,False
4572,validator_17,160073329996,True,71764996,1565000,73329996,True
4573,validator_11,32164955798,True,164013998,941800,164955798,True
4574,validator_28,32694728700,True,136012000,7542030,143554030,False
4575,validator_49,64223087490,True,100628000,733450,101361450,False
4576,validator_17,160134268499,True,59856003,1082500,60938503,True
4577,validator_28,32825449500,True,128699000,2021800,130720800,False
4578,validator_31,160496000800,True,99890000,1138000,101028000,False
4579,validator_12,96431421869,True,74305000,9464040,83769040,True
4580,validator_10,32161665297,True,143396997,18268300,161665297,True
4581,validator_19,64484381908,True,249637002,446000,250083002,True
4582,validator_28,32868681300,True,42723000,508800,43231800,False
4583,validator_17,160361751901,True,225882002,1601400,227483402,True
4584,validator_26,32082845400,True,81714000,1131400,82845400,False
4585,validator_35,96100070520,True,98490000,1580520,100070520,False
4586,validator_7,64110915329,True,109936999,978330,110915329,True
4587,validator_3,32345528226,True,148964992,18908500,167873492,True
4588,validator_0,32282506706,True,115093004,615200,115708204,True
4589,validator_42,32361284940,True,156906000,20158000,177064000,False
4590,validator_1,64135003324,True,134203004,800320,135003324,True
4591,validator_2,32296169813,True,158083992,1432720,159516712,True
4592,validator_8,32119015299,True,113195999,5819300,119015299,True
4593,validator_48,160488354060,True,141093000,524700,141617700,False
4594,validator_3,32523263729,True,174638003,3097500,177735503,True
4595,validator_40,32108059390,True,106575000,1484390,108059390,False
4596,validator_30,64127873920,True,126028000,1845920,127873920,False
4597,validator_5,64474020673,True,328360002,1428920,329788922,True
4598,validator_41,64221020120,True,126346000,1774820,128120820,False
4599,validator_9,32177522740,True,158702000,18820740,177522740,True
4600,validator_13,32120192597,True,118679997,1512600,120192597,True
4601,validator_36,96432950770,True,105120000,2474240,107594240,False
4602,validator_39,32426336690,True,67869000,7595000,75464000,False
4603,validator_7,64325423626,True,211829997,2678300,214508297,True
4604,validator_43,64313097790,True,225549000,5550780,231099780,False
4605,validator_0,32506071148,True,221110992,2453450,223564442,True
4606,validator_18,96505554303,True,88038004,665840,88703844,True
4607,validator_18,96733595543,True,226920000,1121240,228041240,True
4608,validator_34,256530373880,True,129535000,10770700,140305700,False
4609,validator_5,64555139912,True,71218999,9900240,81119239,True
4610,validator_28,33013759600,True,144766000,312300,145078300,False
4611,validator_28,33172508060,True,157678000,1070460,158748460,False
4612,validator_46,96257515800,True,76585000,1248300,77833300,False
4613,validator_33,32114812400,True,95698000,19114400,114812400,False
4614,validator_25,32149736700,True,96300000,5432500,101732500,False
4615,validator_0,32669977720,True,149220992,14685580,163906572,True
4616,validator_16,32142680602,True,141703002,977600,142680602,True
4617,validator_39,32598381620,True,171842000,202930,172044930,False
4618,validator_48,160647790500,True,158883000,553440,159436440,False
4619,validator_31,160563661300,True,66199000,1461500,67660500,False
4620,validator_36,96632384370,True,198068000,1365600,199433600,False
4621,validator_38,32534942040,True,125195000,1840540,127035540,False
4622,validator_22,64386749756,True,100228999,6035800,106264799,True
4623,validator_17,160492093293,True,106546002,23795390,130341392,True
4624,validator_7,64446981758,True,121077002,481130,121558132,True
4625,validator_34,256611162880,True,79422000,1367000,80789000,False
4626,validator_20,32762368796,True,173920000,573340,174493340,True
4627,validator_36,96798837370,True,129685000,36768000,166453000,False
4628,validator_46,96330330540,True,72584000,230740,72814740,False
4629,validator_24,32130560795,True,125350005,5210790,130560795,True
4630,validator_48,160773219860,True,125053000,376360,125429360,False
4631,validator_15,256631189043,True,155382999,641400,156024399,True
4632,validator_9,32346652438,True,167749998,1379700,169129698,True
4633,validator_12,96568407008,True,136114999,870140,136985139,True
4634,validator_19,64543097209,True,58242001,473300,58715301,True
4635,validator_9,32522859939,True,172811001,3396500,176207501,True
4636,validator_20,32850897696,True,87476000,1052900,88528900,True
4637,validator_36,96848543670,True,49040000,666300,49706300,False
4638,validator_35,96207351420,True,98517000,8763900,107280900,False
4639,validator_16,32382868179,True,238771997,1415580,240187577,True
4640,validator_39,32792947820,True,193720000,846200,194566200,False
4641,validator_44,96427989940,True,118906000,433340,119339340,False
4642,validator_35,96307325720,True,98931000,1043300,99974300,False
4643,validator_26,32146037180,True,62800000,391780,63191780,False
4644,validator_34,256722364080,True,110510000,691200,111201200,False
4645,validator_14,96250923004,True,101537003,7969100,109506103,True
4646,validator_31,160762691080,True,194089000,4940780,199029780,False
4647,validator_37,64489107200,True,144263000,2491200,146754200,False
4648,validator_44,96566635320,True,136232000,2413380,138645380,False
4649,validator_1,64270057627,True,133443003,1611300,135054303,True
4650,validator_13,32213547794,True,86255997,7099200,93355197,True
4651,validator_5,64662410311,True,104073999,3196400,107270399,True
4652,validator_0,32826780753,True,156411003,392030,156803033,True
4653,validator_46,96542265480,True,205934000,6000940,211934940,False
4654,validator_14,96294853264,True,43218000,712260,43930260,True
4655,validator_4,32212748920,True,211209000,1539920,212748920,True
4656,validator_34,256844241980,True,121487000,390900,121877900,False
4657,validator_8,32161710001,True,42288002,406700,42694702,True
4658,validator_34,256949413080,True,105072000,99100,105171100,False
4659,validator_41,64340885340,True,118939000,926220,119865220,False
4660,validator_37,64557541620,True,68225000,209420,68434420,False
4661,validator_12,96655349234,True,84398996,2543230,86942226,True
4662,validator_34,257133807480,True,184147000,247400,184394400,False
4663,validator_5,64826506353,True,163213002,883040,164096042,True
4664,validator_30,64225437420,True,93026000,4537500,97563500,False
4665,validator_49,64302827890,True,77572000,2168400,79740400,False
4666,validator_31,160886554920,True,123396000,467840,123863840,False
4667,validator_23,32257816394,True,144538000,1070270,145608270,True
4668,validator_45,32173722040,True,105308000,1484800,106792800,False
4669,validator_22,64496000851,True,101102995,8148100,109251095,True
4670,validator_17,160548375614,True,55838001,444320,56282321,True
4671,validator_42,32512134320,True,142992000,7857380,150849380,False
4672,validator_39,32905967020,True,111636000,1383200,113019200,False
4673,validator_7,64573084198,True,108073000,18029440,126102440,True
4674,validator_31,160980488360,True,75515000,18418440,93933440,False
4675,validator_46,96605205610,True,60860000,2080130,62940130,False
4676,validator_17,160604291114,True,47560000,8355500,55915500,True
4677,validator_16,32586240679,True,201479000,1893500,203372500,True
4678,validator_32,32521044330,True,167166000,1180800,168346800,False
4679,validator_47,64304049890,True,108792000,1529100,110321100,False
4680,validator_35,96408281220,True,99937000,1018500,100955500,False
4681,validator_44,96702937100,True,117849000,18452780,136301780,False
4682,validator_19,64644264134,True,100572995,593930,101166925,True
4683,validator_6,32244331720,True,56799998,22434800,79234798,True
4684,validator_43,64407853330,True,93156000,1599540,94755540,False
4685,validator_12,96831709513,True,175849999,510280,176360279,True
4686,validator_2,32392940210,True,96344997,425400,96770397,True
4687,validator_41,64449786840,True,107402000,1499500,108901500,False
4688,validator_34,257241088380,True,88866000,18414900,107280900,False
4689,validator_10,32223516697,True,60185000,1666400,61851400,True
4690,validator_36,96922159950,True,72149000,1467280,73616280,False
4691,validator_41,64720855870,True,270404000,665030,271069030,False
4692,validator_43,64573716250,True,147660000,18202920,165862920,False
4693,validator_41,64810486670,True,89049000,581800,89630800,False
4694,validator_11,32277619602,True,93945004,18718800,112663804,True
4695,validator_49,64472770790,True,168498000,1444900,169942900,False
4696,validator_36,97124393630,True,193975000,8258680,202233680,False
4697,validator_39,33025239020,True,110182000,9090000,119272000,False
4698,validator_2,32576442713,True,177101003,6401500,183502503,True
4699,validator_30,64361374320,True,133949000,1987900,135936900,False
4700,validator_24,32271110392,True,138362997,2186600,140549597,True
4701,validator_16,32780396887,True,174466008,19690200,194156208,True
4702,validator_44,96802781370,True,99111000,733270,99844270,False
4703,validator_38,32644203240,True,83317000,25944200,109261200,False
4704,validator_27,96551607370,True,120649000,1598100,122247100,False
4705,validator_8,32326233297,True,162982996,1540300,164523296,True
4706,validator_29,32153009620,True,53002000,586230,53588230,False
4707,validator_10,32433591728,True,207036001,3039030,210075031,True
4708,validator_35,96476024220,True,59198000,8545000,67743000,False
4709,validator_11,32377145222,True,97874000,1651620,99525620,True
4710,validator_39,33173121420,True,146179000,1703400,147882400,False
4711,validator_28,33374281400,True,199040000,2733340,201773340,False
4712,validator_17,160736719948,True,131660004,768830,132428834,True
4713,validator_25,32265319300,True,96908000,18674600,115582600,False
4714,validator_48,160819747640,True,44964000,1563780,46527780,False
4715,validator_15,256717199945,True,85057002,953900,86010902,True
4716,validator_33,32359068700,True,242780000,1476300,244256300,False
4717,validator_46,96780662850,True,173674000,1783240,175457240,False
4718,validator_22,64602373830,True,105164999,1207980,106372979,True
4719,validator_49,64601123590,True,127770000,582800,128352800,False
4720,validator_24,32476931219,True,204132997,1687830,205820827,True
4721,validator_22,64713831782,True,109834992,1622960,111457952,True
4722,validator_33,32469663700,True,100989000,9606000,110595000,False
4723,validator_6,32374559136,True,128273996,1953420,130227416,True
4724,validator_40,32215954490,True,107657000,238100,107895100,False
4725,validator_35,96558518620,True,81797000,697400,82494400,False
4726,validator_34,257343967880,True,102056000,823500,102879500,False
4727,validator_31,161059846060,True,78260000,1097700,79357700,False
4728,validator_11,32503226319,True,95849997,30231100,126081097,True
4729,validator_42,32609513160,True,96901000,477840,97378840,False
4730,validator_19,64788724563,True,144161999,298430,144460429,True
4731,validator_7,64645239740,True,71975002,180540,72155542,True
4732,validator_9,32650687817,True,126607998,1219880,127827878,True
4733,validator_20,32990251376,True,133634000,5719680,139353680,True
4734,validator_8,32468127958,True,139238001,2656660,141894661,True
4735,validator_32,32692074890,True,170155000,875560,171030560,False
4736,validator_25,32433003530,True,166175000,1509230,167684230,False
4737,validator_16,32874734308,True,93933001,404420,94337421,True
4738,validator_18,96874486744,True,123054001,17837200,140891201,True
4739,validator_22,64811009779,True,88085997,9092000,97177997,True
4740,validator_36,97309640530,True,184461000,785900,185246900,False
4741,validator_34,257469022550,True,117563000,7491670,125054670,False
4742,validator_35,96614271160,True,47821000,7931540,55752540,False
4743,validator_35,96791178860,True,175438000,1469700,176907700,False
4744,validator_23,32497010526,True,216234002,22960130,239194132,True
4745,validator_4,32385857021,True,172050001,1058100,173108101,True
4746,validator_31,161216970760,True,156209000,915700,157124700,False
4747,validator_11,32582862615,True,77752996,1883300,79636296,True
4748,validator_27,96713804070,True,161219000,977700,162196700,False
4749,validator_44,97065373770,True,261906000,686400,262592400,False
4750,validator_43,64743983700,True,167440000,2827450,170267450,False
4751,validator_26,32345012480,True,198357000,618300,198975300,False
4752,validator_36,97411913930,True,101218000,1055400,102273400,False
4753,validator_26,32494280620,True,147830000,1438140,149268140,False
4754,validator_41,64954725870,True,121934000,22305200,144239200,False
4755,validator_49,64727149190,True,100397000,25628600,126025600,False
4756,validator_18,97004448446,True,122436002,7525700,129961702,True
4757,validator_0,32938030183,True,110331000,918430,111249430,True
4758,validator_46,96889446780,True,108104000,679930,108783930,False
4759,validator_34,257629257940,True,152035000,8200390,160235390,False
4760,validator_46,97013679180,True,105514000,18718400,124232400,False
4761,validator_11,32878903716,True,294338001,1703100,296041101,True
4762,validator_31,161327947260,True,109130000,1846500,110976500,False
4763,validator_27,96796994210,True,64678000,18512140,83190140,False
4764,validator_33,32579749000,True,90565000,19520300,110085300,False
4765,validator_12,97091785215,True,241528002,18547700,260075702,True
4766,validator_37,64600973440,True,43098000,333820,43431820,False
4767,validator_33,32736236530,True,155593000,894530,156487530,False
4768,validator_9,32776054456,True,123901999,1464640,125366639,True
4769,validator_23,32649035599,True,132778003,19247070,152025073,True
4770,validator_29,32315766960,True,161425000,1332340,162757340,False
4771,validator_47,64468972890,True,162714000,2209000,164923000,False
4772,validator_13,32320700696,True,106120002,1032900,107152902,True
4773,validator_6,32498795939,True,123485003,751800,124236803,True
4774,validator_36,97489089210,True,75171000,2004280,77175280,False
4775,validator_43,64877166800,True,131346000,1837100,133183100,False
4776,validator_2,32832184910,True,254111997,1630200,255742197,True
4777,validator_17,160799602584,True,54906996,7975640,62882636,True
4778,validator_6,32581423135,True,81580996,1046200,82627196,True
4779,validator_19,64966318767,True,176318004,1276200,177594204,True
4780,validator_15,256900145237,True,166537002,16408290,182945292,True
4781,validator_33,32828844930,True,91370000,1238400,92608400,False
4782,validator_37,64777415240,True,157826000,18615800,176441800,False
4783,validator_23,32748534299,True,81466000,18032700,99498700,True
4784,validator_11,33001038318,True,121187002,947600,122134602,True
4785,validator_46,97143660180,True,128994000,987000,129981000,False
4786,validator_3,32597186423,True,71834994,2087700,73922694,True
4787,validator_40,32367020390,True,148603000,2462900,151065900,False
4788,validator_6,32681899736,True,98940001,1536600,100476601,True
4789,validator_41,65088716370,True,115225000,18765500,133990500,False
4790,validator_41,65241621900,True,150384000,2521530,152905530,False
4791,validator_42,32822299380,True,211688000,1098220,212786220,False
4792,validator_9,32850448982,True,73095996,1298530,74394526,True
4793,validator_5,64878900256,True,51628003,765900,52393903,True
4794,validator_14,96366982465,True,69592001,2537200,72129201,True
4795,validator_5,64985494558,True,105555002,1039300,106594302,True
4796,validator_31,161466898860,True,119254000,19697600,138951600,False
4797,validator_22,64921562836,True,110086997,466060,110553057,True
4798,validator_13,32451951499,True,128819003,2431800,131250803,True
4799,validator_38,32803161680,True,157910000,1048440,158958440,False
4800,validator_15,257054090738,True,145912001,8033500,153945501,True
4801,validator_17,160871597846,True,71324002,671260,71995262,True
4802,validator_6,32830854835,True,130236999,18718100,148955099,True
4803,validator_6,32912860464,True,81447999,557630,82005629,True
4804,validator_46,97265200340,True,120277000,1263160,121540160,False
4805,validator_23,32986701078,True,234683999,3482780,238166779,True
4806,validator_6,33100953901,True,181360997,6732440,188093437,True
4807,validator_27,96916801510,True,118373000,1434300,119807300,False
4808,validator_4,32501348498,True,114878997,612480,115491477,True
4809,validator_17,161014496480,True,137932994,4965640,142898634,True
4810,validator_5,65080371457,True,92887999,1988900,94876899,True
4811,validator_11,33085477903,True,83301995,1137590,84439585,True
4812,validator_41,65344476400,True,83503000,19351500,102854500,False
4813,validator_12,97197020785,True,92185000,13050570,105235570,True
4814,validator_47,64573088690,True,103428000,687800,104115800,False
4815,validator_7,64787915961,True,142115001,561220,142676221,True
4816,validator_30,64423107900,True,53661000,8072580,61733580,False
4817,validator_26,32683087320,True,188492000,314700,188806700,False
4818,validator_48,160948037240,True,127078000,1211600,128289600,False
4819,validator_29,32425321630,True,108245000,1309670,109554670,False
4820,validator_6,33177865298,True,75477997,1433400,76911397,True
4821,validator_32,32846734890,True,153182000,1478000,154660000,False
4822,validator_32,32917850970,True,69630000,1486080,71116080,False
4823,validator_0,33046190113,True,89068000,19091930,108159930,True
4824,validator_34,257768543130,True,137289000,1996190,139285190,False
4825,validator_10,32601387070,True,166389002,1406340,167795342,True
4826,validator_15,257105727144,True,49490006,2146400,51636406,True
4827,validator_46,97407972360,True,138004000,4768020,142772020,False
4828,validator_43,64919310700,True,41343000,800900,42143900,False
4829,validator_26,32831488240,True,148215000,185920,148400920,False
4830,validator_18,97166077343,True,160421997,1206900,161628897,True
4831,validator_19,65135218465,True,160625998,8273700,168899698,True
4832,validator_22,65204875633,True,282162997,1149800,283312797,True
4833,validator_19,65281882043,True,145838998,824580,146663578,True
4834,validator_6,33229629914,True,49824996,1939620,51764616,True
4835,validator_32,32976848260,True,40394000,18603290,58997290,False
4836,validator_41,65387620640,True,42716000,428240,43144240,False
4837,validator_45,32376349340,True,198925000,3702300,202627300,False
4838,validator_5,65174953558,True,93799001,783100,94582101,True
4839,validator_49,64893259930,True,164370000,1740740,166110740,False
4840,validator_46,97574163950,True,164789000,1402590,166191590,False
4841,validator_36,97590891010,True,95789000,6012800,101801800,False
4842,validator_36,97741713370,True,150168000,654360,150822360,False
4843,validator_16,32933008906,True,57672998,601600,58274598,True
4844,validator_0,33178465711,True,128456998,3818600,132275598,True
4845,validator_37,64896087100,True,115882000,2789860,118671860,False
4846,validator_47,64672180290,True,81070000,18021600,99091600,False
4847,validator_47,64829961770,True,157288000,493480,157781480,False
4848,validator_16,33101460495,True,163014999,5436590,168451589,True
4849,validator_37,65104392200,True,189516000,18789100,208305100,False
4850,validator_17,161192991883,True,177517003,978400,178495403,True
4851,validator_29,32475684130,True,45069000,5293500,50362500,False
4852,validator_15,257352146315,True,244572001,1847170,246419171,True
4853,validator_40,32487301690,True,111963000,8318300,120281300,False
4854,validator_17,161289995526,True,90295003,6708640,97003643,True
4855,validator_14,96593913493,True,225743998,1187030,226931028,True
4856,validator_21,64235234399,True,233804999,1429400,235234399,True
4857,validator_17,161408789531,True,100274005,18520000,118794005,True
4858,validator_9,32933333465,True,82500003,384480,82884483,True
4859,validator_10,32708033170,True,87912000,18734100,106646100,True
4860,validator_25,32614112810,True,178535000,2574280,181109280,False
4861,validator_32,33085068000,True,106221000,1998740,108219740,False
4862,validator_17,161507270631,True,96537000,1944100,98481100,True
4863,validator_18,97289074440,True,122206997,790100,122997097,True
4864,validator_36,97833464110,True,90911000,839740,91750740,False
4865,validator_28,33558862900,True,176295000,8286500,184581500,False
4866,validator_49,64962321530,True,68437000,624600,69061600,False
4867,validator_22,65257218638,True,51942005,401000,52343005,True
4868,validator_46,97690724870,True,115701000,859920,116560920,False
4869,validator_25,32836646810,True,221778000,756000,222534000,False
4870,validator_23,33227412030,True,221028002,19682950,240710952,True
4871,validator_39,33327169720,True,152770000,1278300,154048300,False
4872,validator_1,64358416225,True,87039998,1318600,88358598,True
4873,validator_16,33245202124,True,141363999,2377630,143741629,True
4874,validator_46,97813158570,True,102673000,19760700,122433700,False
4875,validator_2,32913315151,True,79922001,1208240,81130241,True
4876,validator_15,257413949985,True,60573000,1230670,61803670,True
4877,validator_37,65265136800,True,159611000,1133600,160744600,False
4878,validator_48,161025204740,True,75541000,1626500,77167500,False
4879,validator_48,161139311340,True,113196000,910600,114106600,False
4880,validator_7,64864872441,True,76354000,602480,76956480,True
4881,validator_35,96948714260,True,156980000,555400,157535400,False
4882,validator_21,64347529716,True,110172997,2122320,112295317,True
4883,validator_22,65370821380,True,111247002,2355740,113602742,True
4884,validator_48,161302127010,True,160084000,2731670,162815670,False
4885,validator_14,96683569496,True,88896003,760000,89656003,True
4886,validator_5,65311961161,True,133510003,3497600,137007603,True
4887,validator_34,257840642250,True,70386000,1713120,72099120,False
4888,validator_17,161653469728,True,143632997,2566100,146199097,True
4889,validator_25,32940714920,True,100334000,3734110,104068110,False
4890,validator_18,97404382845,True,114553005,755400,115308405,True
4891,validator_5,65463423158,True,149526997,1935000,151461997,True
4892,validator_45,32435849840,True,59120000,380500,59500500,False
4893,validator_7,64900366644,True,34652003,842200,35494203,True
4894,validator_32,33129148320,True,42933000,1147320,44080320,False
4895,validator_37,65319501400,True,53767000,597600,54364600,False
4896,validator_7,65018523092,True,115438008,2718440,118156448,True
4897,validator_28,33655272400,True,92927000,3482500,96409500,False
4898,validator_31,161682447760,True,213666000,1882900,215548900,False
4899,validator_11,33210831948,True,123849005,1505040,125354045,True
4900,validator_21,64419834117,True,53992001,18312400,72304401,True
4901,validator_41,65455295430,True,57534000,10140790,67674790,False
4902,validator_24,32580582825,True,101625006,2026600,103651606,True
4903,validator_27,97041700730,True,123850000,1049220,124899220,False
4904,validator_21,64585487556,True,163687999,1965440,165653439,True
4905,validator_14,96826399392,True,139660996,3168900,142829896,True
4906,validator_6,33307742414,True,69237000,8875500,78112500,True
4907,validator_23,33313293029,True,66338999,19542000,85880999,True
4908,validator_1,64483245661,True,124202006,627430,124829436,True
4909,validator_48,161444077710,True,141298000,652700,141950700,False
4910,validator_36,97963306410,True,129193000,649300,129842300,False
4911,validator_17,161952754218,True,244643000,54641490,299284490,True
4912,validator_15,257566565586,True,134517001,18098600,152615601,True
4913,validator_23,33385831860,True,70466001,2072830,72538831,True
4914,validator_45,32487283840,True,49998000,1436000,51434000,False
4915,validator_18,97463249220,True,56707995,2158380,58866375,True
4916,validator_3,32716219822,True,118448999,584400,119033399,True
4917,validator_18,97642126812,True,174291002,4586590,178877592,True
4918,validator_29,32524725750,True,48626000,415620,49041620,False
4919,validator_16,33386656527,True,139250003,2204400,141454403,True
4920,validator_47,64961802130,True,130967000,873360,131840360,False
4921,validator_15,257628622685,True,61558999,498100,62057099,True
4922,validator_18,97763246413,True,102390001,18729600,121119601,True
4923,validator_10,32873552911,True,153501001,12018740,165519741,True
4924,validator_38,32872663510,True,68731000,770830,69501830,False
4925,validator_2,33084272151,True,170068000,889000,170957000,True
4926,validator_44,97203467570,True,128472000,9621800,138093800,False
4927,validator_1,64690699802,True,206137001,1317140,207454141,True
4928,validator_31,161920173560,True,236416000,1309800,237725800,False
4929,validator_14,96974370974,True,147203002,768580,147971582,True
4930,validator_18,97942064380,True,178669997,147970,178817967,True
4931,validator_8,32566551557,True,90086999,8336600,98423599,True
4932,validator_14,97065406874,True,89382000,1653900,91035900,True
4933,validator_48,161562733510,True,116312000,2343800,118655800,False
4934,validator_33,32998661450,True,168531000,1285520,169816520,False
4935,validator_30,64562190800,True,136406000,2676900,139082900,False
4936,validator_45,32568727530,True,80016000,1427690,81443690,False
4937,validator_10,33057757712,True,183547001,657800,184204801,True
4938,validator_48,161681187110,True,117193000,1260600,118453600,False
4939,validator_3,32841639702,True,120065000,5354880,125419880,True
4940,validator_40,32620867810,True,128141000,5425120,133566120,False
4941,validator_42,32898443460,True,74969000,1175080,76144080,False
4942,validator_13,32571135699,True,116783000,2401200,119184200,True
4943,validator_17,162069107651,True,114926003,1427430,116353433,True
4944,validator_34,257960807890,True,119595000,570640,120165640,False
4945,validator_10,33140661653,True,75143001,7760940,82903941,True
4946,validator_49,65091360430,True,128294000,744900,129038900,False
4947,validator_11,33285343392,True,73443004,1068440,74511444,True
4948,validator_4,32656732599,True,146724001,8660100,155384101,True
4949,validator_41,65608243950,True,151631000,1317520,152948520,False
4950,validator_17,162284683948,True,214977997,598300,215576297,True
4951,validator_14,97209443204,True,142006000,2030330,144036330,True
4952,validator_22,65493489310,True,121872000,795930,122667930,True
4953,validator_41,65680141150,True,70676000,1221200,71897200,False
4954,validator_10,33306182654,True,159803001,5718000,165521001,True
4955,validator_49,65227227230,True,129594000,6272800,135866800,False
4956,validator_47,65074518910,True,111872000,844780,112716780,False
4957,validator_17,162414625140,True,127416002,2525190,129941192,True
4958,validator_6,33398253556,True,89920002,591140,90511142,True
4959,validator_0,33290014342,True,110692001,856630,111548631,True
4960,validator_2,33296146181,True,211699000,175030,211874030,True
4961,validator_49,65311197430,True,73877000,10093200,83970200,False
4962,validator_46,97911285990,True,96929000,1198420,98127420,False
4963,validator_27,97195588770,True,153404000,484040,153888040,False
4964,validator_47,65181017130,True,105463000,1035220,106498220,False
4965,validator_44,97392151370,True,188454000,229800,188683800,False
4966,validator_20,33079917050,True,87186004,2479670,89665674,True
4967,validator_27,97298383900,True,101290000,1505130,102795130,False
4968,validator_46,98099388190,True,186324000,1778200,188102200,False
4969,validator_29,32648192150,True,114613000,8853400,123466400,False
4970,validator_6,33430063156,True,31605000,204600,31809600,True
4971,validator_44,97653287370,True,260486000,650000,261136000,False
4972,validator_22,65629090909,True,134654999,946600,135601599,True
4973,validator_8,32700820648,True,127278001,6991090,134269091,True
4974,validator_47,65328953610,True,146851000,1085480,147936480,False
4975,validator_41,66031923500,True,350411000,1371350,351782350,False
4976,validator_29,32752406080,True,102183000,2030930,104213930,False
4977,validator_29,32888131450,True,134163000,1562370,135725370,False
4978,validator_2,33455703272,True,158114001,1443090,159557091,True
4979,validator_22,65725266135,True,95137006,1038220,96175226,True
4980,validator_29,33021604350,True,132483000,989900,133472900,False
4981,validator_14,97333556244,True,119000000,5113040,124113040,True
4982,validator_22,65785460040,True,57102005,3091900,60193905,True
4983,validator_13,32627299827,True,55677998,486130,56164128,True
4984,validator_10,33417070944,True,109574000,1314290,110888290,True
4985,validator_33,33140593290,True,129675000,12256840,141931840,False
4986,validator_19,65355032443,True,72808000,342400,73150400,True
4987,validator_35,97048034060,True,99063000,256800,99319800,False
4988,validator_22,66095421817,True,309784997,176780,309961777,True
4989,validator_41,66201563060,True,167477000,2162560,169639560,False
4990,validator_42,33019266990,True,116446000,4377530,120823530,False
4991,validator_25,33075443920,True,132346000,2383000,134729000,False
4992,validator_38,32944768280,True,71828000,276770,72104770,False
4993,validator_10,33560856048,True,141650004,2135100,143785104,True
4994,validator_0,33402231670,True,111416998,800330,112217328,True
4995,validator_23,33554855161,True,168725001,298300,169023301,True
4996,validator_40,32784986010,True,162372000,1746200,164118200,False
4997,validator_33,33244760430,True,102932000,1235140,104167140,False
4998,validator_39,33474241020,True,144928000,2143300,147071300,False
4999,validator_31,162186425580,True,264543000,1709020,266252020,False
5000,validator_18,96128910041,True,127529001,1381040,128910041,True
5001,validator_19,64121972386,True,121044996,927390,121972386,True
5002,validator_14,96141416901,True,115480001,25936900,141416901,True
5003,validator_15,256141618599,True,136370999,5247600,141618599,True
5004,validator_15,256287555151,True,145426002,510550,145936552,True
5005,validator_37,64134756300,True,132912000,1844300,134756300,False
5006,validator_48,160130734230,True,129421000,1313230,130734230,False
5007,validator_27,96074262300,True,71916000,2346300,74262300,False
5008,validator_41,64092899300,True,92498000,401300,92899300,False
5009,validator_15,256346569851,True,57338000,1676700,59014700,True
5010,validator_44,96089216800,True,88784000,432800,89216800,False
5011,validator_0,32166798502,True,158512002,8286500,166798502,True
5012,validator_45,32066929240,True,51134000,15795240,66929240,False
5013,validator_12,96178003233,True,173936003,4067230,178003233,True
5014,validator_37,64289859800,True,150236000,4867500,155103500,False
5015,validator_28,32142861200,True,140550000,2311200,142861200,False
5016,validator_27,96173979300,True,99103000,614000,99717000,False
5017,validator_28,32277097570,True,124692000,9544370,134236370,False
5018,validator_18,96211224075,True,81152004,1162030,82314034,True
5019,validator_15,256475164644,True,127882003,712790,128594793,True
5020,validator_31,160186818800,True,184681000,2137800,186818800,False
5021,validator_20,32137200877,True,136528997,671880,137200877,True
5022,validator_42,32184220940,True,163425000,20795940,184220940,False
5023,validator_23,32048351101,True,46948001,1403100,48351101,True
5024,validator_36,96087197990,True,85951000,1246990,87197990,False
5025,validator_6,32165096922,True,162449002,2647920,165096922,True
5026,validator_47,64136954900,True,136151000,803900,136954900,False
5027,validator_37,64342353000,True,46328000,6165200,52493200,False
5028,validator_27,96224585040,True,48765000,1840740,50605740,False
5029,validator_39,32044610220,True,43986000,624220,44610220,False
5030,validator_36,96221380130,True,132162000,2020140,134182140,False
5031,validator_18,96416850459,True,185696994,19929390,205626384,True
5032,validator_27,96385356870,True,159285000,1486830,160771830,False
5033,validator_47,64193728790,True,55553000,1220890,56773890,False
5034,validator_2,32136653101,True,134777001,1876100,136653101,True
5035,validator_38,32120147900,True,119785000,362900,120147900,False
5036,validator_48,160239637120,True,106882000,2020890,108902890,False
5037,validator_12,96347652829,True,168941996,707600,169649596,True
5038,validator_19,64234298906,True,107184000,5142520,112326520,True
5039,validator_44,96194591400,True,103532000,1842600,105374600,False
5040,validator_32,32148836630,True,140968000,7868630,148836630,False
5041,validator_20,32299507959,True,161193002,1114080,162307082,True
5042,validator_43,64032058100,True,31669000,389100,32058100,False
5043,validator_28,32381891170,True,81785000,23008600,104793600,False
5044,validator_22,64215305253,True,213734993,1570260,215305253,True
5045,validator_28,32551174670,True,168407000,876500,169283500,False
5046,validator_39,32083066290,True,37262000,1194070,38456070,False
5047,validator_38,32227098200,True,103891000,3059300,106950300,False
5048,validator_31,160394972800,True,207106000,1048000,208154000,False
5049,validator_34,256155416780,True,154271000,1145780,155416780,False
5050,validator_48,160346736360,True,106352000,747240,107099240,False
5051,validator_43,64081998010,True,48666000,1273910,49939910,False
5052,validator_27,96429360270,True,41506000,2497400,44003400,False
5053,validator_44,96308650600,True,111945000,2114200,114059200,False
5054,validator_25,32048004200,True,47488000,516200,48004200,False
5055,validator_3,32177654734,True,164511994,13142740,177654734,True
5056,validator_20,32446068057,True,145210998,1349100,146560098,True
5057,validator_29,32068527600,True,62760000,5767600,68527600,False
5058,validator_39,32225495690,True,137093000,5336400,142429400,False
5059,validator_46,96179682500,True,161210000,18472500,179682500,False
5060,validator_39,32350872690,True,124204000,1173000,125377000,False
5061,validator_20,32587875456,True,140073999,1733400,141807399,True
5062,validator_5,64144231751,True,142787001,1444750,144231751,True
5063,validator_34,256293439080,True,137160000,862300,138022300,False
5064,validator_29,32099421390,True,28545000,2348790,30893790,False
5065,validator_36,96325356530,True,95681000,8295400,103976400,False
5066,validator_49,64121726040,True,120519000,1207040,121726040,False
5067,validator_32,32352697530,True,200855000,3005900,203860900,False
5068,validator_38,32407906500,True,179397000,1411300,180808300,False
5069,validator_23,32112208124,True,45287003,18570020,63857023,True
5070,validator_22,64280484957,True,59597004,5582700,65179704,True
5071,validator_34,256390068180,True,87589000,9040100,96629100,False
5072,validator_17,160073329996,True,71764996,1565000,73329996,True
5073,validator_11,32164955798,True,164013998,941800,164955798,True
5074,validator_28,32694728700,True,136012000,7542030,143554030,False
5075,validator_49,64223087490,True,100628000,733450,101361450,False
5076,validator_17,160134268499,True,59856003,1082500,60938503,True
5077,validator_28,32825449500,True,128699000,2021800,130720800,False
5078,validator_31,160496000800,True,99890000,1138000,101028000,False
5079,validator_12,96431421869,True,74305000,9464040,83769040,True
5080,validator_10,32161665297,True,143396997,18268300,161665297,True
5081,validator_19,64484381908,True,249637002,446000,250083002,True
5082,validator_28,32868681300,True,42723000,508800,43231800,False
5083,validator_17,160361751901,True,225882002,1601400,227483402,True
5084,validator_26,32082845400,True,81714000,1131400,82845400,False
5085,validator_35,96100070520,True,98490000,1580520,100070520,False
5086,validator_7,64110915329,True,109936999,978330,110915329,True
5087,validator_3,32345528226,True,148964992,18908500,167873492,True
5088,validator_0,32282506706,True,115093004,615200,115708204,True
5089,validator_42,32361284940,True,156906000,20158000,177064000,False
5090,validator_1,64135003324,True,134203004,800320,135003324,True
5091,validator_2,32296169813,True,158083992,1432720,159516712,True
5092,validator_8,32119015299,True,113195999,5819300,119015299,True
5093,validator_48,160488354060,True,141093000,524700,141617700,False
5094,validator_3,32523263729,True,174638003,3097500,177735503,True
5095,validator_40,32108059390,True,106575000,1484390,108059390,False
5096,validator_30,64127873920,True,126028000,1845920,127873920,False
5097,validator_5,64474020673,True,328360002,1428920,329788922,True
5098,validator_41,64221020120,True,126346000,1774820,128120820,False
5099,validator_9,32177522740,True,158702000,18820740,177522740,True
5100,validator_13,32120192597,True,118679997,1512600,120192597,True
5101,validator_36,96432950770,True,105120000,2474240,107594240,False
5102,validator_39,32426336690,True,67869000,7595000,75464000,False
5103,validator_7,64325423626,True,211829997,2678300,214508297,True
5104,validator_43,64313097790,True,225549000,5550780,231099780,False
5105,validator_0,32506071148,True,221110992,2453450,223564442,True
5106,validator_18,96505554303,True,88038004,665840,88703844,True
5107,validator_18,96733595543,True,226920000,1121240,228041240,True
5108,validator_34,256530373880,True,129535000,10770700,140305700,False
5109,validator_5,64555139912,True,71218999,9900240,81119239,True
5110,validator_28,33013759600,True,144766000,312300,145078300,False
5111,validator_28,33172508060,True,157678000,1070460,158748460,False
5112,validator_46,96257515800,True,76585000,1248300,77833300,False
5113,validator_33,32114812400,True,95698000,19114400,114812400,False
5114,validator_25,32149736700,True,96300000,5432500,101732500,False
5115,validator_0,32669977720,True,149220992,14685580,163906572,True
5116,validator_16,32142680602,True,141703002,977600,142680602,True
5117,validator_39,32598381620,True,171842000,202930,172044930,False
5118,validator_48,160647790500,True,158883000,553440,159436440,False
5119,validator_31,160563661300,True,66199000,1461500,67660500,False
5120,validator_36,96632384370,True,198068000,1365600,199433600,False
5121,validator_38,32534942040,True,125195000,1840540,127035540,False
5122,validator_22,64386749756,True,100228999,6035800,106264799,True
5123,validator_17,160492093293,True,106546002,23795390,130341392,True
5124,validator_7,64446981758,True,121077002,481130,121558132,True
5125,validator_34,256611162880,True,79422000,1367000,80789000,False
5126,validator_20,32762368796,True,173920000,573340,174493340,True
5127,validator_36,96798837370,True,129685000,36768000,166453000,False
5128,validator_46,96330330540,True,72584000,230740,72814740,False
5129,validator_24,32130560795,True,125350005,5210790,130560795,True
5130,validator_48,160773219860,True,125053000,376360,125429360,False
5131,validator_15,256631189043,True,155382999,641400,156024399,True
5132,validator_9,32346652438,True,167749998,1379700,169129698,True
5133,validator_12,96568407008,True,136114999,870140,136985139,True
5134,validator_19,64543097209,True,58242001,473300,58715301,True
5135,validator_9,32522859939,True,172811001,3396500,176207501,True
5136,validator_20,32850897696,True,87476000,1052900,88528900,True
5137,validator_36,96848543670,True,49040000,666300,49706300,False
5138,validator_35,96207351420,True,98517000,8763900,107280900,False
5139,validator_16,32382868179,True,238771997,1415580,240187577,True
5140,validator_39,32792947820,True,193720000,846200,194566200,False
5141,validator_44,96427989940,True,118906000,433340,119339340,False
5142,validator_35,96307325720,True,98931000,1043300,99974300,False
5143,validator_26,32146037180,True,62800000,391780,63191780,False
5144,validator_34,256722364080,True,110510000,691200,111201200,False
5145,validator_14,96250923004,True,101537003,7969100,109506103,True
5146,validator_31,160762691080,True,194089000,4940780,199029780,False
5147,validator_37,64489107200,True,144263000,2491200,146754200,False
5148,validator_44,96566635320,True,136232000,2413380,138645380,False
5149,validator_1,64270057627,True,133443003,1611300,135054303,True
5150,validator_13,32213547794,True,86255997,7099200,93355197,True
5151,validator_5,64662410311,True,104073999,3196400,107270399,True
5152,validator_0,32826780753,True,156411003,392030,156803033,True
5153,validator_46,96542265480,True,205934000,6000940,211934940,False
5154,validator_14,96294853264,True,43218000,712260,43930260,True
5155,validator_4,32212748920,True,211209000,1539920,212748920,True
5156,validator_34,256844241980,True,121487000,390900,121877900,False
5157,validator_8,32161710001,True,42288002,406700,42694702,True
5158,validator_34,256949413080,True,105072000,99100,105171100,False
5159,validator_41,64340885340,True,118939000,926220,119865220,False
5160,validator_37,64557541620,True,68225000,209420,68434420,False
5161,validator_12,96655349234,True,84398996,2543230,86942226,True
5162,validator_34,257133807480,True,184147000,247400,184394400,False
5163,validator_5,64826506353,True,163213002,883040,164096042,True
5164,validator_30,64225437420,True,93026000,4537500,97563500,False
5165,validator_49,64302827890,True,77572000,2168400,79740400,False
5166,validator_31,160886554920,True,123396000,467840,123863840,False
5167,validator_23,32257816394,True,144538000,1070270,145608270,True
5168,validator_45,32173722040,True,105308000,1484800,106792800,False
5169,validator_22,64496000851,True,101102995,8148100,109251095,True
5170,validator_17,160548375614,True,55838001,444320,56282321,True
5171,validator_42,32512134320,True,142992000,7857380,150849380,False
5172,validator_39,32905967020,True,111636000,1383200,113019200,False
5173,validator_7,64573084198,True,108073000,18029440,126102440,True
5174,validator_31,160980488360,True,75515000,18418440,93933440,False
5175,validator_46,96605205610,True,60860000,2080130,62940130,False
5176,validator_17,160604291114,True,47560000,8355500,55915500,True
5177,validator_16,32586240679,True,201479000,1893500,203372500,True
5178,validator_32,32521044330,True,167166000,1180800,168346800,False
5179,validator_47,64304049890,True,108792000,1529100,110321100,False
5180,validator_35,96408281220,True,99937000,1018500,100955500,False
5181,validator_44,96702937100,True,117849000,18452780,136301780,False
5182,validator_19,64644264134,True,100572995,593930,101166925,True
5183,validator_6,32244331720,True,56799998,22434800,79234798,True
5184,validator_43,64407853330,True,93156000,1599540,94755540,False
5185,validator_12,96831709513,True,175849999,510280,176360279,True
5186,validator_2,32392940210,True,96344997,425400,96770397,True
5187,validator_41,64449786840,True,107402000,1499500,108901500,False
5188,validator_34,257241088380,True,88866000,18414900,107280900,False
5189,validator_10,32223516697,True,60185000,1666400,61851400,True
5190,validator_36,96922159950,True,72149000,1467280,73616280,False
5191,validator_41,64720855870,True,270404000,665030,271069030,False
5192,validator_43,64573716250,True,147660000,18202920,165862920,False
5193,validator_41,64810486670,True,89049000,581800,89630800,False
5194,validator_11,32277619602,True,93945004,18718800,112663804,True
5195,validator_49,64472770790,True,168498000,1444900,169942900,False
5196,validator_36,97124393630,True,193975000,8258680,202233680,False
5197,validator_39,33025239020,True,110182000,9090000,119272000,False
5198,validator_2,32576442713,True,177101003,6401500,183502503,True
5199,validator_30,64361374320,True,133949000,1987900,135936900,False
5200,validator_24,32271110392,True,138362997,2186600,140549597,True
5201,validator_16,32780396887,True,174466008,19690200,194156208,True
5202,validator_44,96802781370,True,99111000,733270,99844270,False
5203,validator_38,32644203240,True,83317000,25944200,109261200,False
5204,validator_27,96551607370,True,120649000,1598100,122247100,False
5205,validator_8,32326233297,True,162982996,1540300,164523296,True
5206,validator_29,32153009620,True,53002000,586230,53588230,False
5207,validator_10,32433591728,True,207036001,3039030,210075031,True
5208,validator_35,96476024220,True,59198000,8545000,67743000,False
5209,validator_11,32377145222,True,97874000,1651620,99525620,True
5210,validator_39,33173121420,True,146179000,1703400,147882400,False
5211,validator_28,33374281400,True,199040000,2733340,201773340,False
5212,validator_17,160736719948,True,131660004,768830,132428834,True
5213,validator_25,32265319300,True,96908000,18674600,115582600,False
5214,validator_48,160819747640,True,44964000,1563780,46527780,False
5215,validator_15,256717199945,True,85057002,953900,86010902,True
5216,validator_33,32359068700,True,242780000,1476300,244256300,False
5217,validator_46,96780662850,True,173674000,1783240,175457240,False
5218,validator_22,64602373830,True,105164999,1207980,106372979,True
5219,validator_49,64601123590,True,127770000,582800,128352800,False
5220,validator_24,32476931219,True,204132997,1687830,205820827,True
5221,validator_22,64713831782,True,109834992,1622960,111457952,True
5222,validator_33,32469663700,True,100989000,9606000,110595000,False
5223,validator_6,32374559136,True,128273996,1953420,130227416,True
5224,validator_40,32215954490,True,107657000,238100,107895100,False
5225,validator_35,96558518620,True,81797000,697400,82494400,False
5226,validator_34,257343967880,True,102056000,823500,102879500,False
5227,validator_31,161059846060,True,78260000,1097700,79357700,False
5228,validator_11,32503226319,True,95849997,30231100,126081097,True
5229,validator_42,32609513160,True,96901000,477840,97378840,False
5230,validator_19,64788724563,True,144161999,298430,144460429,True
5231,validator_7,64645239740,True,71975002,180540,72155542,True
5232,validator_9,32650687817,True,126607998,1219880,127827878,True
5233,validator_20,32990251376,True,133634000,5719680,139353680,True
5234,validator_8,32468127958,True,139238001,2656660,141894661,True
5235,validator_32,32692074890,True,170155000,875560,171030560,False
5236,validator_25,32433003530,True,166175000,1509230,167684230,False
5237,validator_16,32874734308,True,93933001,404420,94337421,True
5238,validator_18,96874486744,True,123054001,17837200,140891201,True
5239,validator_22,64811009779,True,88085997,9092000,97177997,True
5240,validator_36,97309640530,True,184461000,785900,185246900,False
5241,validator_34,257469022550,True,117563000,7491670,125054670,False
5242,validator_35,96614271160,True,47821000,7931540,55752540,False
5243,validator_35,96791178860,True,175438000,1469700,176907700,False
5244,validator_23,32497010526,True,216234002,22960130,239194132,True
5245,validator_4,32385857021,True,172050001,1058100,173108101,True
5246,validator_31,161216970760,True,156209000,915700,157124700,False
5247,validator_11,32582862615,True,77752996,1883300,79636296,True
5248,validator_27,96713804070,True,161219000,977700,162196700,False
5249,validator_44,97065373770,True,261906000,686400,262592400,False
5250,validator_43,64743983700,True,167440000,2827450,170267450,False
5251,validator_26,32345012480,True,198357000,618300,198975300,False
5252,validator_36,97411913930,True,101218000,1055400,102273400,False
5253,validator_26,32494280620,True,147830000,1438140,149268140,False
5254,validator_41,64954725870,True,121934000,22305200,144239200,False
5255,validator_49,64727149190,True,100397000,25628600,126025600,False
5256,validator_18,97004448446,True,122436002,7525700,129961702,True
5257,validator_0,32938030183,True,110331000,918430,111249430,True
5258,validator_46,96889446780,True,108104000,679930,108783930,False
5259,validator_34,257629257940,True,152035000,8200390,160235390,False
5260,validator_46,97013679180,True,105514000,18718400,124232400,False
5261,validator_11,32878903716,True,294338001,1703100,296041101,True
5262,validator_31,161327947260,True,109130000,1846500,110976500,False
5263,validator_27,96796994210,True,64678000,18512140,83190140,False
5264,validator_33,32579749000,True,90565000,19520300,110085300,False
5265,validator_12,97091785215,True,241528002,18547700,260075702,True
5266,validator_37,64600973440,True,43098000,333820,43431820,False
5267,validator_33,32736236530,True,155593000,894530,156487530,False
5268,validator_9,32776054456,True,123901999,1464640,125366639,True
5269,validator_23,32649035599,True,132778003,19247070,152025073,True
5270,validator_29,32315766960,True,161425000,1332340,162757340,False
5271,validator_47,64468972890,True,162714000,2209000,164923000,False
5272,validator_13,32320700696,True,106120002,1032900,107152902,True
5273,validator_6,32498795939,True,123485003,751800,124236803,True
5274,validator_36,97489089210,True,75171000,2004280,77175280,False
5275,validator_43,64877166800,True,131346000,1837100,133183100,False
5276,validator_2,32832184910,True,254111997,1630200,255742197,True
5277,validator_17,160799602584,True,54906996,7975640,62882636,True
5278,validator_6,32581423135,True,81580996,1046200,82627196,True
5279,validator_19,64966318767,True,176318004,1276200,177594204,True
5280,validator_15,256900145237,True,166537002,16408290,182945292,True
5281,validator_33,32828844930,True,91370000,1238400,92608400,False
5282,validator_37,64777415240,True,157826000,18615800,176441800,False
5283,validator_23,32748534299,True,81466000,18032700,99498700,True
5284,validator_11,33001038318,True,121187002,947600,122134602,True
5285,validator_46,97143660180,True,128994000,987000,129981000,False
5286,validator_3,32597186423,True,71834994,2087700,73922694,True
5287,validator_40,32367020390,True,148603000,2462900,151065900,False
5288,validator_6,32681899736,True,98940001,1536600,100476601,True
5289,validator_41,65088716370,True,115225000,18765500,133990500,False
5290,validator_41,65241621900,True,150384000,2521530,152905530,False
5291,validator_42,32822299380,True,211688000,1098220,212786220,False
5292,validator_9,32850448982,True,73095996,1298530,74394526,True
5293,validator_5,64878900256,True,51628003,765900,52393903,True
5294,validator_14,96366982465,True,69592001,2537200,72129201,True
5295,validator_5,64985494558,True,105555002,1039300,106594302,True
5296,validator_31,161466898860,True,119254000,19697600,138951600,False
5297,validator_22,64921562836,True,110086997,466060,110553057,True
5298,validator_13,32451951499,True,128819003,2431800,131250803,True
5299,validator_38,32803161680,True,157910000,1048440,158958440,False
5300,validator_15,257054090738,True,145912001,8033500,153945501,True
5301,validator_17,160871597846,True,71324002,671260,71995262,True
5302,validator_6,32830854835,True,130236999,18718100,148955099,True
5303,validator_6,32912860464,True,81447999,557630,82005629,True
5304,validator_46,97265200340,True,120277000,1263160,121540160,False
5305,validator_23,32986701078,True,234683999,3482780,238166779,True
5306,validator_6,33100953901,True,181360997,6732440,188093437,True
5307,validator_27,96916801510,True,118373000,1434300,119807300,False
5308,validator_4,32501348498,True,114878997,612480,115491477,True
5309,validator_17,161014496480,True,137932994,4965640,142898634,True
5310,validator_5,65080371457,True,92887999,1988900,94876899,True
5311,validator_11,33085477903,True,83301995,1137590,84439585,True
5312,validator_41,65344476400,True,83503000,19351500,102854500,False
5313,validator_12,97197020785,True,92185000,13050570,105235570,True
5314,validator_47,64573088690,True,103428000,687800,104115800,False
5315,validator_7,64787915961,True,142115001,561220,142676221,True
5316,validator_30,64423107900,True,53661000,8072580,61733580,False
5317,validator_26,32683087320,True,188492000,314700,188806700,False
5318,validator_48,160948037240,True,127078000,1211600,128289600,False
5319,validator_29,32425321630,True,108245000,1309670,109554670,False
5320,validator_6,33177865298,True,75477997,1433400,76911397,True
5321,validator_32,32846734890,True,153182000,1478000,154660000,False
5322,validator_32,32917850970,True,69630000,1486080,71116080,False
5323,validator_0,33046190113,True,89068000,19091930,108159930,True
5324,validator_34,257768543130,True,137289000,1996190,139285190,False
5325,validator_10,32601387070,True,166389002,1406340,167795342,True
5326,validator_15,257105727144,True,49490006,2146400,51636406,True
5327,validator_46,97407972360,True,138004000,4768020,142772020,False
5328,validator_43,64919310700,True,41343000,800900,42143900,False
5329,validator_26,32831488240,True,148215000,185920,148400920,False
5330,validator_18,97166077343,True,160421997,1206900,161628897,True
5331,validator_19,65135218465,True,160625998,8273700,168899698,True
5332,validator_22,65204875633,True,282162997,1149800,283312797,True
5333,validator_19,65281882043,True,145838998,824580,146663578,True
5334,validator_6,33229629914,True,49824996,1939620,51764616,True
5335,validator_32,32976848260,True,40394000,18603290,58997290,False
5336,validator_41,65387620640,True,42716000,428240,43144240,False
5337,validator_45,32376349340,True,198925000,3702300,202627300,False
5338,validator_5,65174953558,True,93799001,783100,94582101,True
5339,validator_49,64893259930,True,164370000,1740740,166110740,False
5340,validator_46,97574163950,True,164789000,1402590,166191590,False
5341,validator_36,97590891010,True,95789000,6012800,101801800,False
5342,validator_36,97741713370,True,150168000,654360,150822360,False
5343,validator_16,32933008906,True,57672998,601600,58274598,True
5344,validator_0,33178465711,True,128456998,3818600,132275598,True
5345,validator_37,64896087100,True,115882000,2789860,118671860,False
5346,validator_47,64672180290,True,81070000,18021600,99091600,False
5347,validator_47,64829961770,True,157288000,493480,157781480,False
5348,validator_16,33101460495,True,163014999,5436590,168451589,True
5349,validator_37,65104392200,True,189516000,18789100,208305100,False
5350,validator_17,161192991883,True,177517003,978400,178495403,True
5351,validator_29,32475684130,True,45069000,5293500,50362500,False
5352,validator_15,257352146315,True,244572001,1847170,246419171,True
5353,validator_40,32487301690,True,111963000,8318300,120281300,False
5354,validator_17,161289995526,True,90295003,6708640,97003643,True
5355,validator_14,96593913493,True,225743998,1187030,226931028,True
5356,validator_21,64235234399,True,233804999,1429400,235234399,True
5357,validator_17,161408789531,True,100274005,18520000,118794005,True
5358,validator_9,32933333465,True,82500003,384480,82884483,True
5359,validator_10,32708033170,True,87912000,18734100,106646100,True
5360,validator_25,32614112810,True,178535000,2574280,181109280,False
5361,validator_32,33085068000,True,106221000,1998740,108219740,False
5362,validator_17,161507270631,True,96537000,1944100,98481100,True
5363,validator_18,97289074440,True,122206997,790100,122997097,True
5364,validator_36,97833464110,True,90911000,839740,91750740,False
5365,validator_28,33558862900,True,176295000,8286500,184581500,False
5366,validator_49,64962321530,True,68437000,624600,69061600,False
5367,validator_22,65257218638,True,51942005,401000,52343005,True
5368,validator_46,97690724870,True,115701000,859920,116560920,False
5369,validator_25,32836646810,True,221778000,756000,222534000,False
5370,validator_23,33227412030,True,221028002,19682950,240710952,True
5371,validator_39,33327169720,True,152770000,1278300,154048300,False
5372,validator_1,64358416225,True,87039998,1318600,88358598,True
5373,validator_16,33245202124,True,141363999,2377630,143741629,True
5374,validator_46,97813158570,True,102673000,19760700,122433700,False
5375,validator_2,32913315151,True,79922001,1208240,81130241,True
5376,validator_15,257413949985,True,60573000,1230670,61803670,True
5377,validator_37,65265136800,True,159611000,1133600,160744600,False
5378,validator_48,161025204740,True,75541000,1626500,77167500,False
5379,validator_48,161139311340,True,113196000,910600,114106600,False
5380,validator_7,64864872441,True,76354000,602480,76956480,True
5381,validator_35,96948714260,True,156980000,555400,157535400,False
5382,validator_21,64347529716,True,110172997,2122320,112295317,True
5383,validator_22,65370821380,True,111247002,2355740,113602742,True
5384,validator_48,161302127010,True,160084000,2731670,162815670,False
5385,validator_14,96683569496,True,88896003,760000,89656003,True
5386,validator_5,65311961161,True,133510003,3497600,137007603,True
5387,validator_34,257840642250,True,70386000,1713120,72099120,False
5388,validator_17,161653469728,True,143632997,2566100,146199097,True
5389,validator_25,32940714920,True,100334000,3734110,104068110,False
5390,validator_18,97404382845,True,114553005,755400,115308405,True
5391,validator_5,65463423158,True,149526997,1935000,151461997,True
5392,validator_45,32435849840,True,59120000,380500,59500500,False
5393,validator_7,64900366644,True,34652003,842200,35494203,True
5394,validator_32,33129148320,True,42933000,1147320,44080320,False
5395,validator_37,65319501400,True,53767000,597600,54364600,False
5396,validator_7,65018523092,True,115438008,2718440,118156448,True
5397,validator_28,33655272400,True,92927000,3482500,96409500,False
5398,validator_31,161682447760,True,213666000,1882900,215548900,False
5399,validator_11,33210831948,True,123849005,1505040,125354045,True
5400,validator_21,64419834117,True,53992001,18312400,72304401,True
5401,validator_41,65455295430,True,57534000,10140790,67674790,False
5402,validator_24,32580582825,True,101625006,2026600,103651606,True
5403,validator_27,97041700730,True,123850000,1049220,124899220,False
5404,validator_21,64585487556,True,163687999,1965440,165653439,True
5405,validator_14,96826399392,True,139660996,3168900,142829896,True
5406,validator_6,33307742414,True,69237000,8875500,78112500,True
5407,validator_23,33313293029,True,66338999,19542000,85880999,True
5408,validator_1,64483245661,True,124202006,627430,124829436,True
5409,validator_48,161444077710,True,141298000,652700,141950700,False
5410,validator_36,97963306410,True,129193000,649300,129842300,False
5411,validator_17,161952754218,True,244643000,54641490,299284490,True
5412,validator_15,257566565586,True,134517001,18098600,152615601,True
5413,validator_23,33385831860,True,70466001,2072830,72538831,True
5414,validator_45,32487283840,True,49998000,1436000,51434000,False
5415,validator_18,97463249220,True,56707995,2158380,58866375,True
5416,validator_3,32716219822,True,118448999,584400,119033399,True
5417,validator_18,97642126812,True,174291002,4586590,178877592,True
5418,validator_29,32524725750,True,48626000,415620,49041620,False
5419,validator_16,33386656527,True,139250003,2204400,141454403,True
5420,validator_47,64961802130,True,130967000,873360,131840360,False
5421,validator_15,257628622685,True,61558999,498100,62057099,True
5422,validator_18,97763246413,True,102390001,18729600,121119601,True
5423,validator_10,32873552911,True,153501001,12018740,165519741,True
5424,validator_38,32872663510,True,68731000,770830,69501830,False
5425,validator_2,33084272151,True,170068000,889000,170957000,True
5426,validator_44,97203467570,True,128472000,9621800,138093800,False
5427,validator_1,64690699802,True,206137001,1317140,207454141,True
5428,validator_31,161920173560,True,236416000,1309800,237725800,False
5429,validator_14,96974370974,True,147203002,768580,147971582,True
5430,validator_18,97942064380,True,178669997,147970,178817967,True
5431,validator_8,32566551557,True,90086999,8336600,98423599,True
5432,validator_14,97065406874,True,89382000,1653900,91035900,True
5433,validator_48,161562733510,True,116312000,2343800,118655800,False
5434,validator_33,32998661450,True,168531000,1285520,169816520,False
5435,validator_30,64562190800,True,136406000,2676900,139082900,False
5436,validator_45,32568727530,True,80016000,1427690,81443690,False
5437,validator_10,33057757712,True,183547001,657800,184204801,True
5438,validator_48,161681187110,True,117193000,1260600,118453600,False
5439,validator_3,32841639702,True,120065000,5354880,125419880,True
5440,validator_40,32620867810,True,128141000,5425120,133566120,False
5441,validator_42,32898443460,True,74969000,1175080,76144080,False
5442,validator_13,32571135699,True,116783000,2401200,119184200,True
5443,validator_17,162069107651,True,114926003,1427430,116353433,True
5444,validator_34,257960807890,True,119595000,570640,120165640,False
5445,validator_10,33140661653,True,75143001,7760940,82903941,True
5446,validator_49,65091360430,True,128294000,744900,129038900,False
5447,validator_11,33285343392,True,73443004,1068440,74511444,True
5448,validator_4,32656732599,True,146724001,8660100,155384101,True
5449,validator_41,65608243950,True,151631000,1317520,152948520,False
5450,validator_17,162284683948,True,214977997,598300,215576297,True
5451,validator_14,97209443204,True,142006000,2030330,144036330,True
5452,validator_22,65493489310,True,121872000,795930,122667930,True
5453,validator_41,65680141150,True,70676000,1221200,71897200,False
5454,validator_10,33306182654,True,159803001,5718000,165521001,True
5455,validator_49,65227227230,True,129594000,6272800,135866800,False
5456,validator_47,65074518910,True,111872000,844780,112716780,False
5457,validator_17,162414625140,True,127416002,2525190,129941192,True
5458,validator_6,33398253556,True,89920002,591140,90511142,True
5459,validator_0,33290014342,True,110692001,856630,111548631,True
5460,validator_2,33296146181,True,211699000,175030,211874030,True
5461,validator_49,65311197430,True,73877000,10093200,83970200,False
5462,validator_46,97911285990,True,96929000,1198420,98127420,False
5463,validator_27,97195588770,True,153404000,484040,153888040,False
5464,validator_47,65181017130,True,105463000,1035220,106498220,False
5465,validator_44,97392151370,True,188454000,229800,188683800,False
5466,validator_20,33079917050,True,87186004,2479670,89665674,True
5467,validator_27,97298383900,True,101290000,1505130,102795130,False
5468,validator_46,98099388190,True,186324000,1778200,188102200,False
5469,validator_29,32648192150,True,114613000,8853400,123466400,False
5470,validator_6,33430063156,True,31605000,204600,31809600,True
5471,validator_44,97653287370,True,260486000,650000,261136000,False
5472,validator_22,65629090909,True,134654999,946600,135601599,True
5473,validator_8,32700820648,True,127278001,6991090,134269091,True
5474,validator_47,65328953610,True,146851000,1085480,147936480,False
5475,validator_41,66031923500,True,350411000,1371350,351782350,False
5476,validator_29,32752406080,True,102183000,2030930,104213930,False
5477,validator_29,32888131450,True,134163000,1562370,135725370,False
5478,validator_2,33455703272,True,158114001,1443090,159557091,True
5479,validator_22,65725266135,True,95137006,1038220,96175226,True
5480,validator_29,33021604350,True,132483000,989900,133472900,False
5481,validator_14,97333556244,True,119000000,5113040,124113040,True
5482,validator_22,65785460040,True,57102005,3091900,60193905,True
5483,validator_13,32627299827,True,55677998,486130,56164128,True
5484,validator_10,33417070944,True,109574000,1314290,110888290,True
5485,validator_33,33140593290,True,129675000,12256840,141931840,False
5486,validator_19,65355032443,True,72808000,342400,73150400,True
5487,validator_35,97048034060,True,99063000,256800,99319800,False
5488,validator_22,66095421817,True,309784997,176780,309961777,True
5489,validator_41,66201563060,True,167477000,2162560,169639560,False
5490,validator_42,33019266990,True,116446000,4377530,120823530,False
5491,validator_25,33075443920,True,132346000,2383000,134729000,False
5492,validator_38,32944768280,True,71828000,276770,72104770,False
5493,validator_10,33560856048,True,141650004,2135100,143785104,True
5494,validator_0,33402231670,True,111416998,800330,112217328,True
5495,validator_23,33554855161,True,168725001,298300,169023301,True
5496,validator_40,32784986010,True,162372000,1746200,164118200,False
5497,validator_33,33244760430,True,102932000,1235140,104167140,False
5498,validator_39,33474241020,True,144928000,2143300,147071300,False
5499,validator_31,162186425580,True,264543000,1709020,266252020,False
5500,validator_18,96128910041,True,127529001,1381040,128910041,True
5501,validator_19,64121972386,True,121044996,927390,121972386,True
5502,validator_14,96141416901,True,115480001,25936900,141416901,True
5503,validator_15,256141618599,True,136370999,5247600,141618599,True
5504,validator_15,256287555151,True,145426002,510550,145936552,True
5505,validator_37,64134756300,True,132912000,1844300,134756300,False
5506,validator_48,160130734230,True,129421000,1313230,130734230,False
5507,validator_27,96074262300,True,71916000,2346300,74262300,False
5508,validator_41,64092899300,True,92498000,401300,92899300,False
5509,validator_15,256346569851,True,57338000,1676700,59014700,True
5510,validator_44,96089216800,True,88784000,432800,89216800,False
5511,validator_0,32166798502,True,158512002,8286500,166798502,True
5512,validator_45,32066929240,True,51134000,15795240,66929240,False
5513,validator_12,96178003233,True,173936003,4067230,178003233,True
5514,validator_37,64289859800,True,150236000,4867500,155103500,False
5515,validator_28,32142861200,True,140550000,2311200,142861200,False
5516,validator_27,96173979300,True,99103000,614000,99717000,False
5517,validator_28,32277097570,True,124692000,9544370,134236370,False
5518,validator_18,96211224075,True,81152004,1162030,82314034,True
5519,validator_15,256475164644,True,127882003,712790,128594793,True
5520,validator_31,160186818800,True,184681000,2137800,186818800,False
5521,validator_20,32137200877,True,136528997,671880,137200877,True
5522,validator_42,32184220940,True,163425000,20795940,184220940,False
5523,validator_23,32048351101,True,46948001,1403100,48351101,True
5524,validator_36,96087197990,True,85951000,1246990,87197990,False
5525,validator_6,32165096922,True,162449002,2647920,165096922,True
5526,validator_47,64136954900,True,136151000,803900,136954900,False
5527,validator_37,64342353000,True,46328000,6165200,52493200,False
5528,validator_27,96224585040,True,48765000,1840740,50605740,False
5529,validator_39,32044610220,True,43986000,624220,44610220,False
5530,validator_36,96221380130,True,132162000,2020140,134182140,False
5531,validator_18,96416850459,True,185696994,19929390,205626384,True
5532,validator_27,96385356870,True,159285000,1486830,160771830,False
5533,validator_47,64193728790,True,55553000,1220890,56773890,False
5534,validator_2,32136653101,True,134777001,1876100,136653101,True
5535,validator_38,32120147900,True,119785000,362900,120147900,False
5536,validator_48,160239637120,True,106882000,2020890,108902890,False
5537,validator_12,96347652829,True,168941996,707600,169649596,True
5538,validator_19,64234298906,True,107184000,5142520,112326520,True
5539,validator_44,96194591400,True,103532000,1842600,105374600,False
5540,validator_32,32148836630,True,140968000,7868630,148836630,False
5541,validator_20,32299507959,True,161193002,1114080,162307082,True
5542,validator_43,64032058100,True,31669000,389100,32058100,False
5543,validator_28,32381891170,True,81785000,23008600,104793600,False
5544,validator_22,64215305253,True,213734993,1570260,215305253,True
5545,validator_28,32551174670,True,168407000,876500,169283500,False
5546,validator_39,32083066290,True,37262000,1194070,38456070,False
5547,validator_38,32227098200,True,103891000,3059300,106950300,False
5548,validator_31,160394972800,True,207106000,1048000,208154000,False
5549,validator_34,256155416780,True,154271000,1145780,155416780,False
5550,validator_48,160346736360,True,106352000,747240,107099240,False
5551,validator_43,64081998010,True,48666000,1273910,49939910,False
5552,validator_27,96429360270,True,41506000,2497400,44003400,False
5553,validator_44,96308650600,True,111945000,2114200,114059200,False
5554,validator_25,32048004200,True,47488000,516200,48004200,False
5555,validator_3,32177654734,True,164511994,13142740,177654734,True
5556,validator_20,32446068057,True,145210998,1349100,146560098,True
5557,validator_29,32068527600,True,62760000,5767600,68527600,False
5558,validator_39,32225495690,True,137093000,5336400,142429400,False
5559,validator_46,96179682500,True,161210000,18472500,179682500,False
5560,validator_39,32350872690,True,124204000,1173000,125377000,False
5561,validator_20,32587875456,True,140073999,1733400,141807399,True
5562,validator_5,64144231751,True,142787001,1444750,144231751,True
5563,validator_34,256293439080,True,137160000,862300,138022300,False
5564,validator_29,32099421390,True,28545000,2348790,30893790,False
5565,validator_36,96325356530,True,95681000,8295400,103976400,False
5566,validator_49,64121726040,True,120519000,1207040,121726040,False
5567,validator_32,32352697530,True,200855000,3005900,203860900,False
5568,validator_38,32407906500,True,179397000,1411300,180808300,False
5569,validator_23,32112208124,True,45287003,18570020,63857023,True
5570,validator_22,64280484957,True,59597004,5582700,65179704,True
5571,validator_34,256390068180,True,87589000,9040100,96629100,False
5572,validator_17,160073329996,True,71764996,1565000,73329996,True
5573,validator_11,32164955798,True,164013998,941800,164955798,True
5574,validator_28,32694728700,True,136012000,7542030,143554030,False
5575,validator_49,64223087490,True,100628000,733450,101361450,False
5576,validator_17,160134268499,True,59856003,1082500,60938503,True
5577,validator_28,32825449500,True,128699000,2021800,130720800,False
5578,validator_31,160496000800,True,99890000,1138000,101028000,False
5579,validator_12,96431421869,True,74305000,9464040,83769040,True
5580,validator_10,32161665297,True,143396997,18268300,161665297,True
5581,validator_19,64484381908,True,249637002,446000,250083002,True
5582,validator_28,32868681300,True,42723000,508800,43231800,False
5583,validator_17,160361751901,True,225882002,1601400,227483402,True
5584,validator_26,32082845400,True,81714000,1131400,82845400,False
5585,validator_35,96100070520,True,98490000,1580520,100070520,False
5586,validator_7,64110915329,True,109936999,978330,110915329,True
5587,validator_3,32345528226,True,148964992,18908500,167873492,True
5588,validator_0,32282506706,True,115093004,615200,115708204,True
5589,validator_42,32361284940,True,156906000,20158000,177064000,False
5590,validator_1,64135003324,True,134203004,800320,135003324,True
5591,validator_2,32296169813,True,158083992,1432720,159516712,True
5592,validator_8,32119015299,True,113195999,5819300,119015299,True
5593,validator_48,160488354060,True,141093000,524700,141617700,False
5594,validator_3,32523263729,True,174638003,3097500,177735503,True
5595,validator_40,32108059390,True,106575000,1484390,108059390,False
5596,validator_30,64127873920,True,126028000,1845920,127873920,False
5597,validator_5,64474020673,True,328360002,1428920,329788922,True
5598,validator_41,64221020120,True,126346000,1774820,128120820,False
5599,validator_9,32177522740,True,158702000,18820740,177522740,True
5600,validator_13,32120192597,True,118679997,1512600,120192597,True
5601,validator_36,96432950770,True,105120000,2474240,107594240,False
5602,validator_39,32426336690,True,67869000,7595000,75464000,False
5603,validator_7,64325423626,True,211829997,2678300,214508297,True
5604,validator_43,64313097790,True,225549000,5550780,231099780,False
5605,validator_0,32506071148,True,221110992,2453450,223564442,True
5606,validator_18,96505554303,True,88038004,665840,88703844,True
5607,validator_18,96733595543,True,226920000,1121240,228041240,True
5608,validator_34,256530373880,True,129535000,10770700,140305700,False
5609,validator_5,64555139912,True,71218999,9900240,81119239,True
5610,validator_28,33013759600,True,144766000,312300,145078300,False
5611,validator_28,33172508060,True,157678000,1070460,158748460,False
5612,validator_46,96257515800,True,76585000,1248300,77833300,False
5613,validator_33,32114812400,True,95698000,19114400,114812400,False
5614,validator_25,32149736700,True,96300000,5432500,101732500,False
5615,validator_0,32669977720,True,149220992,14685580,163906572,True
5616,validator_16,32142680602,True,141703002,977600,142680602,True
5617,validator_39,32598381620,True,171842000,202930,172044930,False
5618,validator_48,160647790500,True,158883000,553440,159436440,False
5619,validator_31,160563661300,True,66199000,1461500,67660500,False
5620,validator_36,96632384370,True,198068000,1365600,199433600,False
5621,validator_38,32534942040,True,125195000,1840540,127035540,False
5622,validator_22,64386749756,True,100228999,6035800,106264799,True
5623,validator_17,160492093293,True,106546002,23795390,130341392,True
5624,validator_7,64446981758,True,121077002,481130,121558132,True
5625,validator_34,256611162880,True,79422000,1367000,80789000,False
5626,validator_20,32762368796,True,173920000,573340,174493340,True
5627,validator_36,96798837370,True,129685000,36768000,166453000,False
5628,validator_46,96330330540,True,72584000,230740,72814740,False
5629,validator_24,32130560795,True,125350005,5210790,130560795,True
5630,validator_48,160773219860,True,125053000,376360,125429360,False
5631,validator_15,256631189043,True,155382999,641400,156024399,True
5632,validator_9,32346652438,True,167749998,1379700,169129698,True
5633,validator_12,96568407008,True,136114999,870140,136985139,True
5634,validator_19,64543097209,True,58242001,473300,58715301,True
5635,validator_9,32522859939,True,172811001,3396500,176207501,True
5636,validator_20,32850897696,True,87476000,1052900,88528900,True
5637,validator_36,96848543670,True,49040000,666300,49706300,False
5638,validator_35,96207351420,True,98517000,8763900,107280900,False
5639,validator_16,32382868179,True,238771997,1415580,240187577,True
5640,validator_39,32792947820,True,193720000,846200,194566200,False
5641,validator_44,96427989940,True,118906000,433340,119339340,False
5642,validator_35,96307325720,True,98931000,1043300,99974300,False
5643,validator_26,32146037180,True,62800000,391780,63191780,False
5644,validator_34,256722364080,True,110510000,691200,111201200,False
5645,validator_14,96250923004,True,101537003,7969100,109506103,True
5646,validator_31,160762691080,True,194089000,4940780,199029780,False
5647,validator_37,64489107200,True,144263000,2491200,146754200,False
5648,validator_44,96566635320,True,136232000,2413380,138645380,False
5649,validator_1,64270057627,True,133443003,1611300,135054303,True
5650,validator_13,32213547794,True,86255997,7099200,93355197,True
5651,validator_5,64662410311,True,104073999,3196400,107270399,True
5652,validator_0,32826780753,True,156411003,392030,156803033,True
5653,validator_46,96542265480,True,205934000,6000940,211934940,False
5654,validator_14,96294853264,True,43218000,712260,43930260,True
5655,validator_4,32212748920,True,211209000,1539920,212748920,True
5656,validator_34,256844241980,True,121487000,390900,121877900,False
5657,validator_8,32161710001,True,42288002,406700,42694702,True
5658,validator_34,256949413080,True,105072000,99100,105171100,False
5659,validator_41,64340885340,True,118939000,926220,119865220,False
5660,validator_37,64557541620,True,68225000,209420,68434420,False
5661,validator_12,96655349234,True,84398996,2543230,86942226,True
5662,validator_34,257133807480,True,184147000,247400,184394400,False
5663,validator_5,64826506353,True,163213002,883040,164096042,True
5664,validator_30,64225437420,True,93026000,4537500,97563500,False
5665,validator_49,64302827890,True,77572000,2168400,79740400,False
5666,validator_31,160886554920,True,123396000,467840,123863840,False
5667,validator_23,32257816394,True,144538000,1070270,145608270,True
5668,validator_45,32173722040,True,105308000,1484800,106792800,False
5669,validator_22,64496000851,True,101102995,8148100,109251095,True
5670,validator_17,160548375614,True,55838001,444320,56282321,True
5671,validator_42,32512134320,True,142992000,7857380,150849380,False
5672,validator_39,32905967020,True,111636000,1383200,113019200,False
5673,validator_7,64573084198,True,108073000,18029440,126102440,True
5674,validator_31,160980488360,True,75515000,18418440,93933440,False
5675,validator_46,96605205610,True,60860000,2080130,62940130,False
5676,validator_17,160604291114,True,47560000,8355500,55915500,True
5677,validator_16,32586240679,True,201479000,1893500,203372500,True
5678,validator_32,32521044330,True,167166000,1180800,168346800,False
5679,validator_47,64304049890,True,108792000,1529100,110321100,False
5680,validator_35,96408281220,True,99937000,1018500,100955500,False
5681,validator_44,96702937100,True,117849000,18452780,136301780,False
5682,validator_19,64644264134,True,100572995,593930,101166925,True
5683,validator_6,32244331720,True,56799998,22434800,79234798,True
5684,validator_43,64407853330,True,93156000,1599540,94755540,False
5685,validator_12,96831709513,True,175849999,510280,176360279,True
5686,validator_2,32392940210,True,96344997,425400,96770397,True
5687,validator_41,64449786840,True,107402000,1499500,108901500,False
5688,validator_34,257241088380,True,88866000,18414900,107280900,False
5689,validator_10,32223516697,True,60185000,1666400,61851400,True
5690,validator_36,96922159950,True,72149000,1467280,73616280,False
5691,validator_41,64720855870,True,270404000,665030,271069030,False
5692,validator_43,64573716250,True,147660000,18202920,165862920,False
5693,validator_41,64810486670,True,89049000,581800,89630800,False
5694,validator_11,32277619602,True,93945004,18718800,112663804,True
5695,validator_49,64472770790,True,168498000,1444900,169942900,False
5696,validator_36,97124393630,True,193975000,8258680,202233680,False
5697,validator_39,33025239020,True,110182000,9090000,119272000,False
5698,validator_2,32576442713,True,177101003,6401500,183502503,True
5699,validator_30,64361374320,True,133949000,1987900,135936900,False
5700,validator_24,32271110392,True,138362997,2186600,140549597,True
5701,validator_16,32780396887,True,174466008,19690200,194156208,True
5702,validator_44,96802781370,True,99111000,733270,99844270,False
5703,validator_38,32644203240,True,83317000,25944200,109261200,False
5704,validator_27,96551607370,True,120649000,1598100,122247100,False
5705,validator_8,32326233297,True,162982996,1540300,164523296,True
5706,validator_29,32153009620,True,53002000,586230,53588230,False
5707,validator_10,32433591728,True,207036001,3039030,210075031,True
5708,validator_35,96476024220,True,59198000,8545000,67743000,False
5709,validator_11,32377145222,True,97874000,1651620,99525620,True
5710,validator_39,33173121420,True,146179000,1703400,147882400,False
5711,validator_28,33374281400,True,199040000,2733340,201773340,False
5712,validator_17,160736719948,True,131660004,768830,132428834,True
5713,validator_25,32265319300,True,96908000,18674600,115582600,False
5714,validator_48,160819747640,True,44964000,1563780,46527780,False
5715,validator_15,256717199945,True,85057002,953900,86010902,True
5716,validator_33,32359068700,True,242780000,1476300,244256300,False
5717,validator_46,96780662850,True,173674000,1783240,175457240,False
5718,validator_22,64602373830,True,105164999,1207980,106372979,True
5719,validator_49,64601123590,True,127770000,582800,128352800,False
5720,validator_24,32476931219,True,204132997,1687830,205820827,True
5721,validator_22,64713831782,True,109834992,1622960,111457952,True
5722,validator_33,32469663700,True,100989000,9606000,110595000,False
5723,validator_6,32374559136,True,128273996,1953420,130227416,True
5724,validator_40,32215954490,True,107657000,238100,107895100,False
5725,validator_35,96558518620,True,81797000,697400,82494400,False
5726,validator_34,257343967880,True,102056000,823500,102879500,False
5727,validator_31,161059846060,True,78260000,1097700,79357700,False
5728,validator_11,32503226319,True,95849997,30231100,126081097,True
5729,validator_42,32609513160,True,96901000,477840,97378840,False
5730,validator_19,64788724563,True,144161999,298430,144460429,True
5731,validator_7,64645239740,True,71975002,180540,72155542,True
5732,validator_9,32650687817,True,126607998,1219880,127827878,True
5733,validator_20,32990251376,True,133634000,5719680,139353680,True
5734,validator_8,32468127958,True,139238001,2656660,141894661,True
5735,validator_32,32692074890,True,170155000,875560,171030560,False
5736,validator_25,32433003530,True,166175000,1509230,167684230,False
5737,validator_16,32874734308,True,93933001,404420,94337421,True
5738,validator_18,96874486744,True,123054001,17837200,140891201,True
5739,validator_22,64811009779,True,88085997,9092000,97177997,True
5740,validator_36,97309640530,True,184461000,785900,185246900,False
5741,validator_34,257469022550,True,117563000,7491670,125054670,False
5742,validator_35,96614271160,True,47821000,7931540,55752540,False
5743,validator_35,96791178860,True,175438000,1469700,176907700,False
5744,validator_23,32497010526,True,216234002,22960130,239194132,True
5745,validator_4,32385857021,True,172050001,1058100,173108101,True
5746,validator_31,161216970760,True,156209000,915700,157124700,False
5747,validator_11,32582862615,True,77752996,1883300,79636296,True
5748,validator_27,96713804070,True,161219000,977700,162196700,False
5749,validator_44,97065373770,True,261906000,686400,262592400,False
5750,validator_43,64743983700,True,167440000,2827450,170267450,False
5751,validator_26,32345012480,True,198357000,618300,198975300,False
5752,validator_36,97411913930,True,101218000,1055400,102273400,False
5753,validator_26,32494280620,True,147830000,1438140,149268140,False
5754,validator_41,64954725870,True,121934000,22305200,144239200,False
5755,validator_49,64727149190,True,100397000,25628600,126025600,False
5756,validator_18,97004448446,True,122436002,7525700,129961702,True
5757,validator_0,32938030183,True,110331000,918430,111249430,True
5758,validator_46,96889446780,True,108104000,679930,108783930,False
5759,validator_34,257629257940,True,152035000,8200390,160235390,False
5760,validator_46,97013679180,True,105514000,18718400,124232400,False
5761,validator_11,32878903716,True,294338001,1703100,296041101,True
5762,validator_31,161327947260,True,109130000,1846500,110976500,False
5763,validator_27,96796994210,True,64678000,18512140,83190140,False
5764,validator_33,32579749000,True,90565000,19520300,110085300,False
5765,validator_12,97091785215,True,241528002,18547700,260075702,True
5766,validator_37,64600973440,True,43098000,333820,43431820,False
5767,validator_33,32736236530,True,155593000,894530,156487530,False
5768,validator_9,32776054456,True,123901999,1464640,125366639,True
5769,validator_23,32649035599,True,132778003,19247070,152025073,True
5770,validator_29,32315766960,True,161425000,1332340,162757340,False
5771,validator_47,64468972890,True,162714000,2209000,164923000,False
5772,validator_13,32320700696,True,106120002,1032900,107152902,True
5773,validator_6,32498795939,True,123485003,751800,124236803,True
5774,validator_36,97489089210,True,75171000,2004280,77175280,False
5775,validator_43,64877166800,True,131346000,1837100,133183100,False
5776,validator_2,32832184910,True,254111997,1630200,255742197,True
5777,validator_17,160799602584,True,54906996,7975640,62882636,True
5778,validator_6,32581423135,True,81580996,1046200,82627196,True
5779,validator_19,64966318767,True,176318004,1276200,177594204,True
5780,validator_15,256900145237,True,166537002,16408290,182945292,True
5781,validator_33,32828844930,True,91370000,1238400,92608400,False
5782,validator_37,64777415240,True,157826000,18615800,176441800,False
5783,validator_23,32748534299,True,81466000,18032700,99498700,True
5784,validator_11,33001038318,True,121187002,947600,122134602,True
5785,validator_46,97143660180,True,128994000,987000,129981000,False
5786,validator_3,32597186423,True,71834994,2087700,73922694,True
5787,validator_40,32367020390,True,148603000,2462900,151065900,False
5788,validator_6,32681899736,True,98940001,1536600,100476601,True
5789,validator_41,65088716370,True,115225000,18765500,133990500,False
5790,validator_41,65241621900,True,150384000,2521530,152905530,False
5791,validator_42,32822299380,True,211688000,1098220,212786220,False
5792,validator_9,32850448982,True,73095996,1298530,74394526,True
5793,validator_5,64878900256,True,51628003,765900,52393903,True
5794,validator_14,96366982465,True,69592001,2537200,72129201,True
5795,validator_5,64985494558,True,105555002,1039300,106594302,True
5796,validator_31,161466898860,True,119254000,19697600,138951600,False
5797,validator_22,64921562836,True,110086997,466060,110553057,True
5798,validator_13,32451951499,True,128819003,2431800,131250803,True
5799,validator_38,32803161680,True,157910000,1048440,158958440,False
5800,validator_15,257054090738,True,145912001,8033500,153945501,True
5801,validator_17,160871597846,True,71324002,671260,71995262,True
5802,validator_6,32830854835,True,130236999,18718100,148955099,True
5803,validator_6,32912860464,True,81447999,557630,82005629,True
5804,validator_46,97265200340,True,120277000,1263160,121540160,False
5805,validator_23,32986701078,True,234683999,3482780,238166779,True
5806,validator_6,33100953901,True,181360997,6732440,188093437,True
5807,validator_27,96916801510,True,118373000,1434300,119807300,False
5808,validator_4,32501348498,True,114878997,612480,115491477,True
5809,validator_17,161014496480,True,137932994,4965640,142898634,True
5810,validator_5,65080371457,True,92887999,1988900,94876899,True
5811,validator_11,33085477903,True,83301995,1137590,84439585,True
5812,validator_41,65344476400,True,83503000,19351500,102854500,False
5813,validator_12,97197020785,True,92185000,13050570,105235570,True
5814,validator_47,64573088690,True,103428000,687800,104115800,False
5815,validator_7,64787915961,True,142115001,561220,142676221,True
5816,validator_30,64423107900,True,53661000,8072580,61733580,False
5817,validator_26,32683087320,True,188492000,314700,188806700,False
5818,validator_48,160948037240,True,127078000,1211600,128289600,False
5819,validator_29,32425321630,True,108245000,1309670,109554670,False
5820,validator_6,33177865298,True,75477997,1433400,76911397,True
5821,validator_32,32846734890,True,153182000,1478000,154660000,False
5822,validator_32,32917850970,True,69630000,1486080,71116080,False
5823,validator_0,33046190113,True,89068000,19091930,108159930,True
5824,validator_34,257768543130,True,137289000,1996190,139285190,False
5825,validator_10,32601387070,True,166389002,1406340,167795342,True
5826,validator_15,257105727144,True,49490006,2146400,51636406,True
5827,validator_46,97407972360,True,138004000,4768020,142772020,False
5828,validator_43,64919310700,True,41343000,800900,42143900,False
5829,validator_26,32831488240,True,148215000,185920,148400920,False
5830,validator_18,97166077343,True,160421997,1206900,161628897,True
5831,validator_19,65135218465,True,160625998,8273700,168899698,True
5832,validator_22,65204875633,True,282162997,1149800,283312797,True
5833,validator_19,65281882043,True,145838998,824580,146663578,True
5834,validator_6,33229629914,True,49824996,1939620,51764616,True
5835,validator_32,32976848260,True,40394000,18603290,58997290,False
5836,validator_41,65387620640,True,42716000,428240,43144240,False
5837,validator_45,32376349340,True,198925000,3702300,202627300,False
5838,validator_5,65174953558,True,93799001,783100,94582101,True
5839,validator_49,64893259930,True,164370000,1740740,166110740,False
5840,validator_46,97574163950,True,164789000,1402590,166191590,False
5841,validator_36,97590891010,True,95789000,6012800,101801800,False
5842,validator_36,97741713370,True,150168000,654360,150822360,False
5843,validator_16,32933008906,True,57672998,601600,58274598,True
5844,validator_0,33178465711,True,128456998,3818600,132275598,True
5845,validator_37,64896087100,True,115882000,2789860,118671860,False
5846,validator_47,64672180290,True,81070000,18021600,99091600,False
5847,validator_47,64829961770,True,157288000,493480,157781480,False
5848,validator_16,33101460495,True,163014999,5436590,168451589,True
5849,validator_37,65104392200,True,189516000,18789100,208305100,False
5850,validator_17,161192991883,True,177517003,978400,178495403,True
5851,validator_29,32475684130,True,45069000,5293500,50362500,False
5852,validator_15,257352146315,True,244572001,1847170,246419171,True
5853,validator_40,32487301690,True,111963000,8318300,120281300,False
5854,validator_17,161289995526,True,90295003,6708640,97003643,True
5855,validator_14,96593913493,True,225743998,1187030,226931028,True
5856,validator_21,64235234399,True,233804999,1429400,235234399,True
5857,validator_17,161408789531,True,100274005,18520000,118794005,True
5858,validator_9,32933333465,True,82500003,384480,82884483,True
5859,validator_10,32708033170,True,87912000,18734100,106646100,True
5860,validator_25,32614112810,True,178535000,2574280,181109280,False
5861,validator_32,33085068000,True,106221000,1998740,108219740,False
5862,validator_17,161507270631,True,96537000,1944100,98481100,True
5863,validator_18,97289074440,True,122206997,790100,122997097,True
5864,validator_36,97833464110,True,90911000,839740,91750740,False
5865,validator_28,33558862900,True,176295000,8286500,184581500,False
5866,validator_49,64962321530,True,68437000,624600,69061600,False
5867,validator_22,65257218638,True,51942005,401000,52343005,True
5868,validator_46,97690724870,True,115701000,859920,116560920,False
5869,validator_25,32836646810,True,221778000,756000,222534000,False
5870,validator_23,33227412030,True,221028002,19682950,240710952,True
5871,validator_39,33327169720,True,152770000,1278300,154048300,False
5872,validator_1,64358416225,True,87039998,1318600,88358598,True
5873,validator_16,33245202124,True,141363999,2377630,143741629,True
5874,validator_46,97813158570,True,102673000,19760700,122433700,False
5875,validator_2,32913315151,True,79922001,1208240,81130241,True
5876,validator_15,257413949985,True,60573000,1230670,61803670,True
5877,validator_37,65265136800,True,159611000,1133600,160744600,False
5878,validator_48,161025204740,True,75541000,1626500,77167500,False
5879,validator_48,161139311340,True,113196000,910600,114106600,False
5880,validator_7,64864872441,True,76354000,602480,76956480,True
5881,validator_35,96948714260,True,156980000,555400,157535400,False
5882,validator_21,64347529716,True,110172997,2122320,112295317,True
5883,validator_22,65370821380,True,111247002,2355740,113602742,True
5884,validator_48,161302127010,True,160084000,2731670,162815670,False
5885,validator_14,96683569496,True,88896003,760000,89656003,True
5886,validator_5,65311961161,True,133510003,3497600,137007603,True
5887,validator_34,257840642250,True,70386000,1713120,72099120,False
5888,validator_17,161653469728,True,143632997,2566100,146199097,True
5889,validator_25,32940714920,True,100334000,3734110,104068110,False
5890,validator_18,97404382845,True,114553005,755400,115308405,True
5891,validator_5,65463423158,True,149526997,1935000,151461997,True
5892,validator_45,32435849840,True,59120000,380500,59500500,False
5893,validator_7,64900366644,True,34652003,842200,35494203,True
5894,validator_32,33129148320,True,42933000,1147320,44080320,False
5895,validator_37,65319501400,True,53767000,597600,54364600,False
5896,validator_7,65018523092,True,115438008,2718440,118156448,True
5897,validator_28,33655272400,True,92927000,3482500,96409500,False
5898,validator_31,161682447760,True,213666000,1882900,215548900,False
5899,validator_11,33210831948,True,123849005,1505040,125354045,True
5900,validator_21,64419834117,True,53992001,18312400,72304401,True
5901,validator_41,65455295430,True,57534000,10140790,67674790,False
5902,validator_24,32580582825,True,101625006,2026600,103651606,True
5903,validator_27,97041700730,True,123850000,1049220,124899220,False
5904,validator_21,64585487556,True,163687999,1965440,165653439,True
5905,validator_14,96826399392,True,139660996,3168900,142829896,True
5906,validator_6,33307742414,True,69237000,8875500,78112500,True
5907,validator_23,33313293029,True,66338999,19542000,85880999,True
5908,validator_1,64483245661,True,124202006,627430,124829436,True
5909,validator_48,161444077710,True,141298000,652700,141950700,False
5910,validator_36,97963306410,True,129193000,649300,129842300,False
5911,validator_17,161952754218,True,244643000,54641490,299284490,True
5912,validator_15,257566565586,True,134517001,18098600,152615601,True
5913,validator_23,33385831860,True,70466001,2072830,72538831,True
5914,validator_45,32487283840,True,49998000,1436000,51434000,False
5915,validator_18,97463249220,True,56707995,2158380,58866375,True
5916,validator_3,32716219822,True,118448999,584400,119033399,True
5917,validator_18,97642126812,True,174291002,4586590,178877592,True
5918,validator_29,32524725750,True,48626000,415620,49041620,False
5919,validator_16,33386656527,True,139250003,2204400,141454403,True
5920,validator_47,64961802130,True,130967000,873360,131840360,False
5921,validator_15,257628622685,True,61558999,498100,62057099,True
5922,validator_18,97763246413,True,102390001,18729600,121119601,True
5923,validator_10,32873552911,True,153501001,12018740,165519741,True
5924,validator_38,32872663510,True,68731000,770830,69501830,False
5925,validator_2,33084272151,True,170068000,889000,170957000,True
5926,validator_44,97203467570,True,128472000,9621800,138093800,False
5927,validator_1,64690699802,True,206137001,1317140,207454141,True
5928,validator_31,161920173560,True,236416000,1309800,237725800,False
5929,validator_14,96974370974,True,147203002,768580,147971582,True
5930,validator_18,97942064380,True,178669997,147970,178817967,True
5931,validator_8,32566551557,True,90086999,8336600,98423599,True
5932,validator_14,97065406874,True,89382000,1653900,91035900,True
5933,validator_48,161562733510,True,116312000,2343800,118655800,False
5934,validator_33,32998661450,True,168531000,1285520,169816520,False
5935,validator_30,64562190800,True,136406000,2676900,139082900,False
5936,validator_45,32568727530,True,80016000,1427690,81443690,False
5937,validator_10,33057757712,True,183547001,657800,184204801,True
5938,validator_48,161681187110,True,117193000,1260600,118453600,False
5939,validator_3,32841639702,True,120065000,5354880,125419880,True
5940,validator_40,32620867810,True,128141000,5425120,133566120,False
5941,validator_42,32898443460,True,74969000,1175080,76144080,False
5942,validator_13,32571135699,True,116783000,2401200,119184200,True
5943,validator_17,162069107651,True,114926003,1427430,116353433,True
5944,validator_34,257960807890,True,119595000,570640,120165640,False
5945,validator_10,33140661653,True,75143001,7760940,82903941,True
5946,validator_49,65091360430,True,128294000,744900,129038900,False
5947,validator_11,33285343392,True,73443004,1068440,74511444,True
5948,validator_4,32656732599,True,146724001,8660100,155384101,True
5949,validator_41,65608243950,True,151631000,1317520,152948520,False
5950,validator_17,162284683948,True,214977997,598300,215576297,True
5951,validator_14,97209443204,True,142006000,2030330,144036330,True
5952,validator_22,65493489310,True,121872000,795930,122667930,True
5953,validator_41,65680141150,True,70676000,1221200,71897200,False
5954,validator_10,33306182654,True,159803001,5718000,165521001,True
5955,validator_49,65227227230,True,129594000,6272800,135866800,False
5956,validator_47,65074518910,True,111872000,844780,112716780,False
5957,validator_17,162414625140,True,127416002,2525190,129941192,True
5958,validator_6,33398253556,True,89920002,591140,90511142,True
5959,validator_0,33290014342,True,110692001,856630,111548631,True
5960,validator_2,33296146181,True,211699000,175030,211874030,True
5961,validator_49,65311197430,True,73877000,10093200,83970200,False
5962,validator_46,97911285990,True,96929000,1198420,98127420,False
5963,validator_27,97195588770,True,153404000,484040,153888040,False
5964,validator_47,65181017130,True,105463000,1035220,106498220,False
5965,validator_44,97392151370,True,188454000,229800,188683800,False
5966,validator_20,33079917050,True,87186004,2479670,89665674,True
5967,validator_27,97298383900,True,101290000,1505130,102795130,False
5968,validator_46,98099388190,True,186324000,1778200,188102200,False
5969,validator_29,32648192150,True,114613000,8853400,123466400,False
5970,validator_6,33430063156,True,31605000,204600,31809600,True
5971,validator_44,97653287370,True,260486000,650000,261136000,False
5972,validator_22,65629090909,True,134654999,946600,135601599,True
5973,validator_8,32700820648,True,127278001,6991090,134269091,True
5974,validator_47,65328953610,True,146851000,1085480,147936480,False
5975,validator_41,66031923500,True,350411000,1371350,351782350,False
5976,validator_29,32752406080,True,102183000,2030930,104213930,False
5977,validator_29,32888131450,True,134163000,1562370,135725370,False
5978,validator_2,33455703272,True,158114001,1443090,159557091,True
5979,validator_22,65725266135,True,95137006,1038220,96175226,True
5980,validator_29,33021604350,True,132483000,989900,133472900,False
5981,validator_14,97333556244,True,119000000,5113040,124113040,True
5982,validator_22,65785460040,True,57102005,3091900,60193905,True
5983,validator_13,32627299827,True,55677998,486130,56164128,True
5984,validator_10,33417070944,True,109574000,1314290,110888290,True
5985,validator_33,33140593290,True,129675000,12256840,141931840,False
5986,validator_19,65355032443,True,72808000,342400,73150400,True
5987,validator_35,97048034060,True,99063000,256800,99319800,False
5988,validator_22,66095421817,True,309784997,176780,309961777,True
5989,validator_41,66201563060,True,167477000,2162560,169639560,False
5990,validator_42,33019266990,True,116446000,4377530,120823530,False
5991,validator_25,33075443920,True,132346000,2383000,134729000,False
5992,validator_38,32944768280,True,71828000,276770,72104770,False
5993,validator_10,33560856048,True,141650004,2135100,143785104,True
5994,validator_0,33402231670,True,111416998,800330,112217328,True
5995,validator_23,33554855161,True,168725001,298300,169023301,True
5996,validator_40,32784986010,True,162372000,1746200,164118200,False
5997,validator_33,33244760430,True,102932000,1235140,104167140,False
5998,validator_39,33474241020,True,144928000,2143300,147071300,False
5999,validator_31,162186425580,True,264543000,1709020,266252020,False
6000,validator_18,96128910041,True,127529001,1381040,128910041,True
6001,validator_19,64121972386,True,121044996,927390,121972386,True
6002,validator_14,96141416901,True,115480001,25936900,141416901,True
6003,validator_15,256141618599,True,136370999,5247600,141618599,True
6004,validator_15,256287555151,True,145426002,510550,145936552,True
6005,validator_37,64134756300,True,132912000,1844300,134756300,False
6006,validator_48,160130734230,True,129421000,1313230,130734230,False
6007,validator_27,96074262300,True,71916000,2346300,74262300,False
6008,validator_41,64092899300,True,92498000,401300,92899300,False
6009,validator_15,256346569851,True,57338000,1676700,59014700,True
6010,validator_44,96089216800,True,88784000,432800,89216800,False
6011,validator_0,32166798502,True,158512002,8286500,166798502,True
6012,validator_45,32066929240,True,51134000,15795240,66929240,False
6013,validator_12,96178003233,True,173936003,4067230,178003233,True
6014,validator_37,64289859800,True,150236000,4867500,155103500,False
6015,validator_28,32142861200,True,140550000,2311200,142861200,False
6016,validator_27,96173979300,True,99103000,614000,99717000,False
6017,validator_28,32277097570,True,124692000,9544370,134236370,False
6018,validator_18,96211224075,True,81152004,1162030,82314034,True
6019,validator_15,256475164644,True,127882003,712790,128594793,True
6020,validator_31,160186818800,True,184681000,2137800,186818800,False
6021,validator_20,32137200877,True,136528997,671880,137200877,True
6022,validator_42,32184220940,True,163425000,20795940,184220940,False
6023,validator_23,32048351101,True,46948001,1403100,48351101,True
6024,validator_36,96087197990,True,85951000,1246990,87197990,False
6025,validator_6,32165096922,True,162449002,2647920,165096922,True
6026,validator_47,64136954900,True,136151000,803900,136954900,False
6027,validator_37,64342353000,True,46328000,6165200,52493200,False
6028,validator_27,96224585040,True,48765000,1840740,50605740,False
6029,validator_39,32044610220,True,43986000,624220,44610220,False
6030,validator_36,96221380130,True,132162000,2020140,134182140,False
6031,validator_18,96416850459,True,185696994,19929390,205626384,True
6032,validator_27,96385356870,True,159285000,1486830,160771830,False
6033,validator_47,64193728790,True,55553000,1220890,56773890,False
6034,validator_2,32136653101,True,134777001,1876100,136653101,True
6035,validator_38,32120147900,True,119785000,362900,120147900,False
6036,validator_48,160239637120,True,106882000,2020890,108902890,False
6037,validator_12,96347652829,True,168941996,707600,169649596,True
6038,validator_19,64234298906,True,107184000,5142520,112326520,True
6039,validator_44,96194591400,True,103532000,1842600,105374600,False
6040,validator_32,32148836630,True,140968000,7868630,148836630,False
6041,validator_20,32299507959,True,161193002,1114080,162307082,True
6042,validator_43,64032058100,True,31669000,389100,32058100,False
6043,validator_28,32381891170,True,81785000,23008600,104793600,False
6044,validator_22,64215305253,True,213734993,1570260,215305253,True
6045,validator_28,32551174670,True,168407000,876500,169283500,False
6046,validator_39,32083066290,True,37262000,1194070,38456070,False
6047,validator_38,32227098200,True,103891000,3059300,106950300,False
6048,validator_31,160394972800,True,207106000,1048000,208154000,False
6049,validator_34,256155416780,True,154271000,1145780,155416780,False
6050,validator_48,160346736360,True,106352000,747240,107099240,False
6051,validator_43,64081998010,True,48666000,1273910,49939910,False
6052,validator_27,96429360270,True,41506000,2497400,44003400,False
6053,validator_44,96308650600,True,111945000,2114200,114059200,False
6054,validator_25,32048004200,True,47488000,516200,48004200,False
6055,validator_3,32177654734,True,164511994,13142740,177654734,True
6056,validator_20,32446068057,True,145210998,1349100,146560098,True
6057,validator_29,32068527600,True,62760000,5767600,68527600,False
6058,validator_39,32225495690,True,137093000,5336400,142429400,False
6059,validator_46,96179682500,True,161210000,18472500,179682500,False
6060,validator_39,32350872690,True,124204000,1173000,125377000,False
6061,validator_20,32587875456,True,140073999,1733400,141807399,True
6062,validator_5,64144231751,True,142787001,1444750,144231751,True
6063,validator_34,256293439080,True,137160000,862300,138022300,False
6064,validator_29,32099421390,True,28545000,2348790,30893790,False
6065,validator_36,96325356530,True,95681000,8295400,103976400,False
6066,validator_49,64121726040,True,120519000,1207040,121726040,False
6067,validator_32,32352697530,True,200855000,3005900,203860900,False
6068,validator_38,32407906500,True,179397000,1411300,180808300,False
6069,validator_23,32112208124,True,45287003,18570020,63857023,True
6070,validator_22,64280484957,True,59597004,5582700,65179704,True
6071,validator_34,256390068180,True,87589000,9040100,96629100,False
6072,validator_17,160073329996,True,71764996,1565000,73329996,True
6073,validator_11,32164955798,True,164013998,941800,164955798,True
6074,validator_28,32694728700,True,136012000,7542030,143554030,False
6075,validator_49,64223087490,True,100628000,733450,101361450,False
6076,validator_17,160134268499,True,59856003,1082500,60938503,True
6077,validator_28,32825449500,True,128699000,2021800,130720800,False
6078,validator_31,160496000800,True,99890000,1138000,101028000,False
6079,validator_12,96431421869,True,74305000,9464040,83769040,True
6080,validator_10,32161665297,True,143396997,18268300,161665297,True
6081,validator_19,64484381908,True,249637002,446000,250083002,True
6082,validator_28,32868681300,True,42723000,508800,43231800,False
6083,validator_17,160361751901,True,225882002,1601400,227483402,True
6084,validator_26,32082845400,True,81714000,1131400,82845400,False
6085,validator_35,96100070520,True,98490000,1580520,100070520,False
6086,validator_7,64110915329,True,109936999,978330,110915329,True
6087,validator_3,32345528226,True,148964992,18908500,167873492,True
6088,validator_0,32282506706,True,115093004,615200,115708204,True
6089,validator_42,32361284940,True,156906000,20158000,177064000,False
6090,validator_1,64135003324,True,134203004,800320,135003324,True
6091,validator_2,32296169813,True,158083992,1432720,159516712,True
6092,validator_8,32119015299,True,113195999,5819300,119015299,True
6093,validator_48,160488354060,True,141093000,524700,141617700,False
6094,validator_3,32523263729,True,174638003,3097500,177735503,True
6095,validator_40,32108059390,True,106575000,1484390,108059390,False
6096,validator_30,64127873920,True,126028000,1845920,127873920,False
6097,validator_5,64474020673,True,328360002,1428920,329788922,True
6098,validator_41,64221020120,True,126346000,1774820,128120820,False
6099,validator_9,32177522740,True,158702000,18820740,177522740,True
6100,validator_13,32120192597,True,118679997,1512600,120192597,True
6101,validator_36,96432950770,True,105120000,2474240,107594240,False
6102,validator_39,32426336690,True,67869000,7595000,75464000,False
6103,validator_7,64325423626,True,211829997,2678300,214508297,True
6104,validator_43,64313097790,True,225549000,5550780,231099780,False
6105,validator_0,32506071148,True,221110992,2453450,223564442,True
6106,validator_18,96505554303,True,88038004,665840,88703844,True
6107,validator_18,96733595543,True,226920000,1121240,228041240,True
6108,validator_34,256530373880,True,129535000,10770700,140305700,False
6109,validator_5,64555139912,True,71218999,9900240,81119239,True
6110,validator_28,33013759600,True,144766000,312300,145078300,False
6111,validator_28,33172508060,True,157678000,1070460,158748460,False
6112,validator_46,96257515800,True,76585000,1248300,77833300,False
6113,validator_33,32114812400,True,95698000,19114400,114812400,False
6114,validator_25,32149736700,True,96300000,5432500,101732500,False
6115,validator_0,32669977720,True,149220992,14685580,163906572,True
6116,validator_16,32142680602,True,141703002,977600,142680602,True
6117,validator_39,32598381620,True,171842000,202930,172044930,False
6118,validator_48,160647790500,True,158883000,553440,159436440,False
6119,validator_31,160563661300,True,66199000,1461500,67660500,False
6120,validator_36,96632384370,True,198068000,1365600,199433600,False
6121,validator_38,32534942040,True,125195000,1840540,127035540,False
6122,validator_22,64386749756,True,100228999,6035800,106264799,True
6123,validator_17,160492093293,True,106546002,23795390,130341392,True
6124,validator_7,64446981758,True,121077002,481130,121558132,True
6125,validator_34,256611162880,True,79422000,1367000,80789000,False
6126,validator_20,32762368796,True,173920000,573340,174493340,True
6127,validator_36,96798837370,True,129685000,36768000,166453000,False
6128,validator_46,96330330540,True,72584000,230740,72814740,False
6129,validator_24,32130560795,True,125350005,5210790,130560795,True
6130,validator_48,160773219860,True,125053000,376360,125429360,False
6131,validator_15,256631189043,True,155382999,641400,156024399,True
6132,validator_9,32346652438,True,167749998,1379700,169129698,True
6133,validator_12,96568407008,True,136114999,870140,136985139,True
6134,validator_19,64543097209,True,58242001,473300,58715301,True
6135,validator_9,32522859939,True,172811001,3396500,176207501,True
6136,validator_20,32850897696,True,87476000,1052900,88528900,True
6137,validator_36,96848543670,True,49040000,666300,49706300,False
6138,validator_35,96207351420,True,98517000,8763900,107280900,False
6139,validator_16,32382868179,True,238771997,1415580,240187577,True
6140,validator_39,32792947820,True,193720000,846200,194566200,False
6141,validator_44,96427989940,True,118906000,433340,119339340,False
6142,validator_35,96307325720,True,98931000,1043300,99974300,False
6143,validator_26,32146037180,True,62800000,391780,63191780,False
6144,validator_34,256722364080,True,110510000,691200,111201200,False
6145,validator_14,96250923004,True,101537003,7969100,109506103,True
6146,validator_31,160762691080,True,194089000,4940780,199029780,False
6147,validator_37,64489107200,True,144263000,2491200,146754200,False
6148,validator_44,96566635320,True,136232000,2413380,138645380,False
6149,validator_1,64270057627,True,133443003,1611300,135054303,True
6150,validator_13,32213547794,True,86255997,7099200,93355197,True
6151,validator_5,64662410311,True,104073999,3196400,107270399,True
6152,validator_0,32826780753,True,156411003,392030,156803033,True
6153,validator_46,96542265480,True,205934000,6000940,211934940,False
6154,validator_14,96294853264,True,43218000,712260,43930260,True
6155,validator_4,32212748920,True,211209000,1539920,212748920,True
6156,validator_34,256844241980,True,121487000,390900,121877900,False
6157,validator_8,32161710001,True,42288002,406700,42694702,True
6158,validator_34,256949413080,True,105072000,99100,105171100,False
6159,validator_41,64340885340,True,118939000,926220,119865220,False
6160,validator_37,64557541620,True,68225000,209420,68434420,False
6161,validator_12,96655349234,True,84398996,2543230,86942226,True
6162,validator_34,257133807480,True,184147000,247400,184394400,False
6163,validator_5,64826506353,True,163213002,883040,164096042,True
6164,validator_30,64225437420,True,93026000,4537500,97563500,False
6165,validator_49,64302827890,True,77572000,2168400,79740400,False
6166,validator_31,160886554920,True,123396000,467840,123863840,False
6167,validator_23,32257816394,True,144538000,1070270,145608270,True
6168,validator_45,32173722040,True,105308000,1484800,106792800,False
6169,validator_22,64496000851,True,101102995,8148100,109251095,True
6170,validator_17,160548375614,True,55838001,444320,56282321,True
6171,validator_42,32512134320,True,142992000,7857380,150849380,False
6172,validator_39,32905967020,True,111636000,1383200,113019200,False
6173,validator_7,64573084198,True,108073000,18029440,126102440,True
6174,validator_31,160980488360,True,75515000,18418440,93933440,False
6175,validator_46,96605205610,True,60860000,2080130,62940130,False
6176,validator_17,160604291114,True,47560000,8355500,55915500,True
6177,validator_16,32586240679,True,201479000,1893500,203372500,True
6178,validator_32,32521044330,True,167166000,1180800,168346800,False
6179,validator_47,64304049890,True,108792000,1529100,110321100,False
6180,validator_35,96408281220,True,99937000,1018500,100955500,False
6181,validator_44,96702937100,True,117849000,18452780,136301780,False
6182,validator_19,64644264134,True,100572995,593930,101166925,True
6183,validator_6,32244331720,True,56799998,22434800,79234798,True
6184,validator_43,64407853330,True,93156000,1599540,94755540,False
6185,validator_12,96831709513,True,175849999,510280,176360279,True
6186,validator_2,32392940210,True,96344997,425400,96770397,True
6187,validator_41,64449786840,True,107402000,1499500,108901500,False
6188,validator_34,257241088380,True,88866000,18414900,107280900,False
6189,validator_10,32223516697,True,60185000,1666400,61851400,True
6190,validator_36,96922159950,True,72149000,1467280,73616280,False
6191,validator_41,64720855870,True,270404000,665030,271069030,False
6192,validator_43,64573716250,True,147660000,18202920,165862920,False
6193,validator_41,64810486670,True,89049000,581800,89630800,False
6194,validator_11,32277619602,True,93945004,18718800,112663804,True
6195,validator_49,64472770790,True,168498000,1444900,169942900,False
6196,validator_36,97124393630,True,193975000,8258680,202233680,False
6197,validator_39,33025239020,True,110182000,9090000,119272000,False
6198,validator_2,32576442713,True,177101003,6401500,183502503,True
6199,validator_30,64361374320,True,133949000,1987900,135936900,False
6200,validator_24,32271110392,True,138362997,2186600,140549597,True
6201,validator_16,32780396887,True,174466008,19690200,194156208,True
6202,validator_44,96802781370,True,99111000,733270,99844270,False
6203,validator_38,32644203240,True,83317000,25944200,109261200,False
6204,validator_27,96551607370,True,120649000,1598100,122247100,False
6205,validator_8,32326233297,True,162982996,1540300,164523296,True
6206,validator_29,32153009620,True,53002000,586230,53588230,False
6207,validator_10,32433591728,True,207036001,3039030,210075031,True
6208,validator_35,96476024220,True,59198000,8545000,67743000,False
6209,validator_11,32377145222,True,97874000,1651620,99525620,True
6210,validator_39,33173121420,True,146179000,1703400,147882400,False
6211,validator_28,33374281400,True,199040000,2733340,201773340,False
6212,validator_17,160736719948,True,131660004,768830,132428834,True
6213,validator_25,32265319300,True,96908000,18674600,115582600,False
6214,validator_48,160819747640,True,44964000,1563780,46527780,False
6215,validator_15,256717199945,True,85057002,953900,86010902,True
6216,validator_33,32359068700,True,242780000,1476300,244256300,False
6217,validator_46,96780662850,True,173674000,1783240,175457240,False
6218,validator_22,64602373830,True,105164999,1207980,106372979,True
6219,validator_49,64601123590,True,127770000,582800,128352800,False
6220,validator_24,32476931219,True,204132997,1687830,205820827,True
6221,validator_22,64713831782,True,109834992,1622960,111457952,True
6222,validator_33,32469663700,True,100989000,9606000,110595000,False
6223,validator_6,32374559136,True,128273996,1953420,130227416,True
6224,validator_40,32215954490,True,107657000,238100,107895100,False
6225,validator_35,96558518620,True,81797000,697400,82494400,False
6226,validator_34,257343967880,True,102056000,823500,102879500,False
6227,validator_31,161059846060,True,78260000,1097700,79357700,False
6228,validator_11,32503226319,True,95849997,30231100,126081097,True
6229,validator_42,32609513160,True,96901000,477840,97378840,False
6230,validator_19,64788724563,True,144161999,298430,144460429,True
6231,validator_7,64645239740,True,71975002,180540,72155542,True
6232,validator_9,32650687817,True,126607998,1219880,127827878,True
6233,validator_20,32990251376,True,133634000,5719680,139353680,True
6234,validator_8,32468127958,True,139238001,2656660,141894661,True
6235,validator_32,32692074890,True,170155000,875560,171030560,False
6236,validator_25,32433003530,True,166175000,1509230,167684230,False
6237,validator_16,32874734308,True,93933001,404420,94337421,True
6238,validator_18,96874486744,True,123054001,17837200,140891201,True
6239,validator_22,64811009779,True,88085997,9092000,97177997,True
6240,validator_36,97309640530,True,184461000,785900,185246900,False
6241,validator_34,257469022550,True,117563000,7491670,125054670,False
6242,validator_35,96614271160,True,47821000,7931540,55752540,False
6243,validator_35,96791178860,True,175438000,1469700,176907700,False
6244,validator_23,32497010526,True,216234002,22960130,239194132,True
6245,validator_4,32385857021,True,172050001,1058100,173108101,True
6246,validator_31,161216970760,True,156209000,915700,157124700,False
6247,validator_11,32582862615,True,77752996,1883300,79636296,True
6248,validator_27,96713804070,True,161219000,977700,162196700,False
6249,validator_44,97065373770,True,261906000,686400,262592400,False
6250,validator_43,64743983700,True,167440000,2827450,170267450,False
6251,validator_26,32345012480,True,198357000,618300,198975300,False
6252,validator_36,97411913930,True,101218000,1055400,102273400,False
6253,validator_26,32494280620,True,147830000,1438140,149268140,False
6254,validator_41,64954725870,True,121934000,22305200,144239200,False
6255,validator_49,64727149190,True,100397000,25628600,126025600,False
6256,validator_18,97004448446,True,122436002,7525700,129961702,True
6257,validator_0,32938030183,True,110331000,918430,111249430,True
6258,validator_46,96889446780,True,108104000,679930,108783930,False
6259,validator_34,257629257940,True,152035000,8200390,160235390,False
6260,validator_46,97013679180,True,105514000,18718400,124232400,False
6261,validator_11,32878903716,True,294338001,1703100,296041101,True
6262,validator_31,161327947260,True,109130000,1846500,110976500,False
6263,validator_27,96796994210,True,64678000,18512140,83190140,False
6264,validator_33,32579749000,True,90565000,19520300,110085300,False
6265,validator_12,97091785215,True,241528002,18547700,260075702,True
6266,validator_37,64600973440,True,43098000,333820,43431820,False
6267,validator_33,32736236530,True,155593000,894530,156487530,False
6268,validator_9,32776054456,True,123901999,1464640,125366639,True
6269,validator_23,32649035599,True,132778003,19247070,152025073,True
6270,validator_29,32315766960,True,161425000,1332340,162757340,False
6271,validator_47,64468972890,True,162714000,2209000,164923000,False
6272,validator_13,32320700696,True,106120002,1032900,107152902,True
6273,validator_6,32498795939,True,123485003,751800,124236803,True
6274,validator_36,97489089210,True,75171000,2004280,77175280,False
6275,validator_43,64877166800,True,131346000,1837100,133183100,False
6276,validator_2,32832184910,True,254111997,1630200,255742197,True
6277,validator_17,160799602584,True,54906996,7975640,62882636,True
6278,validator_6,32581423135,True,81580996,1046200,82627196,True
6279,validator_19,64966318767,True,176318004,1276200,177594204,True
6280,validator_15,256900145237,True,166537002,16408290,182945292,True
6281,validator_33,32828844930,True,91370000,1238400,92608400,False
6282,validator_37,64777415240,True,157826000,18615800,176441800,False
6283,validator_23,32748534299,True,81466000,18032700,99498700,True
6284,validator_11,33001038318,True,121187002,947600,122134602,True
6285,validator_46,97143660180,True,128994000,987000,129981000,False
6286,validator_3,32597186423,True,71834994,2087700,73922694,True
6287,validator_40,32367020390,True,148603000,2462900,151065900,False
6288,validator_6,32681899736,True,98940001,1536600,100476601,True
6289,validator_41,65088716370,True,115225000,18765500,133990500,False
6290,validator_41,65241621900,True,150384000,2521530,152905530,False
6291,validator_42,32822299380,True,211688000,1098220,212786220,False
6292,validator_9,32850448982,True,73095996,1298530,74394526,True
6293,validator_5,64878900256,True,51628003,765900,52393903,True
6294,validator_14,96366982465,True,69592001,2537200,72129201,True
6295,validator_5,64985494558,True,105555002,1039300,106594302,True
6296,validator_31,161466898860,True,119254000,19697600,138951600,False
6297,validator_22,64921562836,True,110086997,466060,110553057,True
6298,validator_13,32451951499,True,128819003,2431800,131250803,True
6299,validator_38,32803161680,True,157910000,1048440,158958440,False
6300,validator_15,257054090738,True,145912001,8033500,153945501,True
6301,validator_17,160871597846,True,71324002,671260,71995262,True
6302,validator_6,32830854835,True,130236999,18718100,148955099,True
6303,validator_6,32912860464,True,81447999,557630,82005629,True
6304,validator_46,97265200340,True,120277000,1263160,121540160,False
6305,validator_23,32986701078,True,234683999,3482780,238166779,True
6306,validator_6,33100953901,True,181360997,6732440,188093437,True
6307,validator_27,96916801510,True,118373000,1434300,119807300,False
6308,validator_4,32501348498,True,114878997,612480,115491477,True
6309,validator_17,161014496480,True,137932994,4965640,142898634,True
6310,validator_5,65080371457,True,92887999,1988900,94876899,True
6311,validator_11,33085477903,True,83301995,1137590,84439585,True
6312,validator_41,65344476400,True,83503000,19351500,102854500,False
6313,validator_12,97197020785,True,92185000,13050570,105235570,True
6314,validator_47,64573088690,True,103428000,687800,104115800,False
6315,validator_7,64787915961,True,142115001,561220,142676221,True
6316,validator_30,64423107900,True,53661000,8072580,61733580,False
6317,validator_26,32683087320,True,188492000,314700,188806700,False
6318,validator_48,160948037240,True,127078000,1211600,128289600,False
6319,validator_29,32425321630,True,108245000,1309670,109554670,False
6320,validator_6,33177865298,True,75477997,1433400,76911397,True
6321,validator_32,32846734890,True,153182000,1478000,154660000,False
6322,validator_32,32917850970,True,69630000,1486080,71116080,False
6323,validator_0,33046190113,True,89068000,19091930,108159930,True
6324,validator_34,257768543130,True,137289000,1996190,139285190,False
6325,validator_10,32601387070,True,166389002,1406340,167795342,True
6326,validator_15,257105727144,True,49490006,2146400,51636406,True
6327,validator_46,97407972360,True,138004000,4768020,142772020,False
6328,validator_43,64919310700,True,41343000,800900,42143900,False
6329,validator_26,32831488240,True,148215000,185920,148400920,False
6330,validator_18,97166077343,True,160421997,1206900,161628897,True
6331,validator_19,65135218465,True,160625998,8273700,168899698,True
6332,validator_22,65204875633,True,282162997,1149800,283312797,True
6333,validator_19,65281882043,True,145838998,824580,146663578,True
6334,validator_6,33229629914,True,49824996,1939620,51764616,True
6335,validator_32,32976848260,True,40394000,18603290,58997290,False
6336,validator_41,65387620640,True,42716000,428240,43144240,False
6337,validator_45,32376349340,True,198925000,3702300,202627300,False
6338,validator_5,65174953558,True,93799001,783100,94582101,True
6339,validator_49,64893259930,True,164370000,1740740,166110740,False
6340,validator_46,97574163950,True,164789000,1402590,166191590,False
6341,validator_36,97590891010,True,95789000,6012800,101801800,False
6342,validator_36,97741713370,True,150168000,654360,150822360,False
6343,validator_16,32933008906,True,57672998,601600,58274598,True
6344,validator_0,33178465711,True,128456998,3818600,132275598,True
6345,validator_37,64896087100,True,115882000,2789860,118671860,False
6346,validator_47,64672180290,True,81070000,18021600,99091600,False
6347,validator_47,64829961770,True,157288000,493480,157781480,False
6348,validator_16,33101460495,True,163014999,5436590,168451589,True
6349,validator_37,65104392200,True,189516000,18789100,208305100,False
6350,validator_17,161192991883,True,177517003,978400,178495403,True
6351,validator_29,32475684130,True,45069000,5293500,50362500,False
6352,validator_15,257352146315,True,244572001,1847170,246419171,True
6353,validator_40,32487301690,True,111963000,8318300,120281300,False
6354,validator_17,161289995526,True,90295003,6708640,97003643,True
6355,validator_14,96593913493,True,225743998,1187030,226931028,True
6356,validator_21,64235234399,True,233804999,1429400,235234399,True
6357,validator_17,161408789531,True,100274005,18520000,118794005,True
6358,validator_9,32933333465,True,82500003,384480,82884483,True
6359,validator_10,32708033170,True,87912000,18734100,106646100,True
6360,validator_25,32614112810,True,178535000,2574280,181109280,False
6361,validator_32,33085068000,True,106221000,1998740,108219740,False
6362,validator_17,161507270631,True,96537000,1944100,98481100,True
6363,validator_18,97289074440,True,122206997,790100,122997097,True
6364,validator_36,97833464110,True,90911000,839740,91750740,False
6365,validator_28,33558862900,True,176295000,8286500,184581500,False
6366,validator_49,64962321530,True,68437000,624600,69061600,False
6367,validator_22,65257218638,True,51942005,401000,52343005,True
6368,validator_46,97690724870,True,115701000,859920,116560920,False
6369,validator_25,32836646810,True,221778000,756000,222534000,False
6370,validator_23,33227412030,True,221028002,19682950,240710952,True
6371,validator_39,33327169720,True,152770000,1278300,154048300,False
6372,validator_1,64358416225,True,87039998,1318600,88358598,True
6373,validator_16,33245202124,True,141363999,2377630,143741629,True
6374,validator_46,97813158570,True,102673000,19760700,122433700,False
6375,validator_2,32913315151,True,79922001,1208240,81130241,True
6376,validator_15,257413949985,True,60573000,1230670,61803670,True
6377,validator_37,65265136800,True,159611000,1133600,160744600,False
6378,validator_48,161025204740,True,75541000,1626500,77167500,False
6379,validator_48,161139311340,True,113196000,910600,114106600,False
6380,validator_7,64864872441,True,76354000,602480,76956480,True
6381,validator_35,96948714260,True,156980000,555400,157535400,False
6382,validator_21,64347529716,True,110172997,2122320,112295317,True
6383,validator_22,65370821380,True,111247002,2355740,113602742,True
6384,validator_48,161302127010,True,160084000,2731670,162815670,False
6385,validator_14,96683569496,True,88896003,760000,89656003,True
6386,validator_5,65311961161,True,133510003,3497600,137007603,True
6387,validator_34,257840642250,True,70386000,1713120,72099120,False
6388,validator_17,161653469728,True,143632997,2566100,146199097,True
6389,validator_25,32940714920,True,100334000,3734110,104068110,False
6390,validator_18,97404382845,True,114553005,755400,115308405,True
6391,validator_5,65463423158,True,149526997,1935000,151461997,True
6392,validator_45,32435849840,True,59120000,380500,59500500,False
6393,validator_7,64900366644,True,34652003,842200,35494203,True
6394,validator_32,33129148320,True,42933000,1147320,44080320,False
6395,validator_37,65319501400,True,53767000,597600,54364600,False
6396,validator_7,65018523092,True,115438008,2718440,118156448,True
6397,validator_28,33655272400,True,92927000,3482500,96409500,False
6398,validator_31,161682447760,True,213666000,1882900,215548900,False
6399,validator_11,33210831948,True,123849005,1505040,125354045,True
6400,validator_21,64419834117,True,53992001,18312400,72304401,True
6401,validator_41,65455295430,True,57534000,10140790,67674790,False
6402,validator_24,32580582825,True,101625006,2026600,103651606,True
6403,validator_27,97041700730,True,123850000,1049220,124899220,False
6404,validator_21,64585487556,True,163687999,1965440,165653439,True
6405,validator_14,96826399392,True,139660996,3168900,142829896,True
6406,validator_6,33307742414,True,69237000,8875500,78112500,True
6407,validator_23,33313293029,True,66338999,19542000,85880999,True
6408,validator_1,64483245661,True,124202006,627430,124829436,True
6409,validator_48,161444077710,True,141298000,652700,141950700,False
6410,validator_36,97963306410,True,129193000,649300,129842300,False
6411,validator_17,161952754218,True,244643000,54641490,299284490,True
6412,validator_15,257566565586,True,134517001,18098600,152615601,True
6413,validator_23,33385831860,True,70466001,2072830,72538831,True
6414,validator_45,32487283840,True,49998000,1436000,51434000,False
6415,validator_18,97463249220,True,56707995,2158380,58866375,True
6416,validator_3,32716219822,True,118448999,584400,119033399,True
6417,validator_18,97642126812,True,174291002,4586590,178877592,True
6418,validator_29,32524725750,True,48626000,415620,49041620,False
6419,validator_16,33386656527,True,139250003,2204400,141454403,True
6420,validator_47,64961802130,True,130967000,873360,131840360,False
6421,validator_15,257628622685,True,61558999,498100,62057099,True
6422,validator_18,97763246413,True,102390001,18729600,121119601,True
6423,validator_10,32873552911,True,153501001,12018740,165519741,True
6424,validator_38,32872663510,True,68731000,770830,69501830,False
6425,validator_2,33084272151,True,170068000,889000,170957000,True
6426,validator_44,97203467570,True,128472000,9621800,138093800,False
6427,validator_1,64690699802,True,206137001,1317140,207454141,True
6428,validator_31,161920173560,True,236416000,1309800,237725800,False
6429,validator_14,96974370974,True,147203002,768580,147971582,True
6430,validator_18,97942064380,True,178669997,147970,178817967,True
6431,validator_8,32566551557,True,90086999,8336600,98423599,True
6432,validator_14,97065406874,True,89382000,1653900,91035900,True
6433,validator_48,161562733510,True,116312000,2343800,118655800,False
6434,validator_33,32998661450,True,168531000,1285520,169816520,False
6435,validator_30,64562190800,True,136406000,2676900,139082900,False
6436,validator_45,32568727530,True,80016000,1427690,81443690,False
6437,validator_10,33057757712,True,183547001,657800,184204801,True
6438,validator_48,161681187110,True,117193000,1260600,118453600,False
6439,validator_3,32841639702,True,120065000,5354880,125419880,True
6440,validator_40,32620867810,True,128141000,5425120,133566120,False
6441,validator_42,32898443460,True,74969000,1175080,76144080,False
6442,validator_13,32571135699,True,116783000,2401200,119184200,True
6443,validator_17,162069107651,True,114926003,1427430,116353433,True
6444,validator_34,257960807890,True,119595000,570640,120165640,False
6445,validator_10,33140661653,True,75143001,7760940,82903941,True
6446,validator_49,65091360430,True,128294000,744900,129038900,False
6447,validator_11,33285343392,True,73443004,1068440,74511444,True
6448,validator_4,32656732599,True,146724001,8660100,155384101,True
6449,validator_41,65608243950,True,151631000,1317520,152948520,False
6450,validator_17,162284683948,True,214977997,598300,215576297,True
6451,validator_14,97209443204,True,142006000,2030330,144036330,True
6452,validator_22,65493489310,True,121872000,795930,122667930,True
6453,validator_41,65680141150,True,70676000,1221200,71897200,False
6454,validator_10,33306182654,True,159803001,5718000,165521001,True
6455,validator_49,65227227230,True,129594000,6272800,135866800,False
6456,validator_47,65074518910,True,111872000,844780,112716780,False
6457,validator_17,162414625140,True,127416002,2525190,129941192,True
6458,validator_6,33398253556,True,89920002,591140,90511142,True
6459,validator_0,33290014342,True,110692001,856630,111548631,True
6460,validator_2,33296146181,True,211699000,175030,211874030,True
6461,validator_49,65311197430,True,73877000,10093200,83970200,False
6462,validator_46,97911285990,True,96929000,1198420,98127420,False
6463,validator_27,97195588770,True,153404000,484040,153888040,False
6464,validator_47,65181017130,True,105463000,1035220,106498220,False
6465,validator_44,97392151370,True,188454000,229800,188683800,False
6466,validator_20,33079917050,True,87186004,2479670,89665674,True
6467,validator_27,97298383900,True,101290000,1505130,102795130,False
6468,validator_46,98099388190,True,186324000,1778200,188102200,False
6469,validator_29,32648192150,True,114613000,8853400,123466400,False
6470,validator_6,33430063156,True,31605000,204600,31809600,True
6471,validator_44,97653287370,True,260486000,650000,261136000,False
6472,validator_22,65629090909,True,134654999,946600,135601599,True
6473,validator_8,32700820648,True,127278001,6991090,134269091,True
6474,validator_47,65328953610,True,146851000,1085480,147936480,False
6475,validator_41,66031923500,True,350411000,1371350,351782350,False
6476,validator_29,32752406080,True,102183000,2030930,104213930,False
6477,validator_29,32888131450,True,134163000,1562370,135725370,False
6478,validator_2,33455703272,True,158114001,1443090,159557091,True
6479,validator_22,65725266135,True,95137006,1038220,96175226,True
6480,validator_29,33021604350,True,132483000,989900,133472900,False
6481,validator_14,97333556244,True,119000000,5113040,124113040,True
6482,validator_22,65785460040,True,57102005,3091900,60193905,True
6483,validator_13,32627299827,True,55677998,486130,56164128,True
6484,validator_10,33417070944,True,109574000,1314290,110888290,True
6485,validator_33,33140593290,True,129675000,12256840,141931840,False
6486,validator_19,65355032443,True,72808000,342400,73150400,True
6487,validator_35,97048034060,True,99063000,256800,99319800,False
6488,validator_22,66095421817,True,309784997,176780,309961777,True
6489,validator_41,66201563060,True,167477000,2162560,169639560,False
6490,validator_42,33019266990,True,116446000,4377530,120823530,False
6491,validator_25,33075443920,True,132346000,2383000,134729000,False
6492,validator_38,32944768280,True,71828000,276770,72104770,False
6493,validator_10,33560856048,True,141650004,2135100,143785104,True
6494,validator_0,33402231670,True,111416998,800330,112217328,True
6495,validator_23,33554855161,True,168725001,298300,169023301,True
6496,validator_40,32784986010,True,162372000,1746200,164118200,False
6497,validator_33,33244760430,True,102932000,1235140,104167140,False
6498,validator_39,33474241020,True,144928000,2143300,147071300,False
6499,validator_31,162186425580,True,264543000,1709020,266252020,False
6500,validator_18,96128910041,True,127529001,1381040,128910041,True
6501,validator_19,64121972386,True,121044996,927390,121972386,True
6502,validator_14,96141416901,True,115480001,25936900,141416901,True
6503,validator_15,256141618599,True,136370999,5247600,141618599,True
6504,validator_15,256287555151,True,145426002,510550,145936552,True
6505,validator_37,64134756300,True,132912000,1844300,134756300,False
6506,validator_48,160130734230,True,129421000,1313230,130734230,False
6507,validator_27,96074262300,True,71916000,2346300,74262300,False
6508,validator_41,64092899300,True,92498000,401300,92899300,False
6509,validator_15,256346569851,True,57338000,1676700,59014700,True
6510,validator_44,96089216800,True,88784000,432800,89216800,False
6511,validator_0,32166798502,True,158512002,8286500,166798502,True
6512,validator_45,32066929240,True,51134000,15795240,66929240,False
6513,validator_12,96178003233,True,173936003,4067230,178003233,True
6514,validator_37,64289859800,True,150236000,4867500,155103500,False
6515,validator_28,32142861200,True,140550000,2311200,142861200,False
6516,validator_27,96173979300,True,99103000,614000,99717000,False
6517,validator_28,32277097570,True,124692000,9544370,134236370,False
6518,validator_18,96211224075,True,81152004,1162030,82314034,True
6519,validator_15,256475164644,True,127882003,712790,128594793,True
6520,validator_31,160186818800,True,184681000,2137800,186818800,False
6521,validator_20,32137200877,True,136528997,671880,137200877,True
6522,validator_42,32184220940,True,163425000,20795940,184220940,False
6523,validator_23,32048351101,True,46948001,1403100,48351101,True
6524,validator_36,96087197990,True,85951000,1246990,87197990,False
6525,validator_6,32165096922,True,162449002,2647920,165096922,True
6526,validator_47,64136954900,True,136151000,803900,136954900,False
6527,validator_37,64342353000,True,46328000,6165200,52493200,False
6528,validator_27,96224585040,True,48765000,1840740,50605740,False
6529,validator_39,32044610220,True,43986000,624220,44610220,False
6530,validator_36,96221380130,True,132162000,2020140,134182140,False
6531,validator_18,96416850459,True,185696994,19929390,205626384,True
6532,validator_27,96385356870,True,159285000,1486830,160771830,False
6533,validator_47,64193728790,True,55553000,1220890,56773890,False
6534,validator_2,32136653101,True,134777001,1876100,136653101,True
6535,validator_38,32120147900,True,119785000,362900,120147900,False
6536,validator_48,160239637120,True,106882000,2020890,108902890,False
6537,validator_12,96347652829,True,168941996,707600,169649596,True
6538,validator_19,64234298906,True,107184000,5142520,112326520,True
6539,validator_44,96194591400,True,103532000,1842600,105374600,False
6540,validator_32,32148836630,True,140968000,7868630,148836630,False
6541,validator_20,32299507959,True,161193002,1114080,162307082,True
6542,validator_43,64032058100,True,31669000,389100,32058100,False
6543,validator_28,32381891170,True,81785000,23008600,104793600,False
6544,validator_22,64215305253,True,213734993,1570260,215305253,True
6545,validator_28,32551174670,True,168407000,876500,169283500,False
6546,validator_39,32083066290,True,37262000,1194070,38456070,False
6547,validator_38,32227098200,True,103891000,3059300,106950300,False
6548,validator_31,160394972800,True,207106000,1048000,208154000,False
6549,validator_34,256155416780,True,154271000,1145780,155416780,False
6550,validator_48,160346736360,True,106352000,747240,107099240,False
6551,validator_43,64081998010,True,48666000,1273910,49939910,False
6552,validator_27,96429360270,True,41506000,2497400,44003400,False
6553,validator_44,96308650600,True,111945000,2114200,114059200,False
6554,validator_25,32048004200,True,47488000,516200,48004200,False
6555,validator_3,32177654734,True,164511994,13142740,177654734,True
6556,validator_20,32446068057,True,145210998,1349100,146560098,True
6557,validator_29,32068527600,True,62760000,5767600,68527600,False
6558,validator_39,32225495690,True,137093000,5336400,142429400,False
6559,validator_46,96179682500,True,161210000,18472500,179682500,False
6560,validator_39,32350872690,True,124204000,1173000,125377000,False
6561,validator_20,32587875456,True,140073999,1733400,141807399,True
6562,validator_5,64144231751,True,142787001,1444750,144231751,True
6563,validator_34,256293439080,True,137160000,862300,138022300,False
6564,validator_29,32099421390,True,28545000,2348790,30893790,False
6565,validator_36,96325356530,True,95681000,8295400,103976400,False
6566,validator_49,64121726040,True,120519000,1207040,121726040,False
6567,validator_32,32352697530,True,200855000,3005900,203860900,False
6568,validator_38,32407906500,True,179397000,1411300,180808300,False
6569,validator_23,32112208124,True,45287003,18570020,63857023,True
6570,validator_22,64280484957,True,59597004,5582700,65179704,True
6571,validator_34,256390068180,True,87589000,9040100,96629100,False
6572,validator_17,160073329996,True,71764996,1565000,73329996,True
6573,validator_11,32164955798,True,164013998,941800,164955798,True
6574,validator_28,32694728700,True,136012000,7542030,143554030,False
6575,validator_49,64223087490,True,100628000,733450,101361450,False
6576,validator_17,160134268499,True,59856003,1082500,60938503,True
6577,validator_28,32825449500,True,128699000,2021800,130720800,False
6578,validator_31,160496000800,True,99890000,1138000,101028000,False
6579,validator_12,96431421869,True,74305000,9464040,83769040,True
6580,validator_10,32161665297,True,143396997,18268300,161665297,True
6581,validator_19,64484381908,True,249637002,446000,250083002,True
6582,validator_28,32868681300,True,42723000,508800,43231800,False
6583,validator_17,160361751901,True,225882002,1601400,227483402,True
6584,validator_26,32082845400,True,81714000,1131400,82845400,False
6585,validator_35,96100070520,True,98490000,1580520,100070520,False
6586,validator_7,64110915329,True,109936999,978330,110915329,True
6587,validator_3,32345528226,True,148964992,18908500,167873492,True
6588,validator_0,32282506706,True,115093004,615200,115708204,True
6589,validator_42,32361284940,True,156906000,20158000,177064000,False
6590,validator_1,64135003324,True,134203004,800320,135003324,True
6591,validator_2,32296169813,True,158083992,1432720,159516712,True
6592,validator_8,32119015299,True,113195999,5819300,119015299,True
6593,validator_48,160488354060,True,141093000,524700,141617700,False
6594,validator_3,32523263729,True,174638003,3097500,177735503,True
6595,validator_40,32108059390,True,106575000,1484390,108059390,False
6596,validator_30,64127873920,True,126028000,1845920,127873920,False
6597,validator_5,64474020673,True,328360002,1428920,329788922,True
6598,validator_41,64221020120,True,126346000,1774820,128120820,False
6599,validator_9,32177522740,True,158702000,18820740,177522740,True
6600,validator_13,32120192597,True,118679997,1512600,120192597,True
6601,validator_36,96432950770,True,105120000,2474240,107594240,False
6602,validator_39,32426336690,True,67869000,7595000,75464000,False
6603,validator_7,64325423626,True,211829997,2678300,214508297,True
6604,validator_43,64313097790,True,225549000,5550780,231099780,False
6605,validator_0,32506071148,True,221110992,2453450,223564442,True
6606,validator_18,96505554303,True,88038004,665840,88703844,True
6607,validator_18,96733595543,True,226920000,1121240,228041240,True
6608,validator_34,256530373880,True,129535000,10770700,140305700,False
6609,validator_5,64555139912,True,71218999,9900240,81119239,True
6610,validator_28,33013759600,True,144766000,312300,145078300,False
6611,validator_28,33172508060,True,157678000,1070460,158748460,False
6612,validator_46,96257515800,True,76585000,1248300,77833300,False
6613,validator_33,32114812400,True,95698000,19114400,114812400,False
6614,validator_25,32149736700,True,96300000,5432500,101732500,False
6615,validator_0,32669977720,True,149220992,14685580,163906572,True
6616,validator_16,32142680602,True,141703002,977600,142680602,True
6617,validator_39,32598381620,True,171842000,202930,172044930,False
6618,validator_48,160647790500,True,158883000,553440,159436440,False
6619,validator_31,160563661300,True,66199000,1461500,67660500,False
6620,validator_36,96632384370,True,198068000,1365600,199433600,False
6621,validator_38,32534942040,True,125195000,1840540,127035540,False
6622,validator_22,64386749756,True,100228999,6035800,106264799,True
6623,validator_17,160492093293,True,106546002,23795390,130341392,True
6624,validator_7,64446981758,True,121077002,481130,121558132,True
6625,validator_34,256611162880,True,79422000,1367000,80789000,False
6626,validator_20,32762368796,True,173920000,573340,174493340,True
6627,validator_36,96798837370,True,129685000,36768000,166453000,False
6628,validator_46,96330330540,True,72584000,230740,72814740,False
6629,validator_24,32130560795,True,125350005,5210790,130560795,True
6630,validator_48,160773219860,True,125053000,376360,125429360,False
6631,validator_15,256631189043,True,155382999,641400,156024399,True
6632,validator_9,32346652438,True,167749998,1379700,169129698,True
6633,validator_12,96568407008,True,136114999,870140,136985139,True
6634,validator_19,64543097209,True,58242001,473300,58715301,True
6635,validator_9,32522859939,True,172811001,3396500,176207501,True
6636,validator_20,32850897696,True,87476000,1052900,88528900,True
6637,validator_36,96848543670,True,49040000,666300,49706300,False
6638,validator_35,96207351420,True,98517000,8763900,107280900,False
6639,validator_16,32382868179,True,238771997,1415580,240187577,True
6640,validator_39,32792947820,True,193720000,846200,194566200,False
6641,validator_44,96427989940,True,118906000,433340,119339340,False
6642,validator_35,96307325720,True,98931000,1043300,99974300,False
6643,validator_26,32146037180,True,62800000,391780,63191780,False
6644,validator_34,256722364080,True,110510000,691200,111201200,False
6645,validator_14,96250923004,True,101537003,7969100,109506103,True
6646,validator_31,160762691080,True,194089000,4940780,199029780,False
6647,validator_37,64489107200,True,144263000,2491200,146754200,False
6648,validator_44,96566635320,True,136232000,2413380,138645380,False
6649,validator_1,64270057627,True,133443003,1611300,135054303,True
6650,validator_13,32213547794,True,86255997,7099200,93355197,True
6651,validator_5,64662410311,True,104073999,3196400,107270399,True
6652,validator_0,32826780753,True,156411003,392030,156803033,True
6653,validator_46,96542265480,True,205934000,6000940,211934940,False
6654,validator_14,96294853264,True,43218000,712260,43930260,True
6655,validator_4,32212748920,True,211209000,1539920,212748920,True
6656,validator_34,256844241980,True,121487000,390900,121877900,False
6657,validator_8,32161710001,True,42288002,406700,42694702,True
6658,validator_34,256949413080,True,105072000,99100,105171100,False
6659,validator_41,64340885340,True,118939000,926220,119865220,False
6660,validator_37,64557541620,True,68225000,209420,68434420,False
6661,validator_12,96655349234,True,84398996,2543230,86942226,True
6662,validator_34,257133807480,True,184147000,247400,184394400,False
6663,validator_5,64826506353,True,163213002,883040,164096042,True
6664,validator_30,64225437420,True,93026000,4537500,97563500,False
6665,validator_49,64302827890,True,77572000,2168400,79740400,False
6666,validator_31,160886554920,True,123396000,467840,123863840,False
6667,validator_23,32257816394,True,144538000,1070270,145608270,True
6668,validator_45,32173722040,True,105308000,1484800,106792800,False
6669,validator_22,64496000851,True,101102995,8148100,109251095,True
6670,validator_17,160548375614,True,55838001,444320,56282321,True
6671,validator_42,32512134320,True,142992000,7857380,150849380,False
6672,validator_39,32905967020,True,111636000,1383200,113019200,False
6673,validator_7,64573084198,True,108073000,18029440,126102440,True
6674,validator_31,160980488360,True,75515000,18418440,93933440,False
6675,validator_46,96605205610,True,60860000,2080130,62940130,False
6676,validator_17,160604291114,True,47560000,8355500,55915500,True
6677,validator_16,32586240679,True,201479000,1893500,203372500,True
6678,validator_32,32521044330,True,167166000,1180800,168346800,False
6679,validator_47,64304049890,True,108792000,1529100,110321100,False
6680,validator_35,96408281220,True,99937000,1018500,100955500,False
6681,validator_44,96702937100,True,117849000,18452780,136301780,False
6682,validator_19,64644264134,True,100572995,593930,101166925,True
6683,validator_6,32244331720,True,56799998,22434800,79234798,True
6684,validator_43,64407853330,True,93156000,1599540,94755540,False
6685,validator_12,96831709513,True,175849999,510280,176360279,True
6686,validator_2,32392940210,True,96344997,425400,96770397,True
6687,validator_41,64449786840,True,107402000,1499500,108901500,False
6688,validator_34,257241088380,True,88866000,18414900,107280900,False
6689,validator_10,32223516697,True,60185000,1666400,61851400,True
6690,validator_36,96922159950,True,72149000,1467280,73616280,False
6691,validator_41,64720855870,True,270404000,665030,271069030,False
6692,validator_43,64573716250,True,147660000,18202920,165862920,False
6693,validator_41,64810486670,True,89049000,581800,89630800,False
6694,validator_11,32277619602,True,93945004,18718800,112663804,True
6695,validator_49,64472770790,True,168498000,1444900,169942900,False
6696,validator_36,97124393630,True,193975000,8258680,202233680,False
6697,validator_39,33025239020,True,110182000,9090000,119272000,False
6698,validator_2,32576442713,True,177101003,6401500,183502503,True
6699,validator_30,64361374320,True,133949000,1987900,135936900,False
6700,validator_24,32271110392,True,138362997,2186600,140549597,True
6701,validator_16,32780396887,True,174466008,19690200,194156208,True
6702,validator_44,96802781370,True,99111000,733270,99844270,False
6703,validator_38,32644203240,True,83317000,25944200,109261200,False
6704,validator_27,96551607370,True,120649000,1598100,122247100,False
6705,validator_8,32326233297,True,162982996,1540300,164523296,True
6706,validator_29,32153009620,True,53002000,586230,53588230,False
6707,validator_10,32433591728,True,207036001,3039030,210075031,True
6708,validator_35,96476024220,True,59198000,8545000,67743000,False
6709,validator_11,32377145222,True,97874000,1651620,99525620,True
6710,validator_39,33173121420,True,146179000,1703400,147882400,False
6711,validator_28,33374281400,True,199040000,2733340,201773340,False
6712,validator_17,160736719948,True,131660004,768830,132428834,True
6713,validator_25,32265319300,True,96908000,18674600,115582600,False
6714,validator_48,160819747640,True,44964000,1563780,46527780,False
6715,validator_15,256717199945,True,85057002,953900,86010902,True
6716,validator_33,32359068700,True,242780000,1476300,244256300,False
6717,validator_46,96780662850,True,173674000,1783240,175457240,False
6718,validator_22,64602373830,True,105164999,1207980,106372979,True
6719,validator_49,64601123590,True,127770000,582800,128352800,False
6720,validator_24,32476931219,True,204132997,1687830,205820827,True
6721,validator_22,64713831782,True,109834992,1622960,111457952,True
6722,validator_33,32469663700,True,100989000,9606000,110595000,False
6723,validator_6,32374559136,True,128273996,1953420,130227416,True
6724,validator_40,32215954490,True,107657000,238100,107895100,False
6725,validator_35,96558518620,True,81797000,697400,82494400,False
6726,validator_34,257343967880,True,102056000,823500,102879500,False
6727,validator_31,161059846060,True,78260000,1097700,79357700,False
6728,validator_11,32503226319,True,95849997,30231100,126081097,True
6729,validator_42,32609513160,True,96901000,477840,97378840,False
6730,validator_19,64788724563,True,144161999,298430,144460429,True
6731,validator_7,64645239740,True,71975002,180540,72155542,True
6732,validator_9,32650687817,True,126607998,1219880,127827878,True
6733,validator_20,32990251376,True,133634000,5719680,139353680,True
6734,validator_8,32468127958,True,139238001,2656660,141894661,True
6735,validator_32,32692074890,True,170155000,875560,171030560,False
6736,validator_25,32433003530,True,166175000,1509230,167684230,False
6737,validator_16,32874734308,True,93933001,404420,94337421,True
6738,validator_18,96874486744,True,123054001,17837200,140891201,True
6739,validator_22,64811009779,True,88085997,9092000,97177997,True
6740,validator_36,97309640530,True,184461000,785900,185246900,False
6741,validator_34,257469022550,True,117563000,7491670,125054670,False
6742,validator_35,96614271160,True,47821000,7931540,55752540,False
6743,validator_35,96791178860,True,175438000,1469700,176907700,False
6744,validator_23,32497010526,True,216234002,22960130,239194132,True
6745,validator_4,32385857021,True,172050001,1058100,173108101,True
6746,validator_31,161216970760,True,156209000,915700,157124700,False
6747,validator_11,32582862615,True,77752996,1883300,79636296,True
6748,validator_27,96713804070,True,161219000,977700,162196700,False
6749,validator_44,97065373770,True,261906000,686400,262592400,False
6750,validator_43,64743983700,True,167440000,2827450,170267450,False
6751,validator_26,32345012480,True,198357000,618300,198975300,False
6752,validator_36,97411913930,True,101218000,1055400,102273400,False
6753,validator_26,32494280620,True,147830000,1438140,149268140,False
6754,validator_41,64954725870,True,121934000,22305200,144239200,False
6755,validator_49,64727149190,True,100397000,25628600,126025600,False
6756,validator_18,97004448446,True,122436002,7525700,129961702,True
6757,validator_0,32938030183,True,110331000,918430,111249430,True
6758,validator_46,96889446780,True,108104000,679930,108783930,False
6759,validator_34,257629257940,True,152035000,8200390,160235390,False
6760,validator_46,97013679180,True,105514000,18718400,124232400,False
6761,validator_11,32878903716,True,294338001,1703100,296041101,True
6762,validator_31,161327947260,True,109130000,1846500,110976500,False
6763,validator_27,96796994210,True,64678000,18512140,83190140,False
6764,validator_33,32579749000,True,90565000,19520300,110085300,False
6765,validator_12,97091785215,True,241528002,18547700,260075702,True
6766,validator_37,64600973440,True,43098000,333820,43431820,False
6767,validator_33,32736236530,True,155593000,894530,156487530,False
6768,validator_9,32776054456,True,123901999,1464640,125366639,True
6769,validator_23,32649035599,True,132778003,19247070,152025073,True
6770,validator_29,32315766960,True,161425000,1332340,162757340,False
6771,validator_47,64468972890,True,162714000,2209000,164923000,False
6772,validator_13,32320700696,True,106120002,1032900,107152902,True
6773,validator_6,32498795939,True,123485003,751800,124236803,True
6774,validator_36,97489089210,True,75171000,2004280,77175280,False
6775,validator_43,64877166800,True,131346000,1837100,133183100,False
6776,validator_2,32832184910,True,254111997,1630200,255742197,True
6777,validator_17,160799602584,True,54906996,7975640,62882636,True
6778,validator_6,32581423135,True,81580996,1046200,82627196,True
6779,validator_19,64966318767,True,176318004,1276200,177594204,True
6780,validator_15,256900145237,True,166537002,16408290,182945292,True
6781,validator_33,32828844930,True,91370000,1238400,92608400,False
6782,validator_37,64777415240,True,157826000,18615800,176441800,False
6783,validator_23,32748534299,True,81466000,18032700,99498700,True
6784,validator_11,33001038318,True,121187002,947600,122134602,True
6785,validator_46,97143660180,True,128994000,987000,129981000,False
6786,validator_3,32597186423,True,71834994,2087700,73922694,True
6787,validator_40,32367020390,True,148603000,2462900,151065900,False
6788,validator_6,32681899736,True,98940001,1536600,100476601,True
6789,validator_41,65088716370,True,115225000,18765500,133990500,False
6790,validator_41,65241621900,True,150384000,2521530,152905530,False
6791,validator_42,32822299380,True,211688000,1098220,212786220,False
6792,validator_9,32850448982,True,73095996,1298530,74394526,True
6793,validator_5,64878900256,True,51628003,765900,52393903,True
6794,validator_14,96366982465,True,69592001,2537200,72129201,True
6795,validator_5,64985494558,True,105555002,1039300,106594302,True
6796,validator_31,161466898860,True,119254000,19697600,138951600,False
6797,validator_22,64921562836,True,110086997,466060,110553057,True
6798,validator_13,32451951499,True,128819003,2431800,131250803,True
6799,validator_38,32803161680,True,157910000,1048440,158958440,False
6800,validator_15,257054090738,True,145912001,8033500,153945501,True
6801,validator_17,160871597846,True,71324002,671260,71995262,True
6802,validator_6,32830854835,True,130236999,18718100,148955099,True
6803,validator_6,32912860464,True,81447999,557630,82005629,True
6804,validator_46,97265200340,True,120277000,1263160,121540160,False
6805,validator_23,32986701078,True,234683999,3482780,238166779,True
6806,validator_6,33100953901,True,181360997,6732440,188093437,True
6807,validator_27,96916801510,True,118373000,1434300,119807300,False
6808,validator_4,32501348498,True,114878997,612480,115491477,True
6809,validator_17,161014496480,True,137932994,4965640,142898634,True
6810,validator_5,65080371457,True,92887999,1988900,94876899,True
6811,validator_11,33085477903,True,83301995,1137590,84439585,True
6812,validator_41,65344476400,True,83503000,19351500,102854500,False
6813,validator_12,97197020785,True,92185000,13050570,105235570,True
6814,validator_47,64573088690,True,103428000,687800,104115800,False
6815,validator_7,64787915961,True,142115001,561220,142676221,True
6816,validator_30,64423107900,True,53661000,8072580,61733580,False
6817,validator_26,32683087320,True,188492000,314700,188806700,False
6818,validator_48,160948037240,True,127078000,1211600,128289600,False
6819,validator_29,32425321630,True,108245000,1309670,109554670,False
6820,validator_6,33177865298,True,75477997,1433400,76911397,True
6821,validator_32,32846734890,True,153182000,1478000,154660000,False
6822,validator_32,32917850970,True,69630000,1486080,71116080,False
6823,validator_0,33046190113,True,89068000,19091930,108159930,True
6824,validator_34,257768543130,True,137289000,1996190,139285190,False
6825,validator_10,32601387070,True,166389002,1406340,167795342,True
6826,validator_15,257105727144,True,49490006,2146400,51636406,True
6827,validator_46,97407972360,True,138004000,4768020,142772020,False
6828,validator_43,64919310700,True,41343000,800900,42143900,False
6829,validator_26,32831488240,True,148215000,185920,148400920,False
6830,validator_18,97166077343,True,160421997,1206900,161628897,True
6831,validator_19,65135218465,True,160625998,8273700,168899698,True
6832,validator_22,65204875633,True,282162997,1149800,283312797,True
6833,validator_19,65281882043,True,145838998,824580,146663578,True
6834,validator_6,33229629914,True,49824996,1939620,51764616,True
6835,validator_32,32976848260,True,40394000,18603290,58997290,False
6836,validator_41,65387620640,True,42716000,428240,43144240,False
6837,validator_45,32376349340,True,198925000,3702300,202627300,False
6838,validator_5,65174953558,True,93799001,783100,94582101,True
6839,validator_49,64893259930,True,164370000,1740740,166110740,False
6840,validator_46,97574163950,True,164789000,1402590,166191590,False
6841,validator_36,97590891010,True,95789000,6012800,101801800,False
6842,validator_36,97741713370,True,150168000,654360,150822360,False
6843,validator_16,32933008906,True,57672998,601600,58274598,True
6844,validator_0,33178465711,True,128456998,3818600,132275598,True
6845,validator_37,64896087100,True,115882000,2789860,118671860,False
6846,validator_47,64672180290,True,81070000,18021600,99091600,False
6847,validator_47,64829961770,True,157288000,493480,157781480,False
6848,validator_16,33101460495,True,163014999,5436590,168451589,True
6849,validator_37,65104392200,True,189516000,18789100,208305100,False
6850,validator_17,161192991883,True,177517003,978400,178495403,True
6851,validator_29,32475684130,True,45069000,5293500,50362500,False
6852,validator_15,257352146315,True,244572001,1847170,246419171,True
6853,validator_40,32487301690,True,111963000,8318300,120281300,False
6854,validator_17,161289995526,True,90295003,6708640,97003643,True
6855,validator_14,96593913493,True,225743998,1187030,226931028,True
6856,validator_21,64235234399,True,233804999,1429400,235234399,True
6857,validator_17,161408789531,True,100274005,18520000,118794005,True
6858,validator_9,32933333465,True,82500003,384480,82884483,True
6859,validator_10,32708033170,True,87912000,18734100,106646100,True
6860,validator_25,32614112810,True,178535000,2574280,181109280,False
6861,validator_32,33085068000,True,106221000,1998740,108219740,False
6862,validator_17,161507270631,True,96537000,1944100,98481100,True
6863,validator_18,97289074440,True,122206997,790100,122997097,True
6864,validator_36,97833464110,True,90911000,839740,91750740,False
6865,validator_28,33558862900,True,176295000,8286500,184581500,False
6866,validator_49,64962321530,True,68437000,624600,69061600,False
6867,validator_22,65257218638,True,51942005,401000,52343005,True
6868,validator_46,97690724870,True,115701000,859920,116560920,False
6869,validator_25,32836646810,True,221778000,756000,222534000,False
6870,validator_23,33227412030,True,221028002,19682950,240710952,True
6871,validator_39,33327169720,True,152770000,1278300,154048300,False
6872,validator_1,64358416225,True,87039998,1318600,88358598,True
6873,validator_16,33245202124,True,141363999,2377630,143741629,True
6874,validator_46,97813158570,True,102673000,19760700,122433700,False
6875,validator_2,32913315151,True,79922001,1208240,81130241,True
6876,validator_15,257413949985,True,60573000,1230670,61803670,True
6877,validator_37,65265136800,True,159611000,1133600,160744600,False
6878,validator_48,161025204740,True,75541000,1626500,77167500,False
6879,validator_48,161139311340,True,113196000,910600,114106600,False
6880,validator_7,64864872441,True,76354000,602480,76956480,True
6881,validator_35,96948714260,True,156980000,555400,157535400,False
6882,validator_21,64347529716,True,110172997,2122320,112295317,True
6883,validator_22,65370821380,True,111247002,2355740,113602742,True
6884,validator_48,161302127010,True,160084000,2731670,162815670,False
6885,validator_14,96683569496,True,88896003,760000,89656003,True
6886,validator_5,65311961161,True,133510003,3497600,137007603,True
6887,validator_34,257840642250,True,70386000,1713120,72099120,False
6888,validator_17,161653469728,True,143632997,2566100,146199097,True
6889,validator_25,32940714920,True,100334000,3734110,104068110,False
6890,validator_18,97404382845,True,114553005,755400,115308405,True
6891,validator_5,65463423158,True,149526997,1935000,151461997,True
6892,validator_45,32435849840,True,59120000,380500,59500500,False
6893,validator_7,64900366644,True,34652003,842200,35494203,True
6894,validator_32,33129148320,True,42933000,1147320,44080320,False
6895,validator_37,65319501400,True,53767000,597600,54364600,False
6896,validator_7,65018523092,True,115438008,2718440,118156448,True
6897,validator_28,33655272400,True,92927000,3482500,96409500,False
6898,validator_31,161682447760,True,213666000,1882900,215548900,False
6899,validator_11,33210831948,True,123849005,1505040,125354045,True
6900,validator_21,64419834117,True,53992001,18312400,72304401,True
6901,validator_41,65455295430,True,57534000,10140790,67674790,False
6902,validator_24,32580582825,True,101625006,2026600,103651606,True
6903,validator_27,97041700730,True,123850000,1049220,124899220,False
6904,validator_21,64585487556,True,163687999,1965440,165653439,True
6905,validator_14,96826399392,True,139660996,3168900,142829896,True
6906,validator_6,33307742414,True,69237000,8875500,78112500,True
6907,validator_23,33313293029,True,66338999,19542000,85880999,True
6908,validator_1,64483245661,True,124202006,627430,124829436,True
6909,validator_48,161444077710,True,141298000,652700,141950700,False
6910,validator_36,97963306410,True,129193000,649300,129842300,False
6911,validator_17,161952754218,True,244643000,54641490,299284490,True
6912,validator_15,257566565586,True,134517001,18098600,152615601,True
6913,validator_23,33385831860,True,70466001,2072830,72538831,True
6914,validator_45,32487283840,True,49998000,1436000,51434000,False
6915,validator_18,97463249220,True,56707995,2158380,58866375,True
6916,validator_3,32716219822,True,118448999,584400,119033399,True
6917,validator_18,97642126812,True,174291002,4586590,178877592,True
6918,validator_29,32524725750,True,48626000,415620,49041620,False
6919,validator_16,33386656527,True,139250003,2204400,141454403,True
6920,validator_47,64961802130,True,130967000,873360,131840360,False
6921,validator_15,257628622685,True,61558999,498100,62057099,True
6922,validator_18,97763246413,True,102390001,18729600,121119601,True
6923,validator_10,32873552911,True,153501001,12018740,165519741,True
6924,validator_38,32872663510,True,68731000,770830,69501830,False
6925,validator_2,33084272151,True,170068000,889000,170957000,True
6926,validator_44,97203467570,True,128472000,9621800,138093800,False
6927,validator_1,64690699802,True,206137001,1317140,207454141,True
6928,validator_31,161920173560,True,236416000,1309800,237725800,False
6929,validator_14,96974370974,True,147203002,768580,147971582,True
6930,validator_18,97942064380,True,178669997,147970,178817967,True
6931,validator_8,32566551557,True,90086999,8336600,98423599,True
6932,validator_14,97065406874,True,89382000,1653900,91035900,True
6933,validator_48,161562733510,True,116312000,2343800,118655800,False
6934,validator_33,32998661450,True,168531000,1285520,169816520,False
6935,validator_30,64562190800,True,136406000,2676900,139082900,False
6936,validator_45,32568727530,True,80016000,1427690,81443690,False
6937,validator_10,33057757712,True,183547001,657800,184204801,True
6938,validator_48,161681187110,True,117193000,1260600,118453600,False
6939,validator_3,32841639702,True,120065000,5354880,125419880,True
6940,validator_40,32620867810,True,128141000,5425120,133566120,False
6941,validator_42,32898443460,True,74969000,1175080,76144080,False
6942,validator_13,32571135699,True,116783000,2401200,119184200,True
6943,validator_17,162069107651,True,114926003,1427430,116353433,True
6944,validator_34,257960807890,True,119595000,570640,120165640,False
6945,validator_10,33140661653,True,75143001,7760940,82903941,True
6946,validator_49,65091360430,True,128294000,744900,129038900,False
6947,validator_11,33285343392,True,73443004,1068440,74511444,True
6948,validator_4,32656732599,True,146724001,8660100,155384101,True
6949,validator_41,65608243950,True,151631000,1317520,152948520,False
6950,validator_17,162284683948,True,214977997,598300,215576297,True
6951,validator_14,97209443204,True,142006000,2030330,144036330,True
6952,validator_22,65493489310,True,121872000,795930,122667930,True
6953,validator_41,65680141150,True,70676000,1221200,71897200,False
6954,validator_10,33306182654,True,159803001,5718000,165521001,True
6955,validator_49,65227227230,True,129594000,6272800,135866800,False
6956,validator_47,65074518910,True,111872000,844780,112716780,False
6957,validator_17,162414625140,True,127416002,2525190,129941192,True
6958,validator_6,33398253556,True,89920002,591140,90511142,True
6959,validator_0,33290014342,True,110692001,856630,111548631,True
6960,validator_2,33296146181,True,211699000,175030,211874030,True
6961,validator_49,65311197430,True,73877000,10093200,83970200,False
6962,validator_46,97911285990,True,96929000,1198420,98127420,False
6963,validator_27,97195588770,True,153404000,484040,153888040,False
6964,validator_47,65181017130,True,105463000,1035220,106498220,False
6965,validator_44,97392151370,True,188454000,229800,188683800,False
6966,validator_20,33079917050,True,87186004,2479670,89665674,True
6967,validator_27,97298383900,True,101290000,1505130,102795130,False
6968,validator_46,98099388190,True,186324000,1778200,188102200,False
6969,validator_29,32648192150,True,114613000,8853400,123466400,False
6970,validator_6,33430063156,True,31605000,204600,31809600,True
6971,validator_44,97653287370,True,260486000,650000,261136000,False
6972,validator_22,65629090909,True,134654999,946600,135601599,True
6973,validator_8,32700820648,True,127278001,6991090,134269091,True
6974,validator_47,65328953610,True,146851000,1085480,147936480,False
6975,validator_41,66031923500,True,350411000,1371350,351782350,False
6976,validator_29,32752406080,True,102183000,2030930,104213930,False
6977,validator_29,32888131450,True,134163000,1562370,135725370,False
6978,validator_2,33455703272,True,158114001,1443090,159557091,True
6979,validator_22,65725266135,True,95137006,1038220,96175226,True
6980,validator_29,33021604350,True,132483000,989900,133472900,False
6981,validator_14,97333556244,True,119000000,5113040,124113040,True
6982,validator_22,65785460040,True,57102005,3091900,60193905,True
6983,validator_13,32627299827,True,55677998,486130,56164128,True
6984,validator_10,33417070944,True,109574000,1314290,110888290,True
6985,validator_33,33140593290,True,129675000,12256840,141931840,False
6986,validator_19,65355032443,True,72808000,342400,73150400,True
6987,validator_35,97048034060,True,99063000,256800,99319800,False
6988,validator_22,66095421817,True,309784997,176780,309961777,True
6989,validator_41,66201563060,True,167477000,2162560,169639560,False
6990,validator_42,33019266990,True,116446000,4377530,120823530,False
6991,validator_25,33075443920,True,132346000,2383000,134729000,False
6992,validator_38,32944768280,True,71828000,276770,72104770,False
6993,validator_10,33560856048,True,141650004,2135100,143785104,True
6994,validator_0,33402231670,True,111416998,800330,112217328,True
6995,validator_23,33554855161,True,168725001,298300,169023301,True
6996,validator_40,32784986010,True,162372000,1746200,164118200,False
6997,validator_33,33244760430,True,102932000,1235140,104167140,False
6998,validator_39,33474241020,True,144928000,2143300,147071300,False
6999,validator_31,162186425580,True,264543000,1709020,266252020,False
7000,validator_10,32078731199,True,78080999,650200,78731199,True
7001,validator_12,96134912187,True,134307997,604190,134912187,True
7002,validator_31,160102139830,True,93211000,8928830,102139830,False
7003,validator_23,32168173501,True,159551001,8622500,168173501,True
7004,validator_34,256069994300,True,59731000,10263300,69994300,False
7005,validator_39,32059019600,True,58732000,287600,59019600,False
7006,validator_20,32082078595,True,80586995,1491600,82078595,True
7007,validator_22,64119155637,True,117292007,1863630,119155637,True
7008,validator_27,96122169700,True,120872000,1297700,122169700,False
7009,validator_18,96129900744,True,126718004,3182740,129900744,True
7010,validator_20,32369635977,True,250538002,37019380,287557382,True
7011,validator_36,96178379340,True,176884000,1495340,178379340,False
7012,validator_14,96154614641,True,154369001,245640,154614641,True
7013,validator_49,64113927600,True,106531000,7396600,113927600,False
7014,validator_10,32285223194,True,205217995,1274000,206491995,True
7015,validator_26,32129023220,True,127198000,1825220,129023220,False
7016,validator_15,256155790498,True,146766998,9023500,155790498,True
7017,validator_17,160156436885,True,153834995,2601890,156436885,True
7018,validator_26,32243406590,True,113210000,1173370,114383370,False
7019,validator_45,32051490100,True,49177000,2313100,51490100,False
7020,validator_2,32105319004,True,102862004,2457000,105319004,True
7021,validator_8,32110713802,True,102272002,8441800,110713802,True
7022,validator_36,96245362370,True,65874000,1109030,66983030,False
7023,validator_17,160241030247,True,83442002,1151360,84593362,True
7024,validator_5,64058544577,True,56815997,1728580,58544577,True
7025,validator_49,64237489200,True,123071000,490600,123561600,False
7026,validator_1,64108776200,True,107108000,1668200,108776200,True
7027,validator_22,64315376963,True,177391006,18830320,196221326,True
7028,validator_36,96426436140,True,172853000,8220770,181073770,False
7029,validator_18,96251438340,True,121131996,405600,121537596,True
7030,validator_42,32132562500,True,130713000,1849500,132562500,False
7031,validator_30,64144227700,True,143788000,439700,144227700,False
7032,validator_48,160062233800,True,60564000,1669800,62233800,False
7033,validator_0,32091705740,True,91060000,645740,91705740,True
7034,validator_46,96160055690,True,141097000,18958690,160055690,False
7035,validator_6,32196392499,True,178282999,18109500,196392499,True
7036,validator_44,96096102740,True,77335000,18767740,96102740,False
7037,validator_20,32509928209,True,138982002,1310230,140292232,True
7038,validator_19,64097218601,True,96766001,452600,97218601,True
7039,validator_28,32127028100,True,126863000,165100,127028100,False
7040,validator_20,32680394997,True,161901998,8564790,170466788,True
7041,validator_7,64115830700,True,110179000,5651700,115830700,True
7042,validator_31,160150960510,True,39317000,9503680,48820680,False
7043,validator_37,64121786260,True,120885000,901260,121786260,False
7044,validator_30,64291967800,True,146453000,1287100,147740100,False
7045,validator_18,96375830866,True,123397006,995520,124392526,True
7046,validator_5,64174887406,True,115113999,1228830,116342829,True
7047,validator_39,32214080600,True,154592000,469000,155061000,False
7048,validator_14,96267470135,True,107589004,5266490,112855494,True
7049,validator_31,160236404810,True,83952000,1492300,85444300,False
7050,validator_31,160394260010,True,156924000,931200,157855200,False
7051,validator_47,64133265520,True,131899000,1366520,133265520,False
7052,validator_49,64350589700,True,106720000,6380500,113100500,False
7053,validator_17,160396474310,True,154536003,908060,155444063,True
7054,validator_15,256355729397,True,199748999,189900,199938899,True
7055,validator_23,32390015342,True,220630001,1211840,221841841,True
7056,validator_30,64407800800,True,96594000,19239000,115833000,False
7057,validator_27,96208241720,True,66681000,19391020,86072020,False
7058,validator_49,64404679000,True,44841000,9248300,54089300,False
7059,validator_49,64509930100,True,103987000,1264100,105251100,False
7060,validator_5,64236361447,True,54046001,7428040,61474041,True
7061,validator_39,32287467040,True,71842000,1544440,73386440,False
7062,validator_11,32125884736,True,124358996,1525740,125884736,True
7063,validator_27,96397302020,True,187339000,1721300,189060300,False
7064,validator_10,32449723817,True,161783003,2717620,164500623,True
7065,validator_42,32242637510,True,105151000,4924010,110075010,False
7066,validator_26,32356554890,True,112692000,456300,113148300,False
7067,validator_8,32274637144,True,155500002,8423340,163923342,True
7068,validator_1,64305593603,True,195534003,1283400,196817403,True
7069,validator_34,256190492390,True,119423000,1075090,120498090,False
7070,validator_13,32223149303,True,221551003,1598300,223149303,True
7071,validator_6,32355786899,True,157010000,2384400,159394400,True
7072,validator_16,32086979880,True,85013000,1966880,86979880,True
7073,validator_22,64404704664,True,87845001,1482700,89327701,True
7074,validator_17,160582803207,True,168104997,18223900,186328897,True
7075,validator_19,64286477904,True,157924003,31335300,189259303,True
7076,validator_24,32083866943,True,76379003,7487940,83866943,True
7077,validator_23,32563014146,True,168397004,4601800,172998804,True
7078,validator_7,64306072878,True,181911998,8330180,190242178,True
7079,validator_17,160723045144,True,138752997,1488940,140241937,True
7080,validator_22,64563775964,True,140662000,18409300,159071300,True
7081,validator_5,64366616143,True,128208996,2045700,130254696,True
7082,validator_7,64418593980,True,111336002,1185100,112521102,True
7083,validator_29,32139901230,True,138183000,1718230,139901230,False
7084,validator_31,160519685800,True,124494000,931790,125425790,False
7085,validator_2,32219502804,True,113682000,501800,114183800,True
7086,validator_44,96298889560,True,196078000,6708820,202786820,False
7087,validator_21,64220749298,True,200862998,19886300,220749298,True
7088,validator_2,32405016062,True,182896998,2616260,185513258,True
7089,validator_36,96499132100,True,72226000,469960,72695960,False
7090,validator_32,32136029320,True,134878000,1151320,136029320,False
7091,validator_22,64656832446,True,91681002,1375480,93056482,True
7092,validator_8,32397995497,True,122346003,1012350,123358353,True
7093,validator_39,32386255380,True,93106000,5682340,98788340,False
7094,validator_36,96581026500,True,79861000,2033400,81894400,False
7095,validator_14,96356082137,True,86831002,1781000,88612002,True
7096,validator_20,32855076195,True,170931998,3749200,174681198,True
7097,validator_41,64056448650,True,55009000,1439650,56448650,False
7098,validator_19,64460251104,True,172881000,892200,173773200,True
7099,validator_4,32197037265,True,196668005,369260,197037265,True
7100,validator_0,32303471738,True,206241998,5524000,211765998,True
7101,validator_27,96473172220,True,68510000,7360200,75870200,False
7102,validator_12,96180170271,True,44532004,726080,45258084,True
7103,validator_26,32433430880,True,56918000,19957990,76875990,False
7104,validator_24,32220011886,True,133670003,2474940,136144943,True
7105,validator_46,96268260690,True,105480000,2725000,108205000,False
7106,validator_24,32512052716,True,286782000,5258830,292040830,True
7107,validator_2,32494254343,True,81546001,7692280,89238281,True
7108,validator_2,32658324242,True,145121999,18947900,164069899,True
7109,validator_25,32090763500,True,88025000,2738500,90763500,False
7110,validator_27,96598303420,True,124766000,365200,125131200,False
7111,validator_33,32155404720,True,154031000,1373720,155404720,False
7112,validator_14,96590178933,True,223876996,10219800,234096796,True
7113,validator_25,32237315330,True,142078000,4473830,146551830,False
7114,validator_38,32171005970,True,147166000,23839970,171005970,False
7115,validator_30,64526529000,True,116996000,1732200,118728200,False
7116,validator_28,32270414900,True,140330000,3056800,143386800,False
7117,validator_42,32316528710,True,66985000,6906200,73891200,False
7118,validator_7,64563205782,True,136222002,8389800,144611802,True
7119,validator_44,96464501860,True,163220000,2392300,165612300,False
7120,validator_14,96690209033,True,98630000,1400100,100030100,True
7121,validator_22,64827417248,True,170292002,292800,170584802,True
7122,validator_23,32659091588,True,90595002,5482440,96077442,True
7123,validator_17,160863717786,True,139708002,964640,140672642,True
7124,validator_7,64631014981,True,66648999,1160200,67809199,True
7125,validator_30,64674952140,True,146933000,1490140,148423140,False
7126,validator_46,96396717030,True,122112000,6344340,128456340,False
7127,validator_41,64110233790,True,52113000,1672140,53785140,False
7128,validator_10,32512167892,True,54972995,7471080,62444075,True
7129,validator_33,32258214720,True,101002000,1808000,102810000,False
7130,validator_43,64068961100,True,66625000,2336100,68961100,False
7131,validator_17,160932900487,True,68022001,1160700,69182701,True
7132,validator_8,32525010399,True,126315002,699900,127014902,True
7133,validator_28,32381217300,True,109582000,1220400,110802400,False
7134,validator_1,64374911773,True,68344000,974170,69318170,True
7135,validator_37,64208346100,True,78912000,7647840,86559840,False
7136,validator_4,32312890759,True,97697994,18155500,115853494,True
7137,validator_44,96628986790,True,163601000,883930,164484930,False
7138,validator_24,32589226640,True,74828004,2345920,77173924,True
7139,validator_23,32877869282,True,217681004,1096690,218777694,True
7140,validator_29,32282927630,True,140944000,2082400,143026400,False
7141,validator_14,96926333968,True,234565005,1559930,236124935,True
7142,validator_48,160134433560,True,72010000,189760,72199760,False
7143,validator_33,32301443220,True,35583000,7645500,43228500,False
7144,validator_2,32916716568,True,235123996,23268330,258392326,True
7145,validator_30,64862234940,True,186257000,1025800,187282800,False
7146,validator_36,96759594640,True,177100000,1468140,178568140,False
7147,validator_25,32311697110,True,72184000,2197780,74381780,False
7148,validator_28,32487106160,True,104952000,936860,105888860,False
7149,validator_32,32199288550,True,60109000,3150230,63259230,False
7150,validator_21,64325918796,True,103406998,1762500,105169498,True
7151,validator_16,32177105720,True,89085000,1040840,90125840,True
7152,validator_30,64979964540,True,116683000,1046600,117729600,False
7153,validator_34,256260026790,True,68294000,1240400,69534400,False
7154,validator_40,32152506220,True,144450000,8056220,152506220,False
7155,validator_9,32064992199,True,64162999,829200,64992199,True
7156,validator_36,96882325530,True,120995000,1735890,122730890,False
7157,validator_33,32417174410,True,113625000,2106190,115731190,False
7158,validator_26,32480345080,True,42012000,4902200,46914200,False
7159,validator_11,32230083232,True,103414996,783500,104198496,True
7160,validator_34,256371905290,True,110691000,1187500,111878500,False
7161,validator_2,32998602058,True,80092000,1793490,81885490,True
7162,validator_24,32749161842,True,153992002,5943200,159935202,True
7163,validator_46,96565987760,True,161790000,7480730,169270730,False
7164,validator_5,64494210345,True,127330002,264200,127594202,True
7165,validator_48,160258087590,True,122307000,1347030,123654030,False
7166,validator_3,32097967815,True,95980995,1986820,97967815,True
7167,validator_37,64283067630,True,74199000,522530,74721530,False
7168,validator_16,32328401912,True,149398992,1897200,151296192,True
7169,validator_28,32587898610,True,99970000,822450,100792450,False
7170,validator_43,64134959600,True,65003000,995500,65998500,False
7171,validator_34,256519955110,True,147377000,672820,148049820,False
7172,validator_22,64979086951,True,150345003,1324700,151669703,True
7173,validator_31,160601350210,True,63032000,18632410,81664410,False
7174,validator_24,32879804444,True,129085002,1557600,130642602,True
7175,validator_28,32688272750,True,99653000,721140,100374140,False
7176,validator_23,33111527814,True,225309002,8349530,233658532,True
7177,validator_27,96672843220,True,73596000,943800,74539800,False
7178,validator_11,32356207535,True,123683003,2441300,126124303,True
7179,validator_31,160655539710,True,53207000,982500,54189500,False
7180,validator_31,160831378210,True,173878000,1960500,175838500,False
7181,validator_11,32462831350,True,105791005,832810,106623815,True
7182,validator_30,65218514130,True,236946000,1603590,238549590,False
7183,validator_32,32370526450,True,169836000,1401900,171237900,False
7184,validator_34,256553508910,True,31669000,1884800,33553800,False
7185,validator_45,32178331600,True,118892000,7949500,126841500,False
7186,validator_14,97055189771,True,122766003,6089800,128855803,True
7187,validator_26,32621545540,True,139678000,1522460,141200460,False
7188,validator_0,32570817739,True,266668001,678000,267346001,True
7189,validator_45,32301636500,True,120922000,2382900,123304900,False
7190,validator_10,32579391641,True,66345999,877750,67223749,True
7191,validator_15,256536242096,True,174404999,6107700,180512699,True
7192,validator_46,96630457500,True,63371000,1098740,64469740,False
7193,validator_17,161201492184,True,267303997,1287700,268591697,True
7194,validator_41,64202268390,True,91396000,638600,92034600,False
7195,validator_1,64445662478,True,65702005,5048700,70750705,True
7196,validator_45,32370626100,True,50049000,18940600,68989600,False
7197,validator_18,96632147665,True,256171999,144800,256316799,True
7198,validator_21,64448269396,True,121172000,1178600,122350600,True
7199,validator_40,32227341220,True,66025000,8810000,74835000,False
7200,validator_34,256862729450,True,307699000,1521540,309220540,False
7201,validator_39,32490665380,True,95257000,9153000,104410000,False
7202,validator_9,32177473731,True,111633002,848530,112481532,True
7203,validator_10,32742363670,True,162542999,429030,162972029,True
7204,validator_12,96264618472,True,79456001,4992200,84448201,True
7205,validator_13,32306582305,True,82500002,933000,83433002,True
7206,validator_28,32773867390,True,84141000,1453640,85594640,False
7207,validator_20,33030788199,True,175004004,708000,175712004,True
7208,validator_3,32244723919,True,144769004,1987100,146756104,True
7209,validator_9,32264405232,True,85662001,1269500,86931501,True
7210,validator_32,32520659200,True,148453000,1679750,150132750,False
7211,validator_9,32352213403,True,87596001,212170,87808171,True
7212,validator_7,64833475323,True,182751002,19709340,202460342,True
7213,validator_37,64379572260,True,94649000,1855630,96504630,False
7214,validator_41,64315343990,True,112706000,369600,113075600,False
7215,validator_35,96145664440,True,140152000,5512440,145664440,False
7216,validator_15,256705459198,True,167979002,1238100,169217102,True
7217,validator_9,32496174458,True,143071005,890050,143961055,True
7218,validator_20,33214280319,True,183125000,367120,183492120,True
7219,validator_13,32399950537,True,92141002,1227230,93368232,True
7220,validator_0,32764646744,True,190593005,3236000,193829005,True
7221,validator_16,32435396814,True,106554002,440900,106994902,True
7222,validator_22,65076949954,True,95150003,2713000,97863003,True
7223,validator_2,33274207155,True,265286997,10318100,275605097,True
7224,validator_17,161414981382,True,212833998,655200,213489198,True
7225,validator_22,65176882453,True,91971999,7960500,99932499,True
7226,validator_44,96734361590,True,104667000,707800,105374800,False
7227,validator_34,257022777290,True,157537000,2510840,160047840,False
7228,validator_15,256861617839,True,154678001,1480640,156158641,True
7229,validator_8,32730552765,True,202368006,3174360,205542366,True
7230,validator_37,64539113440,True,157720000,1821180,159541180,False
7231,validator_42,32515360900,True,198268000,564190,198832190,False
7232,validator_27,96750440920,True,76832000,765700,77597700,False
7233,validator_42,32594606420,True,78987000,258520,79245520,False
7234,validator_44,96896325190,True,160976000,987600,161963600,False
7235,validator_33,32551273840,True,116100000,17999430,134099430,False
7236,validator_44,96988589180,True,91552000,711990,92263990,False
7237,validator_30,65360338930,True,135019000,6805800,141824800,False
7238,validator_39,32579653080,True,88043000,944700,88987700,False
7239,validator_17,161550998957,True,117368005,18649570,136017575,True
7240,validator_22,65248881249,True,70495996,1502800,71998796,True
7241,validator_41,64470026790,True,149011000,5671800,154682800,False
7242,validator_42,32811788050,True,216225000,956630,217181630,False
7243,validator_28,33006680830,True,231315000,1498440,232813440,False
7244,validator_41,64575864020,True,105663000,174230,105837230,False
7245,validator_18,96697072166,True,59833001,5091500,64924501,True
7246,validator_33,32628906140,True,69647000,7985300,77632300,False
7247,validator_9,32760382199,True,244726001,19481740,264207741,True
7248,validator_13,32474419672,True,73887005,582130,74469135,True
7249,validator_7,64971316618,True,129706995,8134300,137841295,True
7250,validator_35,96217195140,True,70204000,1326700,71530700,False
7251,validator_10,32858557273,True,111377003,4816600,116193603,True
7252,validator_6,32552324623,True,186499004,10038720,196537724,True
7253,validator_5,64553094173,True,56430998,2452830,58883828,True
7254,validator_43,64213434730,True,76976000,1499130,78475130,False
7255,validator_17,161720082560,True,167300003,1783600,169083603,True
7256,validator_12,96540014200,True,273916998,1478730,275395728,True
7257,validator_39,32770814980,True,182395000,8766900,191161900,False
7258,validator_48,160518991990,True,260035000,869400,260904400,False
7259,validator_26,32743220170,True,120993000,681630,121674630,False
7260,validator_44,97092160410,True,102468000,1103230,103571230,False
7261,validator_44,97232894200,True,122591000,18142790,140733790,False
7262,validator_0,33000630716,True,215917002,20066970,235983972,True
7263,validator_9,32884689831,True,123709002,598630,124307632,True
7264,validator_18,96767329500,True,69121994,1135340,70257334,True
7265,validator_49,64657664550,True,146219000,1515450,147734450,False
7266,validator_45,32426902800,True,56245000,31700,56276700,False
7267,validator_29,32476325520,True,149262000,44135890,193397890,False
7268,validator_9,33010236625,True,122311994,3234800,125546794,True
7269,validator_14,97196126673,True,140208002,728900,140936902,True
7270,validator_20,33319411520,True,103848001,1283200,105131201,True
7271,validator_1,64582262879,True,128610001,7990400,136600401,True
7272,validator_32,32717866920,True,195471000,1736720,197207720,False
7273,validator_12,96650629780,True,109634000,981580,110615580,True
7274,validator_3,32355512285,True,109367006,1421360,110788366,True
7275,validator_47,64270605620,True,137095000,245100,137340100,False
7276,validator_5,64609891196,True,48769003,8028020,56797023,True
7277,validator_19,64627654806,True,166704002,699700,167403702,True
7278,validator_22,65383432878,True,126729999,7821630,134551629,True
7279,validator_41,64681242280,True,104065000,1313260,105378260,False
7280,validator_21,64547964984,True,81852998,17842590,99695588,True
7281,validator_16,32568842813,True,132503999,942000,133445999,True
7282,validator_5,64731514897,True,119752001,1871700,121623701,True
7283,validator_24,33046350844,True,166336000,210400,166546400,True
7284,validator_19,64770472408,True,141754002,1063600,142817602,True
7285,validator_8,32930217862,True,191728997,7936100,199665097,True
7286,validator_2,33441862997,True,162971002,4684840,167655842,True
7287,validator_38,32261948070,True,89690000,1252100,90942100,False
7288,validator_31,161036249610,True,202889000,1982400,204871400,False
7289,validator_39,32857182410,True,85536000,831430,86367430,False
7290,validator_26,32909661970,True,158141000,8300800,166441800,False
7291,validator_1,64682613283,True,94741004,5609400,100350404,True
7292,validator_5,64943237896,True,209981999,1741000,211722999,True
7293,validator_2,33681030698,True,219914001,19253700,239167701,True
7294,validator_4,32493495860,True,161874001,18731100,180605101,True
7295,validator_18,96897681031,True,129802001,549530,130351531,True
7296,validator_23,33319116513,True,205846999,1741700,207588699,True
7297,validator_47,64402748520,True,130107000,2035900,132142900,False
7298,validator_1,64858820885,True,158064002,18143600,176207602,True
7299,validator_12,96719953974,True,68150004,1174190,69324194,True
7300,validator_1,65002329778,True,122948993,20559900,143508893,True
7301,validator_26,32990870500,True,76323000,4885530,81208530,False
7302,validator_4,32584442862,True,89033002,1914000,90947002,True
7303,validator_37,64639359040,True,99078000,1167600,100245600,False
7304,validator_36,97017090230,True,133929000,835700,134764700,False
7305,validator_11,32568054848,True,104311998,911500,105223498,True
7306,validator_35,96311876120,True,92869000,1811980,94680980,False
7307,validator_44,97342247100,True,100654000,8698900,109352900,False
7308,validator_29,32538968920,True,61967000,676400,62643400,False
7309,validator_47,64523876240,True,120576000,551720,121127720,False
7310,validator_30,65433688400,True,54580000,18769470,73349470,False
7311,validator_15,256977709968,True,111629999,4462130,116092129,True
7312,validator_10,33010288575,True,149318002,2413300,151731302,True
7313,validator_14,97421515476,True,224747003,641800,225388803,True
7314,validator_34,257105816490,True,78219000,4820200,83039200,False
7315,validator_42,32950638450,True,135800000,3050400,138850400,False
7316,validator_43,64287842530,True,73452000,955800,74407800,False
7317,validator_19,64924817612,True,153218004,1127200,154345204,True
7318,validator_32,32775388920,True,56225000,1297000,57522000,False
7319,validator_37,64781567860,True,121515000,20693820,142208820,False
7320,validator_39,32981769810,True,116296000,8291400,124587400,False
7321,validator_23,33580650715,True,259703002,1831200,261534202,True
7322,validator_22,65537398963,True,152925995,1040090,153966085,True
7323,validator_28,33064531330,True,55413000,2437500,57850500,False
7324,validator_4,32646863994,True,61087002,1334130,62421132,True
7325,validator_35,96551254120,True,231547000,7831000,239378000,False
7326,validator_18,97026434232,True,123356001,5397200,128753201,True
7327,validator_40,32392268190,True,156846000,8080970,164926970,False
7328,validator_47,64596624140,True,72405000,342900,72747900,False
7329,validator_10,33136720121,True,125662996,768550,126431546,True
7330,validator_15,257052723666,True,74072998,940700,75013698,True
7331,validator_28,33164586630,True,98627000,1428300,100055300,False
7332,validator_15,257216838269,True,161607003,2507600,164114603,True
7333,validator_34,257181393920,True,74099000,1478430,75577430,False
7334,validator_29,32715847160,True,175942000,936240,176878240,False
7335,validator_35,96712867840,True,160213000,1400720,161613720,False
7336,validator_20,33417670378,True,97652998,605860,98258858,True
7337,validator_16,32701072835,True,129479002,2751020,132230022,True
7338,validator_48,160665240260,True,144077000,2171270,146248270,False
7339,validator_22,65695590015,True,156598002,1593050,158191052,True
7340,validator_6,32672597051,True,117579998,2692430,120272428,True
7341,validator_41,64728679700,True,44779000,2658420,47437420,False
7342,validator_7,65037215436,True,65532998,365820,65898818,True
7343,validator_35,96842423940,True,103717000,25839100,129556100,False
7344,validator_35,96947494910,True,103817000,1253970,105070970,False
7345,validator_42,33061549690,True,109579000,1332240,110911240,False
7346,validator_21,64670096486,True,119880002,2251500,122131502,True
7347,validator_12,96791492602,True,71303998,234630,71538628,True
7348,validator_20,33503377683,True,78838005,6869300,85707305,True
7349,validator_17,161838949656,True,117739996,1127100,118867096,True
7350,validator_10,33234470116,True,95728995,2021000,97749995,True
7351,validator_19,65142164911,True,212010999,5336300,217347299,True
7352,validator_8,32973169439,True,41337997,1613580,42951577,True
7353,validator_1,65142175741,True,139737003,108960,139845963,True
7354,validator_1,65377254733,True,229549992,5529000,235078992,True
7355,validator_15,257294777771,True,77108002,831500,77939502,True
7356,validator_14,97510114981,True,87146005,1453500,88599505,True
7357,validator_0,33074362558,True,71242002,2489840,73731842,True
7358,validator_26,33077721770,True,86369000,482270,86851270,False
7359,validator_35,97098741650,True,146777000,4469740,151246740,False
7360,validator_45,32469687400,True,36848000,5936600,42784600,False
7361,validator_41,64839622140,True,109353000,1589440,110942440,False
7362,validator_34,257259544820,True,76223000,1927900,78150900,False
7363,validator_2,33810469926,True,129129998,309230,129439228,True
7364,validator_28,33296913830,True,131653000,674200,132327200,False
7365,validator_0,33140670477,True,65938999,368920,66307919,True
7366,validator_2,33977300364,True,164154998,2675440,166830438,True
7367,validator_7,65091744813,True,53436997,1092380,54529377,True
7368,validator_39,33159090310,True,175642000,1678500,177320500,False
7369,validator_17,161987545152,True,147474996,1120500,148595496,True
7370,validator_6,32827303226,True,153809995,896180,154706175,True
7371,validator_22,65833723804,True,137615999,517790,138133789,True
7372,validator_23,33664753020,True,65039005,19063300,84102305,True
7373,validator_32,32846301520,True,69174000,1738600,70912600,False
7374,validator_48,160897688460,True,231034000,1414200,232448200,False
7375,validator_44,97468875800,True,123596000,3032700,126628700,False
7376,validator_28,33394305890,True,88149000,9243060,97392060,False
7377,validator_48,161037245680,True,121028000,18529220,139557220,False
7378,validator_31,161148875930,True,112280000,346320,112626320,False
7379,validator_20,33618602981,True,113946998,1278300,115225298,True
7380,validator_34,257436884470,True,175754000,1585650,177339650,False
7381,validator_24,33097902340,True,50448996,1102500,51551496,True
7382,validator_17,162092811941,True,81205999,24060790,105266789,True
7383,validator_17,162229427360,True,130844999,5770420,136615419,True
7384,validator_43,64519337230,True,230873000,621700,231494700,False
7385,validator_23,33820066818,True,145053998,10259800,155313798,True
7386,validator_31,161258943560,True,107512000,2555630,110067630,False
7387,validator_41,64994448440,True,135539000,19287300,154826300,False
7388,validator_27,96868737620,True,116715000,1581700,118296700,False
7389,validator_23,33947936915,True,125212997,2657100,127870097,True
7390,validator_19,65363878013,True,202513002,19200100,221713102,True
7391,validator_37,64903469350,True,104066000,17835490,121901490,False
7392,validator_31,161398873490,True,139698000,231930,139929930,False
7393,validator_23,34193975555,True,245808000,230640,246038640,True
7394,validator_22,66102930932,True,267001008,2206120,269207128,True
7395,validator_5,64994453826,True,49826000,1389930,51215930,True
7396,validator_9,33185530919,True,156009994,19284300,175294294,True
7397,validator_47,64699795280,True,84487000,18684140,103171140,False
7398,validator_32,32995214020,True,147027000,1885500,148912500,False
7399,validator_18,97210780019,True,183173997,1171790,184345787,True
7400,validator_35,97226706450,True,125909000,2055800,127964800,False
7401,validator_48,161141172410,True,96145000,7781730,103926730,False
7402,validator_37,64985428650,True,79907000,2052300,81959300,False
7403,validator_18,97289567519,True,76473000,2314500,78787500,True
7404,validator_47,64888131610,True,186445000,1891330,188336330,False
7405,validator_8,33091362567,True,117330998,862130,118193128,True
7406,validator_34,257559003930,True,121925000,194460,122119460,False
7407,validator_9,33311168119,True,125538000,99200,125637200,True
7408,validator_25,32396618910,True,77065000,7856800,84921800,False
7409,validator_25,32434134990,True,37427000,89080,37516080,False
7410,validator_44,97549021800,True,79662000,484000,80146000,False
7411,validator_34,257652965410,True,91209000,2752480,93961480,False
7412,validator_41,65133063630,True,137544000,1071190,138615190,False
7413,validator_11,32642448547,True,73478999,914700,74393699,True
7414,validator_41,65259459430,True,125537000,858800,126395800,False
7415,validator_10,33349901703,True,113673997,1757590,115431587,True
7416,validator_30,65588078440,True,153389000,1001040,154390040,False
7417,validator_12,96924248624,True,129693002,3063020,132756022,True
7418,validator_35,97278520350,True,51070000,743900,51813900,False
7419,validator_23,34354506156,True,154875001,5655600,160530601,True
7420,validator_13,32621024202,True,145897000,707530,146604530,True
7421,validator_38,32355483970,True,91433000,2102900,93535900,False
7422,validator_45,32591369470,True,121138000,544070,121682070,False
7423,validator_47,64972520140,True,82411000,1977530,84388530,False
7424,validator_8,33338575549,True,245604002,1608980,247212982,True
7425,validator_41,65447044380,True,185780000,1804950,187584950,False
7426,validator_37,65104051370,True,116661000,1961720,118622720,False
7427,validator_45,32664322610,True,71950000,1003140,72953140,False
7428,validator_39,33226088880,True,65360000,1638570,66998570,False
7429,validator_2,34138093882,True,160119998,673520,160793518,True
7430,validator_23,34465412247,True,110457001,449090,110906091,True
7431,validator_48,161250196310,True,108786000,237900,109023900,False
7432,validator_42,33211268790,True,125142000,24577100,149719100,False
7433,validator_42,33352769270,True,132671000,8829480,141500480,False
7434,validator_14,97577068557,True,65735006,1218570,66953576,True
7435,validator_6,32932645768,True,104120002,1222540,105342542,True
7436,validator_49,64727111350,True,63633000,5813800,69446800,False
7437,validator_12,97129157240,True,203846996,1061620,204908616,True
7438,validator_34,257816197610,True,160302000,2930200,163232200,False
7439,validator_11,32885163844,True,233455997,9259300,242715297,True
7440,validator_15,257362638169,True,66905998,954400,67860398,True
7441,validator_18,97393813320,True,96431001,7814800,104245801,True
7442,validator_9,33383803125,True,71810006,825000,72635006,True
7443,validator_35,97343440470,True,61996000,2924120,64920120,False
7444,validator_26,33151768770,True,72409000,1638000,74047000,False
7445,validator_37,65187214590,True,70509000,12654220,83163220,False
7446,validator_15,257543849455,True,179414996,1796290,181211286,True
7447,validator_31,161471580170,True,52268000,20438680,72706680,False
7448,validator_41,65599926280,True,133649000,19232900,152881900,False
7449,validator_0,33285253298,True,143930001,652820,144582821,True
7450,validator_4,32885011535,True,211383001,26764540,238147541,True
7451,validator_9,33553944856,True,168511001,1630730,170141731,True
7452,validator_49,64827182150,True,99802000,268800,100070800,False
7453,validator_48,161330054990,True,79297000,561680,79858680,False
7454,validator_14,97720056717,True,142444000,544160,142988160,True
7455,validator_37,65279878520,True,91517000,1146930,92663930,False
7456,validator_47,65172368540,True,189828000,10020400,199848400,False
7457,validator_34,257925985150,True,108785000,1002540,109787540,False
7458,validator_0,33525041898,True,239616000,172600,239788600,True
7459,validator_33,32702853330,True,68646000,5301190,73947190,False
7460,validator_25,32586564690,True,151905000,524700,152429700,False
7461,validator_23,34570956449,True,105198002,346200,105544202,True
7462,validator_34,257995417450,True,68940000,492300,69432300,False
7463,validator_41,65758527820,True,158371000,230540,158601540,False
7464,validator_8,33497080448,True,157917999,586900,158504899,True
7465,validator_2,34345176458,True,201736996,5345580,207082576,True
7466,validator_9,33663989857,True,107875001,2170000,110045001,True
7467,validator_10,33479713199,True,129140006,671490,129811496,True
7468,validator_17,162390654244,True,160129004,1097880,161226884,True
7469,validator_27,96939049820,True,69264000,1048200,70312200,False
7470,validator_37,65468485400,True,188386000,220880,188606880,False
7471,validator_21,64920924590,True,230350004,20478100,250828104,True
7472,validator_14,97873075414,True,151900997,1117700,153018697,True
7473,validator_38,32450552870,True,76917000,18151900,95068900,False
7474,validator_5,65091121627,True,86393001,10274800,96667801,True
7475,validator_17,162486066642,True,93792998,1619400,95412398,True
7476,validator_28,33489781430,True,94562000,913540,95475540,False
7477,validator_17,162632329723,True,137815001,8448080,146263081,True
7478,validator_22,66253191951,True,149864999,396020,150261019,True
7479,validator_22,66348920514,True,94435003,1293560,95728563,True
7480,validator_34,258037489380,True,41794000,277930,42071930,False
7481,validator_35,97457088650,True,112812000,836180,113648180,False
7482,validator_8,33543817439,True,44614001,2122990,46736991,True
7483,validator_49,64888812950,True,61083000,547800,61630800,False
7484,validator_12,97231397940,True,101949000,291700,102240700,True
7485,validator_26,33297978170,True,144318000,1891400,146209400,False
7486,validator_14,98055855834,True,181259000,1521420,182780420,True
7487,validator_14,98284446450,True,227209996,1380620,228590616,True
7488,validator_48,161620843350,True,289525000,1263360,290788360,False
7489,validator_34,258124498780,True,86124000,885400,87009400,False
7490,validator_28,33548256670,True,57673000,802240,58475240,False
7491,validator_47,65319591440,True,146450000,772900,147222900,False
7492,validator_13,32825010207,True,185584995,18401010,203986005,True
7493,validator_3,32528948106,True,172691001,744820,173435821,True
7494,validator_15,257674571963,True,128414998,2307510,130722508,True
7495,validator_40,32499938490,True,99244000,8426300,107670300,False
7496,validator_17,162740220724,True,99874001,8017000,107891001,True
7497,validator_8,33720913877,True,175799998,1296440,177096438,True
7498,validator_30,65683024240,True,94102000,843800,94945800,False
7499,validator_24,33167102943,True,68934003,266600,69200603,True
7500,validator_10,32078731199,True,78080999,650200,78731199,True
7501,validator_12,96134912187,True,134307997,604190,134912187,True
7502,validator_31,160102139830,True,93211000,8928830,102139830,False
7503,validator_23,32168173501,True,159551001,8622500,168173501,True
7504,validator_34,256069994300,True,59731000,10263300,69994300,False
7505,validator_39,32059019600,True,58732000,287600,59019600,False
7506,validator_20,32082078595,True,80586995,1491600,82078595,True
7507,validator_22,64119155637,True,117292007,1863630,119155637,True
7508,validator_27,96122169700,True,120872000,1297700,122169700,False
7509,validator_18,96129900744,True,126718004,3182740,129900744,True
7510,validator_20,32369635977,True,250538002,37019380,287557382,True
7511,validator_36,96178379340,True,176884000,1495340,178379340,False
7512,validator_14,96154614641,True,154369001,245640,154614641,True
7513,validator_49,64113927600,True,106531000,7396600,113927600,False
7514,validator_10,32285223194,True,205217995,1274000,206491995,True
7515,validator_26,32129023220,True,127198000,1825220,129023220,False
7516,validator_15,256155790498,True,146766998,9023500,155790498,True
7517,validator_17,160156436885,True,153834995,2601890,156436885,True
7518,validator_26,32243406590,True,113210000,1173370,114383370,False
7519,validator_45,32051490100,True,49177000,2313100,51490100,False
7520,validator_2,32105319004,True,102862004,2457000,105319004,True
7521,validator_8,32110713802,True,102272002,8441800,110713802,True
7522,validator_36,96245362370,True,65874000,1109030,66983030,False
7523,validator_17,160241030247,True,83442002,1151360,84593362,True
7524,validator_5,64058544577,True,56815997,1728580,58544577,True
7525,validator_49,64237489200,True,123071000,490600,123561600,False
7526,validator_1,64108776200,True,107108000,1668200,108776200,True
7527,validator_22,64315376963,True,177391006,18830320,196221326,True
7528,validator_36,96426436140,True,172853000,8220770,181073770,False
7529,validator_18,96251438340,True,121131996,405600,121537596,True
7530,validator_42,32132562500,True,130713000,1849500,132562500,False
7531,validator_30,64144227700,True,143788000,439700,144227700,False
7532,validator_48,160062233800,True,60564000,1669800,62233800,False
7533,validator_0,32091705740,True,91060000,645740,91705740,True
7534,validator_46,96160055690,True,141097000,18958690,160055690,False
7535,validator_6,32196392499,True,178282999,18109500,196392499,True
7536,validator_44,96096102740,True,77335000,18767740,96102740,False
7537,validator_20,32509928209,True,138982002,1310230,140292232,True
7538,validator_19,64097218601,True,96766001,452600,97218601,True
7539,validator_28,32127028100,True,126863000,165100,127028100,False
7540,validator_20,32680394997,True,161901998,8564790,170466788,True
7541,validator_7,64115830700,True,110179000,5651700,115830700,True
7542,validator_31,160150960510,True,39317000,9503680,48820680,False
7543,validator_37,64121786260,True,120885000,901260,121786260,False
7544,validator_30,64291967800,True,146453000,1287100,147740100,False
7545,validator_18,96375830866,True,123397006,995520,124392526,True
7546,validator_5,64174887406,True,115113999,1228830,116342829,True
7547,validator_39,32214080600,True,154592000,469000,155061000,False
7548,validator_14,96267470135,True,107589004,5266490,112855494,True
7549,validator_31,160236404810,True,83952000,1492300,85444300,False
7550,validator_31,160394260010,True,156924000,931200,157855200,False
7551,validator_47,64133265520,True,131899000,1366520,133265520,False
7552,validator_49,64350589700,True,106720000,6380500,113100500,False
7553,validator_17,160396474310,True,154536003,908060,155444063,True
7554,validator_15,256355729397,True,199748999,189900,199938899,True
7555,validator_23,32390015342,True,220630001,1211840,221841841,True
7556,validator_30,64407800800,True,96594000,19239000,115833000,False
7557,validator_27,96208241720,True,66681000,19391020,86072020,False
7558,validator_49,64404679000,True,44841000,9248300,54089300,False
7559,validator_49,64509930100,True,103987000,1264100,105251100,False
7560,validator_5,64236361447,True,54046001,7428040,61474041,True
7561,validator_39,32287467040,True,71842000,1544440,73386440,False
7562,validator_11,32125884736,True,124358996,1525740,125884736,True
7563,validator_27,96397302020,True,187339000,1721300,189060300,False
7564,validator_10,32449723817,True,161783003,2717620,164500623,True
7565,validator_42,32242637510,True,105151000,4924010,110075010,False
7566,validator_26,32356554890,True,112692000,456300,113148300,False
7567,validator_8,32274637144,True,155500002,8423340,163923342,True
7568,validator_1,64305593603,True,195534003,1283400,196817403,True
7569,validator_34,256190492390,True,119423000,1075090,120498090,False
7570,validator_13,32223149303,True,221551003,1598300,223149303,True
7571,validator_6,32355786899,True,157010000,2384400,159394400,True
7572,validator_16,32086979880,True,85013000,1966880,86979880,True
7573,validator_22,64404704664,True,87845001,1482700,89327701,True
7574,validator_17,160582803207,True,168104997,18223900,186328897,True
7575,validator_19,64286477904,True,157924003,31335300,189259303,True
7576,validator_24,32083866943,True,76379003,7487940,83866943,True
7577,validator_23,32563014146,True,168397004,4601800,172998804,True
7578,validator_7,64306072878,True,181911998,8330180,190242178,True
7579,validator_17,160723045144,True,138752997,1488940,140241937,True
7580,validator_22,64563775964,True,140662000,18409300,159071300,True
7581,validator_5,64366616143,True,128208996,2045700,130254696,True
7582,validator_7,64418593980,True,111336002,1185100,112521102,True
7583,validator_29,32139901230,True,138183000,1718230,139901230,False
7584,validator_31,160519685800,True,124494000,931790,125425790,False
7585,validator_2,32219502804,True,113682000,501800,114183800,True
7586,validator_44,96298889560,True,196078000,6708820,202786820,False
7587,validator_21,64220749298,True,200862998,19886300,220749298,True
7588,validator_2,32405016062,True,182896998,2616260,185513258,True
7589,validator_36,96499132100,True,72226000,469960,72695960,False
7590,validator_32,32136029320,True,134878000,1151320,136029320,False
7591,validator_22,64656832446,True,91681002,1375480,93056482,True
7592,validator_8,32397995497,True,122346003,1012350,123358353,True
7593,validator_39,32386255380,True,93106000,5682340,98788340,False
7594,validator_36,96581026500,True,79861000,2033400,81894400,False
7595,validator_14,96356082137,True,86831002,1781000,88612002,True
7596,validator_20,32855076195,True,170931998,3749200,174681198,True
7597,validator_41,64056448650,True,55009000,1439650,56448650,False
7598,validator_19,64460251104,True,172881000,892200,173773200,True
7599,validator_4,32197037265,True,196668005,369260,197037265,True
7600,validator_0,32303471738,True,206241998,5524000,211765998,True
7601,validator_27,96473172220,True,68510000,7360200,75870200,False
7602,validator_12,96180170271,True,44532004,726080,45258084,True
7603,validator_26,32433430880,True,56918000,19957990,76875990,False
7604,validator_24,32220011886,True,133670003,2474940,136144943,True
7605,validator_46,96268260690,True,105480000,2725000,108205000,False
7606,validator_24,32512052716,True,286782000,5258830,292040830,True
7607,validator_2,32494254343,True,81546001,7692280,89238281,True
7608,validator_2,32658324242,True,145121999,18947900,164069899,True
7609,validator_25,32090763500,True,88025000,2738500,90763500,False
7610,validator_27,96598303420,True,124766000,365200,125131200,False
7611,validator_33,32155404720,True,154031000,1373720,155404720,False
7612,validator_14,96590178933,True,223876996,10219800,234096796,True
7613,validator_25,32237315330,True,142078000,4473830,146551830,False
7614,validator_38,32171005970,True,147166000,23839970,171005970,False
7615,validator_30,64526529000,True,116996000,1732200,118728200,False
7616,validator_28,32270414900,True,140330000,3056800,143386800,False
7617,validator_42,32316528710,True,66985000,6906200,73891200,False
7618,validator_7,64563205782,True,136222002,8389800,144611802,True
7619,validator_44,96464501860,True,163220000,2392300,165612300,False
7620,validator_14,96690209033,True,98630000,1400100,100030100,True
7621,validator_22,64827417248,True,170292002,292800,170584802,True
7622,validator_23,32659091588,True,90595002,5482440,96077442,True
7623,validator_17,160863717786,True,139708002,964640,140672642,True
7624,validator_7,64631014981,True,66648999,1160200,67809199,True
7625,validator_30,64674952140,True,146933000,1490140,148423140,False
7626,validator_46,96396717030,True,122112000,6344340,128456340,False
7627,validator_41,64110233790,True,52113000,1672140,53785140,False
7628,validator_10,32512167892,True,54972995,7471080,62444075,True
7629,validator_33,32258214720,True,101002000,1808000,102810000,False
7630,validator_43,64068961100,True,66625000,2336100,68961100,False
7631,validator_17,160932900487,True,68022001,1160700,69182701,True
7632,validator_8,32525010399,True,126315002,699900,127014902,True
7633,validator_28,32381217300,True,109582000,1220400,110802400,False
7634,validator_1,64374911773,True,68344000,974170,69318170,True
7635,validator_37,64208346100,True,78912000,7647840,86559840,False
7636,validator_4,32312890759,True,97697994,18155500,115853494,True
7637,validator_44,96628986790,True,163601000,883930,164484930,False
7638,validator_24,32589226640,True,74828004,2345920,77173924,True
7639,validator_23,32877869282,True,217681004,1096690,218777694,True
7640,validator_29,32282927630,True,140944000,2082400,143026400,False
7641,validator_14,96926333968,True,234565005,1559930,236124935,True
7642,validator_48,160134433560,True,72010000,189760,72199760,False
7643,validator_33,32301443220,True,35583000,7645500,43228500,False
7644,validator_2,32916716568,True,235123996,23268330,258392326,True
7645,validator_30,64862234940,True,186257000,1025800,187282800,False
7646,validator_36,96759594640,True,177100000,1468140,178568140,False
7647,validator_25,32311697110,True,72184000,2197780,74381780,False
7648,validator_28,32487106160,True,104952000,936860,105888860,False
7649,validator_32,32199288550,True,60109000,3150230,63259230,False
7650,validator_21,64325918796,True,103406998,1762500,105169498,True
7651,validator_16,32177105720,True,89085000,1040840,90125840,True
7652,validator_30,64979964540,True,116683000,1046600,117729600,False
7653,validator_34,256260026790,True,68294000,1240400,69534400,False
7654,validator_40,32152506220,True,144450000,8056220,152506220,False
7655,validator_9,32064992199,True,64162999,829200,64992199,True
7656,validator_36,96882325530,True,120995000,1735890,122730890,False
7657,validator_33,32417174410,True,113625000,2106190,115731190,False
7658,validator_26,32480345080,True,42012000,4902200,46914200,False
7659,validator_11,32230083232,True,103414996,783500,104198496,True
7660,validator_34,256371905290,True,110691000,1187500,111878500,False
7661,validator_2,32998602058,True,80092000,1793490,81885490,True
7662,validator_24,32749161842,True,153992002,5943200,159935202,True
7663,validator_46,96565987760,True,161790000,7480730,169270730,False
7664,validator_5,64494210345,True,127330002,264200,127594202,True
7665,validator_48,160258087590,True,122307000,1347030,123654030,False
7666,validator_3,32097967815,True,95980995,1986820,97967815,True
7667,validator_37,64283067630,True,74199000,522530,74721530,False
7668,validator_16,32328401912,True,149398992,1897200,151296192,True
7669,validator_28,32587898610,True,99970000,822450,100792450,False
7670,validator_43,64134959600,True,65003000,995500,65998500,False
7671,validator_34,256519955110,True,147377000,672820,148049820,False
7672,validator_22,64979086951,True,150345003,1324700,151669703,True
7673,validator_31,160601350210,True,63032000,18632410,81664410,False
7674,validator_24,32879804444,True,129085002,1557600,130642602,True
7675,validator_28,32688272750,True,99653000,721140,100374140,False
7676,validator_23,33111527814,True,225309002,8349530,233658532,True
7677,validator_27,96672843220,True,73596000,943800,74539800,False
7678,validator_11,32356207535,True,123683003,2441300,126124303,True
7679,validator_31,160655539710,True,53207000,982500,54189500,False
7680,validator_31,160831378210,True,173878000,1960500,175838500,False
7681,validator_11,32462831350,True,105791005,832810,106623815,True
7682,validator_30,65218514130,True,236946000,1603590,238549590,False
7683,validator_32,32370526450,True,169836000,1401900,171237900,False
7684,validator_34,256553508910,True,31669000,1884800,33553800,False
7685,validator_45,32178331600,True,118892000,7949500,126841500,False
7686,validator_14,97055189771,True,122766003,6089800,128855803,True
7687,validator_26,32621545540,True,139678000,1522460,141200460,False
7688,validator_0,32570817739,True,266668001,678000,267346001,True
7689,validator_45,32301636500,True,120922000,2382900,123304900,False
7690,validator_10,32579391641,True,66345999,877750,67223749,True
7691,validator_15,256536242096,True,174404999,6107700,180512699,True
7692,validator_46,96630457500,True,63371000,1098740,64469740,False
7693,validator_17,161201492184,True,267303997,1287700,268591697,True
7694,validator_41,64202268390,True,91396000,638600,92034600,False
7695,validator_1,64445662478,True,65702005,5048700,70750705,True
7696,validator_45,32370626100,True,50049000,18940600,68989600,False
7697,validator_18,96632147665,True,256171999,144800,256316799,True
7698,validator_21,64448269396,True,121172000,1178600,122350600,True
7699,validator_40,32227341220,True,66025000,8810000,74835000,False
7700,validator_34,256862729450,True,307699000,1521540,309220540,False
7701,validator_39,32490665380,True,95257000,9153000,104410000,False
7702,validator_9,32177473731,True,111633002,848530,112481532,True
7703,validator_10,32742363670,True,162542999,429030,162972029,True
7704,validator_12,96264618472,True,79456001,4992200,84448201,True
7705,validator_13,32306582305,True,82500002,933000,83433002,True
7706,validator_28,32773867390,True,84141000,1453640,85594640,False
7707,validator_20,33030788199,True,175004004,708000,175712004,True
7708,validator_3,32244723919,True,144769004,1987100,146756104,True
7709,validator_9,32264405232,True,85662001,1269500,86931501,True
7710,validator_32,32520659200,True,148453000,1679750,150132750,False
7711,validator_9,32352213403,True,87596001,212170,87808171,True
7712,validator_7,64833475323,True,182751002,19709340,202460342,True
7713,validator_37,64379572260,True,94649000,1855630,96504630,False
7714,validator_41,64315343990,True,112706000,369600,113075600,False
7715,validator_35,96145664440,True,140152000,5512440,145664440,False
7716,validator_15,256705459198,True,167979002,1238100,169217102,True
7717,validator_9,32496174458,True,143071005,890050,143961055,True
7718,validator_20,33214280319,True,183125000,367120,183492120,True
7719,validator_13,32399950537,True,92141002,1227230,93368232,True
7720,validator_0,32764646744,True,190593005,3236000,193829005,True
7721,validator_16,32435396814,True,106554002,440900,106994902,True
7722,validator_22,65076949954,True,95150003,2713000,97863003,True
7723,validator_2,33274207155,True,265286997,10318100,275605097,True
7724,validator_17,161414981382,True,212833998,655200,213489198,True
7725,validator_22,65176882453,True,91971999,7960500,99932499,True
7726,validator_44,96734361590,True,104667000,707800,105374800,False
7727,validator_34,257022777290,True,157537000,2510840,160047840,False
7728,validator_15,256861617839,True,154678001,1480640,156158641,True
7729,validator_8,32730552765,True,202368006,3174360,205542366,True
7730,validator_37,64539113440,True,157720000,1821180,159541180,False
7731,validator_42,32515360900,True,198268000,564190,198832190,False
7732,validator_27,96750440920,True,76832000,765700,77597700,False
7733,validator_42,32594606420,True,78987000,258520,79245520,False
7734,validator_44,96896325190,True,160976000,987600,161963600,False
7735,validator_33,32551273840,True,116100000,17999430,134099430,False
7736,validator_44,96988589180,True,91552000,711990,92263990,False
7737,validator_30,65360338930,True,135019000,6805800,141824800,False
7738,validator_39,32579653080,True,88043000,944700,88987700,False
7739,validator_17,161550998957,True,117368005,18649570,136017575,True
7740,validator_22,65248881249,True,70495996,1502800,71998796,True
7741,validator_41,64470026790,True,149011000,5671800,154682800,False
7742,validator_42,32811788050,True,216225000,956630,217181630,False
7743,validator_28,33006680830,True,231315000,1498440,232813440,False
7744,validator_41,64575864020,True,105663000,174230,105837230,False
7745,validator_18,96697072166,True,59833001,5091500,64924501,True
7746,validator_33,32628906140,True,69647000,7985300,77632300,False
7747,validator_9,32760382199,True,244726001,19481740,264207741,True
7748,validator_13,32474419672,True,73887005,582130,74469135,True
7749,validator_7,64971316618,True,129706995,8134300,137841295,True
7750,validator_35,96217195140,True,70204000,1326700,71530700,False
7751,validator_10,32858557273,True,111377003,4816600,116193603,True
7752,validator_6,32552324623,True,186499004,10038720,196537724,True
7753,validator_5,64553094173,True,56430998,2452830,58883828,True
7754,validator_43,64213434730,True,76976000,1499130,78475130,False
7755,validator_17,161720082560,True,167300003,1783600,169083603,True
7756,validator_12,96540014200,True,273916998,1478730,275395728,True
7757,validator_39,32770814980,True,182395000,8766900,191161900,False
7758,validator_48,160518991990,True,260035000,869400,260904400,False
7759,validator_26,32743220170,True,120993000,681630,121674630,False
7760,validator_44,97092160410,True,102468000,1103230,103571230,False
7761,validator_44,97232894200,True,122591000,18142790,140733790,False
7762,validator_0,33000630716,True,215917002,20066970,235983972,True
7763,validator_9,32884689831,True,123709002,598630,124307632,True
7764,validator_18,96767329500,True,69121994,1135340,70257334,True
7765,validator_49,64657664550,True,146219000,1515450,147734450,False
7766,validator_45,32426902800,True,56245000,31700,56276700,False
7767,validator_29,32476325520,True,149262000,44135890,193397890,False
7768,validator_9,33010236625,True,122311994,3234800,125546794,True
7769,validator_14,97196126673,True,140208002,728900,140936902,True
7770,validator_20,33319411520,True,103848001,1283200,105131201,True
7771,validator_1,64582262879,True,128610001,7990400,136600401,True
7772,validator_32,32717866920,True,195471000,1736720,197207720,False
7773,validator_12,96650629780,True,109634000,981580,110615580,True
7774,validator_3,32355512285,True,109367006,1421360,110788366,True
7775,validator_47,64270605620,True,137095000,245100,137340100,False
7776,validator_5,64609891196,True,48769003,8028020,56797023,True
7777,validator_19,64627654806,True,166704002,699700,167403702,True
7778,validator_22,65383432878,True,126729999,7821630,134551629,True
7779,validator_41,64681242280,True,104065000,1313260,105378260,False
7780,validator_21,64547964984,True,81852998,17842590,99695588,True
7781,validator_16,32568842813,True,132503999,942000,133445999,True
7782,validator_5,64731514897,True,119752001,1871700,121623701,True
7783,validator_24,33046350844,True,166336000,210400,166546400,True
7784,validator_19,64770472408,True,141754002,1063600,142817602,True
7785,validator_8,32930217862,True,191728997,7936100,199665097,True
7786,validator_2,33441862997,True,162971002,4684840,167655842,True
7787,validator_38,32261948070,True,89690000,1252100,90942100,False
7788,validator_31,161036249610,True,202889000,1982400,204871400,False
7789,validator_39,32857182410,True,85536000,831430,86367430,False
7790,validator_26,32909661970,True,158141000,8300800,166441800,False
7791,validator_1,64682613283,True,94741004,5609400,100350404,True
7792,validator_5,64943237896,True,209981999,1741000,211722999,True
7793,validator_2,33681030698,True,219914001,19253700,239167701,True
7794,validator_4,32493495860,True,161874001,18731100,180605101,True
7795,validator_18,96897681031,True,129802001,549530,130351531,True
7796,validator_23,33319116513,True,205846999,1741700,207588699,True
7797,validator_47,64402748520,True,130107000,2035900,132142900,False
7798,validator_1,64858820885,True,158064002,18143600,176207602,True
7799,validator_12,96719953974,True,68150004,1174190,69324194,True
7800,validator_1,65002329778,True,122948993,20559900,143508893,True
7801,validator_26,32990870500,True,76323000,4885530,81208530,False
7802,validator_4,32584442862,True,89033002,1914000,90947002,True
7803,validator_37,64639359040,True,99078000,1167600,100245600,False
7804,validator_36,97017090230,True,133929000,835700,134764700,False
7805,validator_11,32568054848,True,104311998,911500,105223498,True
7806,validator_35,96311876120,True,92869000,1811980,94680980,False
7807,validator_44,97342247100,True,100654000,8698900,109352900,False
7808,validator_29,32538968920,True,61967000,676400,62643400,False
7809,validator_47,64523876240,True,120576000,551720,121127720,False
7810,validator_30,65433688400,True,54580000,18769470,73349470,False
7811,validator_15,256977709968,True,111629999,4462130,116092129,True
7812,validator_10,33010288575,True,149318002,2413300,151731302,True
7813,validator_14,97421515476,True,224747003,641800,225388803,True
7814,validator_34,257105816490,True,78219000,4820200,83039200,False
7815,validator_42,32950638450,True,135800000,3050400,138850400,False
7816,validator_43,64287842530,True,73452000,955800,74407800,False
7817,validator_19,64924817612,True,153218004,1127200,154345204,True
7818,validator_32,32775388920,True,56225000,1297000,57522000,False
7819,validator_37,64781567860,True,121515000,20693820,142208820,False
7820,validator_39,32981769810,True,116296000,8291400,124587400,False
7821,validator_23,33580650715,True,259703002,1831200,261534202,True
7822,validator_22,65537398963,True,152925995,1040090,153966085,True
7823,validator_28,33064531330,True,55413000,2437500,57850500,False
7824,validator_4,32646863994,True,61087002,1334130,62421132,True
7825,validator_35,96551254120,True,231547000,7831000,239378000,False
7826,validator_18,97026434232,True,123356001,5397200,128753201,True
7827,validator_40,32392268190,True,156846000,8080970,164926970,False
7828,validator_47,64596624140,True,72405000,342900,72747900,False
7829,validator_10,33136720121,True,125662996,768550,126431546,True
7830,validator_15,257052723666,True,74072998,940700,75013698,True
7831,validator_28,33164586630,True,98627000,1428300,100055300,False
7832,validator_15,257216838269,True,161607003,2507600,164114603,True
7833,validator_34,257181393920,True,74099000,1478430,75577430,False
7834,validator_29,32715847160,True,175942000,936240,176878240,False
7835,validator_35,96712867840,True,160213000,1400720,161613720,False
7836,validator_20,33417670378,True,97652998,605860,98258858,True
7837,validator_16,32701072835,True,129479002,2751020,132230022,True
7838,validator_48,160665240260,True,144077000,2171270,146248270,False
7839,validator_22,65695590015,True,156598002,1593050,158191052,True
7840,validator_6,32672597051,True,117579998,2692430,120272428,True
7841,validator_41,64728679700,True,44779000,2658420,47437420,False
7842,validator_7,65037215436,True,65532998,365820,65898818,True
7843,validator_35,96842423940,True,103717000,25839100,129556100,False
7844,validator_35,96947494910,True,103817000,1253970,105070970,False
7845,validator_42,33061549690,True,109579000,1332240,110911240,False
7846,validator_21,64670096486,True,119880002,2251500,122131502,True
7847,validator_12,96791492602,True,71303998,234630,71538628,True
7848,validator_20,33503377683,True,78838005,6869300,85707305,True
7849,validator_17,161838949656,True,117739996,1127100,118867096,True
7850,validator_10,33234470116,True,95728995,2021000,97749995,True
7851,validator_19,65142164911,True,212010999,5336300,217347299,True
7852,validator_8,32973169439,True,41337997,1613580,42951577,True
7853,validator_1,65142175741,True,139737003,108960,139845963,True
7854,validator_1,65377254733,True,229549992,5529000,235078992,True
7855,validator_15,257294777771,True,77108002,831500,77939502,True
7856,validator_14,97510114981,True,87146005,1453500,88599505,True
7857,validator_0,33074362558,True,71242002,2489840,73731842,True
7858,validator_26,33077721770,True,86369000,482270,86851270,False
7859,validator_35,97098741650,True,146777000,4469740,151246740,False
7860,validator_45,32469687400,True,36848000,5936600,42784600,False
7861,validator_41,64839622140,True,109353000,1589440,110942440,False
7862,validator_34,257259544820,True,76223000,1927900,78150900,False
7863,validator_2,33810469926,True,129129998,309230,129439228,True
7864,validator_28,33296913830,True,131653000,674200,132327200,False
7865,validator_0,33140670477,True,65938999,368920,66307919,True
7866,validator_2,33977300364,True,164154998,2675440,166830438,True
7867,validator_7,65091744813,True,53436997,1092380,54529377,True
7868,validator_39,33159090310,True,175642000,1678500,177320500,False
7869,validator_17,161987545152,True,147474996,1120500,148595496,True
7870,validator_6,32827303226,True,153809995,896180,154706175,True
7871,validator_22,65833723804,True,137615999,517790,138133789,True
7872,validator_23,33664753020,True,65039005,19063300,84102305,True
7873,validator_32,32846301520,True,69174000,1738600,70912600,False
7874,validator_48,160897688460,True,231034000,1414200,232448200,False
7875,validator_44,97468875800,True,123596000,3032700,126628700,False
7876,validator_28,33394305890,True,88149000,9243060,97392060,False
7877,validator_48,161037245680,True,121028000,18529220,139557220,False
7878,validator_31,161148875930,True,112280000,346320,112626320,False
7879,validator_20,33618602981,True,113946998,1278300,115225298,True
7880,validator_34,257436884470,True,175754000,1585650,177339650,False
7881,validator_24,33097902340,True,50448996,1102500,51551496,True
7882,validator_17,162092811941,True,81205999,24060790,105266789,True
7883,validator_17,162229427360,True,130844999,5770420,136615419,True
7884,validator_43,64519337230,True,230873000,621700,231494700,False
7885,validator_23,33820066818,True,145053998,10259800,155313798,True
7886,validator_31,161258943560,True,107512000,2555630,110067630,False
7887,validator_41,64994448440,True,135539000,19287300,154826300,False
7888,validator_27,96868737620,True,116715000,1581700,118296700,False
7889,validator_23,33947936915,True,125212997,2657100,127870097,True
7890,validator_19,65363878013,True,202513002,19200100,221713102,True
7891,validator_37,64903469350,True,104066000,17835490,121901490,False
7892,validator_31,161398873490,True,139698000,231930,139929930,False
7893,validator_23,34193975555,True,245808000,230640,246038640,True
7894,validator_22,66102930932,True,267001008,2206120,269207128,True
7895,validator_5,64994453826,True,49826000,1389930,51215930,True
7896,validator_9,33185530919,True,156009994,19284300,175294294,True
7897,validator_47,64699795280,True,84487000,18684140,103171140,False
7898,validator_32,32995214020,True,147027000,1885500,148912500,False
7899,validator_18,97210780019,True,183173997,1171790,184345787,True
7900,validator_35,97226706450,True,125909000,2055800,127964800,False
7901,validator_48,161141172410,True,96145000,7781730,103926730,False
7902,validator_37,64985428650,True,79907000,2052300,81959300,False
7903,validator_18,97289567519,True,76473000,2314500,78787500,True
7904,validator_47,64888131610,True,186445000,1891330,188336330,False
7905,validator_8,33091362567,True,117330998,862130,118193128,True
7906,validator_34,257559003930,True,121925000,194460,122119460,False
7907,validator_9,33311168119,True,125538000,99200,125637200,True
7908,validator_25,32396618910,True,77065000,7856800,84921800,False
7909,validator_25,32434134990,True,37427000,89080,37516080,False
7910,validator_44,97549021800,True,79662000,484000,80146000,False
7911,validator_34,257652965410,True,91209000,2752480,93961480,False
7912,validator_41,65133063630,True,137544000,1071190,138615190,False
7913,validator_11,32642448547,True,73478999,914700,74393699,True
7914,validator_41,65259459430,True,125537000,858800,126395800,False
7915,validator_10,33349901703,True,113673997,1757590,115431587,True
7916,validator_30,65588078440,True,153389000,1001040,154390040,False
7917,validator_12,96924248624,True,129693002,3063020,132756022,True
7918,validator_35,97278520350,True,51070000,743900,51813900,False
7919,validator_23,34354506156,True,154875001,5655600,160530601,True
7920,validator_13,32621024202,True,145897000,707530,146604530,True
7921,validator_38,32355483970,True,91433000,2102900,93535900,False
7922,validator_45,32591369470,True,121138000,544070,121682070,False
7923,validator_47,64972520140,True,82411000,1977530,84388530,False
7924,validator_8,33338575549,True,245604002,1608980,247212982,True
7925,validator_41,65447044380,True,185780000,1804950,187584950,False
7926,validator_37,65104051370,True,116661000,1961720,118622720,False
7927,validator_45,32664322610,True,71950000,1003140,72953140,False
7928,validator_39,33226088880,True,65360000,1638570,66998570,False
7929,validator_2,34138093882,True,160119998,673520,160793518,True
7930,validator_23,34465412247,True,110457001,449090,110906091,True
7931,validator_48,161250196310,True,108786000,237900,109023900,False
7932,validator_42,33211268790,True,125142000,24577100,149719100,False
7933,validator_42,33352769270,True,132671000,8829480,141500480,False
7934,validator_14,97577068557,True,65735006,1218570,66953576,True
7935,validator_6,32932645768,True,104120002,1222540,105342542,True
7936,validator_49,64727111350,True,63633000,5813800,69446800,False
7937,validator_12,97129157240,True,203846996,1061620,204908616,True
7938,validator_34,257816197610,True,160302000,2930200,163232200,False
7939,validator_11,32885163844,True,233455997,9259300,242715297,True
7940,validator_15,257362638169,True,66905998,954400,67860398,True
7941,validator_18,97393813320,True,96431001,7814800,104245801,True
7942,validator_9,33383803125,True,71810006,825000,72635006,True
7943,validator_35,97343440470,True,61996000,2924120,64920120,False
7944,validator_26,33151768770,True,72409000,1638000,74047000,False
7945,validator_37,65187214590,True,70509000,12654220,83163220,False
7946,validator_15,257543849455,True,179414996,1796290,181211286,True
7947,validator_31,161471580170,True,52268000,20438680,72706680,False
7948,validator_41,65599926280,True,133649000,19232900,152881900,False
7949,validator_0,33285253298,True,143930001,652820,144582821,True
7950,validator_4,32885011535,True,211383001,26764540,238147541,True
7951,validator_9,33553944856,True,168511001,1630730,170141731,True
7952,validator_49,64827182150,True,99802000,268800,100070800,False
7953,validator_48,161330054990,True,79297000,561680,79858680,False
7954,validator_14,97720056717,True,142444000,544160,142988160,True
7955,validator_37,65279878520,True,91517000,1146930,92663930,False
7956,validator_47,65172368540,True,189828000,10020400,199848400,False
7957,validator_34,257925985150,True,108785000,1002540,109787540,False
7958,validator_0,33525041898,True,239616000,172600,239788600,True
7959,validator_33,32702853330,True,68646000,5301190,73947190,False
7960,validator_25,32586564690,True,151905000,524700,152429700,False
7961,validator_23,34570956449,True,105198002,346200,105544202,True
7962,validator_34,257995417450,True,68940000,492300,69432300,False
7963,validator_41,65758527820,True,158371000,230540,158601540,False
7964,validator_8,33497080448,True,157917999,586900,158504899,True
7965,validator_2,34345176458,True,201736996,5345580,207082576,True
7966,validator_9,33663989857,True,107875001,2170000,110045001,True
7967,validator_10,33479713199,True,129140006,671490,129811496,True
7968,validator_17,162390654244,True,160129004,1097880,161226884,True
7969,validator_27,96939049820,True,69264000,1048200,70312200,False
7970,validator_37,65468485400,True,188386000,220880,188606880,False
7971,validator_21,64920924590,True,230350004,20478100,250828104,True
7972,validator_14,97873075414,True,151900997,1117700,153018697,True
7973,validator_38,32450552870,True,76917000,18151900,95068900,False
7974,validator_5,65091121627,True,86393001,10274800,96667801,True
7975,validator_17,162486066642,True,93792998,1619400,95412398,True
7976,validator_28,33489781430,True,94562000,913540,95475540,False
7977,validator_17,162632329723,True,137815001,8448080,146263081,True
7978,validator_22,66253191951,True,149864999,396020,150261019,True
7979,validator_22,66348920514,True,94435003,1293560,95728563,True
7980,validator_34,258037489380,True,41794000,277930,42071930,False
7981,validator_35,97457088650,True,112812000,836180,113648180,False
7982,validator_8,33543817439,True,44614001,2122990,46736991,True
7983,validator_49,64888812950,True,61083000,547800,61630800,False
7984,validator_12,97231397940,True,101949000,291700,102240700,True
7985,validator_26,33297978170,True,144318000,1891400,146209400,False
7986,validator_14,98055855834,True,181259000,1521420,182780420,True
7987,validator_14,98284446450,True,227209996,1380620,228590616,True
7988,validator_48,161620843350,True,289525000,1263360,290788360,False
7989,validator_34,258124498780,True,86124000,885400,87009400,False
7990,validator_28,33548256670,True,57673000,802240,58475240,False
7991,validator_47,65319591440,True,146450000,772900,147222900,False
7992,validator_13,32825010207,True,185584995,18401010,203986005,True
7993,validator_3,32528948106,True,172691001,744820,173435821,True
7994,validator_15,257674571963,True,128414998,2307510,130722508,True
7995,validator_40,32499938490,True,99244000,8426300,107670300,False
7996,validator_17,162740220724,True,99874001,8017000,107891001,True
7997,validator_8,33720913877,True,175799998,1296440,177096438,True
7998,validator_30,65683024240,True,94102000,843800,94945800,False
7999,validator_24,33167102943,True,68934003,266600,69200603,True
8000,validator_10,32078731199,True,78080999,650200,78731199,True
8001,validator_12,96134912187,True,134307997,604190,134912187,True
8002,validator_31,160102139830,True,93211000,8928830,102139830,False
8003,validator_23,32168173501,True,159551001,8622500,168173501,True
8004,validator_34,256069994300,True,59731000,10263300,69994300,False
8005,validator_39,32059019600,True,58732000,287600,59019600,False
8006,validator_20,32082078595,True,80586995,1491600,82078595,True
8007,validator_22,64119155637,True,117292007,1863630,119155637,True
8008,validator_27,96122169700,True,120872000,1297700,122169700,False
8009,validator_18,96129900744,True,126718004,3182740,129900744,True
8010,validator_20,32369635977,True,250538002,37019380,287557382,True
8011,validator_36,96178379340,True,176884000,1495340,178379340,False
8012,validator_14,96154614641,True,154369001,245640,154614641,True
8013,validator_49,64113927600,True,106531000,7396600,113927600,False
8014,validator_10,32285223194,True,205217995,1274000,206491995,True
8015,validator_26,32129023220,True,127198000,1825220,129023220,False
8016,validator_15,256155790498,True,146766998,9023500,155790498,True
8017,validator_17,160156436885,True,153834995,2601890,156436885,True
8018,validator_26,32243406590,True,113210000,1173370,114383370,False
8019,validator_45,32051490100,True,49177000,2313100,51490100,False
8020,validator_2,32105319004,True,102862004,2457000,105319004,True
8021,validator_8,32110713802,True,102272002,8441800,110713802,True
8022,validator_36,96245362370,True,65874000,1109030,66983030,False
8023,validator_17,160241030247,True,83442002,1151360,84593362,True
8024,validator_5,64058544577,True,56815997,1728580,58544577,True
8025,validator_49,64237489200,True,123071000,490600,123561600,False
8026,validator_1,64108776200,True,107108000,1668200,108776200,True
8027,validator_22,64315376963,True,177391006,18830320,196221326,True
8028,validator_36,96426436140,True,172853000,8220770,181073770,False
8029,validator_18,96251438340,True,121131996,405600,121537596,True
8030,validator_42,32132562500,True,130713000,1849500,132562500,False
8031,validator_30,64144227700,True,143788000,439700,144227700,False
8032,validator_48,160062233800,True,60564000,1669800,62233800,False
8033,validator_0,32091705740,True,91060000,645740,91705740,True
8034,validator_46,96160055690,True,141097000,18958690,160055690,False
8035,validator_6,32196392499,True,178282999,18109500,196392499,True
8036,validator_44,96096102740,True,77335000,18767740,96102740,False
8037,validator_20,32509928209,True,138982002,1310230,140292232,True
8038,validator_19,64097218601,True,96766001,452600,97218601,True
8039,validator_28,32127028100,True,126863000,165100,127028100,False
8040,validator_20,32680394997,True,161901998,8564790,170466788,True
8041,validator_7,64115830700,True,110179000,5651700,115830700,True
8042,validator_31,160150960510,True,39317000,9503680,48820680,False
8043,validator_37,64121786260,True,120885000,901260,121786260,False
8044,validator_30,64291967800,True,146453000,1287100,147740100,False
8045,validator_18,96375830866,True,123397006,995520,124392526,True
8046,validator_5,64174887406,True,115113999,1228830,116342829,True
8047,validator_39,32214080600,True,154592000,469000,155061000,False
8048,validator_14,96267470135,True,107589004,5266490,112855494,True
8049,validator_31,160236404810,True,83952000,1492300,85444300,False
8050,validator_31,160394260010,True,156924000,931200,157855200,False
8051,validator_47,64133265520,True,131899000,1366520,133265520,False
8052,validator_49,64350589700,True,106720000,6380500,113100500,False
8053,validator_17,160396474310,True,154536003,908060,155444063,True
8054,validator_15,256355729397,True,199748999,189900,199938899,True
8055,validator_23,32390015342,True,220630001,1211840,221841841,True
8056,validator_30,64407800800,True,96594000,19239000,115833000,False
8057,validator_27,96208241720,True,66681000,19391020,86072020,False
8058,validator_49,64404679000,True,44841000,9248300,54089300,False
8059,validator_49,64509930100,True,103987000,1264100,105251100,False
8060,validator_5,64236361447,True,54046001,7428040,61474041,True
8061,validator_39,32287467040,True,71842000,1544440,73386440,False
8062,validator_11,32125884736,True,124358996,1525740,125884736,True
8063,validator_27,96397302020,True,187339000,1721300,189060300,False
8064,validator_10,32449723817,True,161783003,2717620,164500623,True
8065,validator_42,32242637510,True,105151000,4924010,110075010,False
8066,validator_26,32356554890,True,112692000,456300,113148300,False
8067,validator_8,32274637144,True,155500002,8423340,163923342,True
8068,validator_1,64305593603,True,195534003,1283400,196817403,True
8069,validator_34,256190492390,True,119423000,1075090,120498090,False
8070,validator_13,32223149303,True,221551003,1598300,223149303,True
8071,validator_6,32355786899,True,157010000,2384400,159394400,True
8072,validator_16,32086979880,True,85013000,1966880,86979880,True
8073,validator_22,64404704664,True,87845001,1482700,89327701,True
8074,validator_17,160582803207,True,168104997,18223900,186328897,True
8075,validator_19,64286477904,True,157924003,31335300,189259303,True
8076,validator_24,32083866943,True,76379003,7487940,83866943,True
8077,validator_23,32563014146,True,168397004,4601800,172998804,True
8078,validator_7,64306072878,True,181911998,8330180,190242178,True
8079,validator_17,160723045144,True,138752997,1488940,140241937,True
8080,validator_22,64563775964,True,140662000,18409300,159071300,True
8081,validator_5,64366616143,True,128208996,2045700,130254696,True
8082,validator_7,64418593980,True,111336002,1185100,112521102,True
8083,validator_29,32139901230,True,138183000,1718230,139901230,False
8084,validator_31,160519685800,True,124494000,931790,125425790,False
8085,validator_2,32219502804,True,113682000,501800,114183800,True
8086,validator_44,96298889560,True,196078000,6708820,202786820,False
8087,validator_21,64220749298,True,200862998,19886300,220749298,True
8088,validator_2,32405016062,True,182896998,2616260,185513258,True
8089,validator_36,96499132100,True,72226000,469960,72695960,False
8090,validator_32,32136029320,True,134878000,1151320,136029320,False
8091,validator_22,64656832446,True,91681002,1375480,93056482,True
8092,validator_8,32397995497,True,122346003,1012350,123358353,True
8093,validator_39,32386255380,True,93106000,5682340,98788340,False
8094,validator_36,96581026500,True,79861000,2033400,81894400,False
8095,validator_14,96356082137,True,86831002,1781000,88612002,True
8096,validator_20,32855076195,True,170931998,3749200,174681198,True
8097,validator_41,64056448650,True,55009000,1439650,56448650,False
8098,validator_19,64460251104,True,172881000,892200,173773200,True
8099,validator_4,32197037265,True,196668005,369260,197037265,True
8100,validator_0,32303471738,True,206241998,5524000,211765998,True
8101,validator_27,96473172220,True,68510000,7360200,75870200,False
8102,validator_12,96180170271,True,44532004,726080,45258084,True
8103,validator_26,32433430880,True,56918000,19957990,76875990,False
8104,validator_24,32220011886,True,133670003,2474940,136144943,True
8105,validator_46,96268260690,True,105480000,2725000,108205000,False
8106,validator_24,32512052716,True,286782000,5258830,292040830,True
8107,validator_2,32494254343,True,81546001,7692280,89238281,True
8108,validator_2,32658324242,True,145121999,18947900,164069899,True
8109,validator_25,32090763500,True,88025000,2738500,90763500,False
8110,validator_27,96598303420,True,124766000,365200,125131200,False
8111,validator_33,32155404720,True,154031000,1373720,155404720,False
8112,validator_14,96590178933,True,223876996,10219800,234096796,True
8113,validator_25,32237315330,True,142078000,4473830,146551830,False
8114,validator_38,32171005970,True,147166000,23839970,171005970,False
8115,validator_30,64526529000,True,116996000,1732200,118728200,False
8116,validator_28,32270414900,True,140330000,3056800,143386800,False
8117,validator_42,32316528710,True,66985000,6906200,73891200,False
8118,validator_7,64563205782,True,136222002,8389800,144611802,True
8119,validator_44,96464501860,True,163220000,2392300,165612300,False
8120,validator_14,96690209033,True,98630000,1400100,100030100,True
8121,validator_22,64827417248,True,170292002,292800,170584802,True
8122,validator_23,32659091588,True,90595002,5482440,96077442,True
8123,validator_17,160863717786,True,139708002,964640,140672642,True
8124,validator_7,64631014981,True,66648999,1160200,67809199,True
8125,validator_30,64674952140,True,146933000,1490140,148423140,False
8126,validator_46,96396717030,True,122112000,6344340,128456340,False
8127,validator_41,64110233790,True,52113000,1672140,53785140,False
8128,validator_10,32512167892,True,54972995,7471080,62444075,True
8129,validator_33,32258214720,True,101002000,1808000,102810000,False
8130,validator_43,64068961100,True,66625000,2336100,68961100,False
8131,validator_17,160932900487,True,68022001,1160700,69182701,True
8132,validator_8,32525010399,True,126315002,699900,127014902,True
8133,validator_28,32381217300,True,109582000,1220400,110802400,False
8134,validator_1,64374911773,True,68344000,974170,69318170,True
8135,validator_37,64208346100,True,78912000,7647840,86559840,False
8136,validator_4,32312890759,True,97697994,18155500,115853494,True
8137,validator_44,96628986790,True,163601000,883930,164484930,False
8138,validator_24,32589226640,True,74828004,2345920,77173924,True
8139,validator_23,32877869282,True,217681004,1096690,218777694,True
8140,validator_29,32282927630,True,140944000,2082400,143026400,False
8141,validator_14,96926333968,True,234565005,1559930,236124935,True
8142,validator_48,160134433560,True,72010000,189760,72199760,False
8143,validator_33,32301443220,True,35583000,7645500,43228500,False
8144,validator_2,32916716568,True,235123996,23268330,258392326,True
8145,validator_30,64862234940,True,186257000,1025800,187282800,False
8146,validator_36,96759594640,True,177100000,1468140,178568140,False
8147,validator_25,32311697110,True,72184000,2197780,74381780,False
8148,validator_28,32487106160,True,104952000,936860,105888860,False
8149,validator_32,32199288550,True,60109000,3150230,63259230,False
8150,validator_21,64325918796,True,103406998,1762500,105169498,True
8151,validator_16,32177105720,True,89085000,1040840,90125840,True
8152,validator_30,64979964540,True,116683000,1046600,117729600,False
8153,validator_34,256260026790,True,68294000,1240400,69534400,False
8154,validator_40,32152506220,True,144450000,8056220,152506220,False
8155,validator_9,32064992199,True,64162999,829200,64992199,True
8156,validator_36,96882325530,True,120995000,1735890,122730890,False
8157,validator_33,32417174410,True,113625000,2106190,115731190,False
8158,validator_26,32480345080,True,42012000,4902200,46914200,False
8159,validator_11,32230083232,True,103414996,783500,104198496,True
8160,validator_34,256371905290,True,110691000,1187500,111878500,False
8161,validator_2,32998602058,True,80092000,1793490,81885490,True
8162,validator_24,32749161842,True,153992002,5943200,159935202,True
8163,validator_46,96565987760,True,161790000,7480730,169270730,False
8164,validator_5,64494210345,True,127330002,264200,127594202,True
8165,validator_48,160258087590,True,122307000,1347030,123654030,False
8166,validator_3,32097967815,True,95980995,1986820,97967815,True
8167,validator_37,64283067630,True,74199000,522530,74721530,False
8168,validator_16,32328401912,True,149398992,1897200,151296192,True
8169,validator_28,32587898610,True,99970000,822450,100792450,False
8170,validator_43,64134959600,True,65003000,995500,65998500,False
8171,validator_34,256519955110,True,147377000,672820,148049820,False
8172,validator_22,64979086951,True,150345003,1324700,151669703,True
8173,validator_31,160601350210,True,63032000,18632410,81664410,False
8174,validator_24,32879804444,True,129085002,1557600,130642602,True
8175,validator_28,32688272750,True,99653000,721140,100374140,False
8176,validator_23,33111527814,True,225309002,8349530,233658532,True
8177,validator_27,96672843220,True,73596000,943800,74539800,False
8178,validator_11,32356207535,True,123683003,2441300,126124303,True
8179,validator_31,160655539710,True,53207000,982500,54189500,False
8180,validator_31,160831378210,True,173878000,1960500,175838500,False
8181,validator_11,32462831350,True,105791005,832810,106623815,True
8182,validator_30,65218514130,True,236946000,1603590,238549590,False
8183,validator_32,32370526450,True,169836000,1401900,171237900,False
8184,validator_34,256553508910,True,31669000,1884800,33553800,False
8185,validator_45,32178331600,True,118892000,7949500,126841500,False
8186,validator_14,97055189771,True,122766003,6089800,128855803,True
8187,validator_26,32621545540,True,139678000,1522460,141200460,False
8188,validator_0,32570817739,True,266668001,678000,267346001,True
8189,validator_45,32301636500,True,120922000,2382900,123304900,False
8190,validator_10,32579391641,True,66345999,877750,67223749,True
8191,validator_15,256536242096,True,174404999,6107700,180512699,True
8192,validator_46,96630457500,True,63371000,1098740,64469740,False
8193,validator_17,161201492184,True,267303997,1287700,268591697,True
8194,validator_41,64202268390,True,91396000,638600,92034600,False
8195,validator_1,64445662478,True,65702005,5048700,70750705,True
8196,validator_45,32370626100,True,50049000,18940600,68989600,False
8197,validator_18,96632147665,True,256171999,144800,256316799,True
8198,validator_21,64448269396,True,121172000,1178600,122350600,True
8199,validator_40,32227341220,True,66025000,8810000,74835000,False
8200,validator_34,256862729450,True,307699000,1521540,309220540,False
8201,validator_39,32490665380,True,95257000,9153000,104410000,False
8202,validator_9,32177473731,True,111633002,848530,112481532,True
8203,validator_10,32742363670,True,162542999,429030,162972029,True
8204,validator_12,96264618472,True,79456001,4992200,84448201,True
8205,validator_13,32306582305,True,82500002,933000,83433002,True
8206,validator_28,32773867390,True,84141000,1453640,85594640,False
8207,validator_20,33030788199,True,175004004,708000,175712004,True
8208,validator_3,32244723919,True,144769004,1987100,146756104,True
8209,validator_9,32264405232,True,85662001,1269500,86931501,True
8210,validator_32,32520659200,True,148453000,1679750,150132750,False
8211,validator_9,32352213403,True,87596001,212170,87808171,True
8212,validator_7,64833475323,True,182751002,19709340,202460342,True
8213,validator_37,64379572260,True,94649000,1855630,96504630,False
8214,validator_41,64315343990,True,112706000,369600,113075600,False
8215,validator_35,96145664440,True,140152000,5512440,145664440,False
8216,validator_15,256705459198,True,167979002,1238100,169217102,True
8217,validator_9,32496174458,True,143071005,890050,143961055,True
8218,validator_20,33214280319,True,183125000,367120,183492120,True
8219,validator_13,32399950537,True,92141002,1227230,93368232,True
8220,validator_0,32764646744,True,190593005,3236000,193829005,True
8221,validator_16,32435396814,True,106554002,440900,106994902,True
8222,validator_22,65076949954,True,95150003,2713000,97863003,True
8223,validator_2,33274207155,True,265286997,10318100,275605097,True
8224,validator_17,161414981382,True,212833998,655200,213489198,True
8225,validator_22,65176882453,True,91971999,7960500,99932499,True
8226,validator_44,96734361590,True,104667000,707800,105374800,False
8227,validator_34,257022777290,True,157537000,2510840,160047840,False
8228,validator_15,256861617839,True,154678001,1480640,156158641,True
8229,validator_8,32730552765,True,202368006,3174360,205542366,True
8230,validator_37,64539113440,True,157720000,1821180,159541180,False
8231,validator_42,32515360900,True,198268000,564190,198832190,False
8232,validator_27,96750440920,True,76832000,765700,77597700,False
8233,validator_42,32594606420,True,78987000,258520,79245520,False
8234,validator_44,96896325190,True,160976000,987600,161963600,False
8235,validator_33,32551273840,True,116100000,17999430,134099430,False
8236,validator_44,96988589180,True,91552000,711990,92263990,False
8237,validator_30,65360338930,True,135019000,6805800,141824800,False
8238,validator_39,32579653080,True,88043000,944700,88987700,False
8239,validator_17,161550998957,True,117368005,18649570,136017575,True
8240,validator_22,65248881249,True,70495996,1502800,71998796,True
8241,validator_41,64470026790,True,149011000,5671800,154682800,False
8242,validator_42,32811788050,True,216225000,956630,217181630,False
8243,validator_28,33006680830,True,231315000,1498440,232813440,False
8244,validator_41,64575864020,True,105663000,174230,105837230,False
8245,validator_18,96697072166,True,59833001,5091500,64924501,True
8246,validator_33,32628906140,True,69647000,7985300,77632300,False
8247,validator_9,32760382199,True,244726001,19481740,264207741,True
8248,validator_13,32474419672,True,73887005,582130,74469135,True
8249,validator_7,64971316618,True,129706995,8134300,137841295,True
8250,validator_35,96217195140,True,70204000,1326700,71530700,False
8251,validator_10,32858557273,True,111377003,4816600,116193603,True
8252,validator_6,32552324623,True,186499004,10038720,196537724,True
8253,validator_5,64553094173,True,56430998,2452830,58883828,True
8254,validator_43,64213434730,True,76976000,1499130,78475130,False
8255,validator_17,161720082560,True,167300003,1783600,169083603,True
8256,validator_12,96540014200,True,273916998,1478730,275395728,True
8257,validator_39,32770814980,True,182395000,8766900,191161900,False
8258,validator_48,160518991990,True,260035000,869400,260904400,False
8259,validator_26,32743220170,True,120993000,681630,121674630,False
8260,validator_44,97092160410,True,102468000,1103230,103571230,False
8261,validator_44,97232894200,True,122591000,18142790,140733790,False
8262,validator_0,33000630716,True,215917002,20066970,235983972,True
8263,validator_9,32884689831,True,123709002,598630,124307632,True
8264,validator_18,96767329500,True,69121994,1135340,70257334,True
8265,validator_49,64657664550,True,146219000,1515450,147734450,False
8266,validator_45,32426902800,True,56245000,31700,56276700,False
8267,validator_29,32476325520,True,149262000,44135890,193397890,False
8268,validator_9,33010236625,True,122311994,3234800,125546794,True
8269,validator_14,97196126673,True,140208002,728900,140936902,True
8270,validator_20,33319411520,True,103848001,1283200,105131201,True
8271,validator_1,64582262879,True,128610001,7990400,136600401,True
8272,validator_32,32717866920,True,195471000,1736720,197207720,False
8273,validator_12,96650629780,True,109634000,981580,110615580,True
8274,validator_3,32355512285,True,109367006,1421360,110788366,True
8275,validator_47,64270605620,True,137095000,245100,137340100,False
8276,validator_5,64609891196,True,48769003,8028020,56797023,True
8277,validator_19,64627654806,True,166704002,699700,167403702,True
8278,validator_22,65383432878,True,126729999,7821630,134551629,True
8279,validator_41,64681242280,True,104065000,1313260,105378260,False
8280,validator_21,64547964984,True,81852998,17842590,99695588,True
8281,validator_16,32568842813,True,132503999,942000,133445999,True
8282,validator_5,64731514897,True,119752001,1871700,121623701,True
8283,validator_24,33046350844,True,166336000,210400,166546400,True
8284,validator_19,64770472408,True,141754002,1063600,142817602,True
8285,validator_8,32930217862,True,191728997,7936100,199665097,True
8286,validator_2,33441862997,True,162971002,4684840,167655842,True
8287,validator_38,32261948070,True,89690000,1252100,90942100,False
8288,validator_31,161036249610,True,202889000,1982400,204871400,False
8289,validator_39,32857182410,True,85536000,831430,86367430,False
8290,validator_26,32909661970,True,158141000,8300800,166441800,False
8291,validator_1,64682613283,True,94741004,5609400,100350404,True
8292,validator_5,64943237896,True,209981999,1741000,211722999,True
8293,validator_2,33681030698,True,219914001,19253700,239167701,True
8294,validator_4,32493495860,True,161874001,18731100,180605101,True
8295,validator_18,96897681031,True,129802001,549530,130351531,True
8296,validator_23,33319116513,True,205846999,1741700,207588699,True
8297,validator_47,64402748520,True,130107000,2035900,132142900,False
8298,validator_1,64858820885,True,158064002,18143600,176207602,True
8299,validator_12,96719953974,True,68150004,1174190,69324194,True
8300,validator_1,65002329778,True,122948993,20559900,143508893,True
8301,validator_26,32990870500,True,76323000,4885530,81208530,False
8302,validator_4,32584442862,True,89033002,1914000,90947002,True
8303,validator_37,64639359040,True,99078000,1167600,100245600,False
8304,validator_36,97017090230,True,133929000,835700,134764700,False
8305,validator_11,32568054848,True,104311998,911500,105223498,True
8306,validator_35,96311876120,True,92869000,1811980,94680980,False
8307,validator_44,97342247100,True,100654000,8698900,109352900,False
8308,validator_29,32538968920,True,61967000,676400,62643400,False
8309,validator_47,64523876240,True,120576000,551720,121127720,False
8310,validator_30,65433688400,True,54580000,18769470,73349470,False
8311,validator_15,256977709968,True,111629999,4462130,116092129,True
8312,validator_10,33010288575,True,149318002,2413300,151731302,True
8313,validator_14,97421515476,True,224747003,641800,225388803,True
8314,validator_34,257105816490,True,78219000,4820200,83039200,False
8315,validator_42,32950638450,True,135800000,3050400,138850400,False
8316,validator_43,64287842530,True,73452000,955800,74407800,False
8317,validator_19,64924817612,True,153218004,1127200,154345204,True
8318,validator_32,32775388920,True,56225000,1297000,57522000,False
8319,validator_37,64781567860,True,121515000,20693820,142208820,False
8320,validator_39,32981769810,True,116296000,8291400,124587400,False
8321,validator_23,33580650715,True,259703002,1831200,261534202,True
8322,validator_22,65537398963,True,152925995,1040090,153966085,True
8323,validator_28,33064531330,True,55413000,2437500,57850500,False
8324,validator_4,32646863994,True,61087002,1334130,62421132,True
8325,validator_35,96551254120,True,231547000,7831000,239378000,False
8326,validator_18,97026434232,True,123356001,5397200,128753201,True
8327,validator_40,32392268190,True,156846000,8080970,164926970,False
8328,validator_47,64596624140,True,72405000,342900,72747900,False
8329,validator_10,33136720121,True,125662996,768550,126431546,True
8330,validator_15,257052723666,True,74072998,940700,75013698,True
8331,validator_28,33164586630,True,98627000,1428300,100055300,False
8332,validator_15,257216838269,True,161607003,2507600,164114603,True
8333,validator_34,257181393920,True,74099000,1478430,75577430,False
8334,validator_29,32715847160,True,175942000,936240,176878240,False
8335,validator_35,96712867840,True,160213000,1400720,161613720,False
8336,validator_20,33417670378,True,97652998,605860,98258858,True
8337,validator_16,32701072835,True,129479002,2751020,132230022,True
8338,validator_48,160665240260,True,144077000,2171270,146248270,False
8339,validator_22,65695590015,True,156598002,1593050,158191052,True
8340,validator_6,32672597051,True,117579998,2692430,120272428,True
8341,validator_41,64728679700,True,44779000,2658420,47437420,False
8342,validator_7,65037215436,True,65532998,365820,65898818,True
8343,validator_35,96842423940,True,103717000,25839100,129556100,False
8344,validator_35,96947494910,True,103817000,1253970,105070970,False
8345,validator_42,33061549690,True,109579000,1332240,110911240,False
8346,validator_21,64670096486,True,119880002,2251500,122131502,True
8347,validator_12,96791492602,True,71303998,234630,71538628,True
8348,validator_20,33503377683,True,78838005,6869300,85707305,True
8349,validator_17,161838949656,True,117739996,1127100,118867096,True
8350,validator_10,33234470116,True,95728995,2021000,97749995,True
8351,validator_19,65142164911,True,212010999,5336300,217347299,True
8352,validator_8,32973169439,True,41337997,1613580,42951577,True
8353,validator_1,65142175741,True,139737003,108960,139845963,True
8354,validator_1,65377254733,True,229549992,5529000,235078992,True
8355,validator_15,257294777771,True,77108002,831500,77939502,True
8356,validator_14,97510114981,True,87146005,1453500,88599505,True
8357,validator_0,33074362558,True,71242002,2489840,73731842,True
8358,validator_26,33077721770,True,86369000,482270,86851270,False
8359,validator_35,97098741650,True,146777000,4469740,151246740,False
8360,validator_45,32469687400,True,36848000,5936600,42784600,False
8361,validator_41,64839622140,True,109353000,1589440,110942440,False
8362,validator_34,257259544820,True,76223000,1927900,78150900,False
8363,validator_2,33810469926,True,129129998,309230,129439228,True
8364,validator_28,33296913830,True,131653000,674200,132327200,False
8365,validator_0,33140670477,True,65938999,368920,66307919,True
8366,validator_2,33977300364,True,164154998,2675440,166830438,True
8367,validator_7,65091744813,True,53436997,1092380,54529377,True
8368,validator_39,33159090310,True,175642000,1678500,177320500,False
8369,validator_17,161987545152,True,147474996,1120500,148595496,True
8370,validator_6,32827303226,True,153809995,896180,154706175,True
8371,validator_22,65833723804,True,137615999,517790,138133789,True
8372,validator_23,33664753020,True,65039005,19063300,84102305,True
8373,validator_32,32846301520,True,69174000,1738600,70912600,False
8374,validator_48,160897688460,True,231034000,1414200,232448200,False
8375,validator_44,97468875800,True,123596000,3032700,126628700,False
8376,validator_28,33394305890,True,88149000,9243060,97392060,False
8377,validator_48,161037245680,True,121028000,18529220,139557220,False
8378,validator_31,161148875930,True,112280000,346320,112626320,False
8379,validator_20,33618602981,True,113946998,1278300,115225298,True
8380,validator_34,257436884470,True,175754000,1585650,177339650,False
8381,validator_24,33097902340,True,50448996,1102500,51551496,True
8382,validator_17,162092811941,True,81205999,24060790,105266789,True
8383,validator_17,162229427360,True,130844999,5770420,136615419,True
8384,validator_43,64519337230,True,230873000,621700,231494700,False
8385,validator_23,33820066818,True,145053998,10259800,155313798,True
8386,validator_31,161258943560,True,107512000,2555630,110067630,False
8387,validator_41,64994448440,True,135539000,19287300,154826300,False
8388,validator_27,96868737620,True,116715000,1581700,118296700,False
8389,validator_23,33947936915,True,125212997,2657100,127870097,True
8390,validator_19,65363878013,True,202513002,19200100,221713102,True
8391,validator_37,64903469350,True,104066000,17835490,121901490,False
8392,validator_31,161398873490,True,139698000,231930,139929930,False
8393,validator_23,34193975555,True,245808000,230640,246038640,True
8394,validator_22,66102930932,True,267001008,2206120,269207128,True
8395,validator_5,64994453826,True,49826000,1389930,51215930,True
8396,validator_9,33185530919,True,156009994,19284300,175294294,True
8397,validator_47,64699795280,True,84487000,18684140,103171140,False
8398,validator_32,32995214020,True,147027000,1885500,148912500,False
8399,validator_18,97210780019,True,183173997,1171790,184345787,True
8400,validator_35,97226706450,True,125909000,2055800,127964800,False
8401,validator_48,161141172410,True,96145000,7781730,103926730,False
8402,validator_37,64985428650,True,79907000,2052300,81959300,False
8403,validator_18,97289567519,True,76473000,2314500,78787500,True
8404,validator_47,64888131610,True,186445000,1891330,188336330,False
8405,validator_8,33091362567,True,117330998,862130,118193128,True
8406,validator_34,257559003930,True,121925000,194460,122119460,False
8407,validator_9,33311168119,True,125538000,99200,125637200,True
8408,validator_25,32396618910,True,77065000,7856800,84921800,False
8409,validator_25,32434134990,True,37427000,89080,37516080,False
8410,validator_44,97549021800,True,79662000,484000,80146000,False
8411,validator_34,257652965410,True,91209000,2752480,93961480,False
8412,validator_41,65133063630,True,137544000,1071190,138615190,False
8413,validator_11,32642448547,True,73478999,914700,74393699,True
8414,validator_41,65259459430,True,125537000,858800,126395800,False
8415,validator_10,33349901703,True,113673997,1757590,115431587,True
8416,validator_30,65588078440,True,153389000,1001040,154390040,False
8417,validator_12,96924248624,True,129693002,3063020,132756022,True
8418,validator_35,97278520350,True,51070000,743900,51813900,False
8419,validator_23,34354506156,True,154875001,5655600,160530601,True
8420,validator_13,32621024202,True,145897000,707530,146604530,True
8421,validator_38,32355483970,True,91433000,2102900,93535900,False
8422,validator_45,32591369470,True,121138000,544070,121682070,False
8423,validator_47,64972520140,True,82411000,1977530,84388530,False
8424,validator_8,33338575549,True,245604002,1608980,247212982,True
8425,validator_41,65447044380,True,185780000,1804950,187584950,False
8426,validator_37,65104051370,True,116661000,1961720,118622720,False
8427,validator_45,32664322610,True,71950000,1003140,72953140,False
8428,validator_39,33226088880,True,65360000,1638570,66998570,False
8429,validator_2,34138093882,True,160119998,673520,160793518,True
8430,validator_23,34465412247,True,110457001,449090,110906091,True
8431,validator_48,161250196310,True,108786000,237900,109023900,False
8432,validator_42,33211268790,True,125142000,24577100,149719100,False
8433,validator_42,33352769270,True,132671000,8829480,141500480,False
8434,validator_14,97577068557,True,65735006,1218570,66953576,True
8435,validator_6,32932645768,True,104120002,1222540,105342542,True
8436,validator_49,64727111350,True,63633000,5813800,69446800,False
8437,validator_12,97129157240,True,203846996,1061620,204908616,True
8438,validator_34,257816197610,True,160302000,2930200,163232200,False
8439,validator_11,32885163844,True,233455997,9259300,242715297,True
8440,validator_15,257362638169,True,66905998,954400,67860398,True
8441,validator_18,97393813320,True,96431001,7814800,104245801,True
8442,validator_9,33383803125,True,71810006,825000,72635006,True
8443,validator_35,97343440470,True,61996000,2924120,64920120,False
8444,validator_26,33151768770,True,72409000,1638000,74047000,False
8445,validator_37,65187214590,True,70509000,12654220,83163220,False
8446,validator_15,257543849455,True,179414996,1796290,181211286,True
8447,validator_31,161471580170,True,52268000,20438680,72706680,False
8448,validator_41,65599926280,True,133649000,19232900,152881900,False
8449,validator_0,33285253298,True,143930001,652820,144582821,True
8450,validator_4,32885011535,True,211383001,26764540,238147541,True
8451,validator_9,33553944856,True,168511001,1630730,170141731,True
8452,validator_49,64827182150,True,99802000,268800,100070800,False
8453,validator_48,161330054990,True,79297000,561680,79858680,False
8454,validator_14,97720056717,True,142444000,544160,142988160,True
8455,validator_37,65279878520,True,91517000,1146930,92663930,False
8456,validator_47,65172368540,True,189828000,10020400,199848400,False
8457,validator_34,257925985150,True,108785000,1002540,109787540,False
8458,validator_0,33525041898,True,239616000,172600,239788600,True
8459,validator_33,32702853330,True,68646000,5301190,73947190,False
8460,validator_25,32586564690,True,151905000,524700,152429700,False
8461,validator_23,34570956449,True,105198002,346200,105544202,True
8462,validator_34,257995417450,True,68940000,492300,69432300,False
8463,validator_41,65758527820,True,158371000,230540,158601540,False
8464,validator_8,33497080448,True,157917999,586900,158504899,True
8465,validator_2,34345176458,True,201736996,5345580,207082576,True
8466,validator_9,33663989857,True,107875001,2170000,110045001,True
8467,validator_10,33479713199,True,129140006,671490,129811496,True
8468,validator_17,162390654244,True,160129004,1097880,161226884,True
8469,validator_27,96939049820,True,69264000,1048200,70312200,False
8470,validator_37,65468485400,True,188386000,220880,188606880,False
8471,validator_21,64920924590,True,230350004,20478100,250828104,True
8472,validator_14,97873075414,True,151900997,1117700,153018697,True
8473,validator_38,32450552870,True,76917000,18151900,95068900,False
8474,validator_5,65091121627,True,86393001,10274800,96667801,True
8475,validator_17,162486066642,True,93792998,1619400,95412398,True
8476,validator_28,33489781430,True,94562000,913540,95475540,False
8477,validator_17,162632329723,True,137815001,8448080,146263081,True
8478,validator_22,66253191951,True,149864999,396020,150261019,True
8479,validator_22,66348920514,True,94435003,1293560,95728563,True
8480,validator_34,258037489380,True,41794000,277930,42071930,False
8481,validator_35,97457088650,True,112812000,836180,113648180,False
8482,validator_8,33543817439,True,44614001,2122990,46736991,True
8483,validator_49,64888812950,True,61083000,547800,61630800,False
8484,validator_12,97231397940,True,101949000,291700,102240700,True
8485,validator_26,33297978170,True,144318000,1891400,146209400,False
8486,validator_14,98055855834,True,181259000,1521420,182780420,True
8487,validator_14,98284446450,True,227209996,1380620,228590616,True
8488,validator_48,161620843350,True,289525000,1263360,290788360,False
8489,validator_34,258124498780,True,86124000,885400,87009400,False
8490,validator_28,33548256670,True,57673000,802240,58475240,False
8491,validator_47,65319591440,True,146450000,772900,147222900,False
8492,validator_13,32825010207,True,185584995,18401010,203986005,True
8493,validator_3,32528948106,True,172691001,744820,173435821,True
8494,validator_15,257674571963,True,128414998,2307510,130722508,True
8495,validator_40,32499938490,True,99244000,8426300,107670300,False
8496,validator_17,162740220724,True,99874001,8017000,107891001,True
8497,validator_8,33720913877,True,175799998,1296440,177096438,True
8498,validator_30,65683024240,True,94102000,843800,94945800,False
8499,validator_24,33167102943,True,68934003,266600,69200603,True
8500,validator_10,32078731199,True,78080999,650200,78731199,True
8501,validator_12,96134912187,True,134307997,604190,134912187,True
8502,validator_31,160102139830,True,93211000,8928830,102139830,False
8503,validator_23,32168173501,True,159551001,8622500,168173501,True
8504,validator_34,256069994300,True,59731000,10263300,69994300,False
8505,validator_39,32059019600,True,58732000,287600,59019600,False
8506,validator_20,32082078595,True,80586995,1491600,82078595,True
8507,validator_22,64119155637,True,117292007,1863630,119155637,True
8508,validator_27,96122169700,True,120872000,1297700,122169700,False
8509,validator_18,96129900744,True,126718004,3182740,129900744,True
8510,validator_20,32369635977,True,250538002,37019380,287557382,True
8511,validator_36,96178379340,True,176884000,1495340,178379340,False
8512,validator_14,96154614641,True,154369001,245640,154614641,True
8513,validator_49,64113927600,True,106531000,7396600,113927600,False
8514,validator_10,32285223194,True,205217995,1274000,206491995,True
8515,validator_26,32129023220,True,127198000,1825220,129023220,False
8516,validator_15,256155790498,True,146766998,9023500,155790498,True
8517,validator_17,160156436885,True,153834995,2601890,156436885,True
8518,validator_26,32243406590,True,113210000,1173370,114383370,False
8519,validator_45,32051490100,True,49177000,2313100,51490100,False
8520,validator_2,32105319004,True,102862004,2457000,105319004,True
8521,validator_8,32110713802,True,102272002,8441800,110713802,True
8522,validator_36,96245362370,True,65874000,1109030,66983030,False
8523,validator_17,160241030247,True,83442002,1151360,84593362,True
8524,validator_5,64058544577,True,56815997,1728580,58544577,True
8525,validator_49,64237489200,True,123071000,490600,123561600,False
8526,validator_1,64108776200,True,107108000,1668200,108776200,True
8527,validator_22,64315376963,True,177391006,18830320,196221326,True
8528,validator_36,96426436140,True,172853000,8220770,181073770,False
8529,validator_18,96251438340,True,121131996,405600,121537596,True
8530,validator_42,32132562500,True,130713000,1849500,132562500,False
8531,validator_30,64144227700,True,143788000,439700,144227700,False
8532,validator_48,160062233800,True,60564000,1669800,62233800,False
8533,validator_0,32091705740,True,91060000,645740,91705740,True
8534,validator_46,96160055690,True,141097000,18958690,160055690,False
8535,validator_6,32196392499,True,178282999,18109500,196392499,True
8536,validator_44,96096102740,True,77335000,18767740,96102740,False
8537,validator_20,32509928209,True,138982002,1310230,140292232,True
8538,validator_19,64097218601,True,96766001,452600,97218601,True
8539,validator_28,32127028100,True,126863000,165100,127028100,False
8540,validator_20,32680394997,True,161901998,8564790,170466788,True
8541,validator_7,64115830700,True,110179000,5651700,115830700,True
8542,validator_31,160150960510,True,39317000,9503680,48820680,False
8543,validator_37,64121786260,True,120885000,901260,121786260,False
8544,validator_30,64291967800,True,146453000,1287100,147740100,False
8545,validator_18,96375830866,True,123397006,995520,124392526,True
8546,validator_5,64174887406,True,115113999,1228830,116342829,True
8547,validator_39,32214080600,True,154592000,469000,155061000,False
8548,validator_14,96267470135,True,107589004,5266490,112855494,True
8549,validator_31,160236404810,True,83952000,1492300,85444300,False
8550,validator_31,160394260010,True,156924000,931200,157855200,False
8551,validator_47,64133265520,True,131899000,1366520,133265520,False
8552,validator_49,64350589700,True,106720000,6380500,113100500,False
8553,validator_17,160396474310,True,154536003,908060,155444063,True
8554,validator_15,256355729397,True,199748999,189900,199938899,True
8555,validator_23,32390015342,True,220630001,1211840,221841841,True
8556,validator_30,64407800800,True,96594000,19239000,115833000,False
8557,validator_27,96208241720,True,66681000,19391020,86072020,False
8558,validator_49,64404679000,True,44841000,9248300,54089300,False
8559,validator_49,64509930100,True,103987000,1264100,105251100,False
8560,validator_5,64236361447,True,54046001,7428040,61474041,True
8561,validator_39,32287467040,True,71842000,1544440,73386440,False
8562,validator_11,32125884736,True,124358996,1525740,125884736,True
8563,validator_27,96397302020,True,187339000,1721300,189060300,False
8564,validator_10,32449723817,True,161783003,2717620,164500623,True
8565,validator_42,32242637510,True,105151000,4924010,110075010,False
8566,validator_26,32356554890,True,112692000,456300,113148300,False
8567,validator_8,32274637144,True,155500002,8423340,163923342,True
8568,validator_1,64305593603,True,195534003,1283400,196817403,True
8569,validator_34,256190492390,True,119423000,1075090,120498090,False
8570,validator_13,32223149303,True,221551003,1598300,223149303,True
8571,validator_6,32355786899,True,157010000,2384400,159394400,True
8572,validator_16,32086979880,True,85013000,1966880,86979880,True
8573,validator_22,64404704664,True,87845001,1482700,89327701,True
8574,validator_17,160582803207,True,168104997,18223900,186328897,True
8575,validator_19,64286477904,True,157924003,31335300,189259303,True
8576,validator_24,32083866943,True,76379003,7487940,83866943,True
8577,validator_23,32563014146,True,168397004,4601800,172998804,True
8578,validator_7,64306072878,True,181911998,8330180,190242178,True
8579,validator_17,160723045144,True,138752997,1488940,140241937,True
8580,validator_22,64563775964,True,140662000,18409300,159071300,True
8581,validator_5,64366616143,True,128208996,2045700,130254696,True
8582,validator_7,64418593980,True,111336002,1185100,112521102,True
8583,validator_29,32139901230,True,138183000,1718230,139901230,False
8584,validator_31,160519685800,True,124494000,931790,125425790,False
8585,validator_2,32219502804,True,113682000,501800,114183800,True
8586,validator_44,96298889560,True,196078000,6708820,202786820,False
8587,validator_21,64220749298,True,200862998,19886300,220749298,True
8588,validator_2,32405016062,True,182896998,2616260,185513258,True
8589,validator_36,96499132100,True,72226000,469960,72695960,False
8590,validator_32,32136029320,True,134878000,1151320,136029320,False
8591,validator_22,64656832446,True,91681002,1375480,93056482,True
8592,validator_8,32397995497,True,122346003,1012350,123358353,True
8593,validator_39,32386255380,True,93106000,5682340,98788340,False
8594,validator_36,96581026500,True,79861000,2033400,81894400,False
8595,validator_14,96356082137,True,86831002,1781000,88612002,True
8596,validator_20,32855076195,True,170931998,3749200,174681198,True
8597,validator_41,64056448650,True,55009000,1439650,56448650,False
8598,validator_19,64460251104,True,172881000,892200,173773200,True
8599,validator_4,32197037265,True,196668005,369260,197037265,True
8600,validator_0,32303471738,True,206241998,5524000,211765998,True
8601,validator_27,96473172220,True,68510000,7360200,75870200,False
8602,validator_12,96180170271,True,44532004,726080,45258084,True
8603,validator_26,32433430880,True,56918000,19957990,76875990,False
8604,validator_24,32220011886,True,133670003,2474940,136144943,True
8605,validator_46,96268260690,True,105480000,2725000,108205000,False
8606,validator_24,32512052716,True,286782000,5258830,292040830,True
8607,validator_2,32494254343,True,81546001,7692280,89238281,True
8608,validator_2,32658324242,True,145121999,18947900,164069899,True
8609,validator_25,32090763500,True,88025000,2738500,90763500,False
8610,validator_27,96598303420,True,124766000,365200,125131200,False
8611,validator_33,32155404720,True,154031000,1373720,155404720,False
8612,validator_14,96590178933,True,223876996,10219800,234096796,True
8613,validator_25,32237315330,True,142078000,4473830,146551830,False
8614,validator_38,32171005970,True,147166000,23839970,171005970,False
8615,validator_30,64526529000,True,116996000,1732200,118728200,False
8616,validator_28,32270414900,True,140330000,3056800,143386800,False
8617,validator_42,32316528710,True,66985000,6906200,73891200,False
8618,validator_7,64563205782,True,136222002,8389800,144611802,True
8619,validator_44,96464501860,True,163220000,2392300,165612300,False
8620,validator_14,96690209033,True,98630000,1400100,100030100,True
8621,validator_22,64827417248,True,170292002,292800,170584802,True
8622,validator_23,32659091588,True,90595002,5482440,96077442,True
8623,validator_17,160863717786,True,139708002,964640,140672642,True
8624,validator_7,64631014981,True,66648999,1160200,67809199,True
8625,validator_30,64674952140,True,146933000,1490140,148423140,False
8626,validator_46,96396717030,True,122112000,6344340,128456340,False
8627,validator_41,64110233790,True,52113000,1672140,53785140,False
8628,validator_10,32512167892,True,54972995,7471080,62444075,True
8629,validator_33,32258214720,True,101002000,1808000,102810000,False
8630,validator_43,64068961100,True,66625000,2336100,68961100,False
8631,validator_17,160932900487,True,68022001,1160700,69182701,True
8632,validator_8,32525010399,True,126315002,699900,127014902,True
8633,validator_28,32381217300,True,109582000,1220400,110802400,False
8634,validator_1,64374911773,True,68344000,974170,69318170,True
8635,validator_37,64208346100,True,78912000,7647840,86559840,False
8636,validator_4,32312890759,True,97697994,18155500,115853494,True
8637,validator_44,96628986790,True,163601000,883930,164484930,False
8638,validator_24,32589226640,True,74828004,2345920,77173924,True
8639,validator_23,32877869282,True,217681004,1096690,218777694,True
8640,validator_29,32282927630,True,140944000,2082400,143026400,False
8641,validator_14,96926333968,True,234565005,1559930,236124935,True
8642,validator_48,160134433560,True,72010000,189760,72199760,False
8643,validator_33,32301443220,True,35583000,7645500,43228500,False
8644,validator_2,32916716568,True,235123996,23268330,258392326,True
8645,validator_30,64862234940,True,186257000,1025800,187282800,False
8646,validator_36,96759594640,True,177100000,1468140,178568140,False
8647,validator_25,32311697110,True,72184000,2197780,74381780,False
8648,validator_28,32487106160,True,104952000,936860,105888860,False
8649,validator_32,32199288550,True,60109000,3150230,63259230,False
8650,validator_21,64325918796,True,103406998,1762500,105169498,True
8651,validator_16,32177105720,True,89085000,1040840,90125840,True
8652,validator_30,64979964540,True,116683000,1046600,117729600,False
8653,validator_34,256260026790,True,68294000,1240400,69534400,False
8654,validator_40,32152506220,True,144450000,8056220,152506220,False
8655,validator_9,32064992199,True,64162999,829200,64992199,True
8656,validator_36,96882325530,True,120995000,1735890,122730890,False
8657,validator_33,32417174410,True,113625000,2106190,115731190,False
8658,validator_26,32480345080,True,42012000,4902200,46914200,False
8659,validator_11,32230083232,True,103414996,783500,104198496,True
8660,validator_34,256371905290,True,110691000,1187500,111878500,False
8661,validator_2,32998602058,True,80092000,1793490,81885490,True
8662,validator_24,32749161842,True,153992002,5943200,159935202,True
8663,validator_46,96565987760,True,161790000,7480730,169270730,False
8664,validator_5,64494210345,True,127330002,264200,127594202,True
8665,validator_48,160258087590,True,122307000,1347030,123654030,False
8666,validator_3,32097967815,True,95980995,1986820,97967815,True
8667,validator_37,64283067630,True,74199000,522530,74721530,False
8668,validator_16,32328401912,True,149398992,1897200,151296192,True
8669,validator_28,32587898610,True,99970000,822450,100792450,False
8670,validator_43,64134959600,True,65003000,995500,65998500,False
8671,validator_34,256519955110,True,147377000,672820,148049820,False
8672,validator_22,64979086951,True,150345003,1324700,151669703,True
8673,validator_31,160601350210,True,63032000,18632410,81664410,False
8674,validator_24,32879804444,True,129085002,1557600,130642602,True
8675,validator_28,32688272750,True,99653000,721140,100374140,False
8676,validator_23,33111527814,True,225309002,8349530,233658532,True
8677,validator_27,96672843220,True,73596000,943800,74539800,False
8678,validator_11,32356207535,True,123683003,2441300,126124303,True
8679,validator_31,160655539710,True,53207000,982500,54189500,False
8680,validator_31,160831378210,True,173878000,1960500,175838500,False
8681,validator_11,32462831350,True,105791005,832810,106623815,True
8682,validator_30,65218514130,True,236946000,1603590,238549590,False
8683,validator_32,32370526450,True,169836000,1401900,171237900,False
8684,validator_34,256553508910,True,31669000,1884800,33553800,False
8685,validator_45,32178331600,True,118892000,7949500,126841500,False
8686,validator_14,97055189771,True,122766003,6089800,128855803,True
8687,validator_26,32621545540,True,139678000,1522460,141200460,False
8688,validator_0,32570817739,True,266668001,678000,267346001,True
8689,validator_45,32301636500,True,120922000,2382900,123304900,False
8690,validator_10,32579391641,True,66345999,877750,67223749,True
8691,validator_15,256536242096,True,174404999,6107700,180512699,True
8692,validator_46,96630457500,True,63371000,1098740,64469740,False
8693,validator_17,161201492184,True,267303997,1287700,268591697,True
8694,validator_41,64202268390,True,91396000,638600,92034600,False
8695,validator_1,64445662478,True,65702005,5048700,70750705,True
8696,validator_45,32370626100,True,50049000,18940600,68989600,False
8697,validator_18,96632147665,True,256171999,144800,256316799,True
8698,validator_21,64448269396,True,121172000,1178600,122350600,True
8699,validator_40,32227341220,True,66025000,8810000,74835000,False
8700,validator_34,256862729450,True,307699000,1521540,309220540,False
8701,validator_39,32490665380,True,95257000,9153000,104410000,False
8702,validator_9,32177473731,True,111633002,848530,112481532,True
8703,validator_10,32742363670,True,162542999,429030,162972029,True
8704,validator_12,96264618472,True,79456001,4992200,84448201,True
8705,validator_13,32306582305,True,82500002,933000,83433002,True
8706,validator_28,32773867390,True,84141000,1453640,85594640,False
8707,validator_20,33030788199,True,175004004,708000,175712004,True
8708,validator_3,32244723919,True,144769004,1987100,146756104,True
8709,validator_9,32264405232,True,85662001,1269500,86931501,True
8710,validator_32,32520659200,True,148453000,1679750,150132750,False
8711,validator_9,32352213403,True,87596001,212170,87808171,True
8712,validator_7,64833475323,True,182751002,19709340,202460342,True
8713,validator_37,64379572260,True,94649000,1855630,96504630,False
8714,validator_41,64315343990,True,112706000,369600,113075600,False
8715,validator_35,96145664440,True,140152000,5512440,145664440,False
8716,validator_15,256705459198,True,167979002,1238100,169217102,True
8717,validator_9,32496174458,True,143071005,890050,143961055,True
8718,validator_20,33214280319,True,183125000,367120,183492120,True
8719,validator_13,32399950537,True,92141002,1227230,93368232,True
8720,validator_0,32764646744,True,190593005,3236000,193829005,True
8721,validator_16,32435396814,True,106554002,440900,106994902,True
8722,validator_22,65076949954,True,95150003,2713000,97863003,True
8723,validator_2,33274207155,True,265286997,10318100,275605097,True
8724,validator_17,161414981382,True,212833998,655200,213489198,True
8725,validator_22,65176882453,True,91971999,7960500,99932499,True
8726,validator_44,96734361590,True,104667000,707800,105374800,False
8727,validator_34,257022777290,True,157537000,2510840,160047840,False
8728,validator_15,256861617839,True,154678001,1480640,156158641,True
8729,validator_8,32730552765,True,202368006,3174360,205542366,True
8730,validator_37,64539113440,True,157720000,1821180,159541180,False
8731,validator_42,32515360900,True,198268000,564190,198832190,False
8732,validator_27,96750440920,True,76832000,765700,77597700,False
8733,validator_42,32594606420,True,78987000,258520,79245520,False
8734,validator_44,96896325190,True,160976000,987600,161963600,False
8735,validator_33,32551273840,True,116100000,17999430,134099430,False
8736,validator_44,96988589180,True,91552000,711990,92263990,False
8737,validator_30,65360338930,True,135019000,6805800,141824800,False
8738,validator_39,32579653080,True,88043000,944700,88987700,False
8739,validator_17,161550998957,True,117368005,18649570,136017575,True
8740,validator_22,65248881249,True,70495996,1502800,71998796,True
8741,validator_41,64470026790,True,149011000,5671800,154682800,False
8742,validator_42,32811788050,True,216225000,956630,217181630,False
8743,validator_28,33006680830,True,231315000,1498440,232813440,False
8744,validator_41,64575864020,True,105663000,174230,105837230,False
8745,validator_18,96697072166,True,59833001,5091500,64924501,True
8746,validator_33,32628906140,True,69647000,7985300,77632300,False
8747,validator_9,32760382199,True,244726001,19481740,264207741,True
8748,validator_13,32474419672,True,73887005,582130,74469135,True
8749,validator_7,64971316618,True,129706995,8134300,137841295,True
8750,validator_35,96217195140,True,70204000,1326700,71530700,False
8751,validator_10,32858557273,True,111377003,4816600,116193603,True
8752,validator_6,32552324623,True,186499004,10038720,196537724,True
8753,validator_5,64553094173,True,56430998,2452830,58883828,True
8754,validator_43,64213434730,True,76976000,1499130,78475130,False
8755,validator_17,161720082560,True,167300003,1783600,169083603,True
8756,validator_12,96540014200,True,273916998,1478730,275395728,True
8757,validator_39,32770814980,True,182395000,8766900,191161900,False
8758,validator_48,160518991990,True,260035000,869400,260904400,False
8759,validator_26,32743220170,True,120993000,681630,121674630,False
8760,validator_44,97092160410,True,102468000,1103230,103571230,False
8761,validator_44,97232894200,True,122591000,18142790,140733790,False
8762,validator_0,33000630716,True,215917002,20066970,235983972,True
8763,validator_9,32884689831,True,123709002,598630,124307632,True
8764,validator_18,96767329500,True,69121994,1135340,70257334,True
8765,validator_49,64657664550,True,146219000,1515450,147734450,False
8766,validator_45,32426902800,True,56245000,31700,56276700,False
8767,validator_29,32476325520,True,149262000,44135890,193397890,False
8768,validator_9,33010236625,True,122311994,3234800,125546794,True
8769,validator_14,97196126673,True,140208002,728900,140936902,True
8770,validator_20,33319411520,True,103848001,1283200,105131201,True
8771,validator_1,64582262879,True,128610001,7990400,136600401,True
8772,validator_32,32717866920,True,195471000,1736720,197207720,False
8773,validator_12,96650629780,True,109634000,981580,110615580,True
8774,validator_3,32355512285,True,109367006,1421360,110788366,True
8775,validator_47,64270605620,True,137095000,245100,137340100,False
8776,validator_5,64609891196,True,48769003,8028020,56797023,True
8777,validator_19,64627654806,True,166704002,699700,167403702,True
8778,validator_22,65383432878,True,126729999,7821630,134551629,True
8779,validator_41,64681242280,True,104065000,1313260,105378260,False
8780,validator_21,64547964984,True,81852998,17842590,99695588,True
8781,validator_16,32568842813,True,132503999,942000,133445999,True
8782,validator_5,64731514897,True,119752001,1871700,121623701,True
8783,validator_24,33046350844,True,166336000,210400,166546400,True
8784,validator_19,64770472408,True,141754002,1063600,142817602,True
8785,validator_8,32930217862,True,191728997,7936100,199665097,True
8786,validator_2,33441862997,True,162971002,4684840,167655842,True
8787,validator_38,32261948070,True,89690000,1252100,90942100,False
8788,validator_31,161036249610,True,202889000,1982400,204871400,False
8789,validator_39,32857182410,True,85536000,831430,86367430,False
8790,validator_26,32909661970,True,158141000,8300800,166441800,False
8791,validator_1,64682613283,True,94741004,5609400,100350404,True
8792,validator_5,64943237896,True,209981999,1741000,211722999,True
8793,validator_2,33681030698,True,219914001,19253700,239167701,True
8794,validator_4,32493495860,True,161874001,18731100,180605101,True
8795,validator_18,96897681031,True,129802001,549530,130351531,True
8796,validator_23,33319116513,True,205846999,1741700,207588699,True
8797,validator_47,64402748520,True,130107000,2035900,132142900,False
8798,validator_1,64858820885,True,158064002,18143600,176207602,True
8799,validator_12,96719953974,True,68150004,1174190,69324194,True
8800,validator_1,65002329778,True,122948993,20559900,143508893,True
8801,validator_26,32990870500,True,76323000,4885530,81208530,False
8802,validator_4,32584442862,True,89033002,1914000,90947002,True
8803,validator_37,64639359040,True,99078000,1167600,100245600,False
8804,validator_36,97017090230,True,133929000,835700,134764700,False
8805,validator_11,32568054848,True,104311998,911500,105223498,True
8806,validator_35,96311876120,True,92869000,1811980,94680980,False
8807,validator_44,97342247100,True,100654000,8698900,109352900,False
8808,validator_29,32538968920,True,61967000,676400,62643400,False
8809,validator_47,64523876240,True,120576000,551720,121127720,False
8810,validator_30,65433688400,True,54580000,18769470,73349470,False
8811,validator_15,256977709968,True,111629999,4462130,116092129,True
8812,validator_10,33010288575,True,149318002,2413300,151731302,True
8813,validator_14,97421515476,True,224747003,641800,225388803,True
8814,validator_34,257105816490,True,78219000,4820200,83039200,False
8815,validator_42,32950638450,True,135800000,3050400,138850400,False
8816,validator_43,64287842530,True,73452000,955800,74407800,False
8817,validator_19,64924817612,True,153218004,1127200,154345204,True
8818,validator_32,32775388920,True,56225000,1297000,57522000,False
8819,validator_37,64781567860,True,121515000,20693820,142208820,False
8820,validator_39,32981769810,True,116296000,8291400,124587400,False
8821,validator_23,33580650715,True,259703002,1831200,261534202,True
8822,validator_22,65537398963,True,152925995,1040090,153966085,True
8823,validator_28,33064531330,True,55413000,2437500,57850500,False
8824,validator_4,32646863994,True,61087002,1334130,62421132,True
8825,validator_35,96551254120,True,231547000,7831000,239378000,False
8826,validator_18,97026434232,True,123356001,5397200,128753201,True
8827,validator_40,32392268190,True,156846000,8080970,164926970,False
8828,validator_47,64596624140,True,72405000,342900,72747900,False
8829,validator_10,33136720121,True,125662996,768550,126431546,True
8830,validator_15,257052723666,True,74072998,940700,75013698,True
8831,validator_28,33164586630,True,98627000,1428300,100055300,False
8832,validator_15,257216838269,True,161607003,2507600,164114603,True
8833,validator_34,257181393920,True,74099000,1478430,75577430,False
8834,validator_29,32715847160,True,175942000,936240,176878240,False
8835,validator_35,96712867840,True,160213000,1400720,161613720,False
8836,validator_20,33417670378,True,97652998,605860,98258858,True
8837,validator_16,32701072835,True,129479002,2751020,132230022,True
8838,validator_48,160665240260,True,144077000,2171270,146248270,False
8839,validator_22,65695590015,True,156598002,1593050,158191052,True
8840,validator_6,32672597051,True,117579998,2692430,120272428,True
8841,validator_41,64728679700,True,44779000,2658420,47437420,False
8842,validator_7,65037215436,True,65532998,365820,65898818,True
8843,validator_35,96842423940,True,103717000,25839100,129556100,False
8844,validator_35,96947494910,True,103817000,1253970,105070970,False
8845,validator_42,33061549690,True,109579000,1332240,110911240,False
8846,validator_21,64670096486,True,119880002,2251500,122131502,True
8847,validator_12,96791492602,True,71303998,234630,71538628,True
8848,validator_20,33503377683,True,78838005,6869300,85707305,True
8849,validator_17,161838949656,True,117739996,1127100,118867096,True
8850,validator_10,33234470116,True,95728995,2021000,97749995,True
8851,validator_19,65142164911,True,212010999,5336300,217347299,True
8852,validator_8,32973169439,True,41337997,1613580,42951577,True
8853,validator_1,65142175741,True,139737003,108960,139845963,True
8854,validator_1,65377254733,True,229549992,5529000,235078992,True
8855,validator_15,257294777771,True,77108002,831500,77939502,True
8856,validator_14,97510114981,True,87146005,1453500,88599505,True
8857,validator_0,33074362558,True,71242002,2489840,73731842,True
8858,validator_26,33077721770,True,86369000,482270,86851270,False
8859,validator_35,97098741650,True,146777000,4469740,151246740,False
8860,validator_45,32469687400,True,36848000,5936600,42784600,False
8861,validator_41,64839622140,True,109353000,1589440,110942440,False
8862,validator_34,257259544820,True,76223000,1927900,78150900,False
8863,validator_2,33810469926,True,129129998,309230,129439228,True
8864,validator_28,33296913830,True,131653000,674200,132327200,False
8865,validator_0,33140670477,True,65938999,368920,66307919,True
8866,validator_2,33977300364,True,164154998,2675440,166830438,True
8867,validator_7,65091744813,True,53436997,1092380,54529377,True
8868,validator_39,33159090310,True,175642000,1678500,177320500,False
8869,validator_17,161987545152,True,147474996,1120500,148595496,True
8870,validator_6,32827303226,True,153809995,896180,154706175,True
8871,validator_22,65833723804,True,137615999,517790,138133789,True
8872,validator_23,33664753020,True,65039005,19063300,84102305,True
8873,validator_32,32846301520,True,69174000,1738600,70912600,False
8874,validator_48,160897688460,True,231034000,1414200,232448200,False
8875,validator_44,97468875800,True,123596000,3032700,126628700,False
8876,validator_28,33394305890,True,88149000,9243060,97392060,False
8877,validator_48,161037245680,True,121028000,18529220,139557220,False
8878,validator_31,161148875930,True,112280000,346320,112626320,False
8879,validator_20,33618602981,True,113946998,1278300,115225298,True
8880,validator_34,257436884470,True,175754000,1585650,177339650,False
8881,validator_24,33097902340,True,50448996,1102500,51551496,True
8882,validator_17,162092811941,True,81205999,24060790,105266789,True
8883,validator_17,162229427360,True,130844999,5770420,136615419,True
8884,validator_43,64519337230,True,230873000,621700,231494700,False
8885,validator_23,33820066818,True,145053998,10259800,155313798,True
8886,validator_31,161258943560,True,107512000,2555630,110067630,False
8887,validator_41,64994448440,True,135539000,19287300,154826300,False
8888,validator_27,96868737620,True,116715000,1581700,118296700,False
8889,validator_23,33947936915,True,125212997,2657100,127870097,True
8890,validator_19,65363878013,True,202513002,19200100,221713102,True
8891,validator_37,64903469350,True,104066000,17835490,121901490,False
8892,validator_31,161398873490,True,139698000,231930,139929930,False
8893,validator_23,34193975555,True,245808000,230640,246038640,True
8894,validator_22,66102930932,True,267001008,2206120,269207128,True
8895,validator_5,64994453826,True,49826000,1389930,51215930,True
8896,validator_9,33185530919,True,156009994,19284300,175294294,True
8897,validator_47,64699795280,True,84487000,18684140,103171140,False
8898,validator_32,32995214020,True,147027000,1885500,148912500,False
8899,validator_18,97210780019,True,183173997,1171790,184345787,True
8900,validator_35,97226706450,True,125909000,2055800,127964800,False
8901,validator_48,161141172410,True,96145000,7781730,103926730,False
8902,validator_37,64985428650,True,79907000,2052300,81959300,False
8903,validator_18,97289567519,True,76473000,2314500,78787500,True
8904,validator_47,64888131610,True,186445000,1891330,188336330,False
8905,validator_8,33091362567,True,117330998,862130,118193128,True
8906,validator_34,257559003930,True,121925000,194460,122119460,False
8907,validator_9,33311168119,True,125538000,99200,125637200,True
8908,validator_25,32396618910,True,77065000,7856800,84921800,False
8909,validator_25,32434134990,True,37427000,89080,37516080,False
8910,validator_44,97549021800,True,79662000,484000,80146000,False
8911,validator_34,257652965410,True,91209000,2752480,93961480,False
8912,validator_41,65133063630,True,137544000,1071190,138615190,False
8913,validator_11,32642448547,True,73478999,914700,74393699,True
8914,validator_41,65259459430,True,125537000,858800,126395800,False
8915,validator_10,33349901703,True,113673997,1757590,115431587,True
8916,validator_30,65588078440,True,153389000,1001040,154390040,False
8917,validator_12,96924248624,True,129693002,3063020,132756022,True
8918,validator_35,97278520350,True,51070000,743900,51813900,False
8919,validator_23,34354506156,True,154875001,5655600,160530601,True
8920,validator_13,32621024202,True,145897000,707530,146604530,True
8921,validator_38,32355483970,True,91433000,2102900,93535900,False
8922,validator_45,32591369470,True,121138000,544070,121682070,False
8923,validator_47,64972520140,True,82411000,1977530,84388530,False
8924,validator_8,33338575549,True,245604002,1608980,247212982,True
8925,validator_41,65447044380,True,185780000,1804950,187584950,False
8926,validator_37,65104051370,True,116661000,1961720,118622720,False
8927,validator_45,32664322610,True,71950000,1003140,72953140,False
8928,validator_39,33226088880,True,65360000,1638570,66998570,False
8929,validator_2,34138093882,True,160119998,673520,160793518,True
8930,validator_23,34465412247,True,110457001,449090,110906091,True
8931,validator_48,161250196310,True,108786000,237900,109023900,False
8932,validator_42,33211268790,True,125142000,24577100,149719100,False
8933,validator_42,33352769270,True,132671000,8829480,141500480,False
8934,validator_14,97577068557,True,65735006,1218570,66953576,True
8935,validator_6,32932645768,True,104120002,1222540,105342542,True
8936,validator_49,64727111350,True,63633000,5813800,69446800,False
8937,validator_12,97129157240,True,203846996,1061620,204908616,True
8938,validator_34,257816197610,True,160302000,2930200,163232200,False
8939,validator_11,32885163844,True,233455997,9259300,242715297,True
8940,validator_15,257362638169,True,66905998,954400,67860398,True
8941,validator_18,97393813320,True,96431001,7814800,104245801,True
8942,validator_9,33383803125,True,71810006,825000,72635006,True
8943,validator_35,97343440470,True,61996000,2924120,64920120,False
8944,validator_26,33151768770,True,72409000,1638000,74047000,False
8945,validator_37,65187214590,True,70509000,12654220,83163220,False
8946,validator_15,257543849455,True,179414996,1796290,181211286,True
8947,validator_31,161471580170,True,52268000,20438680,72706680,False
8948,validator_41,65599926280,True,133649000,19232900,152881900,False
8949,validator_0,33285253298,True,143930001,652820,144582821,True
8950,validator_4,32885011535,True,211383001,26764540,238147541,True
8951,validator_9,33553944856,True,168511001,1630730,170141731,True
8952,validator_49,64827182150,True,99802000,268800,100070800,False
8953,validator_48,161330054990,True,79297000,561680,79858680,False
8954,validator_14,97720056717,True,142444000,544160,142988160,True
8955,validator_37,65279878520,True,91517000,1146930,92663930,False
8956,validator_47,65172368540,True,189828000,10020400,199848400,False
8957,validator_34,257925985150,True,108785000,1002540,109787540,False
8958,validator_0,33525041898,True,239616000,172600,239788600,True
8959,validator_33,32702853330,True,68646000,5301190,73947190,False
8960,validator_25,32586564690,True,151905000,524700,152429700,False
8961,validator_23,34570956449,True,105198002,346200,105544202,True
8962,validator_34,257995417450,True,68940000,492300,69432300,False
8963,validator_41,65758527820,True,158371000,230540,158601540,False
8964,validator_8,33497080448,True,157917999,586900,158504899,True
8965,validator_2,34345176458,True,201736996,5345580,207082576,True
8966,validator_9,33663989857,True,107875001,2170000,110045001,True
8967,validator_10,33479713199,True,129140006,671490,129811496,True
8968,validator_17,162390654244,True,160129004,1097880,161226884,True
8969,validator_27,96939049820,True,69264000,1048200,70312200,False
8970,validator_37,65468485400,True,188386000,220880,188606880,False
8971,validator_21,64920924590,True,230350004,20478100,250828104,True
8972,validator_14,97873075414,True,151900997,1117700,153018697,True
8973,validator_38,32450552870,True,76917000,18151900,95068900,False
8974,validator_5,65091121627,True,86393001,10274800,96667801,True
8975,validator_17,162486066642,True,93792998,1619400,95412398,True
8976,validator_28,33489781430,True,94562000,913540,95475540,False
8977,validator_17,162632329723,True,137815001,8448080,146263081,True
8978,validator_22,66253191951,True,149864999,396020,150261019,True
8979,validator_22,66348920514,True,94435003,1293560,95728563,True
8980,validator_34,258037489380,True,41794000,277930,42071930,False
8981,validator_35,97457088650,True,112812000,836180,113648180,False
8982,validator_8,33543817439,True,44614001,2122990,46736991,True
8983,validator_49,64888812950,True,61083000,547800,61630800,False
8984,validator_12,97231397940,True,101949000,291700,102240700,True
8985,validator_26,33297978170,True,144318000,1891400,146209400,False
8986,validator_14,98055855834,True,181259000,1521420,182780420,True
8987,validator_14,98284446450,True,227209996,1380620,228590616,True
8988,validator_48,161620843350,True,289525000,1263360,290788360,False
8989,validator_34,258124498780,True,86124000,885400,87009400,False
8990,validator_28,33548256670,True,57673000,802240,58475240,False
8991,validator_47,65319591440,True,146450000,772900,147222900,False
8992,validator_13,32825010207,True,185584995,18401010,203986005,True
8993,validator_3,32528948106,True,172691001,744820,173435821,True
8994,validator_15,257674571963,True,128414998,2307510,130722508,True
8995,validator_40,32499938490,True,99244000,8426300,107670300,False
8996,validator_17,162740220724,True,99874001,8017000,107891001,True
8997,validator_8,33720913877,True,175799998,1296440,177096438,True
8998,validator_30,65683024240,True,94102000,843800,94945800,False
8999,validator_24,33167102943,True,68934003,266600,69200603,True
9000,validator_10,32078731199,True,78080999,650200,78731199,True
9001,validator_12,96134912187,True,134307997,604190,134912187,True
9002,validator_31,160102139830,True,93211000,8928830,102139830,False
9003,validator_23,32168173501,True,159551001,8622500,168173501,True
9004,validator_34,256069994300,True,59731000,10263300,69994300,False
9005,validator_39,32059019600,True,58732000,287600,59019600,False
9006,validator_20,32082078595,True,80586995,1491600,82078595,True
9007,validator_22,64119155637,True,117292007,1863630,119155637,True
9008,validator_27,96122169700,True,120872000,1297700,122169700,False
9009,validator_18,96129900744,True,126718004,3182740,129900744,True
9010,validator_20,32369635977,True,250538002,37019380,287557382,True
9011,validator_36,96178379340,True,176884000,1495340,178379340,False
9012,validator_14,96154614641,True,154369001,245640,154614641,True
9013,validator_49,64113927600,True,106531000,7396600,113927600,False
9014,validator_10,32285223194,True,205217995,1274000,206491995,True
9015,validator_26,32129023220,True,127198000,1825220,129023220,False
9016,validator_15,256155790498,True,146766998,9023500,155790498,True
9017,validator_17,160156436885,True,153834995,2601890,156436885,True
9018,validator_26,32243406590,True,113210000,1173370,114383370,False
9019,validator_45,32051490100,True,49177000,2313100,51490100,False
9020,validator_2,32105319004,True,102862004,2457000,105319004,True
9021,validator_8,32110713802,True,102272002,8441800,110713802,True
9022,validator_36,96245362370,True,65874000,1109030,66983030,False
9023,validator_17,160241030247,True,83442002,1151360,84593362,True
9024,validator_5,64058544577,True,56815997,1728580,58544577,True
9025,validator_49,64237489200,True,123071000,490600,123561600,False
9026,validator_1,64108776200,True,107108000,1668200,108776200,True
9027,validator_22,64315376963,True,177391006,18830320,196221326,True
9028,validator_36,96426436140,True,172853000,8220770,181073770,False
9029,validator_18,96251438340,True,121131996,405600,121537596,True
9030,validator_42,32132562500,True,130713000,1849500,132562500,False
9031,validator_30,64144227700,True,143788000,439700,144227700,False
9032,validator_48,160062233800,True,60564000,1669800,62233800,False
9033,validator_0,32091705740,True,91060000,645740,91705740,True
9034,validator_46,96160055690,True,141097000,18958690,160055690,False
9035,validator_6,32196392499,True,178282999,18109500,196392499,True
9036,validator_44,96096102740,True,77335000,18767740,96102740,False
9037,validator_20,32509928209,True,138982002,1310230,140292232,True
9038,validator_19,64097218601,True,96766001,452600,97218601,True
9039,validator_28,32127028100,True,126863000,165100,127028100,False
9040,validator_20,32680394997,True,161901998,8564790,170466788,True
9041,validator_7,64115830700,True,110179000,5651700,115830700,True
9042,validator_31,160150960510,True,39317000,9503680,48820680,False
9043,validator_37,64121786260,True,120885000,901260,121786260,False
9044,validator_30,64291967800,True,146453000,1287100,147740100,False
9045,validator_18,96375830866,True,123397006,995520,124392526,True
9046,validator_5,64174887406,True,115113999,1228830,116342829,True
9047,validator_39,32214080600,True,154592000,469000,155061000,False
9048,validator_14,96267470135,True,107589004,5266490,112855494,True
9049,validator_31,160236404810,True,83952000,1492300,85444300,False
9050,validator_31,160394260010,True,156924000,931200,157855200,False
9051,validator_47,64133265520,True,131899000,1366520,133265520,False
9052,validator_49,64350589700,True,106720000,6380500,113100500,False
9053,validator_17,160396474310,True,154536003,908060,155444063,True
9054,validator_15,256355729397,True,199748999,189900,199938899,True
9055,validator_23,32390015342,True,220630001,1211840,221841841,True
9056,validator_30,64407800800,True,96594000,19239000,115833000,False
9057,validator_27,96208241720,True,66681000,19391020,86072020,False
9058,validator_49,64404679000,True,44841000,9248300,54089300,False
9059,validator_49,64509930100,True,103987000,1264100,105251100,False
9060,validator_5,64236361447,True,54046001,7428040,61474041,True
9061,validator_39,32287467040,True,71842000,1544440,73386440,False
9062,validator_11,32125884736,True,124358996,1525740,125884736,True
9063,validator_27,96397302020,True,187339000,1721300,189060300,False
9064,validator_10,32449723817,True,161783003,2717620,164500623,True
9065,validator_42,32242637510,True,105151000,4924010,110075010,False
9066,validator_26,32356554890,True,112692000,456300,113148300,False
9067,validator_8,32274637144,True,155500002,8423340,163923342,True
9068,validator_1,64305593603,True,195534003,1283400,196817403,True
9069,validator_34,256190492390,True,119423000,1075090,120498090,False
9070,validator_13,32223149303,True,221551003,1598300,223149303,True
9071,validator_6,32355786899,True,157010000,2384400,159394400,True
9072,validator_16,32086979880,True,85013000,1966880,86979880,True
9073,validator_22,64404704664,True,87845001,1482700,89327701,True
9074,validator_17,160582803207,True,168104997,18223900,186328897,True
9075,validator_19,64286477904,True,157924003,31335300,189259303,True
9076,validator_24,32083866943,True,76379003,7487940,83866943,True
9077,validator_23,32563014146,True,168397004,4601800,172998804,True
9078,validator_7,64306072878,True,181911998,8330180,190242178,True
9079,validator_17,160723045144,True,138752997,1488940,140241937,True
9080,validator_22,64563775964,True,140662000,18409300,159071300,True
9081,validator_5,64366616143,True,128208996,2045700,130254696,True
9082,validator_7,64418593980,True,111336002,1185100,112521102,True
9083,validator_29,32139901230,True,138183000,1718230,139901230,False
9084,validator_31,160519685800,True,124494000,931790,125425790,False
9085,validator_2,32219502804,True,113682000,501800,114183800,True
9086,validator_44,96298889560,True,196078000,6708820,202786820,False
9087,validator_21,64220749298,True,200862998,19886300,220749298,True
9088,validator_2,32405016062,True,182896998,2616260,185513258,True
9089,validator_36,96499132100,True,72226000,469960,72695960,False
9090,validator_32,32136029320,True,134878000,1151320,136029320,False
9091,validator_22,64656832446,True,91681002,1375480,93056482,True
9092,validator_8,32397995497,True,122346003,1012350,123358353,True
9093,validator_39,32386255380,True,93106000,5682340,98788340,False
9094,validator_36,96581026500,True,79861000,2033400,81894400,False
9095,validator_14,96356082137,True,86831002,1781000,88612002,True
9096,validator_20,32855076195,True,170931998,3749200,174681198,True
9097,validator_41,64056448650,True,55009000,1439650,56448650,False
9098,validator_19,64460251104,True,172881000,892200,173773200,True
9099,validator_4,32197037265,True,196668005,369260,197037265,True
9100,validator_0,32303471738,True,206241998,5524000,211765998,True
9101,validator_27,96473172220,True,68510000,7360200,75870200,False
9102,validator_12,96180170271,True,44532004,726080,45258084,True
9103,validator_26,32433430880,True,56918000,19957990,76875990,False
9104,validator_24,32220011886,True,133670003,2474940,136144943,True
9105,validator_46,96268260690,True,105480000,2725000,108205000,False
9106,validator_24,32512052716,True,286782000,5258830,292040830,True
9107,validator_2,32494254343,True,81546001,7692280,89238281,True
9108,validator_2,32658324242,True,145121999,18947900,164069899,True
9109,validator_25,32090763500,True,88025000,2738500,90763500,False
9110,validator_27,96598303420,True,124766000,365200,125131200,False
9111,validator_33,32155404720,True,154031000,1373720,155404720,False
9112,validator_14,96590178933,True,223876996,10219800,234096796,True
9113,validator_25,32237315330,True,142078000,4473830,146551830,False
9114,validator_38,32171005970,True,147166000,23839970,171005970,False
9115,validator_30,64526529000,True,116996000,1732200,118728200,False
9116,validator_28,32270414900,True,140330000,3056800,143386800,False
9117,validator_42,32316528710,True,66985000,6906200,73891200,False
9118,validator_7,64563205782,True,136222002,8389800,144611802,True
9119,validator_44,96464501860,True,163220000,2392300,165612300,False
9120,validator_14,96690209033,True,98630000,1400100,100030100,True
9121,validator_22,64827417248,True,170292002,292800,170584802,True
9122,validator_23,32659091588,True,90595002,5482440,96077442,True
9123,validator_17,160863717786,True,139708002,964640,140672642,True
9124,validator_7,64631014981,True,66648999,1160200,67809199,True
9125,validator_30,64674952140,True,146933000,1490140,148423140,False
9126,validator_46,96396717030,True,122112000,6344340,128456340,False
9127,validator_41,64110233790,True,52113000,1672140,53785140,False
9128,validator_10,32512167892,True,54972995,7471080,62444075,True
9129,validator_33,32258214720,True,101002000,1808000,102810000,False
9130,validator_43,64068961100,True,66625000,2336100,68961100,False
9131,validator_17,160932900487,True,68022001,1160700,69182701,True
9132,validator_8,32525010399,True,126315002,699900,127014902,True
9133,validator_28,32381217300,True,109582000,1220400,110802400,False
9134,validator_1,64374911773,True,68344000,974170,69318170,True
9135,validator_37,64208346100,True,78912000,7647840,86559840,False
9136,validator_4,32312890759,True,97697994,18155500,115853494,True
9137,validator_44,96628986790,True,163601000,883930,164484930,False
9138,validator_24,32589226640,True,74828004,2345920,77173924,True
9139,validator_23,32877869282,True,217681004,1096690,218777694,True
9140,validator_29,32282927630,True,140944000,2082400,143026400,False
9141,validator_14,96926333968,True,234565005,1559930,236124935,True
9142,validator_48,160134433560,True,72010000,189760,72199760,False
9143,validator_33,32301443220,True,35583000,7645500,43228500,False
9144,validator_2,32916716568,True,235123996,23268330,258392326,True
9145,validator_30,64862234940,True,186257000,1025800,187282800,False
9146,validator_36,96759594640,True,177100000,1468140,178568140,False
9147,validator_25,32311697110,True,72184000,2197780,74381780,False
9148,validator_28,32487106160,True,104952000,936860,105888860,False
9149,validator_32,32199288550,True,60109000,3150230,63259230,False
9150,validator_21,64325918796,True,103406998,1762500,105169498,True
9151,validator_16,32177105720,True,89085000,1040840,90125840,True
9152,validator_30,64979964540,True,116683000,1046600,117729600,False
9153,validator_34,256260026790,True,68294000,1240400,69534400,False
9154,validator_40,32152506220,True,144450000,8056220,152506220,False
9155,validator_9,32064992199,True,64162999,829200,64992199,True
9156,validator_36,96882325530,True,120995000,1735890,122730890,False
9157,validator_33,32417174410,True,113625000,2106190,115731190,False
9158,validator_26,32480345080,True,42012000,4902200,46914200,False
9159,validator_11,32230083232,True,103414996,783500,104198496,True
9160,validator_34,256371905290,True,110691000,1187500,111878500,False
9161,validator_2,32998602058,True,80092000,1793490,81885490,True
9162,validator_24,32749161842,True,153992002,5943200,159935202,True
9163,validator_46,96565987760,True,161790000,7480730,169270730,False
9164,validator_5,64494210345,True,127330002,264200,127594202,True
9165,validator_48,160258087590,True,122307000,1347030,123654030,False
9166,validator_3,32097967815,True,95980995,1986820,97967815,True
9167,validator_37,64283067630,True,74199000,522530,74721530,False
9168,validator_16,32328401912,True,149398992,1897200,151296192,True
9169,validator_28,32587898610,True,99970000,822450,100792450,False
9170,validator_43,64134959600,True,65003000,995500,65998500,False
9171,validator_34,256519955110,True,147377000,672820,148049820,False
9172,validator_22,64979086951,True,150345003,1324700,151669703,True
9173,validator_31,160601350210,True,63032000,18632410,81664410,False
9174,validator_24,32879804444,True,129085002,1557600,130642602,True
9175,validator_28,32688272750,True,99653000,721140,100374140,False
9176,validator_23,33111527814,True,225309002,8349530,233658532,True
9177,validator_27,96672843220,True,73596000,943800,74539800,False
9178,validator_11,32356207535,True,123683003,2441300,126124303,True
9179,validator_31,160655539710,True,53207000,982500,54189500,False
9180,validator_31,160831378210,True,173878000,1960500,175838500,False
9181,validator_11,32462831350,True,105791005,832810,106623815,True
9182,validator_30,65218514130,True,236946000,1603590,238549590,False
9183,validator_32,32370526450,True,169836000,1401900,171237900,False
9184,validator_34,256553508910,True,31669000,1884800,33553800,False
9185,validator_45,32178331600,True,118892000,7949500,126841500,False
9186,validator_14,97055189771,True,122766003,6089800,128855803,True
9187,validator_26,32621545540,True,139678000,1522460,141200460,False
9188,validator_0,32570817739,True,266668001,678000,267346001,True
9189,validator_45,32301636500,True,120922000,2382900,123304900,False
9190,validator_10,32579391641,True,66345999,877750,67223749,True
9191,validator_15,256536242096,True,174404999,6107700,180512699,True
9192,validator_46,96630457500,True,63371000,1098740,64469740,False
9193,validator_17,161201492184,True,267303997,1287700,268591697,True
9194,validator_41,64202268390,True,91396000,638600,92034600,False
9195,validator_1,64445662478,True,65702005,5048700,70750705,True
9196,validator_45,32370626100,True,50049000,18940600,68989600,False
9197,validator_18,96632147665,True,256171999,144800,256316799,True
9198,validator_21,64448269396,True,121172000,1178600,122350600,True
9199,validator_40,32227341220,True,66025000,8810000,74835000,False
9200,validator_34,256862729450,True,307699000,1521540,309220540,False
9201,validator_39,32490665380,True,95257000,9153000,104410000,False
9202,validator_9,32177473731,True,111633002,848530,112481532,True
9203,validator_10,32742363670,True,162542999,429030,162972029,True
9204,validator_12,96264618472,True,79456001,4992200,84448201,True
9205,validator_13,32306582305,True,82500002,933000,83433002,True
9206,validator_28,32773867390,True,84141000,1453640,85594640,False
9207,validator_20,33030788199,True,175004004,708000,175712004,True
9208,validator_3,32244723919,True,144769004,1987100,146756104,True
9209,validator_9,32264405232,True,85662001,1269500,86931501,True
9210,validator_32,32520659200,True,148453000,1679750,150132750,False
9211,validator_9,32352213403,True,87596001,212170,87808171,True
9212,validator_7,64833475323,True,182751002,19709340,202460342,True
9213,validator_37,64379572260,True,94649000,1855630,96504630,False
9214,validator_41,64315343990,True,112706000,369600,113075600,False
9215,validator_35,96145664440,True,140152000,5512440,145664440,False
9216,validator_15,256705459198,True,167979002,1238100,169217102,True
9217,validator_9,32496174458,True,143071005,890050,143961055,True
9218,validator_20,33214280319,True,183125000,367120,183492120,True
9219,validator_13,32399950537,True,92141002,1227230,93368232,True
9220,validator_0,32764646744,True,190593005,3236000,193829005,True
9221,validator_16,32435396814,True,106554002,440900,106994902,True
9222,validator_22,65076949954,True,95150003,2713000,97863003,True
9223,validator_2,33274207155,True,265286997,10318100,275605097,True
9224,validator_17,161414981382,True,212833998,655200,213489198,True
9225,validator_22,65176882453,True,91971999,7960500,99932499,True
9226,validator_44,96734361590,True,104667000,707800,105374800,False
9227,validator_34,257022777290,True,157537000,2510840,160047840,False
9228,validator_15,256861617839,True,154678001,1480640,156158641,True
9229,validator_8,32730552765,True,202368006,3174360,205542366,True
9230,validator_37,64539113440,True,157720000,1821180,159541180,False
9231,validator_42,32515360900,True,198268000,564190,198832190,False
9232,validator_27,96750440920,True,76832000,765700,77597700,False
9233,validator_42,32594606420,True,78987000,258520,79245520,False
9234,validator_44,96896325190,True,160976000,987600,161963600,False
9235,validator_33,32551273840,True,116100000,17999430,134099430,False
9236,validator_44,96988589180,True,91552000,711990,92263990,False
9237,validator_30,65360338930,True,135019000,6805800,141824800,False
9238,validator_39,32579653080,True,88043000,944700,88987700,False
9239,validator_17,161550998957,True,117368005,18649570,136017575,True
9240,validator_22,65248881249,True,70495996,1502800,71998796,True
9241,validator_41,64470026790,True,149011000,5671800,154682800,False
9242,validator_42,32811788050,True,216225000,956630,217181630,False
9243,validator_28,33006680830,True,231315000,1498440,232813440,False
9244,validator_41,64575864020,True,105663000,174230,105837230,False
9245,validator_18,96697072166,True,59833001,5091500,64924501,True
9246,validator_33,32628906140,True,69647000,7985300,77632300,False
9247,validator_9,32760382199,True,244726001,19481740,264207741,True
9248,validator_13,32474419672,True,73887005,582130,74469135,True
9249,validator_7,64971316618,True,129706995,8134300,137841295,True
9250,validator_35,96217195140,True,70204000,1326700,71530700,False
9251,validator_10,32858557273,True,111377003,4816600,116193603,True
9252,validator_6,32552324623,True,186499004,10038720,196537724,True
9253,validator_5,64553094173,True,56430998,2452830,58883828,True
9254,validator_43,64213434730,True,76976000,1499130,78475130,False
9255,validator_17,161720082560,True,167300003,1783600,169083603,True
9256,validator_12,96540014200,True,273916998,1478730,275395728,True
9257,validator_39,32770814980,True,182395000,8766900,191161900,False
9258,validator_48,160518991990,True,260035000,869400,260904400,False
9259,validator_26,32743220170,True,120993000,681630,121674630,False
9260,validator_44,97092160410,True,102468000,1103230,103571230,False
9261,validator_44,97232894200,True,122591000,18142790,140733790,False
9262,validator_0,33000630716,True,215917002,20066970,235983972,True
9263,validator_9,32884689831,True,123709002,598630,124307632,True
9264,validator_18,96767329500,True,69121994,1135340,70257334,True
9265,validator_49,64657664550,True,146219000,1515450,147734450,False
9266,validator_45,32426902800,True,56245000,31700,56276700,False
9267,validator_29,32476325520,True,149262000,44135890,193397890,False
9268,validator_9,33010236625,True,122311994,3234800,125546794,True
9269,validator_14,97196126673,True,140208002,728900,140936902,True
9270,validator_20,33319411520,True,103848001,1283200,105131201,True
9271,validator_1,64582262879,True,128610001,7990400,136600401,True
9272,validator_32,32717866920,True,195471000,1736720,197207720,False
9273,validator_12,96650629780,True,109634000,981580,110615580,True
9274,validator_3,32355512285,True,109367006,1421360,110788366,True
9275,validator_47,64270605620,True,137095000,245100,137340100,False
9276,validator_5,64609891196,True,48769003,8028020,56797023,True
9277,validator_19,64627654806,True,166704002,699700,167403702,True
9278,validator_22,65383432878,True,126729999,7821630,134551629,True
9279,validator_41,64681242280,True,104065000,1313260,105378260,False
9280,validator_21,64547964984,True,81852998,17842590,99695588,True
9281,validator_16,32568842813,True,132503999,942000,133445999,True
9282,validator_5,64731514897,True,119752001,1871700,121623701,True
9283,validator_24,33046350844,True,166336000,210400,166546400,True
9284,validator_19,64770472408,True,141754002,1063600,142817602,True
9285,validator_8,32930217862,True,191728997,7936100,199665097,True
9286,validator_2,33441862997,True,162971002,4684840,167655842,True
9287,validator_38,32261948070,True,89690000,1252100,90942100,False
9288,validator_31,161036249610,True,202889000,1982400,204871400,False
9289,validator_39,32857182410,True,85536000,831430,86367430,False
9290,validator_26,32909661970,True,158141000,8300800,166441800,False
9291,validator_1,64682613283,True,94741004,5609400,100350404,True
9292,validator_5,64943237896,True,209981999,1741000,211722999,True
9293,validator_2,33681030698,True,219914001,19253700,239167701,True
9294,validator_4,32493495860,True,161874001,18731100,180605101,True
9295,validator_18,96897681031,True,129802001,549530,130351531,True
9296,validator_23,33319116513,True,205846999,1741700,207588699,True
9297,validator_47,64402748520,True,130107000,2035900,132142900,False
9298,validator_1,64858820885,True,158064002,18143600,176207602,True
9299,validator_12,96719953974,True,68150004,1174190,69324194,True
9300,validator_1,65002329778,True,122948993,20559900,143508893,True
9301,validator_26,32990870500,True,76323000,4885530,81208530,False
9302,validator_4,32584442862,True,89033002,1914000,90947002,True
9303,validator_37,64639359040,True,99078000,1167600,100245600,False
9304,validator_36,97017090230,True,133929000,835700,134764700,False
9305,validator_11,32568054848,True,104311998,911500,105223498,True
9306,validator_35,96311876120,True,92869000,1811980,94680980,False
9307,validator_44,97342247100,True,100654000,8698900,109352900,False
9308,validator_29,32538968920,True,61967000,676400,62643400,False
9309,validator_47,64523876240,True,120576000,551720,121127720,False
9310,validator_30,65433688400,True,54580000,18769470,73349470,False
9311,validator_15,256977709968,True,111629999,4462130,116092129,True
9312,validator_10,33010288575,True,149318002,2413300,151731302,True
9313,validator_14,97421515476,True,224747003,641800,225388803,True
9314,validator_34,257105816490,True,78219000,4820200,83039200,False
9315,validator_42,32950638450,True,135800000,3050400,138850400,False
9316,validator_43,64287842530,True,73452000,955800,74407800,False
9317,validator_19,64924817612,True,153218004,1127200,154345204,True
9318,validator_32,32775388920,True,56225000,1297000,57522000,False
9319,validator_37,64781567860,True,121515000,20693820,142208820,False
9320,validator_39,32981769810,True,116296000,8291400,124587400,False
9321,validator_23,33580650715,True,259703002,1831200,261534202,True
9322,validator_22,65537398963,True,152925995,1040090,153966085,True
9323,validator_28,33064531330,True,55413000,2437500,57850500,False
9324,validator_4,32646863994,True,61087002,1334130,62421132,True
9325,validator_35,96551254120,True,231547000,7831000,239378000,False
9326,validator_18,97026434232,True,123356001,5397200,128753201,True
9327,validator_40,32392268190,True,156846000,8080970,164926970,False
9328,validator_47,64596624140,True,72405000,342900,72747900,False
9329,validator_10,33136720121,True,125662996,768550,126431546,True
9330,validator_15,257052723666,True,74072998,940700,75013698,True
9331,validator_28,33164586630,True,98627000,1428300,100055300,False
9332,validator_15,257216838269,True,161607003,2507600,164114603,True
9333,validator_34,257181393920,True,74099000,1478430,75577430,False
9334,validator_29,32715847160,True,175942000,936240,176878240,False
9335,validator_35,96712867840,True,160213000,1400720,161613720,False
9336,validator_20,33417670378,True,97652998,605860,98258858,True
9337,validator_16,32701072835,True,129479002,2751020,132230022,True
9338,validator_48,160665240260,True,144077000,2171270,146248270,False
9339,validator_22,65695590015,True,156598002,1593050,158191052,True
9340,validator_6,32672597051,True,117579998,2692430,120272428,True
9341,validator_41,64728679700,True,44779000,2658420,47437420,False
9342,validator_7,65037215436,True,65532998,365820,65898818,True
9343,validator_35,96842423940,True,103717000,25839100,129556100,False
9344,validator_35,96947494910,True,103817000,1253970,105070970,False
9345,validator_42,33061549690,True,109579000,1332240,110911240,False
9346,validator_21,64670096486,True,119880002,2251500,122131502,True
9347,validator_12,96791492602,True,71303998,234630,71538628,True
9348,validator_20,33503377683,True,78838005,6869300,85707305,True
9349,validator_17,161838949656,True,117739996,1127100,118867096,True
9350,validator_10,33234470116,True,95728995,2021000,97749995,True
9351,validator_19,65142164911,True,212010999,5336300,217347299,True
9352,validator_8,32973169439,True,41337997,1613580,42951577,True
9353,validator_1,65142175741,True,139737003,108960,139845963,True
9354,validator_1,65377254733,True,229549992,5529000,235078992,True
9355,validator_15,257294777771,True,77108002,831500,77939502,True
9356,validator_14,97510114981,True,87146005,1453500,88599505,True
9357,validator_0,33074362558,True,71242002,2489840,73731842,True
9358,validator_26,33077721770,True,86369000,482270,86851270,False
9359,validator_35,97098741650,True,146777000,4469740,151246740,False
9360,validator_45,32469687400,True,36848000,5936600,42784600,False
9361,validator_41,64839622140,True,109353000,1589440,110942440,False
9362,validator_34,257259544820,True,76223000,1927900,78150900,False
9363,validator_2,33810469926,True,129129998,309230,129439228,True
9364,validator_28,33296913830,True,131653000,674200,132327200,False
9365,validator_0,33140670477,True,65938999,368920,66307919,True
9366,validator_2,33977300364,True,164154998,2675440,166830438,True
9367,validator_7,65091744813,True,53436997,1092380,54529377,True
9368,validator_39,33159090310,True,175642000,1678500,177320500,False
9369,validator_17,161987545152,True,147474996,1120500,148595496,True
9370,validator_6,32827303226,True,153809995,896180,154706175,True
9371,validator_22,65833723804,True,137615999,517790,138133789,True
9372,validator_23,33664753020,True,65039005,19063300,84102305,True
9373,validator_32,32846301520,True,69174000,1738600,70912600,False
9374,validator_48,160897688460,True,231034000,1414200,232448200,False
9375,validator_44,97468875800,True,123596000,3032700,126628700,False
9376,validator_28,33394305890,True,88149000,9243060,97392060,False
9377,validator_48,161037245680,True,121028000,18529220,139557220,False
9378,validator_31,161148875930,True,112280000,346320,112626320,False
9379,validator_20,33618602981,True,113946998,1278300,115225298,True
9380,validator_34,257436884470,True,175754000,1585650,177339650,False
9381,validator_24,33097902340,True,50448996,1102500,51551496,True
9382,validator_17,162092811941,True,81205999,24060790,105266789,True
9383,validator_17,162229427360,True,130844999,5770420,136615419,True
9384,validator_43,64519337230,True,230873000,621700,231494700,False
9385,validator_23,33820066818,True,145053998,10259800,155313798,True
9386,validator_31,161258943560,True,107512000,2555630,110067630,False
9387,validator_41,64994448440,True,135539000,19287300,154826300,False
9388,validator_27,96868737620,True,116715000,1581700,118296700,False
9389,validator_23,33947936915,True,125212997,2657100,127870097,True
9390,validator_19,65363878013,True,202513002,19200100,221713102,True
9391,validator_37,64903469350,True,104066000,17835490,121901490,False
9392,validator_31,161398873490,True,139698000,231930,139929930,False
9393,validator_23,34193975555,True,245808000,230640,246038640,True
9394,validator_22,66102930932,True,267001008,2206120,269207128,True
9395,validator_5,64994453826,True,49826000,1389930,51215930,True
9396,validator_9,33185530919,True,156009994,19284300,175294294,True
9397,validator_47,64699795280,True,84487000,18684140,103171140,False
9398,validator_32,32995214020,True,147027000,1885500,148912500,False
9399,validator_18,97210780019,True,183173997,1171790,184345787,True
9400,validator_35,97226706450,True,125909000,2055800,127964800,False
9401,validator_48,161141172410,True,96145000,7781730,103926730,False
9402,validator_37,64985428650,True,79907000,2052300,81959300,False
9403,validator_18,97289567519,True,76473000,2314500,78787500,True
9404,validator_47,64888131610,True,186445000,1891330,188336330,False
9405,validator_8,33091362567,True,117330998,862130,118193128,True
9406,validator_34,257559003930,True,121925000,194460,122119460,False
9407,validator_9,33311168119,True,125538000,99200,125637200,True
9408,validator_25,32396618910,True,77065000,7856800,84921800,False
9409,validator_25,32434134990,True,37427000,89080,37516080,False
9410,validator_44,97549021800,True,79662000,484000,80146000,False
9411,validator_34,257652965410,True,91209000,2752480,93961480,False
9412,validator_41,65133063630,True,137544000,1071190,138615190,False
9413,validator_11,32642448547,True,73478999,914700,74393699,True
9414,validator_41,65259459430,True,125537000,858800,126395800,False
9415,validator_10,33349901703,True,113673997,1757590,115431587,True
9416,validator_30,65588078440,True,153389000,1001040,154390040,False
9417,validator_12,96924248624,True,129693002,3063020,132756022,True
9418,validator_35,97278520350,True,51070000,743900,51813900,False
9419,validator_23,34354506156,True,154875001,5655600,160530601,True
9420,validator_13,32621024202,True,145897000,707530,146604530,True
9421,validator_38,32355483970,True,91433000,2102900,93535900,False
9422,validator_45,32591369470,True,121138000,544070,121682070,False
9423,validator_47,64972520140,True,82411000,1977530,84388530,False
9424,validator_8,33338575549,True,245604002,1608980,247212982,True
9425,validator_41,65447044380,True,185780000,1804950,187584950,False
9426,validator_37,65104051370,True,116661000,1961720,118622720,False
9427,validator_45,32664322610,True,71950000,1003140,72953140,False
9428,validator_39,33226088880,True,65360000,1638570,66998570,False
9429,validator_2,34138093882,True,160119998,673520,160793518,True
9430,validator_23,34465412247,True,110457001,449090,110906091,True
9431,validator_48,161250196310,True,108786000,237900,109023900,False
9432,validator_42,33211268790,True,125142000,24577100,149719100,False
9433,validator_42,33352769270,True,132671000,8829480,141500480,False
9434,validator_14,97577068557,True,65735006,1218570,66953576,True
9435,validator_6,32932645768,True,104120002,1222540,105342542,True
9436,validator_49,64727111350,True,63633000,5813800,69446800,False
9437,validator_12,97129157240,True,203846996,1061620,204908616,True
9438,validator_34,257816197610,True,160302000,2930200,163232200,False
9439,validator_11,32885163844,True,233455997,9259300,242715297,True
9440,validator_15,257362638169,True,66905998,954400,67860398,True
9441,validator_18,97393813320,True,96431001,7814800,104245801,True
9442,validator_9,33383803125,True,71810006,825000,72635006,True
9443,validator_35,97343440470,True,61996000,2924120,64920120,False
9444,validator_26,33151768770,True,72409000,1638000,74047000,False
9445,validator_37,65187214590,True,70509000,12654220,83163220,False
9446,validator_15,257543849455,True,179414996,1796290,181211286,True
9447,validator_31,161471580170,True,52268000,20438680,72706680,False
9448,validator_41,65599926280,True,133649000,19232900,152881900,False
9449,validator_0,33285253298,True,143930001,652820,144582821,True
9450,validator_4,32885011535,True,211383001,26764540,238147541,True
9451,validator_9,33553944856,True,168511001,1630730,170141731,True
9452,validator_49,64827182150,True,99802000,268800,100070800,False
9453,validator_48,161330054990,True,79297000,561680,79858680,False
9454,validator_14,97720056717,True,142444000,544160,142988160,True
9455,validator_37,65279878520,True,91517000,1146930,92663930,False
9456,validator_47,65172368540,True,189828000,10020400,199848400,False
9457,validator_34,257925985150,True,108785000,1002540,109787540,False
9458,validator_0,33525041898,True,239616000,172600,239788600,True
9459,validator_33,32702853330,True,68646000,5301190,73947190,False
9460,validator_25,32586564690,True,151905000,524700,152429700,False
9461,validator_23,34570956449,True,105198002,346200,105544202,True
9462,validator_34,257995417450,True,68940000,492300,69432300,False
9463,validator_41,65758527820,True,158371000,230540,158601540,False
9464,validator_8,33497080448,True,157917999,586900,158504899,True
9465,validator_2,34345176458,True,201736996,5345580,207082576,True
9466,validator_9,33663989857,True,107875001,2170000,110045001,True
9467,validator_10,33479713199,True,129140006,671490,129811496,True
9468,validator_17,162390654244,True,160129004,1097880,161226884,True
9469,validator_27,96939049820,True,69264000,1048200,70312200,False
9470,validator_37,65468485400,True,188386000,220880,188606880,False
9471,validator_21,64920924590,True,230350004,20478100,250828104,True
9472,validator_14,97873075414,True,151900997,1117700,153018697,True
9473,validator_38,32450552870,True,76917000,18151900,95068900,False
9474,validator_5,65091121627,True,86393001,10274800,96667801,True
9475,validator_17,162486066642,True,93792998,1619400,95412398,True
9476,validator_28,33489781430,True,94562000,913540,95475540,False
9477,validator_17,162632329723,True,137815001,8448080,146263081,True
9478,validator_22,66253191951,True,149864999,396020,150261019,True
9479,validator_22,66348920514,True,94435003,1293560,95728563,True
9480,validator_34,258037489380,True,41794000,277930,42071930,False
9481,validator_35,97457088650,True,112812000,836180,113648180,False
9482,validator_8,33543817439,True,44614001,2122990,46736991,True
9483,validator_49,64888812950,True,61083000,547800,61630800,False
9484,validator_12,97231397940,True,101949000,291700,102240700,True
9485,validator_26,33297978170,True,144318000,1891400,146209400,False
9486,validator_14,98055855834,True,181259000,1521420,182780420,True
9487,validator_14,98284446450,True,227209996,1380620,228590616,True
9488,validator_48,161620843350,True,289525000,1263360,290788360,False
9489,validator_34,258124498780,True,86124000,885400,87009400,False
9490,validator_28,33548256670,True,57673000,802240,58475240,False
9491,validator_47,65319591440,True,146450000,772900,147222900,False
9492,validator_13,32825010207,True,185584995,18401010,203986005,True
9493,validator_3,32528948106,True,172691001,744820,173435821,True
9494,validator_15,257674571963,True,128414998,2307510,130722508,True
9495,validator_40,32499938490,True,99244000,8426300,107670300,False
9496,validator_17,162740220724,True,99874001,8017000,107891001,True
9497,validator_8,33720913877,True,175799998,1296440,177096438,True
9498,validator_30,65683024240,True,94102000,843800,94945800,False
9499,validator_24,33167102943,True,68934003,266600,69200603,True
9500,validator_10,32078731199,True,78080999,650200,78731199,True
9501,validator_12,96134912187,True,134307997,604190,134912187,True
9502,validator_31,160102139830,True,93211000,8928830,102139830,False
9503,validator_23,32168173501,True,159551001,8622500,168173501,True
9504,validator_34,256069994300,True,59731000,10263300,69994300,False
9505,validator_39,32059019600,True,58732000,287600,59019600,False
9506,validator_20,32082078595,True,80586995,1491600,82078595,True
9507,validator_22,64119155637,True,117292007,1863630,119155637,True
9508,validator_27,96122169700,True,120872000,1297700,122169700,False
9509,validator_18,96129900744,True,126718004,3182740,129900744,True
9510,validator_20,32369635977,True,250538002,37019380,287557382,True
9511,validator_36,96178379340,True,176884000,1495340,178379340,False
9512,validator_14,96154614641,True,154369001,245640,154614641,True
9513,validator_49,64113927600,True,106531000,7396600,113927600,False
9514,validator_10,32285223194,True,205217995,1274000,206491995,True
9515,validator_26,32129023220,True,127198000,1825220,129023220,False
9516,validator_15,256155790498,True,146766998,9023500,155790498,True
9517,validator_17,160156436885,True,153834995,2601890,156436885,True
9518,validator_26,32243406590,True,113210000,1173370,114383370,False
9519,validator_45,32051490100,True,49177000,2313100,51490100,False
9520,validator_2,32105319004,True,102862004,2457000,105319004,True
9521,validator_8,32110713802,True,102272002,8441800,110713802,True
9522,validator_36,96245362370,True,65874000,1109030,66983030,False
9523,validator_17,160241030247,True,83442002,1151360,84593362,True
9524,validator_5,64058544577,True,56815997,1728580,58544577,True
9525,validator_49,64237489200,True,123071000,490600,123561600,False
9526,validator_1,64108776200,True,107108000,1668200,108776200,True
9527,validator_22,64315376963,True,177391006,18830320,196221326,True
9528,validator_36,96426436140,True,172853000,8220770,181073770,False
9529,validator_18,96251438340,True,121131996,405600,121537596,True
9530,validator_42,32132562500,True,130713000,1849500,132562500,False
9531,validator_30,64144227700,True,143788000,439700,144227700,False
9532,validator_48,160062233800,True,60564000,1669800,62233800,False
9533,validator_0,32091705740,True,91060000,645740,91705740,True
9534,validator_46,96160055690,True,141097000,18958690,160055690,False
9535,validator_6,32196392499,True,178282999,18109500,196392499,True
9536,validator_44,96096102740,True,77335000,18767740,96102740,False
9537,validator_20,32509928209,True,138982002,1310230,140292232,True
9538,validator_19,64097218601,True,96766001,452600,97218601,True
9539,validator_28,32127028100,True,126863000,165100,127028100,False
9540,validator_20,32680394997,True,161901998,8564790,170466788,True
9541,validator_7,64115830700,True,110179000,5651700,115830700,True
9542,validator_31,160150960510,True,39317000,9503680,48820680,False
9543,validator_37,64121786260,True,120885000,901260,121786260,False
9544,validator_30,64291967800,True,146453000,1287100,147740100,False
9545,validator_18,96375830866,True,123397006,995520,124392526,True
9546,validator_5,64174887406,True,115113999,1228830,116342829,True
9547,validator_39,32214080600,True,154592000,469000,155061000,False
9548,validator_14,96267470135,True,107589004,5266490,112855494,True
9549,validator_31,160236404810,True,83952000,1492300,85444300,False
9550,validator_31,160394260010,True,156924000,931200,157855200,False
9551,validator_47,64133265520,True,131899000,1366520,133265520,False
9552,validator_49,64350589700,True,106720000,6380500,113100500,False
9553,validator_17,160396474310,True,154536003,908060,155444063,True
9554,validator_15,256355729397,True,199748999,189900,199938899,True
9555,validator_23,32390015342,True,220630001,1211840,221841841,True
9556,validator_30,64407800800,True,96594000,19239000,115833000,False
9557,validator_27,96208241720,True,66681000,19391020,86072020,False
9558,validator_49,64404679000,True,44841000,9248300,54089300,False
9559,validator_49,64509930100,True,103987000,1264100,105251100,False
9560,validator_5,64236361447,True,54046001,7428040,61474041,True
9561,validator_39,32287467040,True,71842000,1544440,73386440,False
9562,validator_11,32125884736,True,124358996,1525740,125884736,True
9563,validator_27,96397302020,True,187339000,1721300,189060300,False
9564,validator_10,32449723817,True,161783003,2717620,164500623,True
9565,validator_42,32242637510,True,105151000,4924010,110075010,False
9566,validator_26,32356554890,True,112692000,456300,113148300,False
9567,validator_8,32274637144,True,155500002,8423340,163923342,True
9568,validator_1,64305593603,True,195534003,1283400,196817403,True
9569,validator_34,256190492390,True,119423000,1075090,120498090,False
9570,validator_13,32223149303,True,221551003,1598300,223149303,True
9571,validator_6,32355786899,True,157010000,2384400,159394400,True
9572,validator_16,32086979880,True,85013000,1966880,86979880,True
9573,validator_22,64404704664,True,87845001,1482700,89327701,True
9574,validator_17,160582803207,True,168104997,18223900,186328897,True
9575,validator_19,64286477904,True,157924003,31335300,189259303,True
9576,validator_24,32083866943,True,76379003,7487940,83866943,True
9577,validator_23,32563014146,True,168397004,4601800,172998804,True
9578,validator_7,64306072878,True,181911998,8330180,190242178,True
9579,validator_17,160723045144,True,138752997,1488940,140241937,True
9580,validator_22,64563775964,True,140662000,18409300,159071300,True
9581,validator_5,64366616143,True,128208996,2045700,130254696,True
9582,validator_7,64418593980,True,111336002,1185100,112521102,True
9583,validator_29,32139901230,True,138183000,1718230,139901230,False
9584,validator_31,160519685800,True,124494000,931790,125425790,False
9585,validator_2,32219502804,True,113682000,501800,114183800,True
9586,validator_44,96298889560,True,196078000,6708820,202786820,False
9587,validator_21,64220749298,True,200862998,19886300,220749298,True
9588,validator_2,32405016062,True,182896998,2616260,185513258,True
9589,validator_36,96499132100,True,72226000,469960,72695960,False
9590,validator_32,32136029320,True,134878000,1151320,136029320,False
9591,validator_22,64656832446,True,91681002,1375480,93056482,True
9592,validator_8,32397995497,True,122346003,1012350,123358353,True
9593,validator_39,32386255380,True,93106000,5682340,98788340,False
9594,validator_36,96581026500,True,79861000,2033400,81894400,False
9595,validator_14,96356082137,True,86831002,1781000,88612002,True
9596,validator_20,32855076195,True,170931998,3749200,174681198,True
9597,validator_41,64056448650,True,55009000,1439650,56448650,False
9598,validator_19,64460251104,True,172881000,892200,173773200,True
9599,validator_4,32197037265,True,196668005,369260,197037265,True
9600,validator_0,32303471738,True,206241998,5524000,211765998,True
9601,validator_27,96473172220,True,68510000,7360200,75870200,False
9602,validator_12,96180170271,True,44532004,726080,45258084,True
9603,validator_26,32433430880,True,56918000,19957990,76875990,False
9604,validator_24,32220011886,True,133670003,2474940,136144943,True
9605,validator_46,96268260690,True,105480000,2725000,108205000,False
9606,validator_24,32512052716,True,286782000,5258830,292040830,True
9607,validator_2,32494254343,True,81546001,7692280,89238281,True
9608,validator_2,32658324242,True,145121999,18947900,164069899,True
9609,validator_25,32090763500,True,88025000,2738500,90763500,False
9610,validator_27,96598303420,True,124766000,365200,125131200,False
9611,validator_33,32155404720,True,154031000,1373720,155404720,False
9612,validator_14,96590178933,True,223876996,10219800,234096796,True
9613,validator_25,32237315330,True,142078000,4473830,146551830,False
9614,validator_38,32171005970,True,147166000,23839970,171005970,False
9615,validator_30,64526529000,True,116996000,1732200,118728200,False
9616,validator_28,32270414900,True,140330000,3056800,143386800,False
9617,validator_42,32316528710,True,66985000,6906200,73891200,False
9618,validator_7,64563205782,True,136222002,8389800,144611802,True
9619,validator_44,96464501860,True,163220000,2392300,165612300,False
9620,validator_14,96690209033,True,98630000,1400100,100030100,True
9621,validator_22,64827417248,True,170292002,292800,170584802,True
9622,validator_23,32659091588,True,90595002,5482440,96077442,True
9623,validator_17,160863717786,True,139708002,964640,140672642,True
9624,validator_7,64631014981,True,66648999,1160200,67809199,True
9625,validator_30,64674952140,True,146933000,1490140,148423140,False
9626,validator_46,96396717030,True,122112000,6344340,128456340,False
9627,validator_41,64110233790,True,52113000,1672140,53785140,False
9628,validator_10,32512167892,True,54972995,7471080,62444075,True
9629,validator_33,32258214720,True,101002000,1808000,102810000,False
9630,validator_43,64068961100,True,66625000,2336100,68961100,False
9631,validator_17,160932900487,True,68022001,1160700,69182701,True
9632,validator_8,32525010399,True,126315002,699900,127014902,True
9633,validator_28,32381217300,True,109582000,1220400,110802400,False
9634,validator_1,64374911773,True,68344000,974170,69318170,True
9635,validator_37,64208346100,True,78912000,7647840,86559840,False
9636,validator_4,32312890759,True,97697994,18155500,115853494,True
9637,validator_44,96628986790,True,163601000,883930,164484930,False
9638,validator_24,32589226640,True,74828004,2345920,77173924,True
9639,validator_23,32877869282,True,217681004,1096690,218777694,True
9640,validator_29,32282927630,True,140944000,2082400,143026400,False
9641,validator_14,96926333968,True,234565005,1559930,236124935,True
9642,validator_48,160134433560,True,72010000,189760,72199760,False
9643,validator_33,32301443220,True,35583000,7645500,43228500,False
9644,validator_2,32916716568,True,235123996,23268330,258392326,True
9645,validator_30,64862234940,True,186257000,1025800,187282800,False
9646,validator_36,96759594640,True,177100000,1468140,178568140,False
9647,validator_25,32311697110,True,72184000,2197780,74381780,False
9648,validator_28,32487106160,True,104952000,936860,105888860,False
9649,validator_32,32199288550,True,60109000,3150230,63259230,False
9650,validator_21,64325918796,True,103406998,1762500,105169498,True
9651,validator_16,32177105720,True,89085000,1040840,90125840,True
9652,validator_30,64979964540,True,116683000,1046600,117729600,False
9653,validator_34,256260026790,True,68294000,1240400,69534400,False
9654,validator_40,32152506220,True,144450000,8056220,152506220,False
9655,validator_9,32064992199,True,64162999,829200,64992199,True
9656,validator_36,96882325530,True,120995000,1735890,122730890,False
9657,validator_33,32417174410,True,113625000,2106190,115731190,False
9658,validator_26,32480345080,True,42012000,4902200,46914200,False
9659,validator_11,32230083232,True,103414996,783500,104198496,True
9660,validator_34,256371905290,True,110691000,1187500,111878500,False
9661,validator_2,32998602058,True,80092000,1793490,81885490,True
9662,validator_24,32749161842,True,153992002,5943200,159935202,True
9663,validator_46,96565987760,True,161790000,7480730,169270730,False
9664,validator_5,64494210345,True,127330002,264200,127594202,True
9665,validator_48,160258087590,True,122307000,1347030,123654030,False
9666,validator_3,32097967815,True,95980995,1986820,97967815,True
9667,validator_37,64283067630,True,74199000,522530,74721530,False
9668,validator_16,32328401912,True,149398992,1897200,151296192,True
9669,validator_28,32587898610,True,99970000,822450,100792450,False
9670,validator_43,64134959600,True,65003000,995500,65998500,False
9671,validator_34,256519955110,True,147377000,672820,148049820,False
9672,validator_22,64979086951,True,150345003,1324700,151669703,True
9673,validator_31,160601350210,True,63032000,18632410,81664410,False
9674,validator_24,32879804444,True,129085002,1557600,130642602,True
9675,validator_28,32688272750,True,99653000,721140,100374140,False
9676,validator_23,33111527814,True,225309002,8349530,233658532,True
9677,validator_27,96672843220,True,73596000,943800,74539800,False
9678,validator_11,32356207535,True,123683003,2441300,126124303,True
9679,validator_31,160655539710,True,53207000,982500,54189500,False
9680,validator_31,160831378210,True,173878000,1960500,175838500,False
9681,validator_11,32462831350,True,105791005,832810,106623815,True
9682,validator_30,65218514130,True,236946000,1603590,238549590,False
9683,validator_32,32370526450,True,169836000,1401900,171237900,False
9684,validator_34,256553508910,True,31669000,1884800,33553800,False
9685,validator_45,32178331600,True,118892000,7949500,126841500,False
9686,validator_14,97055189771,True,122766003,6089800,128855803,True
9687,validator_26,32621545540,True,139678000,1522460,141200460,False
9688,validator_0,32570817739,True,266668001,678000,267346001,True
9689,validator_45,32301636500,True,120922000,2382900,123304900,False
9690,validator_10,32579391641,True,66345999,877750,67223749,True
9691,validator_15,256536242096,True,174404999,6107700,180512699,True
9692,validator_46,96630457500,True,63371000,1098740,64469740,False
9693,validator_17,161201492184,True,267303997,1287700,268591697,True
9694,validator_41,64202268390,True,91396000,638600,92034600,False
9695,validator_1,64445662478,True,65702005,5048700,70750705,True
9696,validator_45,32370626100,True,50049000,18940600,68989600,False
9697,validator_18,96632147665,True,256171999,144800,256316799,True
9698,validator_21,64448269396,True,121172000,1178600,122350600,True
9699,validator_40,32227341220,True,66025000,8810000,74835000,False
9700,validator_34,256862729450,True,307699000,1521540,309220540,False
9701,validator_39,32490665380,True,95257000,9153000,104410000,False
9702,validator_9,32177473731,True,111633002,848530,112481532,True
9703,validator_10,32742363670,True,162542999,429030,162972029,True
9704,validator_12,96264618472,True,79456001,4992200,84448201,True
9705,validator_13,32306582305,True,82500002,933000,83433002,True
9706,validator_28,32773867390,True,84141000,1453640,85594640,False
9707,validator_20,33030788199,True,175004004,708000,175712004,True
9708,validator_3,32244723919,True,144769004,1987100,146756104,True
9709,validator_9,32264405232,True,85662001,1269500,86931501,True
9710,validator_32,32520659200,True,148453000,1679750,150132750,False
9711,validator_9,32352213403,True,87596001,212170,87808171,True
9712,validator_7,64833475323,True,182751002,19709340,202460342,True
9713,validator_37,64379572260,True,94649000,1855630,96504630,False
9714,validator_41,64315343990,True,112706000,369600,113075600,False
9715,validator_35,96145664440,True,140152000,5512440,145664440,False
9716,validator_15,256705459198,True,167979002,1238100,169217102,True
9717,validator_9,32496174458,True,143071005,890050,143961055,True
9718,validator_20,33214280319,True,183125000,367120,183492120,True
9719,validator_13,32399950537,True,92141002,1227230,93368232,True
9720,validator_0,32764646744,True,190593005,3236000,193829005,True
9721,validator_16,32435396814,True,106554002,440900,106994902,True
9722,validator_22,65076949954,True,95150003,2713000,97863003,True
9723,validator_2,33274207155,True,265286997,10318100,275605097,True
9724,validator_17,161414981382,True,212833998,655200,213489198,True
9725,validator_22,65176882453,True,91971999,7960500,99932499,True
9726,validator_44,96734361590,True,104667000,707800,105374800,False
9727,validator_34,257022777290,True,157537000,2510840,160047840,False
9728,validator_15,256861617839,True,154678001,1480640,156158641,True
9729,validator_8,32730552765,True,202368006,3174360,205542366,True
9730,validator_37,64539113440,True,157720000,1821180,159541180,False
9731,validator_42,32515360900,True,198268000,564190,198832190,False
9732,validator_27,96750440920,True,76832000,765700,77597700,False
9733,validator_42,32594606420,True,78987000,258520,79245520,False
9734,validator_44,96896325190,True,160976000,987600,161963600,False
9735,validator_33,32551273840,True,116100000,17999430,134099430,False
9736,validator_44,96988589180,True,91552000,711990,92263990,False
9737,validator_30,65360338930,True,135019000,6805800,141824800,False
9738,validator_39,32579653080,True,88043000,944700,88987700,False
9739,validator_17,161550998957,True,117368005,18649570,136017575,True
9740,validator_22,65248881249,True,70495996,1502800,71998796,True
9741,validator_41,64470026790,True,149011000,5671800,154682800,False
9742,validator_42,32811788050,True,216225000,956630,217181630,False
9743,validator_28,33006680830,True,231315000,1498440,232813440,False
9744,validator_41,64575864020,True,105663000,174230,105837230,False
9745,validator_18,96697072166,True,59833001,5091500,64924501,True
9746,validator_33,32628906140,True,69647000,7985300,77632300,False
9747,validator_9,32760382199,True,244726001,19481740,264207741,True
9748,validator_13,32474419672,True,73887005,582130,74469135,True
9749,validator_7,64971316618,True,129706995,8134300,137841295,True
9750,validator_35,96217195140,True,70204000,1326700,71530700,False
9751,validator_10,32858557273,True,111377003,4816600,116193603,True
9752,validator_6,32552324623,True,186499004,10038720,196537724,True
9753,validator_5,64553094173,True,56430998,2452830,58883828,True
9754,validator_43,64213434730,True,76976000,1499130,78475130,False
9755,validator_17,161720082560,True,167300003,1783600,169083603,True
9756,validator_12,96540014200,True,273916998,1478730,275395728,True
9757,validator_39,32770814980,True,182395000,8766900,191161900,False
9758,validator_48,160518991990,True,260035000,869400,260904400,False
9759,validator_26,32743220170,True,120993000,681630,121674630,False
9760,validator_44,97092160410,True,102468000,1103230,103571230,False
9761,validator_44,97232894200,True,122591000,18142790,140733790,False
9762,validator_0,33000630716,True,215917002,20066970,235983972,True
9763,validator_9,32884689831,True,123709002,598630,124307632,True
9764,validator_18,96767329500,True,69121994,1135340,70257334,True
9765,validator_49,64657664550,True,146219000,1515450,147734450,False
9766,validator_45,32426902800,True,56245000,31700,56276700,False
9767,validator_29,32476325520,True,149262000,44135890,193397890,False
9768,validator_9,33010236625,True,122311994,3234800,125546794,True
9769,validator_14,97196126673,True,140208002,728900,140936902,True
9770,validator_20,33319411520,True,103848001,1283200,105131201,True
9771,validator_1,64582262879,True,128610001,7990400,136600401,True
9772,validator_32,32717866920,True,195471000,1736720,197207720,False
9773,validator_12,96650629780,True,109634000,981580,110615580,True
9774,validator_3,32355512285,True,109367006,1421360,110788366,True
9775,validator_47,64270605620,True,137095000,245100,137340100,False
9776,validator_5,64609891196,True,48769003,8028020,56797023,True
9777,validator_19,64627654806,True,166704002,699700,167403702,True
9778,validator_22,65383432878,True,126729999,7821630,134551629,True
9779,validator_41,64681242280,True,104065000,1313260,105378260,False
9780,validator_21,64547964984,True,81852998,17842590,99695588,True
9781,validator_16,32568842813,True,132503999,942000,133445999,True
9782,validator_5,64731514897,True,119752001,1871700,121623701,True
9783,validator_24,33046350844,True,166336000,210400,166546400,True
9784,validator_19,64770472408,True,141754002,1063600,142817602,True
9785,validator_8,32930217862,True,191728997,7936100,199665097,True
9786,validator_2,33441862997,True,162971002,4684840,167655842,True
9787,validator_38,32261948070,True,89690000,1252100,90942100,False
9788,validator_31,161036249610,True,202889000,1982400,204871400,False
9789,validator_39,32857182410,True,85536000,831430,86367430,False
9790,validator_26,32909661970,True,158141000,8300800,166441800,False
9791,validator_1,64682613283,True,94741004,5609400,100350404,True
9792,validator_5,64943237896,True,209981999,1741000,211722999,True
9793,validator_2,33681030698,True,219914001,19253700,239167701,True
9794,validator_4,32493495860,True,161874001,18731100,180605101,True
9795,validator_18,96897681031,True,129802001,549530,130351531,True
9796,validator_23,33319116513,True,205846999,1741700,207588699,True
9797,validator_47,64402748520,True,130107000,2035900,132142900,False
9798,validator_1,64858820885,True,158064002,18143600,176207602,True
9799,validator_12,96719953974,True,68150004,1174190,69324194,True
9800,validator_1,65002329778,True,122948993,20559900,143508893,True
9801,validator_26,32990870500,True,76323000,4885530,81208530,False
9802,validator_4,32584442862,True,89033002,1914000,90947002,True
9803,validator_37,64639359040,True,99078000,1167600,100245600,False
9804,validator_36,97017090230,True,133929000,835700,134764700,False
9805,validator_11,32568054848,True,104311998,911500,105223498,True
9806,validator_35,96311876120,True,92869000,1811980,94680980,False
9807,validator_44,97342247100,True,100654000,8698900,109352900,False
9808,validator_29,32538968920,True,61967000,676400,62643400,False
9809,validator_47,64523876240,True,120576000,551720,121127720,False
9810,validator_30,65433688400,True,54580000,18769470,73349470,False
9811,validator_15,256977709968,True,111629999,4462130,116092129,True
9812,validator_10,33010288575,True,149318002,2413300,151731302,True
9813,validator_14,97421515476,True,224747003,641800,225388803,True
9814,validator_34,257105816490,True,78219000,4820200,83039200,False
9815,validator_42,32950638450,True,135800000,3050400,138850400,False
9816,validator_43,64287842530,True,73452000,955800,74407800,False
9817,validator_19,64924817612,True,153218004,1127200,154345204,True
9818,validator_32,32775388920,True,56225000,1297000,57522000,False
9819,validator_37,64781567860,True,121515000,20693820,142208820,False
9820,validator_39,32981769810,True,116296000,8291400,124587400,False
9821,validator_23,33580650715,True,259703002,1831200,261534202,True
9822,validator_22,65537398963,True,152925995,1040090,153966085,True
9823,validator_28,33064531330,True,55413000,2437500,57850500,False
9824,validator_4,32646863994,True,61087002,1334130,62421132,True
9825,validator_35,96551254120,True,231547000,7831000,239378000,False
9826,validator_18,97026434232,True,123356001,5397200,128753201,True
9827,validator_40,32392268190,True,156846000,8080970,164926970,False
9828,validator_47,64596624140,True,72405000,342900,72747900,False
9829,validator_10,33136720121,True,125662996,768550,126431546,True
9830,validator_15,257052723666,True,74072998,940700,75013698,True
9831,validator_28,33164586630,True,98627000,1428300,100055300,False
9832,validator_15,257216838269,True,161607003,2507600,164114603,True
9833,validator_34,257181393920,True,74099000,1478430,75577430,False
9834,validator_29,32715847160,True,175942000,936240,176878240,False
9835,validator_35,96712867840,True,160213000,1400720,161613720,False
9836,validator_20,33417670378,True,97652998,605860,98258858,True
9837,validator_16,32701072835,True,129479002,2751020,132230022,True
9838,validator_48,160665240260,True,144077000,2171270,146248270,False
9839,validator_22,65695590015,True,156598002,1593050,158191052,True
9840,validator_6,32672597051,True,117579998,2692430,120272428,True
9841,validator_41,64728679700,True,44779000,2658420,47437420,False
9842,validator_7,65037215436,True,65532998,365820,65898818,True
9843,validator_35,96842423940,True,103717000,25839100,129556100,False
9844,validator_35,96947494910,True,103817000,1253970,105070970,False
9845,validator_42,33061549690,True,109579000,1332240,110911240,False
9846,validator_21,64670096486,True,119880002,2251500,122131502,True
9847,validator_12,96791492602,True,71303998,234630,71538628,True
9848,validator_20,33503377683,True,78838005,6869300,85707305,True
9849,validator_17,161838949656,True,117739996,1127100,118867096,True
9850,validator_10,33234470116,True,95728995,2021000,97749995,True
9851,validator_19,65142164911,True,212010999,5336300,217347299,True
9852,validator_8,32973169439,True,41337997,1613580,42951577,True
9853,validator_1,65142175741,True,139737003,108960,139845963,True
9854,validator_1,65377254733,True,229549992,5529000,235078992,True
9855,validator_15,257294777771,True,77108002,831500,77939502,True
9856,validator_14,97510114981,True,87146005,1453500,88599505,True
9857,validator_0,33074362558,True,71242002,2489840,73731842,True
9858,validator_26,33077721770,True,86369000,482270,86851270,False
9859,validator_35,97098741650,True,146777000,4469740,151246740,False
9860,validator_45,32469687400,True,36848000,5936600,42784600,False
9861,validator_41,64839622140,True,109353000,1589440,110942440,False
9862,validator_34,257259544820,True,76223000,1927900,78150900,False
9863,validator_2,33810469926,True,129129998,309230,129439228,True
9864,validator_28,33296913830,True,131653000,674200,132327200,False
9865,validator_0,33140670477,True,65938999,368920,66307919,True
9866,validator_2,33977300364,True,164154998,2675440,166830438,True
9867,validator_7,65091744813,True,53436997,1092380,54529377,True
9868,validator_39,33159090310,True,175642000,1678500,177320500,False
9869,validator_17,161987545152,True,147474996,1120500,148595496,True
9870,validator_6,32827303226,True,153809995,896180,154706175,True
9871,validator_22,65833723804,True,137615999,517790,138133789,True
9872,validator_23,33664753020,True,65039005,19063300,84102305,True
9873,validator_32,32846301520,True,69174000,1738600,70912600,False
9874,validator_48,160897688460,True,231034000,1414200,232448200,False
9875,validator_44,97468875800,True,123596000,3032700,126628700,False
9876,validator_28,33394305890,True,88149000,9243060,97392060,False
9877,validator_48,161037245680,True,121028000,18529220,139557220,False
9878,validator_31,161148875930,True,112280000,346320,112626320,False
9879,validator_20,33618602981,True,113946998,1278300,115225298,True
9880,validator_34,257436884470,True,175754000,1585650,177339650,False
9881,validator_24,33097902340,True,50448996,1102500,51551496,True
9882,validator_17,162092811941,True,81205999,24060790,105266789,True
9883,validator_17,162229427360,True,130844999,5770420,136615419,True
9884,validator_43,64519337230,True,230873000,621700,231494700,False
9885,validator_23,33820066818,True,145053998,10259800,155313798,True
9886,validator_31,161258943560,True,107512000,2555630,110067630,False
9887,validator_41,64994448440,True,135539000,19287300,154826300,False
9888,validator_27,96868737620,True,116715000,1581700,118296700,False
9889,validator_23,33947936915,True,125212997,2657100,127870097,True
9890,validator_19,65363878013,True,202513002,19200100,221713102,True
9891,validator_37,64903469350,True,104066000,17835490,121901490,False
9892,validator_31,161398873490,True,139698000,231930,139929930,False
9893,validator_23,34193975555,True,245808000,230640,246038640,True
9894,validator_22,66102930932,True,267001008,2206120,269207128,True
9895,validator_5,64994453826,True,49826000,1389930,51215930,True
9896,validator_9,33185530919,True,156009994,19284300,175294294,True
9897,validator_47,64699795280,True,84487000,18684140,103171140,False
9898,validator_32,32995214020,True,147027000,1885500,148912500,False
9899,validator_18,97210780019,True,183173997,1171790,184345787,True
9900,validator_35,97226706450,True,125909000,2055800,127964800,False
9901,validator_48,161141172410,True,96145000,7781730,103926730,False
9902,validator_37,64985428650,True,79907000,2052300,81959300,False
9903,validator_18,97289567519,True,76473000,2314500,78787500,True
9904,validator_47,64888131610,True,186445000,1891330,188336330,False
9905,validator_8,33091362567,True,117330998,862130,118193128,True
9906,validator_34,257559003930,True,121925000,194460,122119460,False
9907,validator_9,33311168119,True,125538000,99200,125637200,True
9908,validator_25,32396618910,True,77065000,7856800,84921800,False
9909,validator_25,32434134990,True,37427000,89080,37516080,False
9910,validator_44,97549021800,True,79662000,484000,80146000,False
9911,validator_34,257652965410,True,91209000,2752480,93961480,False
9912,validator_41,65133063630,True,137544000,1071190,138615190,False
9913,validator_11,32642448547,True,73478999,914700,74393699,True
9914,validator_41,65259459430,True,125537000,858800,126395800,False
9915,validator_10,33349901703,True,113673997,1757590,115431587,True
9916,validator_30,65588078440,True,153389000,1001040,154390040,False
9917,validator_12,96924248624,True,129693002,3063020,132756022,True
9918,validator_35,97278520350,True,51070000,743900,51813900,False
9919,validator_23,34354506156,True,154875001,5655600,160530601,True
9920,validator_13,32621024202,True,145897000,707530,146604530,True
9921,validator_38,32355483970,True,91433000,2102900,93535900,False
9922,validator_45,32591369470,True,121138000,544070,121682070,False
9923,validator_47,64972520140,True,82411000,1977530,84388530,False
9924,validator_8,33338575549,True,245604002,1608980,247212982,True
9925,validator_41,65447044380,True,185780000,1804950,187584950,False
9926,validator_37,65104051370,True,116661000,1961720,118622720,False
9927,validator_45,32664322610,True,71950000,1003140,72953140,False
9928,validator_39,33226088880,True,65360000,1638570,66998570,False
9929,validator_2,34138093882,True,160119998,673520,160793518,True
9930,validator_23,34465412247,True,110457001,449090,110906091,True
9931,validator_48,161250196310,True,108786000,237900,109023900,False
9932,validator_42,33211268790,True,125142000,24577100,149719100,False
9933,validator_42,33352769270,True,132671000,8829480,141500480,False
9934,validator_14,97577068557,True,65735006,1218570,66953576,True
9935,validator_6,32932645768,True,104120002,1222540,105342542,True
9936,validator_49,64727111350,True,63633000,5813800,69446800,False
9937,validator_12,97129157240,True,203846996,1061620,204908616,True
9938,validator_34,257816197610,True,160302000,2930200,163232200,False
9939,validator_11,32885163844,True,233455997,9259300,242715297,True
9940,validator_15,257362638169,True,66905998,954400,67860398,True
9941,validator_18,97393813320,True,96431001,7814800,104245801,True
9942,validator_9,33383803125,True,71810006,825000,72635006,True
9943,validator_35,97343440470,True,61996000,2924120,64920120,False
9944,validator_26,33151768770,True,72409000,1638000,74047000,False
9945,validator_37,65187214590,True,70509000,12654220,83163220,False
9946,validator_15,257543849455,True,179414996,1796290,181211286,True
9947,validator_31,161471580170,True,52268000,20438680,72706680,False
9948,validator_41,65599926280,True,133649000,19232900,152881900,False
9949,validator_0,33285253298,True,143930001,652820,144582821,True
9950,validator_4,32885011535,True,211383001,26764540,238147541,True
9951,validator_9,33553944856,True,168511001,1630730,170141731,True
9952,validator_49,64827182150,True,99802000,268800,100070800,False
9953,validator_48,161330054990,True,79297000,561680,79858680,False
9954,validator_14,97720056717,True,142444000,544160,142988160,True
9955,validator_37,65279878520,True,91517000,1146930,92663930,False
9956,validator_47,65172368540,True,189828000,10020400,199848400,False
9957,validator_34,257925985150,True,108785000,1002540,109787540,False
9958,validator_0,33525041898,True,239616000,172600,239788600,True
9959,validator_33,32702853330,True,68646000,5301190,73947190,False
9960,validator_25,32586564690,True,151905000,524700,152429700,False
9961,validator_23,34570956449,True,105198002,346200,105544202,True
9962,validator_34,257995417450,True,68940000,492300,69432300,False
9963,validator_41,65758527820,True,158371000,230540,158601540,False
9964,validator_8,33497080448,True,157917999,586900,158504899,True
9965,validator_2,34345176458,True,201736996,5345580,207082576,True
9966,validator_9,33663989857,True,107875001,2170000,110045001,True
9967,validator_10,33479713199,True,129140006,671490,129811496,True
9968,validator_17,162390654244,True,160129004,1097880,161226884,True
9969,validator_27,96939049820,True,69264000,1048200,70312200,False
9970,validator_37,65468485400,True,188386000,220880,188606880,False
9971,validator_21,64920924590,True,230350004,20478100,250828104,True
9972,validator_14,97873075414,True,151900997,1117700,153018697,True
9973,validator_38,32450552870,True,76917000,18151900,95068900,False
9974,validator_5,65091121627,True,86393001,10274800,96667801,True
9975,validator_17,162486066642,True,93792998,1619400,95412398,True
9976,validator_28,33489781430,True,94562000,913540,95475540,False
9977,validator_17,162632329723,True,137815001,8448080,146263081,True
9978,validator_22,66253191951,True,149864999,396020,150261019,True
9979,validator_22,66348920514,True,94435003,1293560,95728563,True
9980,validator_34,258037489380,True,41794000,277930,42071930,False
9981,validator_35,97457088650,True,112812000,836180,113648180,False
9982,validator_8,33543817439,True,44614001,2122990,46736991,True
9983,validator_49,64888812950,True,61083000,547800,61630800,False
9984,validator_12,97231397940,True,101949000,291700,102240700,True
9985,validator_26,33297978170,True,144318000,1891400,146209400,False
9986,validator_14,98055855834,True,181259000,1521420,182780420,True
9987,validator_14,98284446450,True,227209996,1380620,228590616,True
9988,validator_48,161620843350,True,289525000,1263360,290788360,False
9989,validator_34,258124498780,True,86124000,885400,87009400,False
9990,validator_28,33548256670,True,57673000,802240,58475240,False
9991,validator_47,65319591440,True,146450000,772900,147222900,False
9992,validator_13,32825010207,True,185584995,18401010,203986005,True
9993,validator_3,32528948106,True,172691001,744820,173435821,True
9994,validator_15,257674571963,True,128414998,2307510,130722508,True
9995,validator_40,32499938490,True,99244000,8426300,107670300,False
9996,validator_17,162740220724,True,99874001,8017000,107891001,True
9997,validator_8,33720913877,True,175799998,1296440,177096438,True
9998,validator_30,65683024240,True,94102000,843800,94945800,False
9999,validator_24,33167102943,True,68934003,266600,69200603,True
