block_num,validator_id,validator_capital,validator_restaking_factor,total_gas_fee,total_mev_available,block_reward,is_attacker,num_validator_nodes
0,validator_8,160535432770,True,533300000,2132770,535432770,False,5
1,validator_18,96616513600,True,589000000,27513600,616513600,False,3
2,validator_2,256643046340,True,642200000,846340,643046340,False,8
3,validator_83,32677231710,True,674900000,2331710,677231710,False,1
4,validator_64,32401099515,True,395799995,5299520,401099515,True,1
5,validator_11,160678093920,True,674170000,3923920,678093920,False,5
6,validator_7,160614845131,True,568320001,46525130,614845131,True,5
7,validator_69,32644945899,True,642099999,2845900,644945899,True,1
8,validator_52,32715460709,True,709199999,6260710,715460709,True,1
9,validator_0,256818001246,True,816400006,1601240,818001246,True,8
10,validator_85,32576729100,True,574000000,2729100,576729100,False,1
11,validator_61,32938284275,True,925420005,12864270,938284275,True,1
12,validator_66,33192210686,True,1190599996,1610690,1192210686,True,1
13,validator_2,257189763690,True,538000000,8717350,546717350,False,8
14,validator_7,161230154133,True,588420002,26889000,615309002,True,5
15,validator_35,64642122800,True,639100000,3022800,642122800,False,2
16,validator_24,64755410402,True,745400002,10010400,755410402,True,2
17,validator_21,96718249720,True,714000000,4249720,718249720,False,3
18,validator_35,65158184100,True,514800000,1261300,516061300,False,2
19,validator_26,64629641509,True,593503999,36137510,629641509,True,2
20,validator_48,32673524223,True,661519993,12004230,673524223,True,1
21,validator_9,160735941300,True,715000000,20941300,735941300,False,5
22,validator_7,162352809858,True,1115800005,6855720,1122655725,True,5
23,validator_22,96767678540,True,764800000,2878540,767678540,False,3
24,validator_54,32791524938,True,774179998,17344940,791524938,True,1
25,validator_14,96510508301,True,508400001,2108300,510508301,True,3
26,validator_69,33304663137,True,656779998,2937240,659717238,True,1
27,validator_7,163045890665,True,680860007,12220800,693080807,True,5
28,validator_43,64502297200,True,499700000,2597200,502297200,False,2
29,validator_82,32549482420,True,547300000,2182420,549482420,False,1
30,validator_12,96620500391,True,587280001,33220390,620500391,True,3
31,validator_37,64788738930,True,785700000,3038930,788738930,False,2
32,validator_67,32844763040,True,824400000,20363040,844763040,True,1
33,validator_20,96573584900,True,563870000,9714900,573584900,False,3
34,validator_73,32512609240,True,503600000,9009240,512609240,False,1
35,validator_3,256711149110,True,701000000,10149110,711149110,False,8
36,validator_5,160431950378,True,426099998,5850380,431950378,True,5
37,validator_51,32866386587,True,829940007,36446580,866386587,True,1
38,validator_8,161150523010,True,607500000,7590240,615090240,False,5
39,validator_40,64635971950,True,615000000,20971950,635971950,False,2
40,validator_19,96470627900,True,468300000,2327900,470627900,False,3
41,validator_1,256606056333,True,550760003,55296330,606056333,True,8
42,validator_62,32649383339,True,617299999,32083340,649383339,True,1
43,validator_75,32566305240,True,563400000,2905240,566305240,False,1
44,validator_1,257195420634,True,579640001,9724300,589364301,True,8
45,validator_21,97680178280,True,958800000,3128560,961928560,False,3
46,validator_35,65722662340,True,543570000,20908240,564478240,False,2
47,validator_67,33353963343,True,484686003,24514300,509200303,True,1
48,validator_43,65099155920,True,595800000,1058720,596858720,False,2
49,validator_36,64516933890,True,515100000,1833890,516933890,False,2
50,validator_48,33447721737,True,749007994,25189520,774197514,True,1
51,validator_16,96671894195,True,667999995,3894200,671894195,True,3
52,validator_15,96747778204,True,735040004,12738200,747778204,True,3
53,validator_3,257263916900,True,549900000,2867790,552767790,False,8
54,validator_2,257949014760,True,757900000,1351070,759251070,False,8
55,validator_26,65264926743,True,622037994,13247240,635285234,True,2
56,validator_31,64723255169,True,702315999,20939170,723255169,True,2
57,validator_57,32799610493,True,756419993,43190500,799610493,True,1
58,validator_1,258046021334,True,839940000,10660700,850600700,True,8
59,validator_6,160530947331,True,486020001,44927330,530947331,True,5
60,validator_38,64624665290,True,594600000,30065290,624665290,False,2
61,validator_0,257404831022,True,579739996,7089780,586829776,True,8
62,validator_16,97268686344,True,576379999,20412150,596792149,True,3
63,validator_71,32497065538,True,471659998,25405540,497065538,True,1
64,validator_57,33407603181,True,607200008,792680,607992688,True,1
65,validator_1,258737852264,True,662059990,29770940,691830930,True,8
66,validator_11,161320732150,True,621100000,21538230,642638230,False,5
67,validator_43,65768137920,True,668300000,682000,668982000,False,2
68,validator_78,32569454740,True,568100000,1354740,569454740,False,1
69,validator_16,97989069364,True,705696000,14687020,720383020,True,3
70,validator_61,33859773773,True,882539988,38949510,921489498,True,1
71,validator_47,32580169738,True,506400008,73769730,580169738,True,1
72,validator_40,65171938930,True,532000000,3966980,535966980,False,2
73,validator_4,160667024037,True,630759997,36264040,667024037,True,5
74,validator_91,32715114360,True,704100000,11014360,715114360,False,1
75,validator_15,97411429241,True,646867997,16783040,663651037,True,3
76,validator_34,64453572200,True,451700000,1872200,453572200,False,2
77,validator_10,160537879200,True,535000000,2879200,537879200,False,5
78,validator_12,97308295594,True,681200003,6595200,687795203,True,3
79,validator_77,32588103500,True,561700000,26403500,588103500,False,1
80,validator_1,259322680392,True,582499998,2328130,584828128,True,8
81,validator_9,161526203290,True,773300000,16961990,790261990,False,5
82,validator_39,64883034600,True,877600000,5434600,883034600,False,2
83,validator_9,162120617680,True,584700000,9714390,594414390,False,5
84,validator_15,98232054639,True,795259998,25365400,820625398,True,3
85,validator_89,32471402010,True,469900000,1502010,471402010,False,1
86,validator_8,161927163220,True,775500000,1140210,776640210,False,5
87,validator_64,33132063304,True,676160009,54803780,730963789,True,1
88,validator_7,163653865866,True,588320001,19655200,607975201,True,5
89,validator_11,162006926740,True,682400000,3794590,686194590,False,5
90,validator_94,32463574800,True,452100000,11474800,463574800,False,1
91,validator_11,162622259260,True,605200000,10132520,615332520,False,5
92,validator_2,258527976760,True,556900000,22062000,578962000,False,8
93,validator_4,161352533439,True,654160002,31349400,685509402,True,5
94,validator_6,161445761113,True,888400002,26413780,914813782,True,5
95,validator_26,65818743928,True,530586005,23231180,553817185,True,2
96,validator_9,162701529520,True,554700000,26211840,580911840,False,5
97,validator_5,161196743041,True,736420003,28372660,764792663,True,5
98,validator_38,65081489910,True,453600000,3224620,456824620,False,2
99,validator_58,32662399474,True,634640004,27759470,662399474,True,1
100,validator_9,163221670420,True,517200000,2940900,520140900,False,5
101,validator_25,64818844096,True,795819996,23024100,818844096,True,2
102,validator_66,33798191291,True,604500005,1480600,605980605,True,1
103,validator_35,66276965440,True,547300000,7003100,554303100,False,2
104,validator_10,161086376450,True,540370000,8127250,548497250,False,5
105,validator_66,34744608418,True,928699997,17717130,946417127,True,1
106,validator_46,32601702296,True,599899996,1802300,601702296,True,1
107,validator_6,162121179719,True,667199996,8218610,675418606,True,5
108,validator_71,33324725073,True,820200005,7459530,827659535,True,1
109,validator_13,96735120600,True,720220000,14900600,735120600,True,3
110,validator_6,162861554799,True,691766000,48609080,740375080,True,5
111,validator_20,97310055000,True,726300000,10170100,736470100,False,3
112,validator_10,161717075590,True,629600000,1099140,630699140,False,5
113,validator_30,64646146117,True,641199997,4946120,646146117,True,2
114,validator_1,260006690240,True,643420008,40589840,684009848,True,8
115,validator_7,164309303570,True,611040004,44397700,655437704,True,5
116,validator_94,33037102720,True,570000000,3527920,573527920,False,1
117,validator_63,32510626074,True,490000004,20626070,510626074,True,1
118,validator_2,259241456010,True,711400000,2079250,713479250,False,8
119,validator_2,260005546870,True,744500000,19590860,764090860,False,8
120,validator_11,163343066560,True,717400000,3407300,720807300,False,5
121,validator_36,65191340480,True,665700000,8706590,674406590,False,2
122,validator_22,97295863280,True,518640000,9544740,528184740,False,3
123,validator_11,163897814680,True,552300000,2448120,554748120,False,5
124,validator_0,258311859176,True,888564004,18464150,907028154,True,8
125,validator_33,64809914337,True,782299997,27614340,809914337,True,2
126,validator_14,97299245985,True,780800004,7937680,788737684,True,3
127,validator_33,65688747252,True,847319995,31512920,878832915,True,2
128,validator_94,33606888800,True,567600000,2186080,569786080,False,1
129,validator_9,163979782020,True,756300000,1811600,758111600,False,5
130,validator_4,161997106739,True,620640000,23933300,644573300,True,5
131,validator_71,34032992312,True,687399999,20867240,708267239,True,1
132,validator_24,65428809138,True,620493996,52904740,673398736,True,2
133,validator_12,98063523072,True,752399998,2827480,755227478,True,3
134,validator_26,66549515033,True,710760005,20011100,730771105,True,2
135,validator_34,65024463090,True,545100000,25790890,570890890,False,2
136,validator_20,97891835900,True,577300000,4480900,581780900,False,3
137,validator_82,33178977450,True,627200000,2295030,629495030,False,1
138,validator_61,34678249173,True,787080000,31395400,818475400,True,1
139,validator_11,164514431980,True,609600000,7017300,616617300,False,5
140,validator_7,165114165800,True,798000000,6862230,804862230,True,5
141,validator_6,163784112886,True,881583997,40974090,922558087,True,5
142,validator_91,33329505360,True,597000000,17391000,614391000,False,1
143,validator_1,260686182548,True,651679998,27812310,679492308,True,8
144,validator_8,162534009520,True,586200000,20646300,606846300,False,5
145,validator_53,32718362974,True,678347994,40014980,718362974,True,1
146,validator_7,165704452073,True,576600003,13686270,590286273,True,5
147,validator_52,33254927399,True,528940000,10526690,539466690,True,1
148,validator_9,164802846070,True,820600000,2464050,823064050,False,5
149,validator_41,64687297470,True,687000000,297470,687297470,False,2
150,validator_2,260536776770,True,507700000,23529900,531229900,False,8
151,validator_67,34166874442,True,805499999,7411100,812911099,True,1
152,validator_22,97874807030,True,558000000,20943750,578943750,False,3
153,validator_36,65908436410,True,708200000,8895930,717095930,False,2
154,validator_40,65940863770,True,731400000,37524840,768924840,False,2
155,validator_9,165451139670,True,645200000,3093600,648293600,False,5
156,validator_43,66377718820,True,607200000,2380900,609580900,False,2
157,validator_52,33994750949,True,673178000,66645550,739823550,True,1
158,validator_71,34874951581,True,805005989,36953280,841959269,True,1
159,validator_18,97266217850,True,646100000,3604250,649704250,False,3
160,validator_21,98318166360,True,605300000,32688080,637988080,False,3
161,validator_96,32561804360,True,560100000,1704360,561804360,False,1
162,validator_42,64651112240,True,648800000,2312240,651112240,False,2
163,validator_7,166229144242,True,499859999,24832170,524692169,True,5
164,validator_56,32676386703,True,674200003,2186700,676386703,True,1
165,validator_34,65685557390,True,658600000,2494300,661094300,False,2
166,validator_41,65275797700,True,578900000,9600230,588500230,False,2
167,validator_63,33163484206,True,612254002,40604130,652858132,True,1
168,validator_34,66400852080,True,708000000,7294690,715294690,False,2
169,validator_37,65290820330,True,493400000,8681400,502081400,False,2
170,validator_20,98322953900,True,421800000,9318000,431118000,False,3
171,validator_21,98802310360,True,463800000,20344000,484144000,False,3
172,validator_33,66431625979,True,704839997,38038730,742878727,True,2
173,validator_5,161742584076,True,520739995,25101040,545841035,True,5
174,validator_10,162102356010,True,378300000,6980420,385280420,False,5
175,validator_85,33088630770,True,509500000,2401670,511901670,False,1
176,validator_11,165271591510,True,744700000,12459530,757159530,False,5
177,validator_4,162645921181,True,641840002,6974440,648814442,True,5
178,validator_40,66347360600,True,405040000,1456830,406496830,False,2
179,validator_5,162599480657,True,836920001,19976580,856896581,True,5
180,validator_5,163478956089,True,876700002,2775430,879475432,True,5
181,validator_41,65809076290,True,531500000,1778590,533278590,False,2
182,validator_56,33589788488,True,847357995,66043790,913401785,True,1
183,validator_35,66786943840,True,509700000,278400,509978400,False,2
184,validator_15,98641088232,True,363680003,45353590,409033593,True,3
185,validator_9,165935193770,True,482900000,1154100,484054100,False,5
186,validator_47,33092841754,True,497759996,14912020,512672016,True,1
187,validator_28,64406762940,True,399040000,7722940,406762940,True,2
188,validator_30,65546285328,True,894000001,6139210,900139211,True,2
189,validator_11,166026648710,True,730200000,24857200,755057200,False,5
190,validator_42,65387108300,True,725500000,10496060,735996060,False,2
191,validator_10,162655695510,True,533300000,20039500,553339500,False,5
192,validator_68,32470618227,True,468299997,2318230,470618227,True,1
193,validator_18,97784216800,True,516900000,1098950,517998950,False,3
194,validator_7,167047241842,True,811720000,6377600,818097600,True,5
195,validator_31,65278494292,True,534370003,20869120,555239123,True,2
196,validator_21,99666047160,True,849100000,14636800,863736800,False,3
197,validator_33,67284207880,True,830820001,21761900,852581901,True,2
198,validator_76,32445371600,True,425250000,20121600,445371600,False,1
199,validator_57,34040182811,True,608480000,24099630,632579630,True,1
200,validator_11,166545183750,True,486300000,32235040,518535040,False,5
201,validator_22,98434502370,True,551000000,8695340,559695340,False,3
202,validator_77,33117099120,True,526100000,2895620,528995620,False,1
203,validator_10,163154355050,True,494900000,3759540,498659540,False,5
204,validator_78,32891528230,True,320340000,1733490,322073490,False,1
205,validator_41,66408782490,True,597900000,1806200,599706200,False,2
206,validator_10,163773873050,True,596800000,22718000,619518000,False,5
207,validator_13,97625197807,True,871799997,18277210,890077207,True,3
208,validator_3,257886614030,True,619700000,2997130,622697130,False,8
209,validator_1,261533279076,True,827299998,19796530,847096528,True,8
210,validator_5,164411156080,True,906316001,25883990,932199991,True,5
211,validator_4,163467263077,True,790124006,31217890,821341896,True,5
212,validator_1,262168606804,True,616085998,19241730,635327728,True,8
213,validator_2,261147505890,True,605700000,5029120,610729120,False,8
214,validator_30,66006992628,True,442200000,18507300,460707300,True,2
215,validator_2,261722437130,True,573300000,1631240,574931240,False,8
216,validator_0,259023767879,True,710400003,1508700,711908703,True,8
217,validator_20,98932860300,True,606800000,3106400,609906400,False,3
218,validator_16,98562059471,True,553400007,19590100,572990107,True,3
219,validator_8,163212622120,True,671000000,7612600,678612600,False,5
220,validator_37,66005533320,True,713100000,1612990,714712990,False,2
221,validator_62,33392414971,True,715220002,27811630,743031632,True,1
222,validator_58,33469126156,True,787540002,19186680,806726682,True,1
223,validator_86,32637920300,True,626400000,11520300,637920300,False,1
224,validator_29,64593578497,True,564545997,29032500,593578497,True,2
225,validator_0,259911956334,True,862019995,26168460,888188455,True,8
226,validator_3,258397043130,True,499800000,10629100,510429100,False,8
227,validator_5,165051285285,True,620540005,19589200,640129205,True,5
228,validator_75,33085646270,True,516100000,3241030,519341030,False,1
229,validator_16,99464572013,True,878560002,23952540,902512542,True,3
230,validator_83,33293819740,True,613500000,3088030,616588030,False,1
231,validator_34,67022372240,True,620500000,1020160,621520160,False,2
232,validator_62,34129756064,True,700005993,37335100,737341093,True,1
233,validator_74,32561167690,True,557700000,3467690,561167690,False,1
234,validator_72,32807099220,True,787400000,19699220,807099220,False,1
235,validator_67,34802298183,True,608380001,27043740,635423741,True,1
236,validator_37,66529676390,True,523000000,1143070,524143070,False,2
237,validator_47,33748786253,True,634399999,21544500,655944499,True,1
238,validator_13,98186993700,True,558799993,2995900,561795893,True,3
239,validator_38,65847536450,True,759200000,6846540,766046540,False,2
240,validator_3,259137436230,True,720400000,19993100,740393100,False,8
241,validator_29,65235480593,True,636019996,5882100,641902096,True,2
242,validator_97,32476368630,True,456200000,20168630,476368630,False,1
243,validator_11,167079065050,True,528700000,5181300,533881300,False,5
244,validator_17,96681171941,True,655700001,25471940,681171941,True,3
245,validator_54,33373597837,True,544559999,37512900,582072899,True,1
246,validator_91,33785018060,True,448900000,6612700,455512700,False,1
247,validator_27,64567481819,True,543259999,24221820,567481819,True,2
248,validator_70,32812001180,True,788120000,23881180,812001180,True,1
249,validator_91,34422218040,True,615200000,21999980,637199980,False,1
250,validator_0,260760525073,True,837199999,11368740,848568739,True,8
251,validator_93,32563744180,True,561300000,2444180,563744180,False,1
252,validator_8,163665855170,True,448000000,5233050,453233050,False,5
253,validator_1,262995550999,True,765799995,61144200,826944195,True,8
254,validator_3,259688024420,True,537200000,13388190,550588190,False,8
255,validator_27,65108470845,True,539500006,1489020,540989026,True,2
256,validator_12,98693832569,True,622499997,7809500,630309497,True,3
257,validator_44,32545423631,True,520660001,24763630,545423631,True,1
258,validator_20,99505066780,True,569700000,2506480,572206480,False,3
259,validator_8,164398502870,True,731300000,1347700,732647700,False,5
260,validator_1,263651266059,True,636140000,19575060,655715060,True,8
261,validator_71,35380236881,True,499300000,5985300,505285300,True,1
262,validator_58,34125121126,True,646854000,9140970,655994970,True,1
263,validator_90,32522194930,True,515200000,6994930,522194930,False,1
264,validator_8,165126825970,True,713700000,14623100,728323100,False,5
265,validator_8,165826642190,True,698440000,1376220,699816220,False,5
266,validator_63,33689215070,True,501759994,23970870,525730864,True,1
267,validator_0,261437820173,True,648700000,28595100,677295100,True,8
268,validator_1,264318282372,True,651840003,15176310,667016313,True,8
269,validator_52,34575168439,True,566600000,13817490,580417490,True,1
270,validator_38,66311129790,True,461900000,1693340,463593340,False,2
271,validator_0,261924497898,True,462713995,23963730,486677725,True,8
272,validator_1,264964940741,True,626439999,20218370,646658369,True,8
273,validator_73,33266293340,True,736600000,17084100,753684100,False,1
274,validator_12,99354806868,True,657599999,3374300,660974299,True,3
275,validator_63,34620653590,True,927800000,3638520,931438520,True,1
276,validator_4,164098551117,True,609800000,21488040,631288040,True,5
277,validator_22,98997767450,True,526100000,37165080,563265080,False,3
278,validator_30,66774902558,True,746980000,20929930,767909930,True,2
279,validator_9,166389634710,True,434200000,20240940,454440940,False,5
280,validator_11,167820454050,True,737200000,4189000,741389000,False,5
281,validator_3,260114725170,True,424900000,1800750,426700750,False,8
282,validator_11,168477309750,True,635300000,21555700,656855700,False,5
283,validator_2,262356220310,True,596000000,37783180,633783180,False,8
284,validator_11,169072966080,True,568200000,27456330,595656330,False,5
285,validator_9,166955900030,True,546700000,19565320,566265320,False,5
286,validator_48,34220378995,True,749239998,23417260,772657258,True,1
287,validator_4,164714792790,True,571319993,44921680,616241673,True,5
288,validator_20,100109105740,True,601200000,2838960,604038960,False,3
289,validator_81,32639975470,True,619800000,20175470,639975470,False,1
290,validator_61,35342115471,True,660339998,3526300,663866298,True,1
291,validator_87,32655369740,True,646300000,9069740,655369740,False,1
292,validator_85,33784074710,True,686100000,9343940,695443940,False,1
293,validator_63,35408734887,True,763353997,24727300,788081297,True,1
294,validator_43,66809585020,True,430800000,1066200,431866200,False,2
295,validator_20,100691517530,True,581800000,611790,582411790,False,3
296,validator_9,167526058660,True,555600000,14558630,570158630,False,5
297,validator_49,32531182028,True,501619998,29562030,531182028,True,1
298,validator_9,168118587300,True,589500000,3028640,592528640,False,5
299,validator_1,265505504720,True,516719999,23843980,540563979,True,8
300,validator_0,262479386338,True,516140000,38748440,554888440,True,8
301,validator_15,99414926768,True,743090006,30748530,773838536,True,3
302,validator_63,35985384439,True,574200002,2449550,576649552,True,1
303,validator_3,260736739400,True,619700000,2314230,622014230,False,8
304,validator_76,33135919760,True,677200000,13348160,690548160,False,1
305,validator_7,167628702944,True,564000002,17461100,581461102,True,5
306,validator_76,33729506440,True,587100000,6486680,593586680,False,1
307,validator_3,261283438170,True,545700000,998770,546698770,False,8
308,validator_39,65539795510,True,655100000,1660910,656760910,False,2
309,validator_15,100083256663,True,659100005,9229890,668329895,True,3
310,validator_4,165574120129,True,856499999,2827340,859327339,True,5
311,validator_1,266248817222,True,703300002,40012500,743312502,True,8
312,validator_72,33449425840,True,641100000,1226620,642326620,False,1
313,validator_27,65726068643,True,614069998,3527800,617597798,True,2
314,validator_15,100696930046,True,567380003,46293380,613673383,True,3
315,validator_20,101306918710,True,612600000,2801180,615401180,False,3
316,validator_15,101391032116,True,691920000,2182070,694102070,True,3
317,validator_80,32880935840,True,871000000,9935840,880935840,False,1
318,validator_47,34324585333,True,561280000,14519080,575799080,True,1
319,validator_69,33842852433,True,500420006,37769290,538189296,True,1
320,validator_9,168738733200,True,616300000,3845900,620145900,False,5
321,validator_65,32760935136,True,753000006,7935130,760935136,True,1
322,validator_11,169630532680,True,554840000,2726600,557566600,False,5
323,validator_87,33219809570,True,560500000,3939830,564439830,False,1
324,validator_9,169387734920,True,646400000,2601720,649001720,False,5
325,validator_60,32650012297,True,609399997,40612300,650012297,True,1
326,validator_25,65705617137,True,883700001,3073040,886773041,True,2
327,validator_57,34561327352,True,496696001,24448540,521144541,True,1
328,validator_5,166015299957,True,936660002,27354670,964014672,True,5
329,validator_2,262941536840,True,583000000,2316530,585316530,False,8
330,validator_78,33491150560,True,594400000,5222330,599622330,False,1
331,validator_0,263084222363,True,580539995,24296030,604836025,True,8
332,validator_4,166241436779,True,615659990,51656660,667316650,True,5
333,validator_2,263533204990,True,586600000,5068150,591668150,False,8
334,validator_39,66141036170,True,599100000,2140660,601240660,False,2
335,validator_29,66022404234,True,778900001,8023640,786923641,True,2
336,validator_0,263599007334,True,500260001,14524970,514784971,True,8
337,validator_3,262074314830,True,754100000,36776660,790876660,False,8
338,validator_97,33032711450,True,547900000,8442820,556342820,False,1
339,validator_28,64983719177,True,522599997,54356240,576956237,True,2
340,validator_24,65899811951,True,457464003,13538810,471002813,True,2
341,validator_1,267064732164,True,798186002,17728940,815914942,True,8
342,validator_14,98016336976,True,714900001,2190990,717090991,True,3
343,validator_19,96977032700,True,502700000,3704800,506404800,False,3
344,validator_46,33290132130,True,644660004,43769830,688429834,True,1
345,validator_63,36555143664,True,556439995,13319230,569759225,True,1
346,validator_79,32653263100,True,652400000,863100,653263100,False,1
347,validator_3,262833765250,True,755900000,3550420,759450420,False,8
348,validator_0,264478644612,True,851459998,28177280,879637278,True,8
349,validator_6,164779915785,True,958499999,37302900,995802899,True,5
350,validator_55,32851356195,True,837446005,13910190,851356195,True,1
351,validator_25,66523382068,True,796490001,21274930,817764931,True,2
352,validator_45,32739578670,True,720700000,18878670,739578670,True,1
353,validator_21,100225332060,True,548100000,11184900,559284900,False,3
354,validator_34,67813172360,True,789300000,1500120,790800120,False,2
355,validator_94,34089673300,True,480700000,2084500,482784500,False,1
356,validator_30,67282146693,True,504700005,2544130,507244135,True,2
357,validator_22,99556723180,True,551400000,7555730,558955730,False,3
358,validator_71,35970528878,True,525177997,65114000,590291997,True,1
359,validator_43,67377172840,True,562700000,4887820,567587820,False,2
360,validator_14,98592993748,True,567400002,9256770,576656772,True,3
361,validator_2,264200567990,True,659400000,7963000,667363000,False,8
362,validator_27,66209521772,True,478299999,5153130,483453129,True,2
363,validator_2,265040921670,True,784000000,56353680,840353680,False,8
364,validator_14,99476703583,True,858499995,25209840,883709835,True,3
365,validator_7,168394948456,True,699936002,66309510,766245512,True,5
366,validator_13,98671172161,True,477520001,6658460,484178461,True,3
367,validator_4,166942788173,True,692600004,8751390,701351394,True,5
368,validator_22,100200282190,True,612300000,31259010,643559010,False,3
369,validator_0,265136778952,True,624880010,33254330,658134340,True,8
370,validator_89,33433159910,True,959500000,2257900,961757900,False,1
371,validator_6,165618220593,True,793580008,44724800,838304808,True,5
372,validator_41,67132384180,True,721900000,1701690,723601690,False,2
373,validator_26,67141848153,True,582000000,10333120,592333120,True,2
374,validator_97,33482981490,True,447700000,2570040,450270040,False,1
375,validator_81,33576751320,True,935600000,1175850,936775850,False,1
376,validator_14,100175457455,True,649240002,49513870,698753872,True,3
377,validator_2,265703432990,True,641500000,21011320,662511320,False,8
378,validator_40,66958793520,True,607900000,3532920,611432920,False,2
379,validator_37,67203246330,True,668400000,5169940,673569940,False,2
380,validator_11,170090342780,True,445900000,13910100,459810100,False,5
381,validator_14,101168294371,True,969519996,23316920,992836916,True,3
382,validator_28,65651147558,True,660000001,7428380,667428381,True,2
383,validator_31,65764421066,True,439879994,46046780,485926774,True,2
384,validator_3,263560520190,True,725000000,1754940,726754940,False,8
385,validator_15,101949462606,True,527622000,30808490,558430490,True,3
386,validator_49,33103979320,True,560539992,12257300,572797292,True,1
387,validator_8,166536142790,True,708800000,700600,709500600,False,5
388,validator_42,65898944320,True,505000000,6836020,511836020,False,2
389,validator_16,99904552443,True,435620000,4360430,439980430,True,3
390,validator_20,101798353670,True,471500000,19934960,491434960,False,3
391,validator_4,167586000965,True,624459992,18752800,643212792,True,5
392,validator_0,265770479359,True,617780007,15920400,633700407,True,8
393,validator_21,100751497240,True,506400000,19765180,526165180,False,3
394,validator_39,66833093320,True,672100000,19957150,692057150,False,2
395,validator_5,166576843656,True,554799999,6743700,561543699,True,5
396,validator_2,266317534450,True,612700000,1401460,614101460,False,8
397,validator_57,35327680021,True,756699999,9652670,766352669,True,1
398,validator_49,33458706521,True,338340001,16387200,354727201,True,1
399,validator_8,166930173920,True,391100000,2931130,394031130,False,5
400,validator_0,266256628097,True,432499998,53648740,486148738,True,8
401,validator_59,32676902602,True,673600002,3302600,676902602,True,1
402,validator_0,266968421936,True,664579999,47213840,711793839,True,8
403,validator_8,167465748820,True,531000000,4574900,535574900,False,5
404,validator_40,67609863440,True,641300000,9769920,651069920,False,2
405,validator_16,100635331727,True,706600004,24179280,730779284,True,3
406,validator_29,66783728675,True,754220001,7104440,761324441,True,2
407,validator_1,267860682048,True,794600004,1349880,795949884,True,8
408,validator_78,34204017200,True,710700000,2166640,712866640,False,1
409,validator_8,168121425490,True,652900000,2776670,655676670,False,5
410,validator_6,166266954849,True,642539996,6194260,648734256,True,5
411,validator_6,166968330675,True,670540006,30835820,701375826,True,5
412,validator_2,266804991650,True,461000000,26457200,487457200,False,8
413,validator_35,67273862070,True,480800000,6118230,486918230,False,2
414,validator_7,169008516659,True,593340003,20228200,613568203,True,5
415,validator_97,34145594330,True,661400000,1212840,662612840,False,1
416,validator_76,34510485050,True,779100000,1878610,780978610,False,1
417,validator_3,264267627980,True,696200000,10907790,707107790,False,8
418,validator_5,167282673787,True,663420001,42410130,705830131,True,5
419,validator_15,102600701405,True,627799999,23438800,651238799,True,3
420,validator_9,170041468400,True,634300000,19433480,653733480,False,5
421,validator_15,103223961832,True,594139997,29120430,623260427,True,3
422,validator_0,267649376984,True,621845998,59109050,680955048,True,8
423,validator_89,34223618490,True,786800000,3658580,790458580,False,1
424,validator_34,68460645060,True,643200000,4272700,647472700,False,2
425,validator_7,169785827658,True,774199999,3111000,777310999,True,5
426,validator_15,104229521962,True,1004200000,1360130,1005560130,True,3
427,validator_97,34662353210,True,515600000,1158880,516758880,False,1
428,validator_29,67444468936,True,657500001,3240260,660740261,True,2
429,validator_88,32723386190,True,720500000,2886190,723386190,False,1
430,validator_5,168011713485,True,724519998,4519700,729039698,True,5
431,validator_34,69222434940,True,750700000,11089880,761789880,False,2
432,validator_0,268339620150,True,686099996,4143170,690243166,True,8
433,validator_25,67359461432,True,832400004,3679360,836079364,True,2
434,validator_41,67714391120,True,579200000,2806940,582006940,False,2
435,validator_43,67808130860,True,423900000,7058020,430958020,False,2
436,validator_39,67677972890,True,813200000,31679570,844879570,False,2
437,validator_30,68114554792,True,807795999,24612100,832408099,True,2
438,validator_14,101863503148,True,670254007,24954770,695208777,True,3
439,validator_82,33762478150,True,561300000,22200700,583500700,False,1
440,validator_76,35136384150,True,612100000,13799100,625899100,False,1
441,validator_46,33817162635,True,519060005,7970500,527030505,True,1
442,validator_17,97492746141,True,809700000,1874200,811574200,True,3
443,validator_2,267500349990,True,671500000,23858340,695358340,False,8
444,validator_46,34396334818,True,568020003,11152180,579172183,True,1
445,validator_59,33275492203,True,590300001,8289600,598589601,True,1
446,validator_9,170426279870,True,383100000,1711470,384811470,False,5
447,validator_23,96579795580,True,575200000,4595580,579795580,False,3
448,validator_8,168768639430,True,643500000,3713940,647213940,False,5
449,validator_36,66648097060,True,729100000,10560650,739660650,False,2
450,validator_63,37130670469,True,529894005,45632800,575526805,True,1
451,validator_55,33622438135,True,743438000,27643940,771081940,True,1
452,validator_4,168369637338,True,765310003,18326370,783636373,True,5
453,validator_10,164367097530,True,584000000,9224480,593224480,False,5
454,validator_11,170588081300,True,494000000,3738520,497738520,False,5
455,validator_15,104800543788,True,542299996,28721830,571021826,True,3
456,validator_14,102724716104,True,818699996,42512960,861212956,True,3
457,validator_49,34371208406,True,878146005,34355880,912501885,True,1
458,validator_52,35533285357,True,957199998,916920,958116918,True,1
459,validator_97,35287722470,True,592800000,32569260,625369260,False,1
460,validator_0,269143985312,True,783300002,21065160,804365162,True,8
461,validator_9,171007626070,True,544640000,36706200,581346200,False,5
462,validator_64,33657083698,True,479805994,45214400,525020394,True,1
463,validator_14,103283476803,True,544979999,13780700,558760699,True,3
464,validator_30,68905155702,True,742760000,47840910,790600910,True,2
465,validator_31,66469296280,True,694198004,10677210,704875214,True,2
466,validator_63,37947184944,True,799060015,17454460,816514475,True,1
467,validator_2,268192835390,True,673000000,19485400,692485400,False,8
468,validator_10,165051137300,True,675800000,8239770,684039770,False,5
469,validator_44,33223202581,True,676400000,1378950,677778950,True,1
470,validator_84,32678192840,True,659300000,18892840,678192840,False,1
471,validator_5,168574529531,True,536199996,26616050,562816046,True,5
472,validator_11,171119543000,True,529170000,2291700,531461700,False,5
473,validator_2,268902630170,True,690290000,19504780,709794780,False,8
474,validator_3,265101779820,True,825700000,8451840,834151840,False,8
475,validator_64,34502039301,True,844600003,355600,844955603,True,1
476,validator_4,169025678532,True,635499994,20541200,656041194,True,5
477,validator_94,34536334000,True,437600000,9060700,446660700,False,1
478,validator_1,268434500332,True,570799994,3018290,573818284,True,8
479,validator_10,165596017750,True,525000000,19880450,544880450,False,5
480,validator_67,35480764979,True,646239996,32226800,678466796,True,1
481,validator_1,269137188132,True,693520000,9167800,702687800,True,8
482,validator_11,171670556600,True,549000000,2013600,551013600,False,5
483,validator_67,36047291515,True,563100006,3426530,566526536,True,1
484,validator_46,35258533190,True,852500002,9698370,862198372,True,1
485,validator_25,68233986721,True,849639989,24885300,874525289,True,2
486,validator_24,66600572236,True,679659995,21100290,700760285,True,2
487,validator_86,33109334120,True,462200000,9213820,471413820,False,1
488,validator_15,105536499914,True,671600006,64356120,735956126,True,3
489,validator_86,33706060150,True,570000000,26726030,596726030,False,1
490,validator_96,33101267300,True,535600000,3862940,539462940,False,1
491,validator_31,67324973881,True,822640001,33037600,855677601,True,2
492,validator_84,33143297950,True,463670000,1435110,465105110,False,1
493,validator_18,98271533620,True,478400000,8916820,487316820,False,3
494,validator_63,38563253355,True,607540001,8528410,616068411,True,1
495,validator_0,269838520015,True,667340003,27194700,694534703,True,8
496,validator_1,269888950118,True,749999996,1761990,751761986,True,8
497,validator_3,265618062740,True,514170000,2112920,516282920,False,8
498,validator_25,68886579253,True,624460002,28132530,652592532,True,2
499,validator_4,169602392947,True,567800005,8914410,576714415,True,5
500,validator_9,171684619590,True,672500000,4493520,676993520,False,5
501,validator_17,98018707832,True,521499991,4461700,525961691,True,3
502,validator_8,169597420010,True,826700000,2080580,828780580,False,5
503,validator_0,270552904415,True,712000000,2384400,714384400,True,8
504,validator_0,271399035250,True,806333995,39796840,846130835,True,8
505,validator_96,33700618200,True,584800000,14550900,599350900,False,1
506,validator_93,33180212580,True,572900000,43568400,616468400,False,1
507,validator_11,172248493200,True,575600000,2336600,577936600,False,5
508,validator_20,102290175510,True,489800000,2021840,491821840,False,3
509,validator_0,272165788482,True,753936002,12817230,766753232,True,8
510,validator_28,66172387660,True,512170002,9070100,521240102,True,2
511,validator_0,272755595686,True,578560004,11247200,589807204,True,8
512,validator_13,99400468682,True,726800001,2496520,729296521,True,3
513,validator_2,269650320800,True,735700000,11990630,747690630,False,8
514,validator_3,266441459380,True,817800000,5596640,823396640,False,8
515,validator_82,34446904980,True,668600000,15826830,684426830,False,1
516,validator_15,106118104050,True,566420006,15184130,581604136,True,3
517,validator_60,33514788617,True,851300000,13476320,864776320,True,1
518,validator_10,166117848140,True,511500000,10330390,521830390,False,5
519,validator_45,33454336284,True,707339994,7417620,714757614,True,1
520,validator_75,33704735950,True,610100000,8989680,619089680,False,1
521,validator_79,33261015540,True,600600000,7152440,607752440,False,1
522,validator_37,67834817880,True,626200000,5371550,631571550,False,2
523,validator_29,68009309133,True,520223997,44616200,564840197,True,2
524,validator_23,97261916970,True,671300000,10821390,682121390,False,3
525,validator_4,170116647049,True,500200002,14054100,514254102,True,5
526,validator_5,169369362890,True,781599999,13233360,794833359,True,5
527,validator_3,267025677410,True,582000000,2218030,584218030,False,8
528,validator_17,98665816944,True,603460002,43649110,647109112,True,3
529,validator_42,66280868350,True,379100000,2824030,381924030,False,2
530,validator_16,101156388360,True,474126003,46930630,521056633,True,3
531,validator_1,270944080054,True,1016879986,38249950,1055129936,True,8
532,validator_16,101929747733,True,721999993,51359380,773359373,True,3
533,validator_22,100784028490,True,577400000,6346300,583746300,False,3
534,validator_30,69642644122,True,691720000,45768420,737488420,True,2
535,validator_57,36088895539,True,724599998,36615520,761215518,True,1
536,validator_45,34088073063,True,607239999,26496780,633736779,True,1
537,validator_11,172985815040,True,735400000,1921840,737321840,False,5
538,validator_12,99969849174,True,588786006,26256300,615042306,True,3
539,validator_28,66928928588,True,737719998,18820930,756540928,True,2
540,validator_52,36344135958,True,770400001,40450600,810850601,True,1
541,validator_10,167008381670,True,888500000,2033530,890533530,False,5
542,validator_7,170610946634,True,815899996,9218980,825118976,True,5
543,validator_7,171441659867,True,817320003,13393230,830713233,True,5
544,validator_0,273376723501,True,598719995,22407820,621127815,True,8
545,validator_23,97899059470,True,627200000,9942500,637142500,False,3
546,validator_2,270300120680,True,646700000,3099880,649799880,False,8
547,validator_0,274296102301,True,904000000,15378800,919378800,True,8
548,validator_8,170079356540,True,479700000,2236530,481936530,False,5
549,validator_65,33380922822,True,574380006,45607680,619987686,True,1
550,validator_64,35178623403,True,596134002,80450100,676584102,True,1
551,validator_25,69763591506,True,866440003,10572250,877012253,True,2
552,validator_20,102798150050,True,504900000,3074540,507974540,False,3
553,validator_8,170587446740,True,506100000,1990200,508090200,False,5
554,validator_4,170555060626,True,418197997,20215580,438413577,True,5
555,validator_11,173809127640,True,812700000,10612600,823312600,False,5
556,validator_66,35538767518,True,767540000,26619100,794159100,True,1
557,validator_5,169959225494,True,561840004,28022600,589862604,True,5
558,validator_7,172041016868,True,589900001,9457000,599357001,True,5
559,validator_12,100733500038,True,735520004,28130860,763650864,True,3
560,validator_58,34734404478,True,605300002,3983350,609283352,True,1
561,validator_7,172573026603,True,511500005,20509730,532009735,True,5
562,validator_9,172517918300,True,824300000,8998710,833298710,False,5
563,validator_75,34197897680,True,485400000,7761730,493161730,False,1
564,validator_3,267781963710,True,746400000,9886300,756286300,False,8
565,validator_60,34080640187,True,558900000,6951570,565851570,True,1
566,validator_4,171253335803,True,663019997,35255180,698275177,True,5
567,validator_13,100082994103,True,654700001,27825420,682525421,True,3
568,validator_31,68017940913,True,636199992,56767040,692967032,True,2
569,validator_17,99261951245,True,588840001,7294300,596134301,True,3
570,validator_28,67654277366,True,698605998,26742780,725348778,True,2
571,validator_86,34277660510,True,546100000,25500360,571600360,False,1
572,validator_5,170972271850,True,1001940006,11106350,1013046356,True,5
573,validator_17,99915074347,True,645740002,7383100,653123102,True,3
574,validator_38,67046739110,True,724500000,11109320,735609320,False,2
575,validator_7,173324468355,True,733680002,17761750,751441752,True,5
576,validator_9,173145621280,True,624800000,2902980,627702980,False,5
577,validator_15,106845405527,True,725799997,1501480,727301477,True,3
578,validator_11,174405945800,True,587500000,9318160,596818160,False,5
579,validator_21,101550547400,True,795800000,3250160,799050160,False,3
580,validator_6,167719974690,True,746700005,4944010,751644015,True,5
581,validator_8,171220683400,True,630200000,3036660,633236660,False,5
582,validator_31,68671396436,True,634200003,19255520,653455523,True,2
583,validator_6,168485024277,True,749080007,15969580,765049587,True,5
584,validator_32,64869043608,True,848113998,20929610,869043608,True,2
585,validator_10,167544723540,True,534450000,1891870,536341870,False,5
586,validator_42,66890744150,True,609000000,875800,609875800,False,2
587,validator_28,68355696410,True,656700004,44719040,701419044,True,2
588,validator_1,271635115254,True,655540000,35495200,691035200,True,8
589,validator_75,34693382750,True,493000000,2485070,495485070,False,1
590,validator_2,270857439780,True,555700000,1619100,557319100,False,8
591,validator_1,272389297905,True,724780001,29402650,754182651,True,8
592,validator_7,174106838014,True,771819999,10549660,782369659,True,5
593,validator_35,67904189750,True,618900000,11427680,630327680,False,2
594,validator_9,173629672980,True,482800000,1251700,484051700,False,5
595,validator_53,33211502351,True,482379997,10759380,493139377,True,1
596,validator_33,68040937903,True,734896003,21834020,756730023,True,2
597,validator_88,33408650310,True,684400000,864120,685264120,False,1
598,validator_0,274973805283,True,674200002,3502980,677702982,True,8
599,validator_25,70428566508,True,649100002,15875000,664975002,True,2
600,validator_13,100803839503,True,693400000,27445400,720845400,True,3
601,validator_17,100454637078,True,474890001,64672730,539562731,True,3
602,validator_56,34236210077,True,614177999,32243590,646421589,True,1
603,validator_79,33845475140,True,564700000,19759600,584459600,False,1
604,validator_8,172035351300,True,805000000,9667900,814667900,False,5
605,validator_11,174900041670,True,491400000,2695870,494095870,False,5
606,validator_2,271535640070,True,676400000,1800290,678200290,False,8
607,validator_2,272364924700,True,825600000,3684630,829284630,False,8
608,validator_14,103970197663,True,638459990,48260870,686720860,True,3
609,validator_11,175333769770,True,431400000,2328100,433728100,False,5
610,validator_23,98594009220,True,692000000,2949750,694949750,False,3
611,validator_6,169112956879,True,623500002,4432600,627932602,True,5
612,validator_17,101343777867,True,880799999,8340790,889140789,True,3
613,validator_31,69599474936,True,911500000,16578500,928078500,True,2
614,validator_89,34907395090,True,678800000,4976600,683776600,False,1
615,validator_73,33978700370,True,691600000,20807030,712407030,False,1
616,validator_46,35852715487,True,575819997,18362300,594182297,True,1
617,validator_3,268583672910,True,792400000,9309200,801709200,False,8
618,validator_92,32679568070,True,672800000,6768070,679568070,False,1
619,validator_28,69191459153,True,774100003,61662740,835762743,True,2
620,validator_5,171698525938,True,692540008,33714080,726254088,True,5
621,validator_4,171916062588,True,649000005,13726780,662726785,True,5
622,validator_46,36550906586,True,678399999,19791100,698191099,True,1
623,validator_47,35334253803,True,995954000,13714470,1009668470,True,1
624,validator_9,174168912010,True,519400000,19839030,539239030,False,5
625,validator_7,174822709215,True,692720001,23151200,715871201,True,5
626,validator_83,33982138680,True,665400000,22918940,688318940,False,1
627,validator_87,33641062530,True,418800000,2452960,421252960,False,1
628,validator_38,67626232050,True,543500000,35992940,579492940,False,2
629,validator_2,272946604600,True,573100000,8579900,581679900,False,8
630,validator_6,169884205368,True,767999999,3248490,771248489,True,5
631,validator_1,272963313757,True,551440002,22575850,574015852,True,8
632,validator_7,175319899015,True,487958000,9231800,497189800,True,5
633,validator_0,275845798328,True,866800005,5193040,871993045,True,8
634,validator_11,175915235610,True,579400000,2065840,581465840,False,5
635,validator_64,35965530700,True,775820007,11087290,786907297,True,1
636,validator_2,273604557280,True,624600000,33352680,657952680,False,8
637,validator_6,170449439903,True,528340005,36894530,565234535,True,5
638,validator_5,172463120629,True,701639991,62954700,764594691,True,5
639,validator_5,173214275620,True,731180001,19974990,751154991,True,5
640,validator_11,176633916940,True,715600000,3081330,718681330,False,5
641,validator_67,36668122013,True,586059998,34770500,620830498,True,1
642,validator_78,34801574040,True,578800000,18756840,597556840,False,1
643,validator_6,170980845071,True,506499998,24905170,531405168,True,5
644,validator_11,177497972930,True,860500000,3555990,864055990,False,5
645,validator_30,70320598239,True,650140007,27814110,677954117,True,2
646,validator_54,33972793123,True,596599996,2595290,599195286,True,1
647,validator_6,171757875073,True,759580002,17450000,777030002,True,5
648,validator_33,68869632798,True,805019995,23674900,828694895,True,2
649,validator_8,172714711470,True,665800000,13560170,679360170,False,5
650,validator_1,273779916772,True,806059995,10543020,816603015,True,8
651,validator_13,101332875333,True,524300000,4735830,529035830,True,3
652,validator_6,172533875556,True,768200003,7800480,776000483,True,5
653,validator_68,33056481406,True,545079999,40783180,585863179,True,1
654,validator_13,101974601061,True,630133998,11591730,641725728,True,3
655,validator_5,173950912564,True,713200004,23436940,736636944,True,5
656,validator_3,269328020790,True,740600000,3747880,744347880,False,8
657,validator_5,174602112566,True,640130002,11070000,651200002,True,5
658,validator_0,276379686924,True,524639996,9248600,533888596,True,8
659,validator_31,70486516806,True,826060000,60981870,887041870,True,2
660,validator_39,68076013470,True,396600000,1440580,398040580,False,2
661,validator_70,33560727179,True,688813999,59912000,748725999,True,1
662,validator_2,274127597460,True,515600000,7440180,523040180,False,8
663,validator_43,68415479980,True,604500000,2849120,607349120,False,2
664,validator_69,34580447707,True,733300004,4295270,737595274,True,1
665,validator_33,69625450727,True,735199999,20617930,755817929,True,2
666,validator_17,101983863272,True,629800005,10285400,640085405,True,3
667,validator_77,33765633660,True,645300000,3234540,648534540,False,1
668,validator_75,35414459890,True,717600000,3477140,721077140,False,1
669,validator_25,71110734499,True,678899991,3268000,682167991,True,2
670,validator_76,35722187770,True,567200000,18603620,585803620,False,1
671,validator_19,97429343870,True,442900000,9411170,452311170,False,3
672,validator_5,175174501345,True,534313999,38074780,572388779,True,5
673,validator_58,35270995173,True,535399995,1190700,536590695,True,1
674,validator_0,277152570521,True,729620007,43263590,772883597,True,8
675,validator_36,67317956840,True,665600000,4259780,669859780,False,2
676,validator_39,68630865860,True,526500000,28352390,554852390,False,2
677,validator_8,173459759670,True,743700000,1348200,745048200,False,5
678,validator_10,168163160340,True,602300000,16136800,618436800,False,5
679,validator_42,67413310940,True,520500000,2066790,522566790,False,2
680,validator_15,107674206661,True,783180004,45621130,828801134,True,3
681,validator_29,68605536119,True,580880006,15346980,596226986,True,2
682,validator_40,67983081570,True,371500000,1718130,373218130,False,2
683,validator_30,70959801031,True,601720002,37482790,639202792,True,2
684,validator_3,270022707690,True,692500000,2186900,694686900,False,8
685,validator_68,33714552945,True,644215999,13855540,658071539,True,1
686,validator_83,34642521270,True,658900000,1482590,660382590,False,1
687,validator_44,33949638704,True,672180003,54256120,726436123,True,1
688,validator_21,102254773330,True,682700000,21525930,704225930,False,3
689,validator_3,270656794490,True,631500000,2586800,634086800,False,8
690,validator_73,34582634030,True,602100000,1833660,603933660,False,1
691,validator_83,35375989640,True,731200000,2268370,733468370,False,1
692,validator_18,99049153540,True,775200000,2419920,777619920,False,3
693,validator_5,175516802817,True,339100002,3201470,342301472,True,5
694,validator_48,34841572007,True,587449992,33743020,621193012,True,1
695,validator_58,35823189178,True,549400005,2794000,552194005,True,1
696,validator_5,176237860250,True,696886003,24171430,721057433,True,5
697,validator_6,173202231355,True,658809999,9545800,668355799,True,5
698,validator_9,174884280370,True,706800000,8568360,715368360,False,5
699,validator_39,69189889890,True,556100000,2924030,559024030,False,2
700,validator_72,34016672040,True,564600000,2646200,567246200,False,1
701,validator_13,102751104349,True,764893988,11609300,776503288,True,3
702,validator_10,168804004150,True,638700000,2143810,640843810,False,5
703,validator_6,173908421603,True,686819998,19370250,706190248,True,5
704,validator_42,68229033760,True,813300000,2422820,815722820,False,2
705,validator_6,174502437480,True,591639997,2375880,594015877,True,5
706,validator_18,99713361740,True,655300000,8908200,664208200,False,3
707,validator_6,175147320183,True,610360003,34522700,644882703,True,5
708,validator_11,178071955510,True,553500000,20482580,573982580,False,5
709,validator_89,35583477560,True,669300000,6782470,676082470,False,1
710,validator_95,32489377000,True,485900000,3477000,489377000,False,1
711,validator_98,32606377830,True,586500000,19877830,606377830,False,1
712,validator_35,68555863960,True,649900000,1774210,651674210,False,2
713,validator_38,68148102050,True,520300000,1570000,521870000,False,2
714,validator_70,34332793615,True,740221996,31844440,772066436,True,1
715,validator_5,177012992032,True,743816002,31315780,775131782,True,5
716,validator_77,34310890670,True,523700000,21557010,545257010,False,1
717,validator_45,34813736395,True,703800002,21863330,725663332,True,1
718,validator_37,68656331210,True,821000000,513330,821513330,False,2
719,validator_3,271083018790,True,424500000,1724300,426224300,False,8
720,validator_0,277801100265,True,621500004,27029740,648529744,True,8
721,validator_87,34063108970,True,419400000,2646440,422046440,False,1
722,validator_40,68611649170,True,626000000,2567600,628567600,False,2
723,validator_2,274683643370,True,538800000,17245910,556045910,False,8
724,validator_18,100360428730,True,644000000,3066990,647066990,False,3
725,validator_35,69143252460,True,578600000,8788500,587388500,False,2
726,validator_84,33707376240,True,543600000,20478290,564078290,False,1
727,validator_6,175821095576,True,670820003,2955390,673775393,True,5
728,validator_65,34172013639,True,778193997,12896820,791090817,True,1
729,validator_28,69903596211,True,698799998,13337060,712137058,True,2
730,validator_10,169508102790,True,685500000,18598640,704098640,False,5
731,validator_12,101419118738,True,659540000,26078700,685618700,True,3
732,validator_30,71528395432,True,534720001,33874400,568594401,True,2
733,validator_63,39408002080,True,837219995,7528730,844748725,True,1
734,validator_51,33579692487,True,639180000,74125900,713305900,True,1
735,validator_57,36697575675,True,606499996,2180140,608680136,True,1
736,validator_28,70656611846,True,710280005,42735630,753015635,True,2
737,validator_33,70295122029,True,644840002,24831300,669671302,True,2
738,validator_16,102934200011,True,990499998,13952280,1004452278,True,3
739,validator_10,170004122580,True,493000000,3019790,496019790,False,5
740,validator_20,103469756030,True,658200000,13405980,671605980,False,3
741,validator_12,102172124065,True,738539997,14465330,753005327,True,3
742,validator_18,100989364610,True,620200000,8735880,628935880,False,3
743,validator_18,101702398890,True,710000000,3034280,713034280,False,3
744,validator_13,103452419738,True,664239999,37075390,701315389,True,3
745,validator_1,274467359700,True,677220008,10222920,687442928,True,8
746,validator_3,271639649530,True,554700000,1930740,556630740,False,8
747,validator_23,99247522680,True,651100000,2413460,653513460,False,3
748,validator_3,272290279200,True,644600000,6029670,650629670,False,8
749,validator_7,176069895437,True,748700002,1296420,749996422,True,5
750,validator_1,275421257140,True,914580000,39317440,953897440,True,8
751,validator_97,35809544650,True,498400000,23422180,521822180,False,1
752,validator_38,68741455680,True,590770000,2583630,593353630,False,2
753,validator_1,276003544238,True,532039998,50247100,582287098,True,8
754,validator_1,276689877845,True,673440007,12893600,686333607,True,8
755,validator_0,278496161877,True,663540002,31521610,695061612,True,8
756,validator_9,175516083470,True,629900000,1903100,631803100,False,5
757,validator_66,36255130109,True,691704001,24658590,716362591,True,1
758,validator_4,172772348424,True,846400006,9885830,856285836,True,5
759,validator_11,178694337510,True,601900000,20482000,622382000,False,5
760,validator_2,275395104710,True,704000000,7461340,711461340,False,8
761,validator_84,34245446010,True,536200000,1869770,538069770,False,1
762,validator_76,36557183650,True,832700000,2295880,834995880,False,1
763,validator_23,99860745500,True,605200000,8022820,613222820,False,3
764,validator_56,34947499467,True,701579990,9709400,711289390,True,1
765,validator_3,272965921310,True,664100000,11542110,675642110,False,8
766,validator_41,68358434150,True,640600000,3443030,644043030,False,2
767,validator_17,102700038676,True,694820004,21355400,716175404,True,3
768,validator_16,103542854875,True,606200004,2454860,608654864,True,3
769,validator_0,279388381282,True,866720005,25499400,892219405,True,8
770,validator_80,33522306110,True,633100000,8270270,641370270,False,1
771,validator_1,277501336747,True,781480002,29978900,811458902,True,8
772,validator_3,273457100550,True,471500000,19679240,491179240,False,8
773,validator_98,33273085810,True,645500000,21207980,666707980,False,1
774,validator_50,32827565618,True,807275998,20289620,827565618,True,1
775,validator_3,274251061550,True,792000000,1961000,793961000,False,8
776,validator_95,33024318300,True,530100000,4841300,534941300,False,1
777,validator_2,275889223810,True,490800000,3319100,494119100,False,8
778,validator_87,34598497350,True,533400000,1988380,535388380,False,1
779,validator_3,274867287610,True,607700000,8526060,616226060,False,8
780,validator_3,275480878830,True,610900000,2691220,613591220,False,8
781,validator_12,102881300512,True,702500007,6676440,709176447,True,3
782,validator_2,276418619860,True,517900000,11496050,529396050,False,8
783,validator_37,69522246510,True,832400000,33515300,865915300,False,2
784,validator_82,34920292420,True,456600000,16787440,473387440,False,1
785,validator_18,102272562670,True,567500000,2663780,570163780,False,3
786,validator_97,36580434440,True,749300000,21589790,770889790,False,1
787,validator_14,104676609744,True,679260001,27152080,706412081,True,3
788,validator_2,277096652360,True,674300000,3732500,678032500,False,8
789,validator_4,173282329820,True,507659996,2321400,509981396,True,5
790,validator_35,69651862910,True,505000000,3610450,508610450,False,2
791,validator_0,280319492484,True,904000002,27111200,931111202,True,8
792,validator_7,176638963604,True,562699997,6368170,569068167,True,5
793,validator_27,66916414287,True,700240005,6652510,706892515,True,2
794,validator_15,108292249492,True,615500001,2542830,618042831,True,3
795,validator_23,100530724840,True,660700000,9279340,669979340,False,3
796,validator_20,104094909440,True,623300000,1853410,625153410,False,3
797,validator_30,72064972721,True,504719999,31857290,536577289,True,2
798,validator_57,37512842621,True,791140006,24126940,815266946,True,1
799,validator_8,174002450480,True,541900000,790810,542690810,False,5
800,validator_39,69656492630,True,461400000,5202740,466602740,False,2
801,validator_23,101109727440,True,576500000,2502600,579002600,False,3
802,validator_22,101575930930,True,781000000,10902440,791902440,False,3
803,validator_5,177711339133,True,675340001,23007100,698347101,True,5
804,validator_15,108878754500,True,581800008,4705000,586505008,True,3
805,validator_3,276032595050,True,546200000,5516220,551716220,False,8
806,validator_45,35312692501,True,475819996,23136110,498956106,True,1
807,validator_8,174522172660,True,494380000,25342180,519722180,False,5
808,validator_0,280933751658,True,596980004,17279170,614259174,True,8
809,validator_1,278246853091,True,699200004,46316340,745516344,True,8
810,validator_20,104724264480,True,622900000,6455040,629355040,False,3
811,validator_12,103570012809,True,650419997,38292300,688712297,True,3
812,validator_4,173836849918,True,543419998,11100100,554520098,True,5
813,validator_22,102317379570,True,739300000,2148640,741448640,False,3
814,validator_22,103093750410,True,774400000,1970840,776370840,False,3
815,validator_22,103621688840,True,527100000,838430,527938430,False,3
816,validator_6,176626098869,True,794763993,10239300,805003293,True,5
817,validator_25,72007800356,True,865459997,31605860,897065857,True,2
818,validator_20,105486245320,True,753900000,8080840,761980840,False,3
819,validator_4,174348825216,True,487279998,24695300,511975298,True,5
820,validator_8,175034989060,True,498700000,14116400,512816400,False,5
821,validator_1,279396131320,True,1138863999,10414230,1149278229,True,8
822,validator_53,34067448454,True,810584003,45362100,855946103,True,1
823,validator_1,280039151553,True,641800003,1220230,643020233,True,8
824,validator_56,35844061664,True,860999997,35562200,896562197,True,1
825,validator_97,37045677980,True,462300000,2943540,465243540,False,1
826,validator_21,102771313210,True,515300000,1239880,516539880,False,3
827,validator_4,175130461864,True,740477998,41158650,781636648,True,5
828,validator_1,280583656750,True,525739997,18765200,544505197,True,8
829,validator_69,35438045829,True,838490002,19108120,857598122,True,1
830,validator_34,69802576130,True,577600000,2541190,580141190,False,2
831,validator_42,68893459760,True,663800000,626000,664426000,False,2
832,validator_9,176192486200,True,640500000,35902730,676402730,False,5
833,validator_10,170446967170,True,440270000,2574590,442844590,False,5
834,validator_14,105459747087,True,774800003,8337340,783137343,True,3
835,validator_79,34399209040,True,545500000,8233900,553733900,False,1
836,validator_56,36566940488,True,712066004,10812820,722878824,True,1
837,validator_59,34091651207,True,796860004,19299000,816159004,True,1
838,validator_10,171066793570,True,616700000,3126400,619826400,False,5
839,validator_5,178262419475,True,540804002,10276340,551080342,True,5
840,validator_2,277639177990,True,540600000,1925630,542525630,False,8
841,validator_31,71159723667,True,651800001,21406860,673206861,True,2
842,validator_14,106266145469,True,780978002,25420380,806398382,True,3
843,validator_5,178661144334,True,394459999,4264860,398724859,True,5
844,validator_0,281722297311,True,769660003,18885650,788545653,True,8
845,validator_44,34583929086,True,609800002,24490380,634290382,True,1
846,validator_79,34745722140,True,342900000,3613100,346513100,False,1
847,validator_36,67930983440,True,611900000,1126600,613026600,False,2
848,validator_30,72817110906,True,724640005,27498180,752138185,True,2
849,validator_1,281261501873,True,631088003,46757120,677845123,True,8
850,validator_1,282107896295,True,820699992,25694430,846394422,True,8
851,validator_28,71259960749,True,599040003,4308900,603348903,True,2
852,validator_5,179357675239,True,623120005,73410900,696530905,True,5
853,validator_63,40059773408,True,630499998,21271330,651771328,True,1
854,validator_20,106044448020,True,554500000,3702700,558202700,False,3
855,validator_43,68999940140,True,580900000,3560160,584460160,False,2
856,validator_38,69168348360,True,407940000,18952680,426892680,False,2
857,validator_36,68589614400,True,656800000,1830960,658630960,False,2
858,validator_65,34978468944,True,795500005,10955300,806455305,True,1
859,validator_4,175820915363,True,677779999,12673500,690453499,True,5
860,validator_2,278268204070,True,626000000,3026080,629026080,False,8
861,validator_3,276624008620,True,584400000,7013570,591413570,False,8
862,validator_7,177543823477,True,876540003,28319870,904859873,True,5
863,validator_22,104291720160,True,656400000,13631320,670031320,False,3
864,validator_95,33574809450,True,543700000,6791150,550491150,False,1
865,validator_14,106987858526,True,688119997,33593060,721713057,True,3
866,validator_10,171657295550,True,570700000,19801980,590501980,False,5
867,validator_71,36693231635,True,695519997,27182760,722702757,True,1
868,validator_13,104207081835,True,738495997,16166100,754662097,True,3
869,validator_23,101752857360,True,599700000,43429920,643129920,False,3
870,validator_2,278766788170,True,489000000,9584100,498584100,False,8
871,validator_56,37398154883,True,824399995,6814400,831214395,True,1
872,validator_20,106701725120,True,654300000,2977100,657277100,False,3
873,validator_12,104171484307,True,566319998,35151500,601471498,True,3
874,validator_67,37388497953,True,715200000,5175940,720375940,True,1
875,validator_1,282794998560,True,676600005,10502260,687102265,True,8
876,validator_10,172458159350,True,769700000,31163800,800863800,False,5
877,validator_56,38137698675,True,696345992,43197800,739543792,True,1
878,validator_10,173053812950,True,592700000,2953600,595653600,False,5
879,validator_30,73390441907,True,552940001,20391000,573331001,True,2
880,validator_6,177384053664,True,748399995,9554800,757954795,True,5
881,validator_64,36616299045,True,648100005,2668340,650768345,True,1
882,validator_41,68877698640,True,512600000,6664490,519264490,False,2
883,validator_22,105057987600,True,764900000,1367440,766267440,False,3
884,validator_2,279314189270,True,545000000,2401100,547401100,False,8
885,validator_19,98234734000,True,785500000,19890130,805390130,False,3
886,validator_2,279937585690,True,603500000,19896420,623396420,False,8
887,validator_66,37035170379,True,778600000,1440270,780040270,True,1
888,validator_60,34702575567,True,584140000,37795380,621935380,True,1
889,validator_65,35525572038,True,524400004,22703090,547103094,True,1
890,validator_31,71724317559,True,511740002,52853890,564593892,True,2
891,validator_1,283637186763,True,806780003,35408200,842188203,True,8
892,validator_1,284174896164,True,535100001,2609400,537709401,True,8
893,validator_66,37598693749,True,538080000,25443370,563523370,True,1
894,validator_22,105750338900,True,686500000,5851300,692351300,False,3
895,validator_67,38166602284,True,739864001,38240330,778104331,True,1
896,validator_25,72708075182,True,685779996,14494830,700274826,True,2
897,validator_7,178287819377,True,723040000,20955900,743995900,True,5
898,validator_2,280671646030,True,732300000,1760340,734060340,False,8
899,validator_29,69191156377,True,567819998,17800260,585620258,True,2
900,validator_8,175486424490,True,449200000,2235430,451435430,False,5
901,validator_27,67571110985,True,622939998,31756700,654696698,True,2
902,validator_3,277477045430,True,832700000,20336810,853036810,False,8
903,validator_89,36186803760,True,593300000,10026200,603326200,False,1
904,validator_16,104391687275,True,842274000,6558400,848832400,True,3
905,validator_71,37499500234,True,795399999,10868600,806268599,True,1
906,validator_32,65603337806,True,669739998,64554200,734294198,True,2
907,validator_99,32782128010,True,780300000,1828010,782128010,False,1
908,validator_62,34634940095,True,493059991,12124040,505184031,True,1
909,validator_2,281175249810,True,498900000,4703780,503603780,False,8
910,validator_7,178980803679,True,672274012,20710290,692984302,True,5
911,validator_26,67822511547,True,653777994,26885400,680663394,True,2
912,validator_10,173671763980,True,601700000,16251030,617951030,False,5
913,validator_10,174205920890,True,513500000,20656910,534156910,False,5
914,validator_1,284818788190,True,601943996,41948030,643892026,True,8
915,validator_31,72356287140,True,623960001,8009580,631969581,True,2
916,validator_97,37665838810,True,606500000,13660830,620160830,False,1
917,validator_42,69447250400,True,552500000,1290640,553790640,False,2
918,validator_7,179777037011,True,770100002,26133330,796233332,True,5
919,validator_2,281841698850,True,662700000,3749040,666449040,False,8
920,validator_17,103271402479,True,527080003,44283800,571363803,True,3
921,validator_35,70237768350,True,582400000,3505440,585905440,False,2
922,validator_21,103404518650,True,624500000,8705440,633205440,False,3
923,validator_9,176771776630,True,568900000,10390430,579290430,False,5
924,validator_9,177375378360,True,582200000,21401730,603601730,False,5
925,validator_35,70858842550,True,611200000,9874200,621074200,False,2
926,validator_77,34993277000,True,679800000,2586330,682386330,False,1
927,validator_1,285693906482,True,853934002,21184290,875118292,True,8
928,validator_23,102333010560,True,559200000,20953200,580153200,False,3
929,validator_0,282350307900,True,593279999,34730590,628010589,True,8
930,validator_20,107426520300,True,697900000,26895180,724795180,False,3
931,validator_1,286482500081,True,762839999,25753600,788593599,True,8
932,validator_46,37355107681,True,802939995,1261100,804201095,True,1
933,validator_36,69122017690,True,522400000,10003290,532403290,False,2
934,validator_82,35488150120,True,565100000,2757700,567857700,False,1
935,validator_0,283354925763,True,951319993,53297870,1004617863,True,8
936,validator_99,33434151440,True,647900000,4123430,652023430,False,1
937,validator_0,284124828466,True,765700003,4202700,769902703,True,8
938,validator_88,34125642940,True,710700000,6292630,716992630,False,1
939,validator_35,71574226090,True,713700000,1683540,715383540,False,2
940,validator_11,179233377710,True,530300000,8740200,539040200,False,5
941,validator_48,35659468614,True,796340007,21556600,817896607,True,1
942,validator_19,98882085300,True,641900000,5451300,647351300,False,3
943,validator_90,33129210680,True,606200000,815750,607015750,False,1
944,validator_35,72212762260,True,594600000,43936170,638536170,False,2
945,validator_98,33901200910,True,621800000,6315100,628115100,False,1
946,validator_27,68486717605,True,892840000,22766620,915606620,True,2
947,validator_69,36066099158,True,606079999,21973330,628053329,True,1
948,validator_11,179868173840,True,624600000,10196130,634796130,False,5
949,validator_38,69589555260,True,419600000,1606900,421206900,False,2
950,validator_14,107629755660,True,625020004,16877130,641897134,True,3
951,validator_32,66277048944,True,667999998,5711140,673711138,True,2
952,validator_21,104048733080,True,623900000,20314430,644214430,False,3
953,validator_1,287175595159,True,689140008,3955070,693095078,True,8
954,validator_43,69631403310,True,629800000,1663170,631463170,False,2
955,validator_41,69467353470,True,586800000,2854830,589654830,False,2
956,validator_3,278133800350,True,631300000,25454920,656754920,False,8
957,validator_50,33482593340,True,635640002,19387720,655027722,True,1
958,validator_23,102951382130,True,611800000,6571570,618371570,False,3
959,validator_0,284825723619,True,643766003,57129150,700895153,True,8
960,validator_0,285342736532,True,503120013,13892900,517012913,True,8
961,validator_0,286248601538,True,870643996,35221010,905865006,True,8
962,validator_38,70360531050,True,762600000,8375790,770975790,False,2
963,validator_34,70305591020,True,502000000,1014890,503014890,False,2
964,validator_1,287805553263,True,610400004,19558100,629958104,True,8
965,validator_37,69979166850,True,450400000,6520340,456920340,False,2
966,validator_65,36081528877,True,541799999,14156840,555956839,True,1
967,validator_13,105002874138,True,757800003,37992300,795792303,True,3
968,validator_15,109548975156,True,633300006,36920650,670220656,True,3
969,validator_3,278850177870,True,712000000,4377520,716377520,False,8
970,validator_27,69168244395,True,652360000,29166790,681526790,True,2
971,validator_14,108306646888,True,620259998,56631230,676891228,True,3
972,validator_7,180397832454,True,615900003,4895440,620795443,True,5
973,validator_25,73174043763,True,458180001,7788580,465968581,True,2
974,validator_41,70001930100,True,532100000,2476630,534576630,False,2
975,validator_4,176642927961,True,805219998,16792600,822012598,True,5
976,validator_17,104098978418,True,806720009,20855930,827575939,True,3
977,validator_31,73166816917,True,783635997,26893780,810529777,True,2
978,validator_0,286926764025,True,675900007,2262480,678162487,True,8
979,validator_33,70960409160,True,644820001,20467130,665287131,True,2
980,validator_30,74091844311,True,637540004,63862400,701402404,True,2
981,validator_92,33361918870,True,680500000,1850800,682350800,False,1
982,validator_3,279352371190,True,492000000,10193320,502193320,False,8
983,validator_2,282457881250,True,614400000,1782400,616182400,False,8
984,validator_19,99525316410,True,635700000,7531110,643231110,False,3
985,validator_6,178238152790,True,849540006,4559120,854099126,True,5
986,validator_26,68501128930,True,658066003,20551380,678617383,True,2
987,validator_84,34979518520,True,724600000,9472510,734072510,False,1
988,validator_28,72092862893,True,808100004,24802140,832902144,True,2
989,validator_81,34170241420,True,573700000,19790100,593490100,False,1
990,validator_1,288394271823,True,584999990,3718570,588718560,True,9
991,validator_39,70421053660,True,738900000,25661030,764561030,False,2
992,validator_7,181008521756,True,604920002,5769300,610689302,True,5
993,validator_20,108123150380,True,676500000,20130080,696630080,False,3
994,validator_1,288983978648,True,579019995,10686830,589706825,True,9
995,validator_0,287435057862,True,483900007,24393830,508293837,True,8
996,validator_39,71072668690,True,649400000,2215030,651615030,False,2
997,validator_5,180039167045,True,663900006,17591800,681491806,True,5
998,validator_76,37160719820,True,595100000,8436170,603536170,False,1
999,validator_33,71538294001,True,560300001,17584840,577884841,True,2
1000,validator_79,35238536460,True,489560000,3254320,492814320,False,1
1001,validator_1,289587414045,True,595459997,7975400,603435397,True,9
1002,validator_8,176075384580,True,588100000,860090,588960090,False,5
1003,validator_18,102728194800,True,447900000,7732130,455632130,False,3
1004,validator_2,283091147850,True,627300000,5966600,633266600,False,8
1005,validator_20,108789865480,True,664800000,1915100,666715100,False,3
1006,validator_0,288133102161,True,678553999,19490300,698044299,True,9
1007,validator_52,36999930374,True,638903996,16890420,655794416,True,1
1008,validator_42,70067955080,True,618100000,2604680,620704680,False,2
1009,validator_10,174669064990,True,455100000,8044100,463144100,False,5
1010,validator_1,290208016934,True,599559999,21042890,620602889,True,9
1011,validator_2,283742107850,True,623800000,27160000,650960000,False,8
1012,validator_2,284267806250,True,506000000,19698400,525698400,False,8
1013,validator_14,109134801361,True,772436003,55718470,828154473,True,3
1014,validator_10,175422907520,True,750100000,3742530,753842530,False,5
1015,validator_7,181643715409,True,606780003,28413650,635193653,True,5
1016,validator_2,284918104050,True,625800000,24497800,650297800,False,8
1017,validator_61,36059757043,True,706180002,11461570,717641572,True,1
1018,validator_38,70991719590,True,629100000,2088540,631188540,False,2
1019,validator_76,37547503080,True,385000000,1783260,386783260,False,1
1020,validator_34,70919490720,True,611700000,2199700,613899700,False,2
1021,validator_41,70655928730,True,634800000,19198630,653998630,False,2
1022,validator_41,71287435470,True,592600000,38906740,631506740,False,2
1023,validator_40,69142578890,True,512100000,18829720,530929720,False,2
1024,validator_5,180789450474,True,739439999,10843430,750283429,True,5
1025,validator_5,181367083863,True,537819989,39813400,577633389,True,5
1026,validator_61,36703963441,True,631699998,12506400,644206398,True,1
1027,validator_45,36031154123,True,683840002,34621620,718461622,True,1
1028,validator_54,34745978191,True,762739998,10445070,773185068,True,1
1029,validator_33,72421797601,True,879300000,4203600,883503600,True,2
1030,validator_5,182210734003,True,818840000,24810140,843650140,True,5
1031,validator_5,182889921414,True,662780001,16407410,679187411,True,5
1032,validator_40,69773043640,True,627400000,3064750,630464750,False,2
1033,validator_10,176082640890,True,640000000,19733370,659733370,False,5
1034,validator_9,178048853670,True,670300000,3175310,673475310,False,5
1035,validator_91,35085385640,True,661700000,1467600,663167600,False,1
1036,validator_0,289002992780,True,848059999,21830620,869890619,True,9
1037,validator_85,34381843650,True,577100000,20668940,597768940,False,1
1038,validator_24,67334209117,True,691339991,42296890,733636881,True,2
1039,validator_69,37010986102,True,916039994,28846950,944886944,True,1
1040,validator_0,289818124982,True,812400002,2732200,815132202,True,9
1041,validator_88,34685364510,True,553400000,6321570,559721570,False,1
1042,validator_11,180496221330,True,608500000,19547490,628047490,False,5
1043,validator_10,176761032360,True,675500000,2891470,678391470,False,5
1044,validator_1,291070184804,True,844600000,17567870,862167870,True,9
1045,validator_17,104802612917,True,700499999,3134500,703634499,True,3
1046,validator_32,66875302242,True,589099998,9153300,598253298,True,2
1047,validator_83,36063916720,True,666570000,21357080,687927080,False,1
1048,validator_10,177437950760,True,675700000,1218400,676918400,False,5
1049,validator_54,35323722761,True,558000000,19744570,577744570,True,1
1050,validator_26,69191278332,True,659840002,30309400,690149402,True,2
1051,validator_6,178786662280,True,545100000,3409490,548509490,True,5
1052,validator_11,180992829380,True,493360000,3248050,496608050,False,5
1053,validator_68,34333478155,True,590360000,28565210,618925210,True,1
1054,validator_23,103507321640,True,552700000,3239510,555939510,False,3
1055,validator_0,290494725083,True,668200001,8400100,676600101,True,9
1056,validator_3,279912658690,True,539400000,20887500,560287500,False,8
1057,validator_11,181568739550,True,572500000,3410170,575910170,False,5
1058,validator_12,105016570837,True,820399990,24686540,845086530,True,3
1059,validator_34,71574321320,True,652200000,2630600,654830600,False,2
1060,validator_39,71831355510,True,748800000,9886820,758686820,False,2
1061,validator_43,70173440710,True,539200000,2837400,542037400,False,2
1062,validator_4,177362348385,True,671259994,48160430,719420424,True,5
1063,validator_2,285657186720,True,737100000,1982670,739082670,False,8
1064,validator_9,178593263010,True,534300000,10109340,544409340,False,5
1065,validator_8,176708788180,True,614600000,18803600,633403600,False,5
1066,validator_9,179005677010,True,407100000,5314000,412414000,False,5
1067,validator_50,34192429514,True,675099994,34736180,709836174,True,1
1068,validator_0,291082752291,True,567660008,20367200,588027208,True,9
1069,validator_50,34694006442,True,472820008,28756920,501576928,True,1
1070,validator_1,291878236513,True,750086009,57965700,808051709,True,9
1071,validator_7,182407741032,True,735800003,28225620,764025623,True,5
1072,validator_9,179650788040,True,642400000,2711030,645111030,False,5
1073,validator_17,105437575438,True,592313991,42648530,634962521,True,3
1074,validator_3,280508392760,True,592600000,3134070,595734070,False,8
1075,validator_23,104080401580,True,568600000,4479940,573079940,False,3
1076,validator_9,180164682610,True,494100000,19794570,513894570,False,5
1077,validator_7,183161571332,True,718840000,34990300,753830300,True,5
1078,validator_42,70561024980,True,473540000,19529900,493069900,False,2
1079,validator_34,72086801010,True,508300000,4179690,512479690,False,2
1080,validator_3,281117628140,True,606300000,2935380,609235380,False,8
1081,validator_19,100139485830,True,605100000,9069420,614169420,False,3
1082,validator_4,178092840144,True,727999999,2491760,730491759,True,5
1083,validator_43,70847353570,True,670100000,3812860,673912860,False,2
1084,validator_22,106447350600,True,694300000,2711700,697011700,False,3
1085,validator_80,34170877380,True,628300000,20271270,648571270,False,1
1086,validator_18,103270999630,True,540600000,2204830,542804830,False,3
1087,validator_5,183619642795,True,703540001,26181380,729721381,True,5
1088,validator_61,37577853766,True,856868005,17022320,873890325,True,1
1089,validator_43,71496384420,True,641000000,8030850,649030850,False,2
1090,validator_41,71782110320,True,487800000,6874850,494674850,False,2
1091,validator_35,72727944940,True,509000000,6182680,515182680,False,2
1092,validator_2,286255915420,True,578500000,20228700,598728700,False,8
1093,validator_1,292918114809,True,1032645996,7232300,1039878296,True,9
1094,validator_29,69874901481,True,674900004,8845100,683745104,True,2
1095,validator_80,34697536080,True,522300000,4358700,526658700,False,1
1096,validator_1,293696500827,True,759339998,19046020,778386018,True,9
1097,validator_1,294337236325,True,630699998,10035500,640735498,True,9
1098,validator_7,183842182223,True,653786001,26824890,680610891,True,5
1099,validator_7,184750078878,True,887999995,19896660,907896655,True,5
1100,validator_16,104839726401,True,431589996,16449130,448039126,True,3
1101,validator_4,178745995873,True,631219999,21935730,653155729,True,5
1102,validator_55,34204742812,True,574920007,7384670,582304677,True,1
1103,validator_6,179406984035,True,579700005,40621750,620321755,True,5
1104,validator_17,106046349663,True,551459995,57314230,608774225,True,3
1105,validator_9,180874894460,True,705300000,4911850,710211850,False,5
1106,validator_2,286938701220,True,678500000,4285800,682785800,False,8
1107,validator_3,281551722860,True,396500000,37594720,434094720,False,8
1108,validator_34,72837588800,True,749000000,1787790,750787790,False,2
1109,validator_59,34863408852,True,766800005,4957640,771757645,True,1
1110,validator_11,182245055250,True,667400000,8915700,676315700,False,5
1111,validator_6,180250867317,True,812540002,31343280,843883282,True,5
1112,validator_0,292071456266,True,985799995,2903980,988703975,True,9
1113,validator_52,37654576228,True,629420004,25225850,654645854,True,1
1114,validator_11,182963683650,True,708740000,9888400,718628400,False,5
1115,validator_3,282219504190,True,656400000,11381330,667781330,False,8
1116,validator_18,103945546210,True,671900000,2646580,674546580,False,3
1117,validator_90,33683447160,True,551360000,2876480,554236480,False,1
1118,validator_49,35374567400,True,986439994,16919000,1003358994,True,1
1119,validator_1,295056297685,True,691373990,27687370,719061360,True,9
1120,validator_77,35491301570,True,496700000,1324570,498024570,False,1
1121,validator_22,107068765000,True,619300000,2114400,621414400,False,3
1122,validator_7,185525444027,True,747411999,27953150,775365149,True,5
1123,validator_66,38340314947,True,716869998,24751200,741621198,True,1
1124,validator_1,295724876711,True,642799996,25779030,668579026,True,9
1125,validator_31,73826279825,True,634099998,25362910,659462908,True,2
1126,validator_38,71469182110,True,473600000,3862520,477462520,False,2
1127,validator_43,72029462960,True,530000000,3078540,533078540,False,2
1128,validator_21,104807928340,True,755300000,3895260,759195260,False,3
1129,validator_9,181563494160,True,685900000,2699700,688599700,False,5
1130,validator_2,287471760100,True,513600000,19458880,533058880,False,8
1131,validator_9,182233786780,True,666800000,3492620,670292620,False,5
1132,validator_9,182865312640,True,629500000,2025860,631525860,False,5
1133,validator_2,287964213660,True,489300000,3153560,492453560,False,8
1134,validator_83,36506420140,True,438500000,4003420,442503420,False,1
1135,validator_87,35297183180,True,696100000,2585830,698685830,False,1
1136,validator_39,72371364110,True,520200000,19808600,540008600,False,2
1137,validator_0,292620320866,True,538668000,10196600,548864600,True,9
1138,validator_29,70522767310,True,620019999,27845830,647865829,True,2
1139,validator_9,183565006770,True,690200000,9494130,699694130,False,5
1140,validator_6,181015278580,True,748240003,16171260,764411263,True,5
1141,validator_3,282793822790,True,560900000,13418600,574318600,False,8
1142,validator_41,72399451320,True,613700000,3641000,617341000,False,2
1143,validator_48,36194800317,True,514440003,20891700,535331703,True,1
1144,validator_39,73074795710,True,697100000,6331600,703431600,False,2
1145,validator_72,34944044540,True,923200000,4172500,927372500,False,1
1146,validator_10,178006171960,True,559400000,8821200,568221200,False,5
1147,validator_10,178615229260,True,581800000,27257300,609057300,False,5
1148,validator_18,104555424350,True,603600000,6278140,609878140,False,3
1149,validator_6,181849452659,True,806819999,27354080,834174079,True,5
1150,validator_2,288560591900,True,594500000,1878240,596378240,False,9
1151,validator_88,35353260590,True,662000000,5896080,667896080,False,1
1152,validator_7,186147335830,True,614540003,7351800,621891803,True,5
1153,validator_67,38651020381,True,450199997,34218100,484418097,True,1
1154,validator_55,34788410482,True,539440000,44227670,583667670,True,1
1155,validator_4,179314289754,True,540316001,27977880,568293881,True,5
1156,validator_31,74552956748,True,715800003,10876920,726676923,True,2
1157,validator_33,73253389498,True,783119997,48471900,831591897,True,2
1158,validator_36,69732390310,True,609000000,1372620,610372620,False,2
1159,validator_31,75100246484,True,545199996,2089740,547289736,True,2
1160,validator_9,184137618870,True,569700000,2912100,572612100,False,5
1161,validator_21,105369395340,True,560300000,1167000,561467000,False,3
1162,validator_32,67779805644,True,880400002,24103400,904503402,True,2
1163,validator_50,35289939140,True,567179998,28752700,595932698,True,1
1164,validator_19,100860241070,True,714200000,6555240,720755240,False,3
1165,validator_14,109745066256,True,608199995,2064900,610264895,True,3
1166,validator_3,283328807920,True,513900000,21085130,534985130,False,8
1167,validator_23,104792049740,True,708900000,2748160,711648160,False,3
1168,validator_6,182514128532,True,651499993,13175880,664675873,True,5
1169,validator_30,74695541493,True,555082002,48615180,603697182,True,2
1170,validator_6,183336159116,True,803980004,18050580,822030584,True,5
1171,validator_10,179154752760,True,533200000,6323500,539523500,False,5
1172,validator_98,34550371450,True,647300000,1870540,649170540,False,1
1173,validator_22,107647404660,True,576400000,2239660,578639660,False,3
1174,validator_5,184379702003,True,743916008,16143200,760059208,True,5
1175,validator_56,38955214176,True,805620001,11895500,817515501,True,1
1176,validator_59,35656788248,True,758879996,34499400,793379396,True,1
1177,validator_7,186946913371,True,783300001,16277540,799577541,True,5
1178,validator_17,106834628427,True,781100004,7178760,788278764,True,3
1179,validator_57,38007388854,True,478300003,16246230,494546233,True,1
1180,validator_79,35968416240,True,721200000,8679780,729879780,False,1
1181,validator_21,105985810770,True,610700000,5715430,616415430,False,3
1182,validator_13,105485908944,True,472620006,10414800,483034806,True,3
1183,validator_50,36056720047,True,748679997,18100910,766780907,True,1
1184,validator_87,35910494040,True,611800000,1510860,613310860,False,1
1185,validator_23,105311379660,True,516700000,2629920,519329920,False,3
1186,validator_3,283895506630,True,554500000,12198710,566698710,False,8
1187,validator_2,289138790030,True,557400000,20798130,578198130,False,9
1188,validator_6,183881968546,True,511520000,34289430,545809430,True,5
1189,validator_39,73598809380,True,516900000,7113670,524013670,False,2
1190,validator_17,107380371128,True,527880001,17862700,545742701,True,3
1191,validator_9,184766962070,True,627000000,2343200,629343200,False,5
1192,validator_32,68287955117,True,487799993,20349480,508149473,True,2
1193,validator_0,293806811997,True,1148320001,38171130,1186491131,True,9
1194,validator_0,294659247963,True,812499996,39935970,852435966,True,9
1195,validator_88,36024632730,True,651300000,20072140,671372140,False,1
1196,validator_2,289930990560,True,790800000,1400530,792200530,False,9
1197,validator_8,177280395380,True,545300000,26307200,571607200,False,5
1198,validator_1,296322470641,True,587040000,10553930,597593930,True,9
1199,validator_18,105138203150,True,579700000,3078800,582778800,False,3
1200,validator_2,290476396680,True,537100000,8306120,545406120,False,9
1201,validator_16,105867239907,True,995740006,31773500,1027513506,True,3
1202,validator_16,106687472913,True,810720006,9513000,820233006,True,3
1203,validator_21,106430419850,True,442280000,2329080,444609080,False,3
1204,validator_96,34350694700,True,643000000,7076500,650076500,False,1
1205,validator_9,185297340330,True,527600000,2778260,530378260,False,5
1206,validator_4,179990399889,True,674300005,1810130,676110135,True,5
1207,validator_2,291168487180,True,682700000,9390500,692090500,False,9
1208,validator_16,107444224014,True,753500001,3251100,756751101,True,3
1209,validator_3,284577180670,True,673700000,7974040,681674040,False,8
1210,validator_69,37678289294,True,606979992,60323200,667303192,True,1
1211,validator_24,68158509771,True,803140004,21160650,824300654,True,2
1212,validator_64,37189678987,True,526040002,47339940,573379942,True,1
1213,validator_12,105836444528,True,801500001,18373690,819873691,True,3
1214,validator_1,296946024977,True,591120006,32434330,623554336,True,9
1215,validator_64,37859895413,True,625139996,45076430,670216426,True,1
1216,validator_10,179712860460,True,556700000,1407700,558107700,False,5
1217,validator_1,297621055480,True,651460003,23570500,675030503,True,9
1218,validator_9,186118615250,True,818700000,2574920,821274920,False,5
1219,validator_58,36393576759,True,550764001,19623580,570387581,True,1
1220,validator_0,295286894039,True,607839996,19806080,627646076,True,9
1221,validator_5,184966912502,True,576099999,11110500,587210499,True,5
1222,validator_1,298194151065,True,553920005,19175580,573095585,True,9
1223,validator_34,73524655580,True,666000000,21066780,687066780,False,2
1224,validator_6,184384417677,True,486860001,15589130,502449131,True,5
1225,validator_15,110195123938,True,643400002,2748780,646148782,True,3
1226,validator_10,180390056760,True,674900000,2296300,677196300,False,5
1227,validator_26,69833456851,True,609513999,32664520,642178519,True,2
1228,validator_0,295906028764,True,576579995,42554730,619134725,True,9
1229,validator_19,101501446000,True,629400000,11804930,641204930,False,3
1230,validator_33,73843609045,True,576113997,14105550,590219547,True,2
1231,validator_6,184893742371,True,498199994,11124700,509324694,True,5
1232,validator_43,72579990920,True,543200000,7327960,550527960,False,2
1233,validator_7,187474282970,True,501919999,25449600,527369599,True,5
1234,validator_23,105957910260,True,641900000,4630600,646530600,False,3
1235,validator_14,110562722958,True,779920002,37736700,817656702,True,3
1236,validator_3,285238520790,True,660200000,1140120,661340120,False,8
1237,validator_1,299011900868,True,804200003,13549800,817749803,True,9
1238,validator_2,291800043980,True,629200000,2356800,631556800,False,9
1239,validator_40,70307197840,True,530400000,3754200,534154200,False,2
1240,validator_74,32968548630,True,385370000,22010940,407380940,False,1
1241,validator_25,73858723060,True,681299997,3379300,684679297,True,2
1242,validator_40,71101566780,True,791300000,3068940,794368940,False,2
1243,validator_8,177973410920,True,690700000,2315540,693015540,False,5
1244,validator_1,299909453565,True,886319997,11232700,897552697,True,9
1245,validator_11,183635919470,True,671000000,1235820,672235820,False,5
1246,validator_8,178623785590,True,630500000,19874670,650374670,False,5
1247,validator_19,102317404500,True,794700000,21258500,815958500,False,3
1248,validator_89,36849946530,True,661400000,1742770,663142770,False,1
1249,validator_23,106650763280,True,692300000,553020,692853020,False,3
1250,validator_11,184111261860,True,449900000,25442390,475342390,False,5
1251,validator_1,300671751478,True,749499993,12797920,762297913,True,9
1252,validator_3,285884875830,True,637900000,8455040,646355040,False,8
1253,validator_85,35008096280,True,621900000,4352630,626252630,False,1
1254,validator_42,71142043150,True,578500000,2518170,581018170,False,2
1255,validator_2,292380397680,True,577600000,2753700,580353700,False,9
1256,validator_15,110881681375,True,672199997,14357440,686557437,True,3
1257,validator_10,181048831860,True,642600000,16175100,658775100,False,5
1258,validator_99,33992725880,True,547000000,11574440,558574440,False,1
1259,validator_10,181603461240,True,533800000,20829380,554629380,False,5
1260,validator_96,34873333300,True,518000000,4638600,522638600,False,1
1261,validator_32,69014314827,True,708060000,18299710,726359710,True,2
1262,validator_6,185400678861,True,456240000,50696490,506936490,True,5
1263,validator_84,35670955450,True,679500000,11936930,691436930,False,1
1264,validator_29,71212450115,True,682499995,7182810,689682805,True,2
1265,validator_3,286611380190,True,721600000,4904360,726504360,False,8
1266,validator_58,37063334771,True,644040002,25718010,669758012,True,1
1267,validator_12,106516961234,True,656820006,23696700,680516706,True,3
1268,validator_26,70465973955,True,625640004,6877100,632517104,True,2
1269,validator_66,38900863028,True,550740001,9808080,560548081,True,1
1270,validator_3,287104024990,True,491500000,1144800,492644800,False,8
1271,validator_17,108187421800,True,782220002,24830670,807050672,True,3
1272,validator_43,73048868720,True,466400000,2477800,468877800,False,2
1273,validator_58,37598831405,True,511539994,23956640,535496634,True,1
1274,validator_36,70478453810,True,742600000,3463500,746063500,False,2
1275,validator_18,105810142380,True,670400000,1539230,671939230,False,3
1276,validator_68,34986028664,True,628479999,24070510,652550509,True,1
1277,validator_89,37535919790,True,684300000,1673260,685973260,False,1
1278,validator_62,35228002496,True,581600001,11462400,593062401,True,1
1279,validator_33,74575645079,True,704280004,27756030,732036034,True,2
1280,validator_37,70706423550,True,725200000,2056700,727256700,False,2
1281,validator_89,38201500650,True,663000000,2580860,665580860,False,1
1282,validator_52,38371201727,True,704619999,12005500,716625499,True,1
1283,validator_21,106971946010,True,535800000,5726160,541526160,False,3
1284,validator_71,38508018365,True,992839991,15678140,1008518131,True,1
1285,validator_58,38168035703,True,527505998,41698300,569204298,True,1
1286,validator_49,36247142998,True,829420008,43155590,872575598,True,1
1287,validator_73,35140026560,True,554500000,2892530,557392530,False,1
1288,validator_8,179225848240,True,599900000,2162650,602062650,False,5
1289,validator_51,34171090083,True,579939996,11457600,591397596,True,1
1290,validator_8,179857385600,True,627240000,4297360,631537360,False,5
1291,validator_7,188349104407,True,853939997,20881440,874821437,True,5
1292,validator_0,296673381568,True,753300004,14052800,767352804,True,9
1293,validator_11,184989246150,True,875600000,2384290,877984290,False,5
1294,validator_42,71744756400,True,598500000,4213250,602713250,False,2
1295,validator_0,297275464349,True,580860001,21222780,602082781,True,9
1296,validator_29,71841082334,True,600059999,28572220,628632219,True,2
1297,validator_9,186799773190,True,678400000,2757940,681157940,False,5
1298,validator_15,111656388261,True,766799996,7906890,774706886,True,3
1299,validator_88,36564242530,True,536400000,3209800,539609800,False,1
1300,validator_79,36424076710,True,454500000,1160470,455660470,False,1
1301,validator_9,187360824820,True,560300000,751630,561051630,False,5
1302,validator_90,34270874480,True,562600000,24827320,587427320,False,1
1303,validator_8,180583975950,True,724100000,2490350,726590350,False,5
1304,validator_14,111329402053,True,729239995,37439100,766679095,True,3
1305,validator_2,292924810280,True,534900000,9512600,544412600,False,9
1306,validator_37,71354568780,True,646800000,1345230,648145230,False,2
1307,validator_49,36859810241,True,589199993,23467250,612667243,True,1
1308,validator_3,287998173350,True,886100000,8048360,894148360,False,8
1309,validator_3,288557747910,True,558300000,1274560,559574560,False,9
1310,validator_32,69725481423,True,696999996,14166600,711166596,True,2
1311,validator_9,187919972120,True,556500000,2647300,559147300,False,5
1312,validator_57,38473628662,True,449300008,16939800,466239808,True,1
1313,validator_66,39788194346,True,872839998,14491320,887331318,True,1
1314,validator_36,71089878320,True,602600000,8824510,611424510,False,2
1315,validator_42,72308115500,True,560100000,3259100,563359100,False,2
1316,validator_82,35993756540,True,498300000,7306420,505606420,False,1
1317,validator_3,289307385660,True,721300000,28337750,749637750,False,9
1318,validator_28,72866167167,True,756239994,17064280,773304274,True,2
1319,validator_38,71996845290,True,508100000,19563180,527663180,False,2
1320,validator_13,106175899426,True,666366002,23624480,689990482,True,3
1321,validator_1,301523554917,True,836099999,15703440,851803439,True,9
1322,validator_0,298246147732,True,964596003,6087380,970683383,True,9
1323,validator_10,182072793200,True,459410000,9921960,469331960,False,5
1324,validator_1,302457555309,True,908359992,25640400,934000392,True,9
1325,validator_21,107748517710,True,750500000,26071700,776571700,False,3
1326,validator_2,293608358570,True,664500000,19048290,683548290,False,9
1327,validator_1,303247221809,True,760642000,29024500,789666500,True,9
1328,validator_5,185998783331,True,1004859999,27010830,1031870829,True,5
1329,validator_89,38658417490,True,448000000,8916840,456916840,False,1
1330,validator_86,34877426950,True,589900000,9866440,599766440,False,1
1331,validator_27,69952694709,True,780899994,3550320,784450314,True,2
1332,validator_45,36800335324,True,762000001,7181200,769181201,True,1
1333,validator_90,34856554640,True,583400000,2280160,585680160,False,1
1334,validator_17,109062096904,True,835760004,38915100,874675104,True,3
1335,validator_11,185424187450,True,427300000,7641300,434941300,False,5
1336,validator_32,70307168724,True,580100001,1587300,581687301,True,2
1337,validator_3,289755453360,True,444400000,3667700,448067700,False,9
1338,validator_58,38942992102,True,763939999,11016400,774956399,True,1
1339,validator_10,182539566520,True,443200000,23573320,466773320,False,5
1340,validator_54,36081888379,True,729789998,28375620,758165618,True,1
1341,validator_5,186886060638,True,876020007,11257300,887277307,True,5
1342,validator_2,294386163090,True,771700000,6104520,777804520,False,9
1343,validator_50,36600784677,True,521700000,22364630,544064630,True,1
1344,validator_61,38388598216,True,793560000,17184450,810744450,True,1
1345,validator_0,298920817865,True,655620003,19050130,674670133,True,9
1346,validator_23,107263939200,True,593600000,19575920,613175920,False,3
1347,validator_0,299468508697,True,504054002,43636830,547690832,True,9
1348,validator_41,72979741000,True,578500000,1789680,580289680,False,2
1349,validator_5,187572995732,True,672180004,14755090,686935094,True,5
1350,validator_16,108057143438,True,581740004,31179420,612919424,True,3
1351,validator_7,188967700910,True,599200003,19396500,618596503,True,5
1352,validator_20,109416939760,True,625600000,1474280,627074280,False,3
1353,validator_9,188527893620,True,607600000,321500,607921500,False,5
1354,validator_6,186215057831,True,798800000,15578970,814378970,True,5
1355,validator_58,39414760163,True,453498001,18270060,471768061,True,1
1356,validator_33,75261475119,True,671400000,14430040,685830040,True,2
1357,validator_12,107263709629,True,743999995,2748400,746748395,True,3
1358,validator_51,34848577364,True,597640001,79847280,677487281,True,1
1359,validator_39,74265560820,True,661200000,5551440,666751440,False,2
1360,validator_10,183215710060,True,664400000,11743540,676143540,False,5
1361,validator_33,76242145997,True,958203998,22466880,980670878,True,2
1362,validator_27,70550032371,True,596200002,1137660,597337662,True,2
1363,validator_1,304162672353,True,895457994,19992550,915450544,True,9
1364,validator_6,186837403928,True,611699997,10646100,622346097,True,5
1365,validator_33,76737668186,True,487539999,7982190,495522189,True,2
1366,validator_0,299961179503,True,465940006,26730800,492670806,True,9
1367,validator_13,106564582249,True,373840003,14842820,388682823,True,3
1368,validator_0,300723465850,True,718139997,44146350,762286347,True,9
1369,validator_89,39308253190,True,647800000,2035700,649835700,False,1
1370,validator_8,181122614370,True,518100000,20538420,538638420,False,5
1371,validator_96,35555421700,True,666400000,15688400,682088400,False,1
1372,validator_1,305095491455,True,922185992,10633110,932819102,True,9
1373,validator_15,112591334552,True,912339991,22606300,934946291,True,3
1374,validator_12,107945163183,True,655099994,26353560,681453554,True,3
1375,validator_1,305453713415,True,355700000,2521960,358221960,True,9
1376,validator_80,35225679570,True,526700000,1443490,528143490,False,1
1377,validator_90,35494560410,True,632500000,5505770,638005770,False,1
1378,validator_59,36449569450,True,748040002,44741200,792781202,True,1
1379,validator_88,37131630220,True,562100000,5287690,567387690,False,1
1380,validator_3,290440859540,True,683900000,1506180,685406180,False,9
1381,validator_0,301455830897,True,704339997,28025050,732365047,True,9
1382,validator_89,39877800420,True,565700000,3847230,569547230,False,1
1383,validator_27,71220500459,True,657889988,12578100,670468088,True,2
1384,validator_99,34751399680,True,717600000,41073800,758673800,False,1
1385,validator_18,106299757490,True,488100000,1515110,489615110,False,3
1386,validator_53,34799906759,True,715600005,16858300,732458305,True,1
1387,validator_3,291040709530,True,588000000,11849990,599849990,False,9
1388,validator_47,36012552842,True,675999999,2299040,678299039,True,1
1389,validator_12,108722629023,True,764200000,13265840,777465840,True,3
1390,validator_25,74657729912,True,767800002,31206850,799006852,True,2
1391,validator_2,294864522680,True,476200000,2159590,478359590,False,9
1392,validator_7,189477814312,True,494968002,15145400,510113402,True,5
1393,validator_18,106853972510,True,552000000,2215020,554215020,False,3
1394,validator_94,35111824070,True,542900000,32590070,575490070,False,1
1395,validator_86,35437403380,True,532300000,27676430,559976430,False,1
1396,validator_0,302188634373,True,683239986,49563490,732803476,True,9
1397,validator_1,306150295317,True,672800002,23781900,696581902,True,9
1398,validator_6,187337758219,True,494520001,5834290,500354291,True,5
1399,validator_43,73564416220,True,496300000,19247500,515547500,False,2
1400,validator_50,37326226297,True,716140000,9301620,725441620,True,1
1401,validator_20,110040298630,True,598200000,25158870,623358870,False,3
1402,validator_5,188378469686,True,790880004,14593950,805473954,True,5
1403,validator_9,189085050310,True,536900000,20256690,557156690,False,5
1404,validator_5,189136921079,True,746459993,11991400,758451393,True,5
1405,validator_55,35345531085,True,527340003,29780600,557120603,True,1
1406,validator_0,303455577755,True,1249920002,17023380,1266943382,True,9
1407,validator_21,108636154920,True,882400000,5237210,887637210,False,3
1408,validator_14,112285092015,True,925760002,29929960,955689962,True,3
1409,validator_98,35200948250,True,650000000,576800,650576800,False,1
1410,validator_23,107868179300,True,600700000,3540100,604240100,False,3
1411,validator_34,74425266680,True,882300000,18311100,900611100,False,2
1412,validator_3,291768697080,True,719700000,8287550,727987550,False,9
1413,validator_55,36019005528,True,644940003,28534440,673474443,True,1
1414,validator_0,304187285994,True,730199999,1508240,731708239,True,9
1415,validator_36,72041788650,True,949500000,2410330,951910330,False,2
1416,validator_18,107432505940,True,562000000,16533430,578533430,False,3
1417,validator_25,75293185702,True,609140000,26315790,635455790,True,2
1418,validator_75,35989812880,True,556100000,19252990,575352990,False,1
1419,validator_1,306955165376,True,749939999,54930060,804870059,True,9
1420,validator_8,181664136070,True,522500000,19021700,541521700,False,5
1421,validator_80,35903085690,True,655900000,21506120,677406120,False,1
1422,validator_14,112793751853,True,484539998,24119840,508659838,True,3
1423,validator_3,292350106150,True,579900000,1509070,581409070,False,9
1424,validator_3,292937302740,True,565910000,21286590,587196590,False,9
1425,validator_2,295482713340,True,596900000,21290660,618190660,False,9
1426,validator_97,38344433500,True,674000000,4594690,678594690,False,1
1427,validator_2,296288301470,True,796600000,8988130,805588130,False,9
1428,validator_21,109187115450,True,540000000,10960530,550960530,False,3
1429,validator_81,34634310850,True,462100000,1969430,464069430,False,1
1430,validator_1,307393360254,True,429819998,8374880,438194878,True,9
1431,validator_34,75058084880,True,613300000,19518200,632818200,False,2
1432,validator_1,308146477132,True,752099998,1016880,753116878,True,9
1433,validator_45,37593348963,True,754559999,38453640,793013639,True,1
1434,validator_10,183850888640,True,631200000,3978580,635178580,False,5
1435,validator_21,109800975480,True,610900000,2960030,613860030,False,3
1436,validator_60,35568324400,True,812560003,53188830,865748833,True,1
1437,validator_22,108244861370,True,578200000,19256710,597456710,False,3
1438,validator_30,75459847400,True,740254007,24051900,764305907,True,2
1439,validator_91,35700543080,True,596700000,18457440,615157440,False,1
1440,validator_23,108398624700,True,527200000,3245400,530445400,False,3
1441,validator_0,304988725124,True,749106000,52333130,801439130,True,9
1442,validator_11,186071354040,True,643500000,3666590,647166590,False,5
1443,validator_12,109433109619,True,653859996,56620600,710480596,True,3
1444,validator_1,308947511637,True,779760005,21274500,801034505,True,9
1445,validator_93,33779002820,True,578400000,20390240,598790240,False,1
1446,validator_16,108712642236,True,624219998,31278800,655498798,True,3
1447,validator_3,293632038980,True,673300000,21436240,694736240,False,9
1448,validator_24,68657989589,True,476399998,23079820,499479818,True,2
1449,validator_40,71729063980,True,620300000,7197200,627497200,False,2
1450,validator_20,110674867540,True,631900000,2668910,634568910,False,3
1451,validator_96,36129496430,True,555200000,18874730,574074730,False,1
1452,validator_22,108690748700,True,426970000,18917330,445887330,False,3
1453,validator_1,309639568571,True,684880004,7176930,692056934,True,9
1454,validator_23,108973935530,True,573300000,2010830,575310830,False,3
1455,validator_11,186727733970,True,629400000,26979930,656379930,False,5
1456,validator_18,108004308280,True,565300000,6502340,571802340,False,3
1457,validator_39,74805198450,True,535700000,3937630,539637630,False,2
1458,validator_1,310281199660,True,599439999,42191090,641631089,True,9
1459,validator_91,36388061000,True,686600000,917920,687517920,False,1
1460,validator_3,294176803960,True,535900000,8864980,544764980,False,9
1461,validator_41,73727446310,True,746000000,1705310,747705310,False,2
1462,validator_13,107091433092,True,524200003,2650840,526850843,True,3
1463,validator_6,188190104652,True,828434003,23912430,852346433,True,5
1464,validator_21,110323911380,True,521800000,1135900,522935900,False,3
1465,validator_9,189692774560,True,606300000,1424250,607724250,False,5
1466,validator_1,311033835686,True,724899996,27736030,752636026,True,9
1467,validator_42,73017026100,True,688200000,20710600,708910600,False,2
1468,validator_12,110117118378,True,681699999,2308760,684008759,True,3
1469,validator_11,187282107100,True,551100000,3273130,554373130,False,5
1470,validator_16,109384901038,True,643778002,28480800,672258802,True,3
1471,validator_73,35890843590,True,746600000,4217030,750817030,False,1
1472,validator_42,73705370600,True,685300000,3044500,688344500,False,2
1473,validator_73,36384442670,True,483700000,9899080,493599080,False,1
1474,validator_35,73328483510,True,599300000,1238570,600538570,False,2
1475,validator_16,110025026533,True,628599995,11525500,640125495,True,3
1476,validator_21,110816276690,True,484300000,8065310,492365310,False,3
1477,validator_11,187918952900,True,632400000,4445800,636845800,False,5
1478,validator_95,34122100830,True,541400000,5891380,547291380,False,1
1479,validator_71,39260561668,True,723520003,29023300,752543303,True,1
1480,validator_46,38110504018,True,748199997,7196340,755396337,True,1
1481,validator_2,296834030250,True,540000000,5728780,545728780,False,9
1482,validator_11,188529956130,True,607700000,3303230,611003230,False,5
1483,validator_70,35147361210,True,806354005,8213590,814567595,True,1
1484,validator_2,297488580480,True,617900000,36650230,654550230,False,9
1485,validator_58,40197077483,True,737700000,44617320,782317320,True,1
1486,validator_2,298037851510,True,545600000,3671030,549271030,False,9
1487,validator_6,188917590151,True,703419999,24065500,727485499,True,5
1488,validator_60,36464692827,True,857288007,39080420,896368427,True,1
1489,validator_4,180641904399,True,631060000,20444510,651504510,True,5
1490,validator_26,71032574192,True,557739997,8860240,566600237,True,2
1491,validator_77,36121423010,True,627400000,2721440,630121440,False,1
1492,validator_18,108571455660,True,565600000,1547380,567147380,False,3
1493,validator_7,189906431307,True,428000005,616990,428616995,True,5
1494,validator_9,190183166980,True,488900000,1492420,490392420,False,5
1495,validator_28,73507512289,True,634620002,6725120,641345122,True,2
1496,validator_63,40818887891,True,726280003,32834480,759114483,True,1
1497,validator_1,311752386891,True,677000005,41551200,718551205,True,9
1498,validator_3,294772532970,True,592800000,2929010,595729010,False,9
1499,validator_6,189700712953,True,777599992,5522810,783122802,True,5
1500,validator_1,312452419011,True,673700000,26332120,700032120,True,9
1501,validator_18,109160339800,True,577000000,11884140,588884140,False,3
1502,validator_19,102919504990,True,593000000,9100490,602100490,False,3
1503,validator_4,181452125727,True,783319998,26901330,810221328,True,5
1504,validator_86,36023188920,True,583600000,2185540,585785540,False,1
1505,validator_41,74432105380,True,695900000,8759070,704659070,False,2
1506,validator_47,36675361137,True,642499995,20308300,662808295,True,1
1507,validator_79,37139093680,True,696700000,18316970,715016970,False,1
1508,validator_61,38990295919,True,592220003,9477700,601697703,True,1
1509,validator_55,36625383829,True,597740001,8638300,606378301,True,1
1510,validator_42,74353287630,True,623600000,24317030,647917030,False,2
1511,validator_31,76123636055,True,999700001,23689570,1023389571,True,2
1512,validator_4,182163593650,True,675259993,36207930,711467923,True,5
1513,validator_21,111422809890,True,586800000,19733200,606533200,False,3
1514,validator_0,305707862624,True,668500000,50637500,719137500,True,9
1515,validator_1,313087149708,True,614039997,20690700,634730697,True,9
1516,validator_51,35568177362,True,693559998,26040000,719599998,True,1
1517,validator_0,306571085617,True,834266003,28956990,863222993,True,9
1518,validator_19,103549095330,True,624100000,5490340,629590340,False,3
1519,validator_3,295344735470,True,559200000,13002500,572202500,False,9
1520,validator_12,110898794731,True,772899993,8776360,781676353,True,3
1521,validator_11,189014451960,True,476000000,8495830,484495830,False,5
1522,validator_8,182253678970,True,569300000,20242900,589542900,False,5
1523,validator_45,38205037283,True,593664000,18024320,611688320,True,1
1524,validator_5,189884193555,True,726799996,20472480,747272476,True,5
1525,validator_53,35403057979,True,582980000,20171220,603151220,True,1
1526,validator_74,33570826590,True,598800000,3477960,602277960,False,1
1527,validator_37,71965991220,True,603100000,8322440,611422440,False,2
1528,validator_9,190665208980,True,479300000,2742000,482042000,False,5
1529,validator_90,36153483130,True,656800000,2122720,658922720,False,1
1530,validator_82,36685365740,True,671400000,20209200,691609200,False,1
1531,validator_21,111954767790,True,523500000,8457900,531957900,False,3
1532,validator_16,110741331160,True,682039997,34264630,716304627,True,3
1533,validator_4,182781758637,True,603439997,14724990,618164987,True,5
1534,validator_49,37376435673,True,495577992,21047440,516625432,True,1
1535,validator_9,191138947700,True,463400000,10338720,473738720,False,5
1536,validator_6,190396649653,True,685100000,10836700,695936700,True,5
1537,validator_16,111242558790,True,486880000,14347630,501227630,True,3
1538,validator_20,111160959070,True,485400000,691530,486091530,False,3
1539,validator_19,104080165620,True,505900000,25170290,531070290,False,3
1540,validator_3,295957283710,True,609200000,3348240,612548240,False,9
1541,validator_20,111894713000,True,731800000,1953930,733753930,False,3
1542,validator_32,71276485458,True,943459994,25856740,969316734,True,2
1543,validator_11,189626377650,True,592900000,19025690,611925690,False,5
1544,validator_9,191736138600,True,588800000,8390900,597190900,False,5
1545,validator_87,36723180870,True,785500000,27186830,812686830,False,1
1546,validator_17,109947934785,True,881400001,4437880,885837881,True,3
1547,validator_38,72763413600,True,763500000,3068310,766568310,False,2
1548,validator_82,37092141940,True,404200000,2576200,406776200,False,1
1549,validator_1,313798408007,True,699439999,11818300,711258299,True,9
1550,validator_87,37378044070,True,652900000,1963200,654863200,False,1
1551,validator_93,34520574750,True,736900000,4671930,741571930,False,1
1552,validator_1,314566204040,True,744480003,23316030,767796033,True,9
1553,validator_45,39060521498,True,844799995,10684220,855484215,True,1
1554,validator_0,307352842614,True,755339997,26417000,781756997,True,9
1555,validator_4,183306752063,True,496659996,28333430,524993426,True,5
1556,validator_30,76221579902,True,710640002,51092500,761732502,True,2
1557,validator_4,184012045891,True,697019998,8273830,705293828,True,5
1558,validator_94,35894682090,True,775900000,6958020,782858020,False,1
1559,validator_7,190524191000,True,585999993,31759700,617759693,True,5
1560,validator_2,298530730200,True,484600000,8278690,492878690,False,9
1561,validator_8,182887694370,True,625000000,9015400,634015400,False,5
1562,validator_64,38639308455,True,742379992,37033050,779413042,True,1
1563,validator_47,37317504495,True,635899998,6243360,642143358,True,1
1564,validator_33,77376287090,True,614640004,23978900,638618904,True,2
1565,validator_63,41287109387,True,447539996,20681500,468221496,True,1
1566,validator_15,113474119675,True,851518003,31267120,882785123,True,3
1567,validator_23,109534456770,True,557600000,2921240,560521240,False,3
1568,validator_14,113601098463,True,797699990,9646620,807346610,True,3
1569,validator_20,112511100730,True,615200000,1187730,616387730,False,3
1570,validator_96,36799516970,True,661500000,8520540,670020540,False,1
1571,validator_9,192457183500,True,693300000,27744900,721044900,False,6
1572,validator_36,72590626450,True,545600000,3237800,548837800,False,2
1573,validator_19,104673705960,True,592200000,1340340,593540340,False,3
1574,validator_67,39455326417,True,749503996,54802040,804306036,True,1
1575,validator_65,36885032836,True,775819999,27683960,803503959,True,1
1576,validator_2,299042900770,True,503400000,8770570,512170570,False,9
1577,validator_0,307962078540,True,585199996,24035930,609235926,True,9
1578,validator_3,296513820310,True,536000000,20536600,556536600,False,9
1579,validator_21,112554592880,True,571700000,28125090,599825090,False,3
1580,validator_1,315405328884,True,828400004,10724840,839124844,True,9
1581,validator_83,37165731340,True,641800000,17511200,659311200,False,1
1582,validator_25,76058547849,True,741616007,23746140,765362147,True,2
1583,validator_84,36283686550,True,591000000,21731100,612731100,False,1
1584,validator_10,184400833300,True,547300000,2644660,549944660,False,5
1585,validator_0,308681319138,True,692539998,26700600,719240598,True,9
1586,validator_7,191283276694,True,756399994,2685700,759085694,True,5
1587,validator_19,105394269890,True,712200000,8363930,720563930,False,3
1588,validator_72,35613398200,True,667000000,2353660,669353660,False,1
1589,validator_86,36650512220,True,624700000,2623300,627323300,False,1
1590,validator_4,184692572292,True,666190001,14336400,680526401,True,5
1591,validator_68,35584801439,True,556360005,42412770,598772775,True,1
1592,validator_71,40109719304,True,842899996,6257640,849157636,True,1
1593,validator_23,110302852950,True,759300000,9096180,768396180,False,3
1594,validator_9,193142120030,True,676300000,8636530,684936530,False,6
1595,validator_29,72687353534,True,823420000,22851200,846271200,True,2
1596,validator_15,114564254503,True,1056799998,33334830,1090134828,True,3
1597,validator_70,35973772621,True,809240001,17171410,826411411,True,1
1598,validator_7,192215528401,True,897720007,34531700,932251707,True,6
1599,validator_3,297215389970,True,693100000,8469660,701569660,False,9
1600,validator_22,109162753480,True,469500000,2504780,472004780,False,3
1601,validator_79,37873558630,True,710900000,23564950,734464950,False,1
1602,validator_5,190670043257,True,782900002,2949700,785849702,True,5
1603,validator_18,109829114690,True,666100000,2674890,668774890,False,3
1604,validator_9,193693006030,True,547100000,3786000,550886000,False,6
1605,validator_74,34064975430,True,482600000,11548840,494148840,False,1
1606,validator_56,39631495681,True,609160005,67121500,676281505,True,1
1607,validator_10,184797070240,True,394100000,2136940,396236940,False,5
1608,validator_17,110732277981,True,738779996,45563200,784343196,True,3
1609,validator_5,191312695129,True,632840002,9811870,642651872,True,5
1610,validator_11,190378411250,True,742200000,9833600,752033600,False,5
1611,validator_25,76782819547,True,708779998,15491700,724271698,True,2
1612,validator_43,74348712230,True,759000000,25296010,784296010,False,2
1613,validator_72,36084008750,True,451300000,19310550,470610550,False,1
1614,validator_42,74756974450,True,395600000,8086820,403686820,False,2
1615,validator_23,111012611180,True,707900000,1858230,709758230,False,3
1616,validator_3,297848193750,True,623500000,9303780,632803780,False,9
1617,validator_5,191833355289,True,517000000,3660160,520660160,True,5
1618,validator_30,76899867956,True,644179994,34108060,678288054,True,2
1619,validator_74,34785466730,True,717400000,3091300,720491300,False,1
1620,validator_11,191067419270,True,679500000,9508020,689008020,False,5
1621,validator_66,40327170143,True,533719997,5255800,538975797,True,1
1622,validator_4,185255961428,True,554319996,9069140,563389136,True,5
1623,validator_7,193048108798,True,825895997,6684400,832580397,True,6
1624,validator_3,298453831180,True,603100000,2537430,605637430,False,9
1625,validator_2,299822112970,True,768100000,11112200,779212200,False,9
1626,validator_81,35343542990,True,690400000,18832140,709232140,False,1
1627,validator_0,309398268545,True,700194007,16755400,716949407,True,9
1628,validator_22,109755606800,True,590300000,2553320,592853320,False,3
1629,validator_1,316100156462,True,680819998,14007580,694827578,True,9
1630,validator_4,185843738563,True,531780005,55997130,587777135,True,5
1631,validator_98,35827776710,True,624100000,2728460,626828460,False,1
1632,validator_8,183558706110,True,670200000,811740,671011740,False,5
1633,validator_19,105963038990,True,557900000,10869100,568769100,False,3
1634,validator_77,36828883650,True,705200000,2260640,707460640,False,1
1635,validator_11,191711770420,True,624400000,19951150,644351150,False,5
1636,validator_8,184041483770,True,475400000,7377660,482777660,False,5
1637,validator_50,37918175798,True,548738001,43211500,591949501,True,1
1638,validator_7,193841856287,True,780065999,13681490,793747489,True,6
1639,validator_5,192755931074,True,894120005,28455780,922575785,True,6
1640,validator_24,69297654814,True,620299995,19365230,639665225,True,2
1641,validator_9,194338990990,True,639800000,6184960,645984960,False,6
1642,validator_2,300272081040,True,448000000,1968070,449968070,False,9
1643,validator_7,194402339108,True,539440001,21042820,560482821,True,6
1644,validator_74,35411933510,True,624300000,2166780,626466780,False,1
1645,validator_18,110462638070,True,631500000,2023380,633523380,False,3
1646,validator_35,73868092600,True,530600000,9009090,539609090,False,2
1647,validator_19,106536007600,True,567200000,5768610,572968610,False,3
1648,validator_39,75350573950,True,539200000,6175500,545375500,False,2
1649,validator_0,310135920977,True,734700002,2952430,737652432,True,9
1650,validator_1,316701563681,True,592203999,9203220,601407219,True,9
1651,validator_1,317382567482,True,661200001,19803800,681003801,True,9
1652,validator_1,318035060012,True,638980000,13512530,652492530,True,9
1653,validator_9,195089109380,True,747900000,2218390,750118390,False,6
1654,validator_47,38013459866,True,672000001,23955370,695955371,True,1
1655,validator_71,40644639130,True,504959996,29959830,534919826,True,1
1656,validator_27,71988555590,True,735710011,32345120,768055131,True,2
1657,validator_0,311038595849,True,899000002,3674870,902674872,True,9
1658,validator_10,185305023270,True,494100000,13853030,507953030,False,5
1659,validator_8,184535518070,True,474800000,19234300,494034300,False,5
1660,validator_7,195262625095,True,832839997,27445990,860285987,True,6
1661,validator_39,75840064180,True,488000000,1490230,489490230,False,2
1662,validator_2,301000623770,True,725300000,3242730,728542730,False,9
1663,validator_31,76916765241,True,785839996,7289190,793129186,True,2
1664,validator_21,113274581280,True,715200000,4788400,719988400,False,3
1665,validator_2,301615427370,True,608500000,6303600,614803600,False,9
1666,validator_25,77588205333,True,800399996,4985790,805385786,True,2
1667,validator_14,114206484580,True,598960007,6426110,605386117,True,3
1668,validator_3,299015427280,True,523300000,38296100,561596100,False,9
1669,validator_1,318822658655,True,778900003,8698640,787598643,True,9
1670,validator_1,319489742350,True,634199995,32883700,667083695,True,9
1671,validator_95,34778950750,True,635600000,21249920,656849920,False,1
1672,validator_11,192241515620,True,528700000,1045200,529745200,False,6
1673,validator_2,302367633900,True,731200000,21006530,752206530,False,9
1674,validator_9,195727106020,True,635100000,2896640,637996640,False,6
1675,validator_7,195798011089,True,530439994,4946000,535385994,True,6
1676,validator_40,72317478560,True,586000000,2414580,588414580,False,2
1677,validator_50,38752105527,True,795919999,38009730,833929729,True,1
1678,validator_1,320220196354,True,721300004,9154000,730454004,True,10
1679,validator_0,311881712447,True,820745998,22370600,843116598,True,9
1680,validator_38,73357060030,True,591000000,2646430,593646430,False,2
1681,validator_48,36861165058,True,632860001,33504740,666364741,True,1
1682,validator_38,74157646030,True,799200000,1386000,800586000,False,2
1683,validator_32,71913287958,True,617396000,19406500,636802500,True,2
1684,validator_38,74839404730,True,662600000,19158700,681758700,False,2
1685,validator_2,302947473170,True,565300000,14539270,579839270,False,9
1686,validator_6,191028242145,True,628000002,3592490,631592492,True,5
1687,validator_25,78205692134,True,598460001,19026800,617486801,True,2
1688,validator_60,37269945365,True,777679998,27572540,805252538,True,1
1689,validator_17,111527717183,True,756180002,39259200,795439202,True,3
1690,validator_4,186513690599,True,631420006,38532030,669952036,True,5
1691,validator_30,77680462686,True,761940000,18654730,780594730,True,2
1692,validator_71,41195904424,True,543400004,7865290,551265294,True,1
1693,validator_0,312586373444,True,684367997,20293000,704660997,True,9
1694,validator_6,191774867587,True,740999992,5625450,746625442,True,5
1695,validator_4,187056042099,True,475040000,67311500,542351500,True,5
1696,validator_22,110430303640,True,663600000,11096840,674696840,False,3
1697,validator_91,36928032020,True,538600000,1371020,539971020,False,1
1698,validator_3,299563827960,True,537800000,10600680,548400680,False,9
1699,validator_22,111096777640,True,664800000,1674000,666474000,False,3
1700,validator_4,187613716690,True,528739991,28934600,557674591,True,5
1701,validator_4,188060948415,True,392913995,54317730,447231725,True,5
1702,validator_10,185997049670,True,673000000,19026400,692026400,False,5
1703,validator_96,37204750730,True,402500000,2733760,405233760,False,1
1704,validator_49,38261069174,True,847140001,37493500,884633501,True,1
1705,validator_71,41925548021,True,704959997,24683600,729643597,True,1
1706,validator_88,37538743000,True,400100000,7012780,407112780,False,1
1707,validator_5,193504250982,True,738154008,10165900,748319908,True,6
1708,validator_4,188659405415,True,567740000,30717000,598457000,True,5
1709,validator_13,107710709078,True,604498006,14777980,619275986,True,3
1710,validator_1,320837882948,True,585233994,32452600,617686594,True,10
1711,validator_2,303592279890,True,625600000,19206720,644806720,False,9
1712,validator_43,74924030140,True,548800000,26517910,575317910,False,2
1713,validator_2,304363106010,True,746800000,24026120,770826120,False,9
1714,validator_64,39449922782,True,805999997,4614330,810614327,True,1
1715,validator_13,108742301387,True,1022699999,8892310,1031592309,True,3
1716,validator_15,115454318945,True,858020002,32044440,890064442,True,3
1717,validator_0,313156183348,True,554400004,15409900,569809904,True,9
1718,validator_9,196431985940,True,700600000,4279920,704879920,False,6
1719,validator_63,41862998060,True,558719993,17168680,575888673,True,1
1720,validator_3,299875339400,True,309900000,1611440,311511440,False,9
1721,validator_12,111632933217,True,716680006,17458480,734138486,True,3
1722,validator_24,69981326039,True,674620005,9051220,683671225,True,2
1723,validator_62,36179947459,True,941770003,10174960,951944963,True,1
1724,validator_7,196611986413,True,803600004,10375320,813975324,True,6
1725,validator_43,75450760070,True,504480000,22249930,526729930,False,2
1726,validator_74,36116054200,True,702100000,2020690,704120690,False,1
1727,validator_13,109550773184,True,763199997,45271800,808471797,True,3
1728,validator_3,300497750660,True,611700000,10711260,622411260,False,9
1729,validator_9,197167342670,True,733400000,1956730,735356730,False,6
1730,validator_5,194270490811,True,758799999,7439830,766239829,True,6
1731,validator_1,321377756364,True,515419996,24453420,539873416,True,10
1732,validator_10,186599527000,True,599600000,2877330,602477330,False,5
1733,validator_2,305051981310,True,686500000,2375300,688875300,False,9
1734,validator_21,113737351160,True,461300000,1469880,462769880,False,3
1735,validator_87,37991528130,True,610310000,3174060,613484060,False,1
1736,validator_36,73034740610,True,442500000,1614160,444114160,False,2
1737,validator_48,37622171149,True,741500001,19506090,761006091,True,1
1738,validator_34,75502088570,True,434100000,9903690,444003690,False,2
1739,validator_38,75333678140,True,486900000,7373410,494273410,False,2
1740,validator_19,107290241840,True,730200000,24034240,754234240,False,3
1741,validator_10,187222123200,True,614000000,8596200,622596200,False,5
1742,validator_13,110221932120,True,652559996,18598940,671158936,True,3
1743,validator_3,301074305550,True,570000000,6554890,576554890,False,9
1744,validator_0,314124933373,True,922680005,46070020,968750025,True,9
1745,validator_44,34978503459,True,392500003,2074370,394574373,True,1
1746,validator_1,322175994663,True,766239999,31998300,798238299,True,10
1747,validator_67,40168707454,True,689720007,23661030,713381037,True,1
1748,validator_45,39793218680,True,704140002,28557180,732697182,True,1
1749,validator_41,75088985600,True,653600000,3280220,656880220,False,2
1750,validator_14,114942666067,True,689979987,46201500,736181487,True,3
1751,validator_1,322813500488,True,621099995,16405830,637505825,True,10
1752,validator_20,112989109530,True,474570000,3438800,478008800,False,3
1753,validator_7,197142772215,True,510000002,20785800,530785802,True,6
1754,validator_62,36960355352,True,772899993,7507900,780407893,True,1
1755,validator_1,323561649014,True,716839996,31308530,748148526,True,10
1756,validator_16,111963421488,True,688015998,32846700,720862698,True,3
1757,validator_30,78454745187,True,747240001,27042500,774282501,True,2
1758,validator_13,110700174621,True,471200001,7042500,478242501,True,3
1759,validator_26,71870274164,True,799560002,38139970,837699972,True,2
1760,validator_21,114253354830,True,512240000,3763670,516003670,False,3
1761,validator_3,301850472780,True,775600000,567230,776167230,False,9
1762,validator_43,75941625070,True,488500000,2365000,490865000,False,2
1763,validator_2,305591069970,True,518300000,20788660,539088660,False,9
1764,validator_2,306206622630,True,613100000,2452660,615552660,False,9
1765,validator_45,40375283436,True,567559996,14504760,582064756,True,1
1766,validator_1,324170407882,True,548599998,60158870,608758868,True,10
1767,validator_39,76500193430,True,658500000,1629250,660129250,False,2
1768,validator_94,36441997310,True,543900000,3415220,547315220,False,1
1769,validator_47,38596196058,True,569360002,13376190,582736192,True,1
1770,validator_51,36207298659,True,629099997,10021300,639121297,True,1
1771,validator_76,38142383480,True,591800000,3080400,594880400,False,1
1772,validator_13,111228092923,True,496660002,31258300,527918302,True,3
1773,validator_79,38550699720,True,658400000,18741090,677141090,False,1
1774,validator_16,112545544878,True,568800000,13323390,582123390,True,3
1775,validator_24,70707771501,True,719020002,7425460,726445462,True,2
1776,validator_7,197823591919,True,625840004,54979700,680819704,True,6
1777,validator_37,72538788080,True,568600000,4196860,572796860,False,2
1778,validator_17,112221075987,True,690400004,2958800,693358804,True,3
1779,validator_81,36075804320,True,718200000,14061330,732261330,False,1
1780,validator_7,198705029838,True,851639999,29797920,881437919,True,6
1781,validator_39,77072293310,True,561000000,11099880,572099880,False,2
1782,validator_0,314639567718,True,482760005,31874340,514634345,True,9
1783,validator_5,194741718564,True,435000003,36227750,471227753,True,6
1784,validator_2,306727065820,True,511000000,9443190,520443190,False,9
1785,validator_3,302490397300,True,636900000,3024520,639924520,False,9
1786,validator_2,307233167460,True,482600000,23501640,506101640,False,9
1787,validator_16,113048990297,True,499639999,3805420,503445419,True,3
1788,validator_34,75993435210,True,482400000,8946640,491346640,False,2
1789,validator_0,315405864571,True,764999993,1296860,766296853,True,9
1790,validator_11,192754026660,True,510300000,2211040,512511040,False,6
1791,validator_2,307924655190,True,688700000,2787730,691487730,False,9
1792,validator_1,324921840522,True,731760000,19672640,751432640,True,10
1793,validator_2,308487808290,True,559100000,4053100,563153100,False,9
1794,validator_96,37805493210,True,599000000,1742480,600742480,False,1
1795,validator_1,325428540915,True,480969993,25730400,506700393,True,10
1796,validator_21,114897158060,True,630900000,12903230,643803230,False,3
1797,validator_7,199559371731,True,833999993,20341900,854341893,True,6
1798,validator_7,200228150514,True,661800003,6978780,668778783,True,6
1799,validator_11,193479342270,True,721800000,3515610,725315610,False,6
1800,validator_31,77685120096,True,760099995,8254860,768354855,True,2
1801,validator_29,73399144452,True,703839998,7950920,711790918,True,2
1802,validator_0,316348492753,True,890918002,51710180,942628182,True,9
1803,validator_46,38623191407,True,509839999,2847390,512687389,True,1
1804,validator_1,326215981237,True,778060002,9380320,787440322,True,10
1805,validator_4,189850043612,True,1186999997,3638200,1190638197,True,5
1806,validator_80,36482524610,True,560100000,19338920,579438920,False,1
1807,validator_11,193896343770,True,407200000,9801500,417001500,False,6
1808,validator_13,111770308898,True,526639995,15575980,542215975,True,3
1809,validator_3,302849580280,True,355660000,3522980,359182980,False,9
1810,validator_5,195466077121,True,692699997,31658560,724358557,True,6
1811,validator_1,326861462866,True,621439999,24041630,645481629,True,10
1812,validator_97,39241928170,True,895000000,2494670,897494670,False,1
1813,validator_17,112765849821,True,535074004,9699830,544773834,True,3
1814,validator_39,77757318140,True,682500000,2524830,685024830,False,2
1815,validator_29,74112368169,True,688695997,24527720,713223717,True,2
1816,validator_2,308964446490,True,470980000,5658200,476638200,False,9
1817,validator_24,71511829311,True,765279990,38777820,804057810,True,2
1818,validator_7,201019701641,True,759919997,31631130,791551127,True,6
1819,validator_43,76575812240,True,615600000,18587170,634187170,False,2
1820,validator_9,197726960060,True,555520000,4097390,559617390,False,6
1821,validator_47,39259386181,True,652920003,10270120,663190123,True,1
1822,validator_3,303556018080,True,679000000,27437800,706437800,False,9
1823,validator_13,112569695103,True,791539995,7846210,799386205,True,3
1824,validator_9,198353383220,True,620200000,6223160,626423160,False,6
1825,validator_63,42480181263,True,609840003,7343200,617183203,True,1
1826,validator_44,35516942759,True,536500000,1939300,538439300,True,1
1827,validator_79,39078536710,True,526100000,1736990,527836990,False,1
1828,validator_16,113721208290,True,648166003,24051990,672217993,True,3
1829,validator_0,317236919340,True,852359997,36066590,888426587,True,9
1830,validator_31,78489270198,True,760400002,43750100,804150102,True,2
1831,validator_19,107792103220,True,492840000,9021380,501861380,False,3
1832,validator_65,37441223925,True,531419999,24771090,556191089,True,1
1833,validator_73,37125078700,True,737800000,2836030,740636030,False,1
1834,validator_1,327533476565,True,641873999,30139700,672013699,True,10
1835,validator_70,36482295749,True,499879998,8643130,508523128,True,1
1836,validator_37,73232647110,True,691200000,2659030,693859030,False,2
1837,validator_32,72648023383,True,711479995,23255430,734735425,True,2
1838,validator_51,37096286861,True,880840002,8148200,888988202,True,1
1839,validator_36,73524489680,True,488200000,1549070,489749070,False,2
1840,validator_39,78222244540,True,441800000,23126400,464926400,False,2
1841,validator_5,196252671020,True,755079999,31513900,786593899,True,6
1842,validator_13,113417169805,True,817800002,29674700,847474702,True,3
1843,validator_9,198820386140,True,459500000,7502920,467002920,False,6
1844,validator_43,77301444060,True,722200000,3431820,725631820,False,2
1845,validator_16,114375559797,True,648320007,6031500,654351507,True,3
1846,validator_1,328401129209,True,845200004,22452640,867652644,True,10
1847,validator_16,115127956727,True,740460000,11936930,752396930,True,3
1848,validator_25,78710479928,True,500039994,4747800,504787794,True,2
1849,validator_23,111571172190,True,557000000,1561010,558561010,False,3
1850,validator_80,37065695520,True,582500000,670910,583170910,False,1
1851,validator_11,194541992760,True,644400000,1248990,645648990,False,6
1852,validator_0,317955998525,True,685440005,33639180,719079185,True,9
1853,validator_36,74229623180,True,702200000,2933500,705133500,False,2
1854,validator_1,328922682751,True,516300002,5253540,521553542,True,10
1855,validator_32,73212367174,True,519839991,44503800,564343791,True,2
1856,validator_33,78201810255,True,823900005,1623160,825523165,True,2
1857,validator_29,74697486031,True,583200002,1917860,585117862,True,2
1858,validator_13,114078560301,True,654299996,7090500,661390496,True,3
1859,validator_2,309611631490,True,643700000,3485000,647185000,False,9
1860,validator_0,318562495101,True,603339996,3156580,606496576,True,9
1861,validator_29,75331675627,True,620920006,13269590,634189596,True,2
1862,validator_7,201614188089,True,567559998,26926450,594486448,True,6
1863,validator_17,113582907621,True,816200000,857800,817057800,True,3
1864,validator_87,38591477150,True,597200000,2749020,599949020,False,1
1865,validator_3,304039475180,True,478840000,4617100,483457100,False,9
1866,validator_16,116150276848,True,986520001,35800120,1022320121,True,3
1867,validator_98,36473541430,True,642100000,3664720,645764720,False,1
1868,validator_88,38062715100,True,520700000,3272100,523972100,False,1
1869,validator_14,115612748909,True,662780002,7302840,670082842,True,3
1870,validator_64,40248114610,True,778099998,20091830,798191828,True,1
1871,validator_87,39117323750,True,525200000,646600,525846600,False,1
1872,validator_49,39101406244,True,793120000,47217070,840337070,True,1
1873,validator_36,74769389960,True,530800000,8966780,539766780,False,2
1874,validator_3,304713895780,True,670600000,3820600,674420600,False,9
1875,validator_2,310292063190,True,671500000,8931700,680431700,False,9
1876,validator_35,74329234060,True,459300000,1841460,461141460,False,2
1877,validator_5,196867430200,True,605880000,8879180,614759180,True,6
1878,validator_6,192665546579,True,884340012,6338980,890678992,True,6
1879,validator_97,39828443410,True,581600000,4915240,586515240,False,1
1880,validator_6,193595897449,True,877700000,52650870,930350870,True,6
1881,validator_7,202172496686,True,549499997,8808600,558308597,True,6
1882,validator_95,35417550670,True,637200000,1399920,638599920,False,1
1883,validator_29,76112086003,True,747259996,33150380,780410376,True,2
1884,validator_2,311007945020,True,713400000,2481830,715881830,False,9
1885,validator_33,78971264452,True,753300007,16154190,769454197,True,2
1886,validator_17,114140742128,True,554399997,3434510,557834507,True,3
1887,validator_18,111078718970,True,587400000,28680900,616080900,False,3
1888,validator_18,111633661090,True,553000000,1942120,554942120,False,3
1889,validator_11,195379660800,True,832900000,4768040,837668040,False,6
1890,validator_36,75353240680,True,579100000,4750720,583850720,False,2
1891,validator_43,77794740360,True,490100000,3196300,493296300,False,2
1892,validator_10,187807051640,True,583100000,1828440,584928440,False,5
1893,validator_38,76006788810,True,672000000,1110670,673110670,False,2
1894,validator_85,35658112960,True,646900000,3116680,650016680,False,1
1895,validator_31,79172639489,True,676940001,6429290,683369291,True,2
1896,validator_47,39864017100,True,600399999,4230920,604630919,True,1
1897,validator_3,305411158750,True,684400000,12862970,697262970,False,9
1898,validator_1,329642405500,True,707721999,12000750,719722749,True,10
1899,validator_73,37701935410,True,574100000,2756710,576856710,False,1
1900,validator_8,185094185990,True,541800000,16867920,558667920,False,5
1901,validator_93,35069946740,True,530200000,19171990,549371990,False,1
1902,validator_4,190503267654,True,636640002,16584040,653224042,True,5
1903,validator_7,202801955389,True,578300003,51158700,629458703,True,6
1904,validator_6,194057778477,True,432779998,29101030,461881028,True,6
1905,validator_6,194766725869,True,696240002,12707390,708947392,True,6
1906,validator_6,195629737969,True,823480000,39532100,863012100,True,6
1907,validator_97,40550812940,True,714800000,7569530,722369530,False,1
1908,validator_1,330529444559,True,861899999,25139060,887039059,True,10
1909,validator_64,41087209864,True,828519994,10575260,839095254,True,1
1910,validator_9,199362996450,True,540600000,2010310,542610310,False,6
1911,validator_17,114833388633,True,656300005,36346500,692646505,True,3
1912,validator_80,37795637810,True,726300000,3642290,729942290,False,1
1913,validator_35,75077178590,True,742300000,5644530,747944530,False,2
1914,validator_71,42572451200,True,615453999,31449180,646903179,True,1
1915,validator_7,203353731559,True,523280000,28496170,551776170,True,6
1916,validator_50,39235237503,True,462019996,21111980,483131976,True,1
1917,validator_9,200146515690,True,780700000,2819240,783519240,False,6
1918,validator_11,195904333700,True,522600000,2072900,524672900,False,6
1919,validator_0,319189672846,True,590420005,36757740,627177745,True,9
1920,validator_57,39022136342,True,534380000,14127680,548507680,True,1
1921,validator_60,38221154398,True,935380003,15829030,951209033,True,1
1922,validator_23,112125842840,True,553200000,1470650,554670650,False,3
1923,validator_3,305883494390,True,470200000,2135640,472335640,False,9
1924,validator_1,331478764851,True,945500002,3820290,949320292,True,10
1925,validator_43,78375773180,True,572100000,8932820,581032820,False,2
1926,validator_67,40932873732,True,737520008,26646270,764166278,True,1
1927,validator_4,191319295222,True,813799998,2227570,816027568,True,5
1928,validator_1,332223076659,True,706999998,37311810,744311808,True,10
1929,validator_14,116495791154,True,839620005,43422240,883042245,True,3
1930,validator_56,40337863319,True,682099998,24267640,706367638,True,1
1931,validator_1,332740442458,True,516399999,965800,517365799,True,10
1932,validator_9,200707158100,True,556300000,4342410,560642410,False,6
1933,validator_96,38519089310,True,710100000,3496100,713596100,False,1
1934,validator_66,41218449554,True,863759991,27519420,891279411,True,1
1935,validator_31,79890234622,True,698800003,18795130,717595133,True,2
1936,validator_1,333539364047,True,766703989,32217600,798921589,True,10
1937,validator_32,74028268204,True,790900000,25001030,815901030,True,2
1938,validator_32,74680765532,True,623499998,28997330,652497328,True,2
1939,validator_3,306344536030,True,455800000,5241640,461041640,False,9
1940,validator_13,114792456871,True,700340000,13556570,713896570,True,3
1941,validator_57,39804307210,True,756459998,25710870,782170868,True,1
1942,validator_3,306912709380,True,554500000,13673350,568173350,False,9
1943,validator_27,72590119134,True,570054004,31509540,601563544,True,2
1944,validator_0,319954879557,True,758700001,6506710,765206711,True,9
1945,validator_2,311598724200,True,570000000,20779180,590779180,False,9
1946,validator_14,116866934356,True,351088002,20055200,371143202,True,3
1947,validator_0,320713566059,True,742468002,16218500,758686502,True,10
1948,validator_16,116876388660,True,686180002,39931810,726111812,True,3
1949,validator_11,196407340900,True,501200000,1807200,503007200,False,6
1950,validator_3,307693075980,True,779200000,1166600,780366600,False,9
1951,validator_13,115396158972,True,594620001,9082100,603702101,True,3
1952,validator_8,185864146250,True,767800000,2160260,769960260,False,5
1953,validator_11,197104271400,True,694200000,2730500,696930500,False,6
1954,validator_15,116097053814,True,598419999,44314870,642734869,True,3
1955,validator_75,36579840360,True,587400000,2627480,590027480,False,1
1956,validator_6,196293339470,True,615796001,47805500,663601501,True,6
1957,validator_1,334365377975,True,805639998,20373930,826013928,True,10
1958,validator_27,73216186521,True,619039997,7027390,626067387,True,2
1959,validator_43,79301950100,True,917100000,9076920,926176920,False,2
1960,validator_41,75633195800,True,522300000,21910200,544210200,False,2
1961,validator_49,39814352345,True,688540001,24406100,712946101,True,1
1962,validator_31,80435977721,True,536667999,9075100,545743099,True,2
1963,validator_9,201410719160,True,702300000,1261060,703561060,False,6
1964,validator_4,192082894352,True,761500000,2099130,763599130,True,6
1965,validator_50,40026314185,True,755604002,35472680,791076682,True,1
1966,validator_8,186638840550,True,727900000,46794300,774694300,False,5
1967,validator_32,75451983428,True,762699996,8517900,771217896,True,2
1968,validator_25,79185964054,True,472599996,2884130,475484126,True,2
1969,validator_88,38631570930,True,559470000,9385830,568855830,False,1
1970,validator_12,112399727589,True,728679992,38114380,766794372,True,3
1971,validator_22,111668700740,True,550400000,21523100,571923100,False,3
1972,validator_17,115695644769,True,858100006,4156130,862256136,True,3
1973,validator_24,72131947211,True,615920000,4197900,620117900,True,2
1974,validator_0,321481572766,True,741700007,26306700,768006707,True,10
1975,validator_2,312305111480,True,687200000,19187280,706387280,False,9
1976,validator_5,197388792339,True,511659999,9702140,521362139,True,6
1977,validator_10,188275876440,True,467300000,1524800,468824800,False,5
1978,validator_8,187371053270,True,726700000,5512720,732212720,False,5
1979,validator_79,39573973770,True,474900000,20537060,495437060,False,1
1980,validator_22,112274237720,True,602600000,2936980,605536980,False,3
1981,validator_2,312995640610,True,688600000,1929130,690529130,False,9
1982,validator_1,335264739880,True,872900005,26461900,899361905,True,10
1983,validator_0,322351366866,True,858400000,11394100,869794100,True,10
1984,validator_7,204316977739,True,961700000,1546180,963246180,True,6
1985,validator_14,117624460385,True,756399999,1126030,757526029,True,3
1986,validator_24,72828070071,True,679520000,16602860,696122860,True,2
1987,validator_26,72446625062,True,571179998,5170900,576350898,True,2
1988,validator_16,117498246742,True,583188002,38670080,621858082,True,3
1989,validator_11,197737996730,True,631700000,2025330,633725330,False,6
1990,validator_0,323217779311,True,803460005,62952440,866412445,True,10
1991,validator_1,335739914337,True,454840007,20334450,475174457,True,10
1992,validator_37,73828489810,True,593000000,2842700,595842700,False,2
1993,validator_24,73877776366,True,1030879995,18826300,1049706295,True,2
1994,validator_84,36972116370,True,679400000,9029820,688429820,False,1
1995,validator_6,196888889491,True,558626001,36924020,595550021,True,6
1996,validator_1,336420779934,True,674799997,6065600,680865597,True,10
1997,validator_32,76011675555,True,556900007,2792120,559692127,True,2
1998,validator_7,205000424744,True,681300005,2147000,683447005,True,6
1999,validator_3,308319142200,True,623500000,2566220,626066220,False,9
2000,validator_95,36202425720,True,761200000,23675050,784875050,False,1
2001,validator_57,40630542812,True,806600002,19635600,826235602,True,1
2002,validator_41,76158990250,True,522900000,2894450,525794450,False,2
2003,validator_45,40986339007,True,570220001,40835570,611055571,True,1
2004,validator_7,205770872440,True,741919996,28527700,770447696,True,6
2005,validator_41,76697776950,True,537100000,1686700,538786700,False,2
2006,validator_18,112432727350,True,797200000,1866260,799066260,False,3
2007,validator_0,323974939243,True,753700002,3459930,757159932,True,10
2008,validator_0,324534962786,True,531979993,28043550,560023543,True,10
2009,validator_8,188044646970,True,671800000,1793700,673593700,False,5
2010,validator_9,202072147560,True,659500000,1928400,661428400,False,6
2011,validator_29,76876092225,True,694419992,69586230,764006222,True,2
2012,validator_0,325130438885,True,566919999,28556100,595476099,True,10
2013,validator_43,79897934670,True,586200000,9784570,595984570,False,2
2014,validator_10,188960252440,True,683100000,1276000,684376000,False,5
2015,validator_2,313455822100,True,450700000,9481490,460181490,False,9
2016,validator_57,41565147949,True,922899997,11705140,934605137,True,1
2017,validator_15,116998216852,True,885757998,15405040,901163038,True,3
2018,validator_1,337122444336,True,685900002,15764400,701664402,True,10
2019,validator_1,337847328268,True,685404002,39479930,724883932,True,10
2020,validator_98,37124782610,True,639600000,11641180,651241180,False,1
2021,validator_21,115453604500,True,546500000,9946440,556446440,False,3
2022,validator_62,37942468197,True,943580005,38532840,982112845,True,1
2023,validator_67,41937795727,True,987299995,17622000,1004921995,True,1
2024,validator_43,80496586000,True,552270000,46381330,598651330,False,2
2025,validator_96,39179905080,True,653100000,7715770,660815770,False,1
2026,validator_21,115968165630,True,490100000,24461130,514561130,False,3
2027,validator_16,118214613287,True,700700005,15666540,716366545,True,3
2028,validator_0,325874720246,True,722160001,22121360,744281361,True,10
2029,validator_45,41421850218,True,412400001,23111210,435511211,True,1
2030,validator_5,198208926521,True,806680002,13454180,820134182,True,6
2031,validator_25,79940171696,True,713140002,41067640,754207642,True,2
2032,validator_8,188746500470,True,692900000,8953500,701853500,False,5
2033,validator_14,118269914284,True,621519999,23933900,645453899,True,3
2034,validator_38,76602685010,True,595200000,696200,595896200,False,2
2035,validator_53,36000939962,True,569840003,28041980,597881983,True,1
2036,validator_3,308844171590,True,505000000,20029390,525029390,False,9
2037,validator_22,113095204620,True,810000000,10966900,820966900,False,3
2038,validator_11,198279561710,True,539500000,2064980,541564980,False,6
2039,validator_13,116149165016,True,728696004,24310040,753006044,True,3
2040,validator_2,313944606180,True,487400000,1384080,488784080,False,9
2041,validator_96,39708737260,True,527400000,1432180,528832180,False,1
2042,validator_39,78786065840,True,561400000,2421300,563821300,False,2
2043,validator_58,40857640909,True,648959996,11603430,660563426,True,1
2044,validator_3,309470938410,True,606700000,20066820,626766820,False,9
2045,validator_6,197643152863,True,753099992,1163380,754263372,True,6
2046,validator_60,38897655611,True,664960003,11541210,676501213,True,1
2047,validator_33,79779866981,True,805359999,3242530,808602529,True,2
2048,validator_24,74492384947,True,606540001,8068580,614608581,True,2
2049,validator_17,116357792697,True,658799998,3347930,662147928,True,3
2050,validator_0,326483994649,True,588920003,20354400,609274403,True,10
2051,validator_90,36770776690,True,608500000,8793560,617293560,False,1
2052,validator_7,206568920338,True,782239998,15807900,798047898,True,6
2053,validator_8,189427331810,True,679700000,1131340,680831340,False,5
2054,validator_4,192570978489,True,485799997,2284140,488084137,True,6
2055,validator_1,338491747266,True,623487998,20931000,644418998,True,10
2056,validator_7,207415932758,True,828040010,18972410,847012420,True,6
2057,validator_4,193287234874,True,691640005,24616380,716256385,True,6
2058,validator_5,198945265726,True,735700005,639200,736339205,True,6
2059,validator_24,75211805441,True,698239994,21180500,719420494,True,2
2060,validator_39,79395251930,True,603900000,5286090,609186090,False,2
2061,validator_17,117150026603,True,749960006,42273900,792233906,True,3
2062,validator_1,339117004994,True,575439998,49817730,625257728,True,10
2063,validator_19,108289040650,True,487500000,9437430,496937430,False,3
2064,validator_13,116733785213,True,571219997,13400200,584620197,True,3
2065,validator_72,36710293740,True,624300000,1984990,626284990,False,1
2066,validator_17,117583675941,True,402688008,30961330,433649338,True,3
2067,validator_10,189716552020,True,728100000,28199580,756299580,False,5
2068,validator_22,113534315400,True,437500000,1610780,439110780,False,3
2069,validator_1,339727583810,True,602739996,7838820,610578816,True,10
2070,validator_1,340424625946,True,677759996,19282140,697042136,True,10
2071,validator_52,38943060665,True,543800008,28058930,571858938,True,1
2072,validator_22,114180342170,True,643900000,2126770,646026770,False,3
2073,validator_5,199870813128,True,916540002,9007400,925547402,True,6
2074,validator_82,37701198140,True,606300000,2756200,609056200,False,1
2075,validator_57,42301396541,True,723908002,12340590,736248592,True,1
2076,validator_84,37679473220,True,704500000,2856850,707356850,False,1
2077,validator_1,340913754848,True,479140002,9988900,489128902,True,10
2078,validator_10,190362565050,True,617000000,29013030,646013030,False,5
2079,validator_9,202607343780,True,532170000,3026220,535196220,False,6
2080,validator_24,75817489215,True,595279994,10403780,605683774,True,2
2081,validator_14,118797317513,True,506199999,21203230,527403229,True,3
2082,validator_9,203241189560,True,632200000,1645780,633845780,False,6
2083,validator_14,119435428800,True,628796007,9315280,638111287,True,3
2084,validator_13,117729629809,True,925880006,69964590,995844596,True,3
2085,validator_34,76666457840,True,666200000,6822630,673022630,False,2
2086,validator_3,310303344910,True,824400000,8006500,832406500,False,9
2087,validator_11,199031694110,True,742600000,9532400,752132400,False,6
2088,validator_34,77143309540,True,456200000,20651700,476851700,False,2
2089,validator_52,39822220465,True,870240000,8919800,879159800,True,1
2090,validator_52,40504588566,True,644280001,38088100,682368101,True,1
2091,validator_30,79367110818,True,856000001,56365630,912365631,True,2
2092,validator_59,37303769674,True,795980004,58220220,854200224,True,1
2093,validator_47,40645127000,True,768374000,12735900,781109900,True,1
2094,validator_5,200321735716,True,418179998,32742590,450922588,True,6
2095,validator_66,41860469353,True,624819999,17199800,642019799,True,1
2096,validator_3,311065822610,True,742200000,20277700,762477700,False,9
2097,validator_29,77376058821,True,492559996,7406600,499966596,True,2
2098,validator_1,341751865680,True,836100002,2010830,838110832,True,10
2099,validator_18,112859512880,True,425400000,1385530,426785530,False,3
2100,validator_14,120184343898,True,725999998,22915100,748915098,True,3
2101,validator_3,311664326910,True,595500000,3004300,598504300,False,9
2102,validator_4,194138036280,True,816160006,34641400,850801406,True,6
2103,validator_21,116586025530,True,597600000,20259900,617859900,False,3
2104,validator_92,33932593600,True,549000000,21674730,570674730,False,1
2105,validator_38,77116516480,True,503900000,9931470,513831470,False,2
2106,validator_54,36862029914,True,777000005,3141530,780141535,True,1
2107,validator_2,314423675280,True,476100000,2969100,479069100,False,9
2108,validator_62,38876121218,True,923280001,10373020,933653021,True,1
2109,validator_11,199715494130,True,682100000,1700020,683800020,False,6
2110,validator_64,41947941766,True,824780002,35951900,860731902,True,1
2111,validator_17,118392323366,True,797719995,10927430,808647425,True,3
2112,validator_2,315130339280,True,702200000,4464000,706664000,False,9
2113,validator_29,78157896923,True,751120002,30718100,781838102,True,2
2114,validator_2,315625541720,True,493580000,1622440,495202440,False,9
2115,validator_27,73956076156,True,696766005,43123630,739889635,True,2
2116,validator_3,312360141250,True,692900000,2914340,695814340,False,9
2117,validator_3,313023159810,True,643000000,20018560,663018560,False,9
2118,validator_68,36122513736,True,531799997,5912300,537712297,True,1
2119,validator_88,39197601820,True,545000000,21030890,566030890,False,1
2120,validator_14,120940765597,True,749499999,6921700,756421699,True,3
2121,validator_48,38415896748,True,782839999,10885600,793725599,True,1
2122,validator_17,119133570827,True,714400001,26847460,741247461,True,3
2123,validator_25,80732007528,True,755500002,36335830,791835832,True,2
2124,validator_31,81166489651,True,724666000,5845930,730511930,True,2
2125,validator_1,342596041380,True,828200000,15975700,844175700,True,10
2126,validator_8,190024985500,True,593900000,3753690,597653690,False,5
2127,validator_0,327024789845,True,517365996,23429200,540795196,True,10
2128,validator_10,190845214980,True,480300000,2349930,482649930,False,5
2129,validator_1,343502288285,True,891300005,14946900,906246905,True,10
2130,validator_1,344367551869,True,857939994,7323590,865263584,True,10
2131,validator_43,80988587160,True,454900000,37101160,492001160,False,2
2132,validator_18,113557079380,True,691000000,6566500,697566500,False,3
2133,validator_55,37399933968,True,752851999,21698140,774550139,True,1
2134,validator_34,77637625420,True,477900000,16415880,494315880,False,2
2135,validator_13,118213228023,True,476940004,6658210,483598214,True,3
2136,validator_73,38111593610,True,400670000,8988200,409658200,False,1
2137,validator_48,39293479525,True,855500007,22082770,877582777,True,1
2138,validator_42,75405933160,True,639400000,9558710,648958710,False,2
2139,validator_24,76512835690,True,687099995,8246480,695346475,True,2
2140,validator_8,190478936460,True,452200000,1750960,453950960,False,5
2141,validator_11,200184665760,True,466600000,2571630,469171630,False,6
2142,validator_63,43055480729,True,541741996,33557470,575299466,True,1
2143,validator_17,119807481834,True,626103997,47807010,673911007,True,3
2144,validator_10,191576224760,True,729100000,1909780,731009780,False,5
2145,validator_15,117735493616,True,731100004,6176760,737276764,True,3
2146,validator_56,41208812038,True,821639999,49308720,870948719,True,1
2147,validator_36,76257932760,True,884200000,20492080,904692080,False,2
2148,validator_97,41216976120,True,659200000,6963180,666163180,False,1
2149,validator_3,313720581530,True,695300000,2121720,697421720,False,9
2150,validator_3,314264155740,True,537500000,6074210,543574210,False,9
2151,validator_4,194996156255,True,809119995,48999980,858119975,True,6
2152,validator_2,316391283450,True,763400000,2341730,765741730,False,9
2153,validator_8,191137335090,True,638600000,19798630,658398630,False,5
2154,validator_5,201002570986,True,655839990,24995280,680835270,True,6
2155,validator_0,327878393525,True,828400000,25203680,853603680,True,10
2156,validator_21,117166516100,True,577100000,3390570,580490570,False,3
2157,validator_38,77816813090,True,697700000,2596610,700296610,False,2
2158,validator_8,191814156700,True,673400000,3421610,676821610,False,5
2159,validator_31,81706285493,True,538700002,1095840,539795842,True,2
2160,validator_5,201683917020,True,640300004,41046030,681346034,True,6
2161,validator_29,79035487708,True,813639995,63950790,877590785,True,2
2162,validator_14,121601298674,True,635759997,24773080,660533077,True,3
2163,validator_21,117910484680,True,742200000,1768580,743968580,False,3
2164,validator_33,80407290076,True,616103995,11319100,627423095,True,2
2165,validator_57,43096454943,True,748540002,46518400,795058402,True,1
2166,validator_28,74230883522,True,707240003,16131230,723371233,True,2
2167,validator_7,208297059985,True,870499997,10627230,881127227,True,6
2168,validator_28,74948510042,True,691970000,25656520,717626520,True,2
2169,validator_12,113079323952,True,647080003,32516360,679596363,True,3
2170,validator_15,118246897021,True,502040005,9363400,511403405,True,3
2171,validator_21,118447325080,True,516600000,20240400,536840400,False,3
2172,validator_1,344833031767,True,459509998,5969900,465479898,True,10
2173,validator_33,81210569011,True,765299995,37978940,803278935,True,2
2174,validator_9,203827512440,True,576800000,9522880,586322880,False,6
2175,validator_15,118918734249,True,615180008,56657220,671837228,True,3
2176,validator_21,119056468580,True,598000000,11143500,609143500,False,3
2177,validator_40,72945901410,True,604800000,23622850,628422850,False,2
2178,validator_18,114136168360,True,557700000,21388980,579088980,False,3
2179,validator_30,80096947711,True,728900003,936890,729836893,True,2
2180,validator_29,79683606345,True,639339997,8778640,648118637,True,2
2181,validator_7,208905092228,True,576239993,31792250,608032243,True,6
2182,validator_75,37244796200,True,644500000,20455840,664955840,False,1
2183,validator_3,314835565970,True,541400000,30010230,571410230,False,9
2184,validator_28,75405315067,True,449400005,7405020,456805025,True,2
2185,validator_18,114785661090,True,647300000,2192730,649492730,False,3
2186,validator_29,80388450276,True,691100001,13743930,704843931,True,2
2187,validator_8,192508996320,True,689200000,5639620,694839620,False,6
2188,validator_25,81332944150,True,583100002,17836620,600936622,True,2
2189,validator_8,193125889070,True,616130000,762750,616892750,False,6
2190,validator_28,76367145594,True,946386007,15444520,961830527,True,2
2191,validator_72,37325719640,True,612300000,3125900,615425900,False,1
2192,validator_2,316773518980,True,377100000,5135530,382235530,False,9
2193,validator_58,41636799550,True,777300001,1858640,779158641,True,1
2194,validator_1,345480981565,True,609917998,38031800,647949798,True,10
2195,validator_28,76984759596,True,577780002,39834000,617614002,True,2
2196,validator_36,76869397460,True,610200000,1264700,611464700,False,2
2197,validator_33,81835865009,True,600473998,24822000,625295998,True,2
2198,validator_7,209629866202,True,721620004,3153970,724773974,True,6
2199,validator_14,122109434012,True,501099998,7035340,508135338,True,3
2200,validator_84,38152098260,True,465000000,7625040,472625040,False,1
2201,validator_6,198491936657,True,727963994,120819800,848783794,True,6
2202,validator_40,73483885020,True,518000000,19983610,537983610,False,2
2203,validator_60,39500836544,True,589958003,13222930,603180933,True,1
2204,validator_27,74424685896,True,466320000,2289740,468609740,True,2
2205,validator_88,39690520300,True,490400000,2518480,492918480,False,1
2206,validator_2,317396792030,True,621100000,2173050,623273050,False,9
2207,validator_0,328555000415,True,648300000,28306890,676606890,True,10
2208,validator_83,37702168820,True,523400000,13037480,536437480,False,1
2209,validator_22,114920184690,True,735600000,4242520,739842520,False,3
2210,validator_83,38437381000,True,713800000,21412180,735212180,False,1
2211,validator_62,39549802021,True,649580003,24100800,673680803,True,1
2212,validator_6,199227912743,True,703089996,32886090,735976086,True,6
2213,validator_94,37054520570,True,611200000,1323260,612523260,False,1
2214,validator_77,37391402590,True,533400000,29118940,562518940,False,1
2215,validator_43,81547254160,True,554100000,4567000,558667000,False,2
2216,validator_7,210338032028,True,669633996,38531830,708165826,True,6
2217,validator_61,39602002342,True,567499993,44206430,611706423,True,1
2218,validator_13,118933847716,True,672179993,48439700,720619693,True,3
2219,validator_18,115300386010,True,511400000,3324920,514724920,False,3
2220,validator_85,36357121680,True,688000000,11008720,699008720,False,1
2221,validator_62,40298696008,True,739800007,9093980,748893987,True,1
2222,validator_2,318012712630,True,608930000,6990600,615920600,False,9
2223,validator_7,211024792258,True,630286000,56474230,686760230,True,6
2224,validator_80,38253969390,True,453600000,4731580,458331580,False,1
2225,validator_6,199938531089,True,682320006,28298340,710618346,True,6
2226,validator_90,37509809820,True,738400000,633130,739033130,False,1
2227,validator_0,329270257241,True,694159996,21096830,715256826,True,10
2228,validator_60,40134523483,True,619359999,14326940,633686939,True,1
2229,validator_21,119577093080,True,517500000,3124500,520624500,False,3
2230,validator_3,315431559970,True,587700000,8294000,595994000,False,9
2231,validator_4,195558096156,True,540254001,21685900,561939901,True,6
2232,validator_0,329747670136,True,456405995,21006900,477412895,True,10
2233,validator_18,115868549900,True,563400000,4763890,568163890,False,3
2234,validator_23,112612619540,True,458800000,27976700,486776700,False,3
2235,validator_53,36652500420,True,632340008,19220450,651560458,True,1
2236,validator_36,77537125790,True,665300000,2428330,667728330,False,2
2237,validator_5,202420613792,True,720720002,15976770,736696772,True,6
2238,validator_0,330478046805,True,716799999,13576670,730376669,True,10
2239,validator_5,203201596567,True,748019995,32962780,780982775,True,6
2240,validator_0,331044428702,True,548479997,17901900,566381897,True,10
2241,validator_86,37420567840,True,767300000,2755620,770055620,False,1
2242,validator_23,113495479840,True,879600000,3260300,882860300,False,3
2243,validator_5,204175295213,True,936620006,37078640,973698646,True,6
2244,validator_34,78171656700,True,532600000,1431280,534031280,False,2
2245,validator_10,192318067640,True,739400000,2442880,741842880,False,6
2246,validator_56,42158564202,True,944558004,5194160,949752164,True,1
2247,validator_30,80945239825,True,815261994,33030120,848292114,True,2
2248,validator_0,331572948038,True,490399996,38119340,528519336,True,10
2249,validator_79,40519888490,True,944400000,1514720,945914720,False,1
2250,validator_61,40470037942,True,832660000,35375600,868035600,True,1
2251,validator_13,119571938612,True,578547996,59542900,638090896,True,3
2252,validator_15,119423656645,True,485600006,19322390,504922396,True,3
2253,validator_97,41791713660,True,572200000,2537540,574737540,False,1
2254,validator_2,318614233230,True,597500000,4020600,601520600,False,9
2255,validator_47,41354052901,True,688720001,20205900,708925901,True,1
2256,validator_2,319127009950,True,506300000,6476720,512776720,False,9
2257,validator_43,82184842490,True,631400000,6188330,637588330,False,2
2258,validator_25,82117869898,True,773140008,11785740,784925748,True,2
2259,validator_23,114049117140,True,547500000,6137300,553637300,False,3
2260,validator_20,113515996170,True,525200000,1686640,526886640,False,3
2261,validator_18,116498541560,True,628000000,1991660,629991660,False,3
2262,validator_0,332146087658,True,553500000,19639620,573139620,True,10
2263,validator_14,122659759644,True,506098002,44227630,550325632,True,3
2264,validator_38,78493504330,True,673700000,2991240,676691240,False,2
2265,validator_8,193657818970,True,529500000,2429900,531929900,False,6
2266,validator_72,37847192080,True,512700000,8772440,521472440,False,1
2267,validator_6,200526659015,True,579099996,9027930,588127926,True,6
2268,validator_70,37186450002,True,680274003,23880250,704154253,True,1
2269,validator_4,196220802560,True,636820004,25886400,662706404,True,6
2270,validator_93,35867703140,True,774500000,23256400,797756400,False,1
2271,validator_48,39952021826,True,642620001,15922300,658542301,True,1
2272,validator_10,192991357780,True,668000000,5290140,673290140,False,6
2273,validator_11,200673050050,True,483500000,4884290,488384290,False,6
2274,validator_48,40447695451,True,486700005,8973620,495673625,True,1
2275,validator_31,82405836719,True,696500006,3051220,699551226,True,2
2276,validator_4,196779668786,True,519739996,39126230,558866226,True,6
2277,validator_11,201309551570,True,635100000,1401520,636501520,False,6
2278,validator_7,211867028691,True,839700003,2536430,842236433,True,6
2279,validator_87,39751447480,True,632500000,1623730,634123730,False,1
2280,validator_41,77369643520,True,670000000,1866570,671866570,False,2
2281,validator_66,42429419905,True,560979992,7970560,568950552,True,1
2282,validator_15,120048390869,True,592069994,32664230,624734224,True,3
2283,validator_29,81091839610,True,683100004,20289330,703389334,True,2
2284,validator_3,316045512850,True,593400000,20552880,613952880,False,9
2285,validator_12,113703059001,True,614239999,9495050,623735049,True,3
2286,validator_33,82547305551,True,697200002,14240540,711440542,True,2
2287,validator_53,37313035238,True,656299998,4234820,660534818,True,1
2288,validator_20,114186843900,True,662500000,8347730,670847730,False,3
2289,validator_0,332935614437,True,785599999,3926780,789526779,True,10
2290,validator_68,36824892116,True,673360000,29018380,702378380,True,1
2291,validator_32,76779317487,True,743000002,24641930,767641932,True,2
2292,validator_66,43030770404,True,573799999,27550500,601350499,True,1
2293,validator_30,81598747628,True,651600003,1907800,653507803,True,2
2294,validator_10,193627308830,True,615000000,20951050,635951050,False,6
2295,validator_2,319878047650,True,747000000,4037700,751037700,False,9
2296,validator_11,201821203640,True,510300000,1352070,511652070,False,6
2297,validator_3,316586365540,True,538400000,2452690,540852690,False,9
2298,validator_0,333563205426,True,601419999,26170990,627590989,True,10
2299,validator_13,120299686844,True,702200002,25548230,727748232,True,3
2300,validator_97,42449615620,True,648700000,9201960,657901960,False,1
2301,validator_28,77807918294,True,812179998,10978700,823158698,True,2
2302,validator_91,37527612150,True,584000000,15580130,599580130,False,1
2303,validator_10,194450695070,True,821200000,2186240,823386240,False,6
2304,validator_9,204490345570,True,661000000,1833130,662833130,False,6
2305,validator_8,194310156170,True,651500000,837200,652337200,False,6
2306,validator_9,205058138890,True,560300000,7493320,567793320,False,6
2307,validator_0,334467535617,True,902599991,1730200,904330191,True,10
2308,validator_41,77996129410,True,624400000,2085890,626485890,False,2
2309,validator_14,123284568785,True,601740001,23069140,624809141,True,3
2310,validator_42,76061709630,True,653000000,2776470,655776470,False,2
2311,validator_33,83157571134,True,596440003,13825580,610265583,True,2
2312,validator_5,204874968151,True,683299998,16372940,699672938,True,6
2313,validator_0,335168783618,True,699900001,1348000,701248001,True,10
2314,validator_11,202511601160,True,664100000,26297520,690397520,False,6
2315,validator_40,74157018190,True,671600000,1533170,673133170,False,2
2316,validator_7,212487369226,True,593153995,27186540,620340535,True,6
2317,validator_3,317077808320,True,488900000,2542780,491442780,False,9
2318,validator_9,205488678660,True,420300000,10239770,430539770,False,6
2319,validator_64,42536144181,True,584599995,3602420,588202415,True,1
2320,validator_54,37474254686,True,591259992,20964780,612224772,True,1
2321,validator_13,120992469634,True,682460000,10322790,692782790,True,3
2322,validator_10,195154437620,True,697100000,6642550,703742550,False,6
2323,validator_28,78618994259,True,808499995,2575970,811075965,True,2
2324,validator_7,213228479368,True,717154002,23956140,741110142,True,6
2325,validator_63,43703228728,True,640339999,7408000,647747999,True,1
2326,validator_3,317671137160,True,590200000,3128840,593328840,False,9
2327,validator_0,335887236403,True,709239995,9212790,718452785,True,10
2328,validator_1,346214997867,True,726800002,7216300,734016302,True,10
2329,validator_10,195628032520,True,469200000,4394900,473594900,False,6
2330,validator_28,79241361238,True,607040009,15326970,622366979,True,2
2331,validator_24,77306179868,True,750339998,43004180,793344178,True,2
2332,validator_7,214092307425,True,855479997,8348060,863828057,True,6
2333,validator_19,108913012060,True,622200000,1771410,623971410,False,3
2334,validator_19,109434006320,True,517000000,3994260,520994260,False,3
2335,validator_24,78191683684,True,858039996,27463820,885503816,True,2
2336,validator_14,124107851265,True,796710000,26572480,823282480,True,3
2337,validator_37,74303806580,True,473700000,1616770,475316770,False,2
2338,validator_3,318379918580,True,705400000,3381420,708781420,False,9
2339,validator_30,82452869333,True,833220005,20901700,854121705,True,2
2340,validator_30,83084478422,True,601679999,29929090,631609089,True,2
2341,validator_40,74731737810,True,554600000,20119620,574719620,False,2
2342,validator_4,197202254452,True,373489996,49095670,422585666,True,6
2343,validator_2,320464936450,True,567800000,19088800,586888800,False,10
2344,validator_22,115519775230,True,586500000,13090540,599590540,False,3
2345,validator_38,79188355550,True,674500000,20351220,694851220,False,2
2346,validator_7,214661136066,True,549000001,19828640,568828641,True,6
2347,validator_11,203019688460,True,501900000,6187300,508087300,False,6
2348,validator_81,36702116220,True,621300000,5011900,626311900,False,1
2349,validator_8,194983585950,True,670400000,3029780,673429780,False,6
2350,validator_78,35465024480,True,643500000,19950440,663450440,False,1
2351,validator_95,36744401550,True,539600000,2375830,541975830,False,1
2352,validator_44,36094923600,True,527796001,50184840,577980841,True,1
2353,validator_51,37738013650,True,617457999,24268790,641726789,True,1
2354,validator_10,196260857890,True,630300000,2525370,632825370,False,6
2355,validator_79,41347319520,True,820300000,7131030,827431030,False,1
2356,validator_81,37356228310,True,647000000,7112090,654112090,False,1
2357,validator_50,40608884847,True,544840002,37730660,582570662,True,1
2358,validator_8,195527126890,True,536700000,6840940,543540940,False,6
2359,validator_50,41248795037,True,612640000,27270190,639910190,True,1
2360,validator_15,120761386526,True,687999997,24995660,712995657,True,3
2361,validator_0,336368480284,True,471940001,9303880,481243881,True,10
2362,validator_32,77558186923,True,754779996,24089440,778869436,True,2
2363,validator_10,196851453580,True,586100000,4495690,590595690,False,6
2364,validator_23,114665815990,True,613900000,2798850,616698850,False,3
2365,validator_2,321220738820,True,749100000,6702370,755802370,False,10
2366,validator_10,197535182970,True,673300000,10429390,683729390,False,6
2367,validator_25,83134088501,True,973820003,42398600,1016218603,True,2
2368,validator_96,40238817700,True,527900000,2180440,530080440,False,1
2369,validator_8,196180650920,True,624300000,29224030,653524030,False,6
2370,validator_16,119010677087,True,762040000,34023800,796063800,True,3
2371,validator_41,78935665190,True,938500000,1035780,939535780,False,2
2372,validator_41,79552879360,True,606300000,10914170,617214170,False,2
2373,validator_77,37825190890,True,431600000,2188300,433788300,False,1
2374,validator_29,81810695909,True,694699999,24156300,718856299,True,2
2375,validator_2,321887975360,True,662000000,5236540,667236540,False,10
2376,validator_4,197686523332,True,473700000,10568880,484268880,True,6
2377,validator_27,75039615062,True,613599996,1329170,614929166,True,2
2378,validator_19,110271185420,True,798800000,38379100,837179100,False,3
2379,validator_0,337253772681,True,856757997,28534400,885292397,True,10
2380,validator_35,75658480110,True,579200000,2101520,581301520,False,2
2381,validator_1,347017574291,True,783200004,19376420,802576424,True,10
2382,validator_15,121370383532,True,581700006,27297000,608997006,True,3
2383,validator_7,215497224989,True,803719993,32368930,836088923,True,6
2384,validator_24,78917419627,True,707800003,17935940,725735943,True,2
2385,validator_26,73118399393,True,666400001,5374330,671774331,True,2
2386,validator_2,322350803250,True,459500000,3327890,462827890,False,10
2387,validator_2,322935336050,True,577300000,7232800,584532800,False,10
2388,validator_17,120549710554,True,731620000,10608720,742228720,True,3
2389,validator_24,79733831370,True,808620003,7791740,816411743,True,2
2390,validator_58,42589681896,True,913620006,39262340,952882346,True,1
2391,validator_9,206011163170,True,518700000,3784510,522484510,False,6
2392,validator_4,198498373331,True,781879999,29970000,811849999,True,6
2393,validator_75,37902798340,True,656200000,1802140,658002140,False,1
2394,validator_10,198026825690,True,447600000,44042720,491642720,False,6
2395,validator_3,318881533300,True,477000000,24614720,501614720,False,9
2396,validator_75,38615813440,True,709300000,3715100,713015100,False,1
2397,validator_68,37540898649,True,707200003,8806530,716006533,True,1
2398,validator_36,78183208760,True,643900000,2182970,646082970,False,2
2399,validator_10,198668869980,True,624000000,18044290,642044290,False,6
2400,validator_78,36092972400,True,626200000,1747920,627947920,False,1
2401,validator_93,36350093540,True,479900000,2490400,482390400,False,1
2402,validator_1,347680485292,True,658620001,4291000,662911001,True,10
2403,validator_34,78704340000,True,522900000,9783300,532683300,False,2
2404,validator_93,36971524260,True,609200000,12230720,621430720,False,1
2405,validator_82,38246364670,True,541600000,3566530,545166530,False,1
2406,validator_9,206593793870,True,577500000,5130700,582630700,False,6
2407,validator_37,74808459600,True,494300000,10353020,504653020,False,2
2408,validator_0,338093730401,True,829995990,9961730,839957720,True,10
2409,validator_2,323377457310,True,426970000,15151260,442121260,False,10
2410,validator_32,78196693925,True,591386002,47121000,638507002,True,2
2411,validator_9,207163384500,True,558000000,11590630,569590630,False,6
2412,validator_1,348153680333,True,452500001,20695040,473195041,True,10
2413,validator_49,40734961644,True,897713999,22895300,920609299,True,1
2414,validator_6,201183528618,True,650660003,6209600,656869603,True,6
2415,validator_46,39169726949,True,526706002,19829540,546535542,True,1
2416,validator_5,205742524507,True,826459996,41096360,867556356,True,6
2417,validator_11,203735794390,True,714700000,1405930,716105930,False,6
2418,validator_11,204282734520,True,544200000,2740130,546940130,False,6
2419,validator_2,323898192970,True,514000000,6735660,520735660,False,10
2420,validator_12,114458246298,True,733939997,21247300,755187297,True,3
2421,validator_23,115159574490,True,479000000,14758500,493758500,False,3
2422,validator_9,207715878000,True,544700000,7793500,552493500,False,6
2423,validator_49,41252642583,True,466079999,51600940,517680939,True,1
2424,validator_7,216427246904,True,926300005,3721910,930021915,True,6
2425,validator_28,80033600633,True,771659995,20579400,792239395,True,2
2426,validator_25,83749395599,True,570819998,44487100,615307098,True,2
2427,validator_25,84432938864,True,679100005,4443260,683543265,True,2
2428,validator_7,216911745276,True,476453992,8044380,484498372,True,6
2429,validator_83,39089605300,True,643900000,8324300,652224300,False,1
2430,validator_1,348984400631,True,823439998,7280300,830720298,True,10
2431,validator_60,41021249598,True,870239995,16486120,886726115,True,1
2432,validator_0,338497895925,True,387039994,17125530,404165524,True,10
2433,validator_15,121890485436,True,490740004,29361900,520101904,True,3
2434,validator_10,199437825410,True,757100000,11855430,768955430,False,6
2435,validator_94,37909741570,True,843900000,11321000,855221000,False,1
2436,validator_1,349660342127,True,616359996,59581500,675941496,True,10
2437,validator_19,110922321620,True,649300000,1836200,651136200,False,3
2438,validator_27,75559733193,True,498620001,21498130,520118131,True,2
2439,validator_57,43805906154,True,704800011,4651200,709451211,True,1
2440,validator_42,76850975490,True,786500000,2765860,789265860,False,2
2441,validator_28,80638163034,True,596274001,8288400,604562401,True,2
2442,validator_4,198960377428,True,441919997,20084100,462004097,True,6
2443,validator_87,40407793210,True,636600000,19745730,656345730,False,1
2444,validator_18,117109732450,True,609400000,1790890,611190890,False,3
2445,validator_58,43152170331,True,543119995,19368440,562488435,True,1
2446,validator_9,208208972200,True,491100000,1994200,493094200,False,6
2447,validator_38,79937414780,True,739600000,9459230,749059230,False,2
2448,validator_93,37410447090,True,429600000,9322830,438922830,False,1
2449,validator_9,208859200860,True,644600000,5628660,650228660,False,6
2450,validator_1,350491708602,True,829600005,1766470,831366475,True,10
2451,validator_1,351254445782,True,694959990,67777190,762737180,True,10
2452,validator_62,40840956184,True,529099996,13160180,542260176,True,1
2453,validator_99,35351299240,True,570400000,29499560,599899560,False,1
2454,validator_1,351832002943,True,558340001,19217160,577557161,True,10
2455,validator_69,38420883434,True,723500000,19094140,742594140,True,1
2456,validator_3,319593801530,True,639400000,72868230,712268230,False,9
2457,validator_0,339020882291,True,506320006,16666360,522986366,True,10
2458,validator_1,352948485266,True,1095199993,21282330,1116482323,True,11
2459,validator_11,204903560980,True,618600000,2226460,620826460,False,6
2460,validator_6,201786390813,True,581799995,21062200,602862195,True,6
2461,validator_0,339650707041,True,627200000,2624750,629824750,True,10
2462,validator_8,196664755140,True,481700000,2404220,484104220,False,6
2463,validator_25,85058958561,True,601499997,24519700,626019697,True,2
2464,validator_76,38802836990,True,641100000,19353510,660453510,False,1
2465,validator_27,76279342910,True,712719997,6889720,719609717,True,2
2466,validator_7,217405363913,True,467640007,25978630,493618637,True,6
2467,validator_3,320151275630,True,520800000,36674100,557474100,False,10
2468,validator_10,199928619030,True,480400000,10393620,490793620,False,6
2469,validator_36,78657466790,True,470200000,4058030,474258030,False,2
2470,validator_5,206371891564,True,611299997,18067060,629367057,True,6
2471,validator_93,38146197940,True,726800000,8950850,735750850,False,1
2472,validator_9,209480245200,True,618500000,2544340,621044340,False,6
2473,validator_2,324497189470,True,597000000,1996500,598996500,False,10
2474,validator_9,210004412430,True,503700000,20467230,524167230,False,6
2475,validator_89,40402823250,True,522900000,2122830,525022830,False,1
2476,validator_6,202397016020,True,583060007,27565200,610625207,True,6
2477,validator_6,203096440570,True,690500000,8924550,699424550,True,6
2478,validator_27,76835124714,True,526200004,29581800,555781804,True,2
2479,validator_3,320664675770,True,511900000,1500140,513400140,False,10
2480,validator_16,119764725201,True,741740004,12308110,754048114,True,3
2481,validator_51,38409877962,True,662240002,9624310,671864312,True,1
2482,validator_83,39764228230,True,673100000,1522930,674622930,False,1
2483,validator_29,82501596530,True,668370001,22530620,690900621,True,2
2484,validator_5,207195338881,True,813954007,9493310,823447317,True,6
2485,validator_74,36861152460,True,742000000,3098260,745098260,False,1
2486,validator_9,210461448830,True,454600000,2436400,457036400,False,6
2487,validator_1,353765772234,True,814799998,2486970,817286968,True,11
2488,validator_78,36625139930,True,529700000,2467530,532167530,False,1
2489,validator_15,122534422565,True,635739999,8197130,643937129,True,3
2490,validator_94,38431865110,True,497000000,25123540,522123540,False,1
2491,validator_39,80004496530,True,601400000,7844600,609244600,False,2
2492,validator_85,36997915550,True,639200000,1593870,640793870,False,1
2493,validator_1,354611444128,True,842899994,2771900,845671894,True,11
2494,validator_1,355322109955,True,684300007,26365820,710665827,True,11
2495,validator_0,340560771640,True,879459999,30604600,910064599,True,10
2496,validator_2,325159577450,True,644500000,17887980,662387980,False,10
2497,validator_19,111484985790,True,559700000,2964170,562664170,False,3
2498,validator_33,83660549371,True,489779997,13198240,502978237,True,2
2499,validator_87,41096490710,True,667000000,21697500,688697500,False,1
2500,validator_17,121265689803,True,709899999,6079250,715979249,True,3
2501,validator_25,85774427165,True,704680004,10788600,715468604,True,2
2502,validator_41,80021364620,True,444300000,24185260,468485260,False,2
2503,validator_1,356002364973,True,661859998,18395020,680255018,True,11
2504,validator_10,200725825120,True,795700000,1506090,797206090,False,6
2505,validator_59,38109993414,True,786120000,20103740,806223740,True,1
2506,validator_16,120316434876,True,530520005,21189670,551709675,True,3
2507,validator_91,38219120910,True,685800000,5708760,691508760,False,1
2508,validator_54,38446413589,True,968480003,3678900,972158903,True,1
2509,validator_33,84304006856,True,614980005,28477480,643457485,True,2
2510,validator_3,321260029600,True,570200000,25153830,595353830,False,10
2511,validator_10,201254471720,True,516300000,12346600,528646600,False,6
2512,validator_34,79243896500,True,519100000,20456500,539556500,False,2
2513,validator_33,84995510085,True,689699999,1803230,691503229,True,2
2514,validator_61,40960773175,True,477740003,12995230,490735233,True,1
2515,validator_83,40358268370,True,591400000,2640140,594040140,False,1
2516,validator_56,42871672021,True,681799999,31307820,713107819,True,1
2517,validator_35,76203895810,True,544200000,1215700,545415700,False,2
2518,validator_15,123354084895,True,760160000,59502330,819662330,True,3
2519,validator_31,82808140718,True,392799999,9504000,402303999,True,2
2520,validator_32,78904643316,True,686866001,21083390,707949391,True,2
2521,validator_6,203937994873,True,831540003,10014300,841554303,True,6
2522,validator_9,210942362230,True,477100000,3813400,480913400,False,6
2523,validator_42,77360067690,True,507100000,1992200,509092200,False,2
2524,validator_90,38196484830,True,667200000,19475010,686675010,False,1
2525,validator_34,79986128640,True,718700000,23532140,742232140,False,2
2526,validator_24,80392860614,True,633440004,25589240,659029244,True,2
2527,validator_61,41667887004,True,703999999,3113830,707113829,True,1
2528,validator_11,205610809690,True,704400000,2848710,707248710,False,6
2529,validator_83,40918205840,True,537900000,22037470,559937470,False,1
2530,validator_74,37662823240,True,785300000,16370780,801670780,False,1
2531,validator_2,325772762040,True,612800000,384590,613184590,False,10
2532,validator_4,199615747128,True,634040000,21329700,655369700,True,6
2533,validator_17,121967156919,True,663655996,37811120,701467116,True,3
2534,validator_3,321902699600,True,636000000,6670000,642670000,False,10
2535,validator_7,218042652606,True,566100003,71188690,637288693,True,6
2536,validator_36,79090838330,True,413700000,19671540,433371540,False,2
2537,validator_5,207771626788,True,547786007,28501900,576287907,True,6
2538,validator_4,200335726960,True,698300002,21679830,719979832,True,6
2539,validator_23,115867749950,True,700500000,7675460,708175460,False,3
2540,validator_51,39232024424,True,799958002,22188460,822146462,True,1
2541,validator_10,201923050910,True,648200000,20379190,668579190,False,6
2542,validator_41,80528766920,True,504600000,2802300,507402300,False,2
2543,validator_10,202507487070,True,582200000,2236160,584436160,False,6
2544,validator_21,120274306210,True,674800000,22413130,697213130,False,3
2545,validator_22,116227777520,True,706100000,1902290,708002290,False,3
2546,validator_2,326422812140,True,648100000,1950100,650050100,False,10
2547,validator_33,85626544188,True,607180003,23854100,631034103,True,2
2548,validator_22,117043824250,True,815100000,946730,816046730,False,3
2549,validator_55,38072392991,True,655999993,16459030,672459023,True,1
2550,validator_0,341150237011,True,586239991,3225380,589465371,True,10
2551,validator_1,356837990014,True,830900001,4725040,835625041,True,11
2552,validator_36,79882784160,True,769600000,22345830,791945830,False,2
2553,validator_94,38915332340,True,480600000,2867230,483467230,False,1
2554,validator_15,123847211092,True,484645997,8480200,493126197,True,3
2555,validator_1,357475509827,True,629300003,8219810,637519813,True,11
2556,validator_3,322473221030,True,550800000,19721430,570521430,False,10
2557,validator_14,124852478987,True,736220002,8407720,744627722,True,3
2558,validator_2,326994281350,True,570700000,769210,571469210,False,10
2559,validator_22,117579368190,True,530800000,4743940,535543940,False,3
2560,validator_7,218760561541,True,707960005,9948930,717908935,True,6
2561,validator_9,211660687980,True,697500000,20825750,718325750,False,6
2562,validator_57,44436060460,True,605960006,24194300,630154306,True,1
2563,validator_2,327683412320,True,680800000,8330970,689130970,False,10
2564,validator_86,37945269000,True,521000000,3701160,524701160,False,1
2565,validator_36,80497648930,True,613400000,1464770,614864770,False,2
2566,validator_15,124582936662,True,699220000,36505570,735725570,True,3
2567,validator_61,42423397603,True,753499999,2010600,755510599,True,1
2568,validator_11,206235383160,True,623100000,1473470,624573470,False,6
2569,validator_49,41959386527,True,685740004,21003940,706743944,True,1
2570,validator_3,323299811080,True,816000000,10590050,826590050,False,10
2571,validator_11,206817367000,True,580100000,1883840,581983840,False,6
2572,validator_71,43218390821,True,611500001,34439620,645939621,True,1
2573,validator_1,358023235637,True,546000000,1725810,547725810,True,11
2574,validator_22,118282694150,True,699900000,3425960,703325960,False,3
2575,validator_19,112391902970,True,885900000,21017180,906917180,False,3
2576,validator_47,41986692801,True,630100000,2539900,632639900,True,1
2577,validator_32,79620394014,True,699019998,16730700,715750698,True,2
2578,validator_9,212322382660,True,655100000,6594680,661694680,False,6
2579,validator_22,118885095330,True,600700000,1701180,602401180,False,3
2580,validator_23,116424569120,True,534300000,22519170,556819170,False,3
2581,validator_32,80437941722,True,770520008,47027700,817547708,True,2
2582,validator_56,43554791237,True,610320006,72799210,683119216,True,1
2583,validator_4,201229914741,True,864188001,29999780,894187781,True,6
2584,validator_13,121569961695,True,575400001,2092060,577492061,True,3
2585,validator_27,77373915777,True,528520003,10271060,538791063,True,2
2586,validator_56,44202057877,True,633540000,13726640,647266640,True,1
2587,validator_70,37882517052,True,670580010,25487040,696067050,True,1
2588,validator_35,76752006040,True,546900000,1210230,548110230,False,2
2589,validator_10,203158708570,True,648400000,2821500,651221500,False,6
2590,validator_19,113154400870,True,737300000,25197900,762497900,False,3
2591,validator_28,81498528829,True,858200005,2165790,860365795,True,2
2592,validator_34,80453274140,True,465200000,1945500,467145500,False,2
2593,validator_39,80782947370,True,759400000,19050840,778450840,False,2
2594,validator_2,328322154040,True,611700000,27041720,638741720,False,10
2595,validator_90,38609494130,True,410500000,2509300,413009300,False,1
2596,validator_1,358826713032,True,770639995,32837400,803477395,True,11
2597,validator_25,86493465461,True,711999996,7038300,719038296,True,2
2598,validator_42,77957091720,True,596000000,1024030,597024030,False,2
2599,validator_31,83853911716,True,1016563998,29207000,1045770998,True,2
2600,validator_82,38821078600,True,558100000,16613930,574713930,False,1
2601,validator_4,201994452846,True,754940005,9598100,764538105,True,6
2602,validator_90,39204608770,True,592500000,2614640,595114640,False,1
2603,validator_22,119612431650,True,701600000,25736320,727336320,False,3
2604,validator_11,207207668560,True,386400000,3901560,390301560,False,6
2605,validator_0,341857220260,True,662919999,44063250,706983249,True,10
2606,validator_4,202800082360,True,803900004,1729510,805629514,True,6
2607,validator_10,203751349240,True,587600000,5040670,592640670,False,6
2608,validator_77,38393971910,True,566600000,2181020,568781020,False,1
2609,validator_62,41637923112,True,791653998,5312930,796966928,True,1
2610,validator_10,204443590370,True,664100000,28141130,692241130,False,6
2611,validator_37,75342874230,True,531800000,2614630,534414630,False,2
2612,validator_0,342483036255,True,616919995,8896000,625815995,True,10
2613,validator_28,82153742129,True,644500000,10713300,655213300,True,2
2614,validator_18,117619540720,True,507480000,2328270,509808270,False,3
2615,validator_1,359383383231,True,555699999,970200,556670199,True,11
2616,validator_21,120741039950,True,464700000,2033740,466733740,False,3
2617,validator_82,39368089300,True,537000000,10010700,547010700,False,1
2618,validator_18,118105180480,True,484300000,1339760,485639760,False,3
2619,validator_31,84773770507,True,895799991,24058800,919858791,True,2
2620,validator_47,42785765949,True,747720008,51353140,799073148,True,1
2621,validator_20,114776525100,True,578900000,10781200,589681200,False,3
2622,validator_5,208348543592,True,558040004,18876800,576916804,True,6
2623,validator_1,359920947732,True,523220001,14344500,537564501,True,11
2624,validator_35,77291549860,True,538000000,1543820,539543820,False,2
2625,validator_24,81149318034,True,740960000,15497420,756457420,True,2
2626,validator_61,43198695175,True,751420002,23877570,775297572,True,1
2627,validator_26,73715791262,True,589559999,7831870,597391869,True,2
2628,validator_85,37631049690,True,607900000,25234140,633134140,False,1
2629,validator_11,207762039270,True,552600000,1770710,554370710,False,6
2630,validator_6,204591479898,True,615800005,37685020,653485025,True,6
2631,validator_3,323975488570,True,669200000,6477490,675677490,False,10
2632,validator_69,39232818560,True,798919996,13015130,811935126,True,1
2633,validator_20,115229091910,True,441800000,10766810,452566810,False,3
2634,validator_90,39825100270,True,615000000,5491500,620491500,False,1
2635,validator_22,120295760920,True,680700000,2629270,683329270,False,3
2636,validator_27,78242243077,True,835180000,33147300,868327300,True,2
2637,validator_20,115752777810,True,519600000,4085900,523685900,False,3
2638,validator_1,360523575140,True,599820008,2807400,602627408,True,11
2639,validator_5,209089685190,True,706709998,34431600,741141598,True,6
2640,validator_14,125683151674,True,824499997,6172690,830672687,True,3
2641,validator_21,121357497740,True,612900000,3557790,616457790,False,3
2642,validator_70,38435913183,True,517100001,36296130,553396131,True,1
2643,validator_52,41249599999,True,733840003,11171430,745011433,True,1
2644,validator_4,203374516794,True,546000004,28434430,574434434,True,6
2645,validator_2,328842887870,True,515700000,5033830,520733830,False,10
2646,validator_84,38610480160,True,448000000,10381900,458381900,False,1
2647,validator_88,40178593590,True,485200000,2873290,488073290,False,1
2648,validator_1,361132997366,True,597739996,11682230,609422226,True,11
2649,validator_78,37426353870,True,797900000,3313940,801213940,False,1
2650,validator_28,83021300524,True,836739995,30818400,867558395,True,2
2651,validator_0,343316420087,True,829200002,4183830,833383832,True,10
2652,validator_5,209563098429,True,469619999,3793240,473413239,True,6
2653,validator_13,122263788106,True,651040011,42786400,693826411,True,3
2654,validator_35,77921925390,True,620500000,9875530,630375530,False,2
2655,validator_6,205077163512,True,458599994,27083620,485683614,True,6
2656,validator_22,120954114150,True,651400000,6953230,658353230,False,3
2657,validator_12,115163795531,True,690460003,15089230,705549233,True,3
2658,validator_12,115733218804,True,568399993,1023280,569423273,True,3
2659,validator_3,324697972400,True,716600000,5883830,722483830,False,10
2660,validator_29,83309011076,True,771000006,36414540,807414546,True,2
2661,validator_8,197037517230,True,369900000,2862090,372762090,False,6
2662,validator_32,81182968806,True,714936004,30091080,745027084,True,2
2663,validator_62,42458256530,True,813873998,6459420,820333418,True,1
2664,validator_11,208424883670,True,654900000,7944400,662844400,False,6
2665,validator_2,329667652500,True,818200000,6564630,824764630,False,10
2666,validator_1,361694600388,True,560700002,903020,561603022,True,11
2667,validator_60,42021703233,True,989400005,11053630,1000453635,True,1
2668,validator_60,42703542965,True,660800002,21039730,681839732,True,1
2669,validator_19,113787626730,True,625700000,7525860,633225860,False,3
2670,validator_83,41464103240,True,527200000,18697400,545897400,False,1
2671,validator_64,43224931378,True,661999997,26787200,688787197,True,1
2672,validator_1,362531105421,True,798040003,38465030,836505033,True,11
2673,validator_58,43766599166,True,607464005,6964830,614428835,True,1
2674,validator_56,45011047006,True,754959999,54029130,808989129,True,1
2675,validator_7,219506390450,True,699840009,45988900,745828909,True,6
2676,validator_60,43252418574,True,514240009,34635600,548875609,True,1
2677,validator_9,213060533920,True,736300000,1851260,738151260,False,6
2678,validator_8,197685605890,True,646300000,1788660,648088660,False,6
2679,validator_1,363386472850,True,846199999,9167430,855367429,True,11
2680,validator_65,38102964529,True,655820004,5920600,661740604,True,1
2681,validator_22,121522691430,True,566700000,1877280,568577280,False,3
2682,validator_17,122627862524,True,623300005,37405600,660705605,True,3
2683,validator_69,39730865537,True,490240007,7806970,498046977,True,1
2684,validator_54,39252878434,True,800939995,5524850,806464845,True,1
2685,validator_2,330269346640,True,598700000,2994140,601694140,False,10
2686,validator_39,81392072540,True,599200000,9925170,609125170,False,2
2687,validator_41,81299752570,True,769100000,1885650,770985650,False,2
2688,validator_10,205068150100,True,615400000,9159730,624559730,False,6
2689,validator_15,125220862508,True,590860006,47065840,637925846,True,3
2690,validator_8,198342112490,True,655000000,1506600,656506600,False,6
2691,validator_22,122159518230,True,634500000,2326800,636826800,False,3
2692,validator_71,43948489203,True,719300002,10798380,730098382,True,1
2693,validator_21,122018228010,True,658200000,2530270,660730270,False,3
2694,validator_0,344042583604,True,716399997,9763520,726163517,True,10
2695,validator_10,205644506040,True,557600000,18755940,576355940,False,6
2696,validator_6,205810400154,True,724290002,8946640,733236642,True,6
2697,validator_9,213542897400,True,472900000,9463480,482363480,False,6
2698,validator_6,206830174058,True,989920004,29853900,1019773904,True,6
2699,validator_26,74352544398,True,609340006,27413130,636753136,True,2
2700,validator_10,206292827240,True,628800000,19521200,648321200,False,6
2701,validator_25,87149607061,True,620860000,35281600,656141600,True,2
2702,validator_22,122676692030,True,514400000,2773800,517173800,False,3
2703,validator_3,325381526000,True,681800000,1753600,683553600,False,10
2704,validator_13,122880791827,True,578253991,38749730,617003721,True,3
2705,validator_59,38824743335,True,681200001,33549920,714749921,True,1
2706,validator_67,42599232669,True,620680002,40756940,661436942,True,1
2707,validator_13,123616468852,True,733949995,1727030,735677025,True,3
2708,validator_91,38703340670,True,474700000,9519760,484219760,False,1
2709,validator_1,364194289572,True,792639992,15176730,807816722,True,11
2710,validator_8,198731888560,True,387500000,2276070,389776070,False,6
2711,validator_18,118820841050,True,707500000,8160570,715660570,False,3
2712,validator_6,207343536302,True,488906004,24456240,513362244,True,6
2713,validator_5,210049670258,True,470599999,15971830,486571829,True,6
2714,validator_25,87912641630,True,729505999,33528570,763034569,True,2
2715,validator_20,116284127020,True,529800000,1549210,531349210,False,3
2716,validator_56,45668564704,True,650919998,6597700,657517698,True,1
2717,validator_39,81914260470,True,514600000,7587930,522187930,False,2
2718,validator_17,123274651622,True,637920008,8869090,646789098,True,3
2719,validator_5,210934692562,True,871320004,13702300,885022304,True,6
2720,validator_26,74943847305,True,570014007,21288900,591302907,True,2
2721,validator_40,75174424880,True,440700000,1987070,442687070,False,2
2722,validator_61,43829657097,True,619499992,11461930,630961922,True,1
2723,validator_0,344783742470,True,729219996,11938870,741158866,True,10
2724,validator_25,88479247669,True,529719999,36886040,566606039,True,2
2725,validator_90,40507343310,True,662500000,19743040,682243040,False,1
2726,validator_82,39948749530,True,559500000,21160230,580660230,False,1
2727,validator_32,82158692077,True,955800001,19923270,975723271,True,2
2728,validator_24,81988870337,True,822196003,17356300,839552303,True,2
2729,validator_62,43140546237,True,664640007,17649700,682289707,True,1
2730,validator_39,82474165910,True,551400000,8505440,559905440,False,2
2731,validator_41,82039994230,True,703600000,36641660,740241660,False,2
2732,validator_4,203999458473,True,581059999,43881680,624941679,True,6
2733,validator_46,39825515778,True,647899999,7888830,655788829,True,1
2734,validator_60,43954575170,True,698139996,4016600,702156596,True,1
2735,validator_7,220319268547,True,799059997,13818100,812878097,True,6
2736,validator_4,204651285870,True,644559997,7267400,651827397,True,6
2737,validator_20,117025180260,True,738500000,2553240,741053240,False,3
2738,validator_44,36676224959,True,571220009,10081350,581301359,True,1
2739,validator_14,126441609668,True,733999994,24458000,758457994,True,3
2740,validator_88,40747089390,True,565800000,2695800,568495800,False,1
2741,validator_12,116356151819,True,548765995,74167020,622933015,True,3
2742,validator_39,83074216450,True,594100000,5950540,600050540,False,2
2743,validator_85,38439376920,True,804900000,3427230,808327230,False,1
2744,validator_19,114379612290,True,589700000,2285560,591985560,False,3
2745,validator_27,78862546518,True,612860001,7443440,620303441,True,2
2746,validator_41,82607668640,True,545700000,21974410,567674410,False,2
2747,validator_17,124039607057,True,761899995,3055440,764955435,True,3
2748,validator_36,81058085650,True,558300000,2136720,560436720,False,2
2749,validator_97,42945466320,True,488900000,6950700,495850700,False,1
2750,validator_62,43913935953,True,754139996,19249720,773389716,True,1
2751,validator_14,127072167090,True,621200002,9357420,630557422,True,3
2752,validator_86,38567613830,True,613600000,8744830,622344830,False,1
2753,validator_2,330985569940,True,714800000,1423300,716223300,False,10
2754,validator_23,117090574720,True,657800000,8205600,666005600,False,3
2755,validator_55,38617707875,True,498560004,46754880,545314884,True,1
2756,validator_8,199338862500,True,581600000,25373940,606973940,False,6
2757,validator_2,331592577730,True,603900000,3107790,607007790,False,10
2758,validator_14,128011129142,True,909999992,28962060,938962052,True,4
2759,validator_0,345534052371,True,711820001,38489900,750309901,True,10
2760,validator_72,38656242300,True,805800000,3250220,809050220,False,1
2761,validator_16,120849473018,True,461200002,71838140,533038142,True,3
2762,validator_3,326102620220,True,714400000,6694220,721094220,False,10
2763,validator_56,46431294240,True,726299996,36429540,762729536,True,1
2764,validator_14,128704717373,True,644700001,48888230,693588231,True,4
2765,validator_4,205359454466,True,699245996,8922600,708168596,True,6
2766,validator_94,39439813880,True,520840000,3641540,524481540,False,1
2767,validator_5,211521606216,True,560919994,25993660,586913654,True,6
2768,validator_5,212228123940,True,701800004,4717720,706517724,True,6
2769,validator_20,117714732100,True,683900000,5651840,689551840,False,3
2770,validator_36,81740997790,True,676000000,6912140,682912140,False,2
2771,validator_11,209273004430,True,827800000,20320760,848120760,False,6
2772,validator_17,124666531659,True,599440002,27484600,626924602,True,3
2773,validator_27,79566536945,True,675570007,28420420,703990427,True,2
2774,validator_22,123288132780,True,589800000,21640750,611440750,False,3
2775,validator_8,199928023720,True,586200000,2961220,589161220,False,6
2776,validator_84,39304115470,True,685600000,8035310,693635310,False,1
2777,validator_6,208116034103,True,712588001,59909800,772497801,True,6
2778,validator_72,39086125500,True,428100000,1783200,429883200,False,1
2779,validator_10,206839959710,True,544900000,2232470,547132470,False,6
2780,validator_68,38354352154,True,781399995,32053510,813453505,True,1
2781,validator_1,365141484574,True,925100002,22095000,947195002,True,11
2782,validator_14,129451209211,True,728379998,18111840,746491838,True,4
2783,validator_1,365894872066,True,690300002,63087490,753387492,True,11
2784,validator_12,117095607824,True,679340005,60116000,739456005,True,3
2785,validator_17,125347909562,True,660560003,20817900,681377903,True,3
2786,validator_5,212899965722,True,669100002,2741780,671841782,True,6
2787,validator_34,81105925120,True,643300000,9350980,652650980,False,2
2788,validator_96,40828049430,True,585700000,3531730,589231730,False,1
2789,validator_22,123917067030,True,619800000,9134250,628934250,False,3
2790,validator_26,75525617402,True,565859997,15910100,581770097,True,2
2791,validator_10,207274931890,True,429100000,5872180,434972180,False,6
2792,validator_1,366686803934,True,788399998,3531870,791931868,True,11
2793,validator_19,115036416720,True,646900000,9904430,656804430,False,3
2794,validator_5,213511045732,True,585198000,25882010,611080010,True,6
2795,validator_99,36025927370,True,654000000,20628130,674628130,False,1
2796,validator_7,220937825546,True,616399999,2157000,618556999,True,6
2797,validator_43,82758122320,True,566600000,6679830,573279830,False,2
2798,validator_4,206330047010,True,944000004,26592540,970592544,True,6
2799,validator_5,214437963816,True,905200004,21718080,926918084,True,6
2800,validator_2,331990286050,True,396400000,1308320,397708320,False,10
2801,validator_50,41689396039,True,437800002,2801000,440601002,True,1
2802,validator_14,130015376855,True,561600004,2567640,564167644,True,4
2803,validator_7,221415329947,True,474400001,3104400,477504401,True,6
2804,validator_90,41185961470,True,665000000,13618160,678618160,False,1
2805,validator_17,126101367106,True,751600004,1857540,753457544,True,3
2806,validator_37,75968078830,True,622500000,2704600,625204600,False,2
2807,validator_83,41919586470,True,452100000,3383230,455483230,False,1
2808,validator_5,215120757005,True,662579999,20213190,682793189,True,6
2809,validator_5,215624091541,True,471179996,32154540,503334536,True,6
2810,validator_40,76000217700,True,813500000,12292820,825792820,False,2
2811,validator_4,207023346993,True,660880003,32419980,693299983,True,6
2812,validator_5,216296579539,True,654523998,17964000,672487998,True,6
2813,validator_6,208755732739,True,617779996,21918640,639698636,True,6
2814,validator_71,44600608384,True,637860001,14259180,652119181,True,1
2815,validator_4,207630594688,True,579159995,28087700,607247695,True,6
2816,validator_4,208670060744,True,974135996,65330060,1039466056,True,6
2817,validator_83,42571954700,True,646800000,5568230,652368230,False,1
2818,validator_4,209495694844,True,763506000,62128100,825634100,True,6
2819,validator_15,125889570683,True,648646005,20062170,668708175,True,3
2820,validator_20,118370788590,True,627100000,28956490,656056490,False,3
2821,validator_18,119555679610,True,714500000,20338560,734838560,False,3
2822,validator_1,367277945089,True,566099995,25041160,591141155,True,11
2823,validator_15,126885280826,True,959364003,36346140,995710143,True,3
2824,validator_22,124601898590,True,675200000,9631560,684831560,False,3
2825,validator_1,368137925792,True,807118003,52862700,859980703,True,11
2826,validator_2,332724110880,True,724100000,9724830,733824830,False,10
2827,validator_39,83764623450,True,685300000,5107000,690407000,False,2
2828,validator_85,39083860780,True,640800000,3683860,644483860,False,1
2829,validator_37,76612274050,True,639100000,5095220,644195220,False,2
2830,validator_35,78589585630,True,664500000,3160240,667660240,False,2
2831,validator_10,207987589690,True,692500000,20157800,712657800,False,6
2832,validator_62,44774341477,True,831340004,29065520,860405524,True,1
2833,validator_27,80056187027,True,443580002,46070080,489650082,True,2
2834,validator_14,130543415108,True,520919993,7118260,528038253,True,4
2835,validator_41,83255695340,True,645500000,2526700,648026700,False,2
2836,validator_8,200506914390,True,575700000,3190670,578890670,False,6
2837,validator_40,76756345860,True,749700000,6428160,756128160,False,2
2838,validator_6,209388217719,True,631000000,1484980,632484980,True,6
2839,validator_3,326825905060,True,711700000,11584840,723284840,False,10
2840,validator_13,124205338752,True,566360000,22509900,588869900,True,3
2841,validator_21,122669423640,True,649400000,1795630,651195630,False,3
2842,validator_10,208639895570,True,649200000,3105880,652305880,False,6
2843,validator_50,42390422163,True,690800004,10226120,701026124,True,1
2844,validator_34,81781131120,True,655000000,20206000,675206000,False,2
2845,validator_1,368829226431,True,680999999,10300640,691300639,True,11
2846,validator_13,124791382251,True,574899999,11143500,586043499,True,3
2847,validator_2,333246888160,True,511000000,11777280,522777280,False,10
2848,validator_9,214176103000,True,629700000,3505600,633205600,False,6
2849,validator_10,209250045170,True,573200000,36949600,610149600,False,6
2850,validator_10,209964230250,True,711100000,3085080,714185080,False,6
2851,validator_76,39448812070,True,635700000,10275080,645975080,False,1
2852,validator_4,210150908667,True,630160003,25053820,655213823,True,6
2853,validator_70,39184634557,True,722319994,26401380,748721374,True,1
2854,validator_0,346159128400,True,618199999,6876030,625076029,True,10
2855,validator_8,201028169920,True,508700000,12555530,521255530,False,6
2856,validator_34,82286978420,True,485000000,20847300,505847300,False,2
2857,validator_5,217045618807,True,703920008,45119260,749039268,True,6
2858,validator_0,346798130803,True,630139993,8862410,639002403,True,10
2859,validator_39,84675838570,True,910200000,1015120,911215120,False,2
2860,validator_21,123128137400,True,429000000,29713760,458713760,False,3
2861,validator_61,44678700763,True,844400006,4643660,849043666,True,1
2862,validator_40,77261485980,True,498500000,6640120,505140120,False,2
2863,validator_27,81038486761,True,944440004,37859730,982299734,True,2
2864,validator_21,123729764330,True,564000000,37626930,601626930,False,3
2865,validator_9,214747862380,True,564100000,7659380,571759380,False,6
2866,validator_78,37917644030,True,488200000,3090160,491290160,False,1
2867,validator_28,83779753988,True,737559994,20893470,758453464,True,2
2868,validator_37,77157014530,True,538400000,6340480,544740480,False,2
2869,validator_97,43637121520,True,689200000,2455200,691655200,False,1
2870,validator_20,118973986510,True,579900000,23297920,603197920,False,3
2871,validator_94,40039454680,True,576900000,22740800,599640800,False,1
2872,validator_76,40121926570,True,663100000,10014500,673114500,False,1
2873,validator_1,369611317163,True,775040002,7050730,782090732,True,11
2874,validator_89,40871290150,True,465600000,2866900,468466900,False,1
2875,validator_13,125363138426,True,550469995,21286180,571756175,True,3
2876,validator_68,38827803847,True,464393993,9057700,473451693,True,1
2877,validator_2,334014814700,True,764300000,3626540,767926540,False,10
2878,validator_6,210117604502,True,716245993,13140790,729386783,True,6
2879,validator_70,39894434384,True,671659997,38139830,709799827,True,1
2880,validator_14,131372729307,True,824999999,4314200,829314199,True,4
2881,validator_13,125977332862,True,605699996,8494440,614194436,True,3
2882,validator_2,334733792680,True,695100000,23877980,718977980,False,10
2883,validator_5,217676458771,True,627499994,3339970,630839964,True,6
2884,validator_9,215262470800,True,498400000,16208420,514608420,False,6
2885,validator_95,37291938220,True,545300000,2236670,547536670,False,1
2886,validator_77,38951846240,True,556400000,1474330,557874330,False,1
2887,validator_8,201753065400,True,715900000,8995480,724895480,False,6
2888,validator_75,39275892070,True,658500000,1578630,660078630,False,1
2889,validator_6,210830711359,True,687599997,25506860,713106857,True,6
2890,validator_7,222079007995,True,645940008,17738040,663678048,True,6
2891,validator_72,39739256800,True,633900000,19231300,653131300,False,1
2892,validator_19,115760355120,True,704200000,19738400,723938400,False,3
2893,validator_11,209861707830,True,569200000,19503400,588703400,False,6
2894,validator_34,82885937640,True,595100000,3859220,598959220,False,2
2895,validator_86,39202465010,True,614000000,20851180,634851180,False,1
2896,validator_1,370167233463,True,544640000,11276300,555916300,True,11
2897,validator_11,210530380790,True,664200000,4472960,668672960,False,6
2898,validator_14,132219527042,True,814999995,31797740,846797735,True,4
2899,validator_17,127204266338,True,1083000002,19899230,1102899232,True,3
2900,validator_48,41125661498,True,658919997,19046050,677966047,True,1
2901,validator_4,210973092824,True,780659997,41524160,822184157,True,6
2902,validator_77,39510893040,True,555300000,3746800,559046800,False,1
2903,validator_68,39620722842,True,764659995,28259000,792918995,True,1
2904,validator_5,218160137867,True,476519996,7159100,483679096,True,6
2905,validator_10,210524188790,True,551600000,8358540,559958540,False,6
2906,validator_29,83900877573,True,582739997,9126500,591866497,True,2
2907,validator_3,327412502300,True,566100000,20497240,586597240,False,10
2908,validator_33,86198237985,True,570099997,1593800,571693797,True,2
2909,validator_0,347299461004,True,493300001,8030200,501330201,True,10
2910,validator_9,216054951940,True,781300000,11181140,792481140,False,6
2911,validator_52,41826604085,True,570599996,6404090,577004086,True,1
2912,validator_11,211321569600,True,787900000,3288810,791188810,False,6
2913,validator_11,212029568710,True,698900000,9099110,707999110,False,6
2914,validator_86,39750982410,True,537500000,11017400,548517400,False,1
2915,validator_11,212610002610,True,573400000,7033900,580433900,False,6
2916,validator_11,213183653300,True,537700000,35950690,573650690,False,6
2917,validator_3,327983910490,True,565700000,5708190,571408190,False,10
2918,validator_53,38158678912,True,842800004,2843670,845643674,True,1
2919,validator_3,328483088490,True,480000000,19178000,499178000,False,10
2920,validator_19,116343490630,True,563600000,19535510,583135510,False,3
2921,validator_87,41919043450,True,816600000,5952740,822552740,False,1
2922,validator_16,121434755389,True,582500001,2782370,585282371,True,3
2923,validator_32,82742859811,True,582440004,1727730,584167734,True,2
2924,validator_17,127776558288,True,552520010,19771940,572291950,True,3
2925,validator_88,41323383850,True,574500000,1794460,576294460,False,1
2926,validator_30,83857178255,True,730560003,42139830,772699833,True,2
2927,validator_3,329089413490,True,601100000,5225000,606325000,False,10
2928,validator_33,87094411962,True,865199997,30973980,896173977,True,2
2929,validator_3,329576601110,True,468300000,18887620,487187620,False,10
2930,validator_2,335254623410,True,500800000,20030730,520830730,False,10
2931,validator_0,347962540376,True,655420002,7659370,663079372,True,10
2932,validator_86,40421028070,True,667600000,2445660,670045660,False,1
2933,validator_25,89327298938,True,837259999,10791270,848051269,True,2
2934,validator_36,82249162050,True,497300000,10864260,508164260,False,2
2935,validator_10,211259076330,True,706300000,28587540,734887540,False,6
2936,validator_39,85194993490,True,512900000,6254920,519154920,False,2
2937,validator_13,126925127700,True,902479998,45314840,947794838,True,3
2938,validator_0,348548425273,True,576899997,8984900,585884897,True,10
2939,validator_10,211847858030,True,557300000,31481700,588781700,False,6
2940,validator_1,371016575030,True,844500007,4841560,849341567,True,11
2941,validator_89,41439974150,True,561000000,7684000,568684000,False,1
2942,validator_54,39845982283,True,575419999,17683850,593103849,True,1
2943,validator_75,39843218030,True,547300000,20025960,567325960,False,1
2944,validator_11,213967296230,True,781000000,2642930,783642930,False,6
2945,validator_0,349199916564,True,641599991,9891300,651491291,True,10
2946,validator_7,223026092318,True,920020003,27064320,947084323,True,6
2947,validator_20,119696703050,True,685200000,37516540,722716540,False,3
2948,validator_42,78578083100,True,617400000,3591380,620991380,False,2
2949,validator_15,127727002343,True,819335997,22385520,841721517,True,3
2950,validator_28,84470801188,True,672840000,18207200,691047200,True,2
2951,validator_8,202434416660,True,662200000,19151260,681351260,False,6
2952,validator_29,84438150185,True,524120002,13152610,537272612,True,2
2953,validator_9,216684715160,True,624300000,5463220,629763220,False,6
2954,validator_7,223937733541,True,848606003,63035220,911641223,True,6
2955,validator_98,37723445210,True,587800000,10862600,598662600,False,1
2956,validator_4,211652967992,True,658419998,21455170,679875168,True,6
2957,validator_3,330211112590,True,614600000,19911480,634511480,False,10
2958,validator_7,224729093715,True,776800004,14560170,791360174,True,7
2959,validator_47,43441608422,True,603640003,52202470,655842473,True,1
2960,validator_38,80795602490,True,856500000,1687710,858187710,False,2
2961,validator_93,38806381340,True,641200000,18983400,660183400,False,1
2962,validator_20,120461738590,True,764200000,835540,765035540,False,3
2963,validator_18,120273978390,True,698800000,19498780,718298780,False,3
2964,validator_95,37867930260,True,573000000,2992040,575992040,False,1
2965,validator_2,335623449280,True,362500000,6325870,368825870,False,10
2966,validator_8,202959732780,True,521100000,4216120,525316120,False,6
2967,validator_3,330737820490,True,499900000,26807900,526707900,False,10
2968,validator_70,40666437635,True,770400001,1603250,772003251,True,1
2969,validator_3,331406967430,True,666400000,2746940,669146940,False,10
2970,validator_0,349715334758,True,503200004,12218190,515418194,True,10
2971,validator_7,225565887015,True,801800000,34993300,836793300,True,7
2972,validator_0,350539870521,True,817679993,6855770,824535763,True,10
2973,validator_99,36838621140,True,810300000,2393770,812693770,False,1
2974,validator_94,40597616480,True,550500000,7661800,558161800,False,1
2975,validator_1,371806792763,True,768840003,21377730,790217733,True,11
2976,validator_32,83594446643,True,820220002,31366830,851586832,True,2
2977,validator_6,211627285763,True,769100004,27474400,796574404,True,6
2978,validator_23,117686040820,True,591100000,4366100,595466100,False,3
2979,validator_96,41289064460,True,459000000,2015030,461015030,False,1
2980,validator_7,226141052102,True,554439997,20725090,575165087,True,7
2981,validator_1,372519611290,True,683639997,29178530,712818527,True,11
2982,validator_11,214551692730,True,556700000,27696500,584396500,False,6
2983,validator_9,217278614160,True,584000000,9899000,593899000,False,6
2984,validator_21,124254374100,True,518700000,5909770,524609770,False,3
2985,validator_12,117966189299,True,853579995,17001480,870581475,True,3
2986,validator_5,218877806173,True,707900006,9768300,717668306,True,6
2987,validator_1,373471849835,True,943100005,9138540,952238545,True,11
2988,validator_4,212383999096,True,722970004,8061100,731031104,True,6
2989,validator_30,84501774756,True,637460001,7136500,644596501,True,2
2990,validator_63,44541199707,True,826239999,11730980,837970979,True,1
2991,validator_78,38523313000,True,586000000,19668970,605668970,False,1
2992,validator_83,43221920020,True,647700000,2265320,649965320,False,1
2993,validator_83,43944379230,True,711900000,10559210,722459210,False,1
2994,validator_10,212466788610,True,611800000,7130580,618930580,False,6
2995,validator_59,39382587241,True,519939996,37903910,557843906,True,1
2996,validator_30,85059715983,True,505039997,52901230,557941227,True,2
2997,validator_7,226736345192,True,584699990,10593100,595293090,True,7
2998,validator_6,212389311611,True,738099998,23925850,762025848,True,6
2999,validator_10,213143377650,True,664500000,12089040,676589040,False,6
3000,validator_22,125394169350,True,790400000,1870760,792270760,False,3
3001,validator_3,332109793290,True,694600000,8225860,702825860,False,10
3002,validator_2,336132231240,True,502300000,6481960,508781960,False,10
3003,validator_3,332699847560,True,562300000,27754270,590054270,False,10
3004,validator_8,203365234080,True,383100000,22401300,405501300,False,6
3005,validator_17,128401915572,True,615900004,9457280,625357284,True,4
3006,validator_41,83743664140,True,479400000,8568800,487968800,False,2
3007,validator_42,79141019280,True,559400000,3536180,562936180,False,2
3008,validator_90,42023409100,True,809800000,27647630,837447630,False,1
3009,validator_9,217951762780,True,671700000,1448620,673148620,False,6
3010,validator_1,374145640380,True,645640005,28150540,673790545,True,11
3011,validator_4,213237737485,True,852099999,1638390,853738389,True,6
3012,validator_9,218610251400,True,623600000,34888620,658488620,False,6
3013,validator_0,351246335126,True,660439995,46024610,706464605,True,10
3014,validator_42,79666645700,True,516000000,9626420,525626420,False,2
3015,validator_10,213875272350,True,708600000,23294700,731894700,False,6
3016,validator_20,120969272030,True,505370000,2163440,507533440,False,3
3017,validator_6,213175341856,True,746760005,39270240,786030245,True,6
3018,validator_47,44090354318,True,605119996,43625900,648745896,True,1
3019,validator_61,45331403763,True,557152000,95551000,652703000,True,1
3020,validator_9,219351168140,True,721900000,19016740,740916740,False,6
3021,validator_15,128407281830,True,641379997,38899490,680279487,True,4
3022,validator_40,77837103380,True,573200000,2417400,575617400,False,2
3023,validator_45,42100167065,True,666220007,12096840,678316847,True,1
3024,validator_5,219941079211,True,1031340008,31933030,1063273038,True,6
3025,validator_20,121510033840,True,529600000,11161810,540761810,False,3
3026,validator_57,45005178196,True,542140006,26977730,569117736,True,1
3027,validator_16,122083150278,True,639760009,8634880,648394889,True,3
3028,validator_23,118328350020,True,568300000,74009200,642309200,False,3
3029,validator_39,85826792490,True,605500000,26299000,631799000,False,2
3030,validator_14,132867666937,True,631285995,16853900,648139895,True,4
3031,validator_4,214004074219,True,735374004,30962730,766336734,True,6
3032,validator_13,127679427271,True,729200001,25099570,754299571,True,3
3033,validator_11,215013738960,True,455400000,6646230,462046230,False,6
3034,validator_8,203992378080,True,618200000,8944000,627144000,False,6
3035,validator_0,352265213385,True,1002439999,16438260,1018878259,True,11
3036,validator_3,333529207030,True,827800000,1559470,829359470,False,10
3037,validator_0,352934258480,True,667199995,1845100,669045095,True,11
3038,validator_42,80316427200,True,643600000,6181500,649781500,False,2
3039,validator_52,42738481970,True,894999995,16877890,911877885,True,1
3040,validator_48,41905715893,True,765587995,14466400,780054395,True,1
3041,validator_83,44427724330,True,477400000,5945100,483345100,False,1
3042,validator_32,84245364273,True,635340000,15577630,650917630,True,2
3043,validator_2,336851564140,True,716500000,2832900,719332900,False,10
3044,validator_65,39068198562,True,934200003,31034030,965234033,True,1
3045,validator_1,374955959466,True,752940006,57379080,810319086,True,11
3046,validator_47,44613356755,True,494619997,28382440,523002437,True,1
3047,validator_1,375670967236,True,657900000,57107770,715007770,True,11
3048,validator_14,133799236637,True,902500000,29069700,931569700,True,4
3049,validator_31,85776810365,True,987899998,15139860,1003039858,True,2
3050,validator_2,337465681340,True,611900000,2217200,614117200,False,10
3051,validator_21,124932700240,True,635200000,43126140,678326140,False,3
3052,validator_34,83510372090,True,613500000,10934450,624434450,False,2
3053,validator_36,82978852250,True,718200000,11490200,729690200,False,2
3054,validator_49,42490571299,True,508760002,22424770,531184772,True,1
3055,validator_0,353535322722,True,570360002,30704240,601064242,True,11
3056,validator_2,338169646470,True,694800000,9165130,703965130,False,10
3057,validator_53,38680076915,True,519720003,1678000,521398003,True,1
3058,validator_95,38381282360,True,481700000,31652100,513352100,False,1
3059,validator_1,376494928183,True,801640007,22320940,823960947,True,11
3060,validator_17,129024597439,True,618899997,3781870,622681867,True,4
3061,validator_39,86468430270,True,640000000,1637780,641637780,False,2
3062,validator_27,81676462566,True,627920005,10055800,637975805,True,2
3063,validator_1,377077671424,True,580440001,2303240,582743241,True,11
3064,validator_3,334080283960,True,549600000,1476930,551076930,False,10
3065,validator_9,219931498630,True,573500000,6830490,580330490,False,6
3066,validator_16,122835863178,True,649564000,103148900,752712900,True,3
3067,validator_87,42373960280,True,441600000,13316830,454916830,False,1
3068,validator_66,43761485286,True,726700002,4014880,730714882,True,1
3069,validator_2,338755606800,True,571900000,14060330,585960330,False,10
3070,validator_70,41486215532,True,809519997,10257900,819777897,True,1
3071,validator_0,354172683090,True,600093998,37266370,637360368,True,11
3072,validator_6,213972631592,True,760619996,36669740,797289736,True,6
3073,validator_83,45030854960,True,600100000,3030630,603130630,False,1
3074,validator_40,78525577140,True,686600000,1873760,688473760,False,2
3075,validator_12,118639004300,True,651960001,20855000,672815001,True,3
3076,validator_0,354734425422,True,552840002,8902330,561742332,True,11
3077,validator_62,45364131643,True,586139996,3650170,589790166,True,1
3078,validator_42,80879831370,True,556400000,7004170,563404170,False,2
3079,validator_46,40358744772,True,509879994,23349000,533228994,True,1
3080,validator_21,125670184530,True,730600000,6884290,737484290,False,3
3081,validator_0,355519852771,True,778499999,6927350,785427349,True,11
3082,validator_73,38936713210,True,802300000,22819600,825119600,False,1
3083,validator_74,38434755240,True,770600000,1332000,771932000,False,1
3084,validator_62,46395196773,True,1019240000,11825130,1031065130,True,1
3085,validator_11,215625932460,True,609700000,2493500,612193500,False,6
3086,validator_5,220602001481,True,655799990,5122280,660922270,True,6
3087,validator_3,334659105590,True,574300000,4521630,578821630,False,10
3088,validator_0,356216488138,True,692299997,4335370,696635367,True,11
3089,validator_2,339434577870,True,668800000,10171070,678971070,False,10
3090,validator_22,126178323470,True,781300000,2854120,784154120,False,3
3091,validator_81,37894100640,True,512990000,24882330,537872330,False,1
3092,validator_84,39813812930,True,506100000,3597460,509697460,False,1
3093,validator_22,126964001360,True,766100000,19577890,785677890,False,3
3094,validator_1,377808149529,True,704240005,26238100,730478105,True,11
3095,validator_67,43420151566,True,803563997,17354900,820918897,True,1
3096,validator_34,84136102100,True,605800000,19930010,625730010,False,2
3097,validator_5,221252053336,True,644720005,5331850,650051855,True,6
3098,validator_19,116884139930,True,538600000,2049300,540649300,False,3
3099,validator_78,39229522680,True,704300000,1909680,706209680,False,1
3100,validator_75,40456840930,True,592900000,20722900,613622900,False,1
3101,validator_23,119017908020,True,683700000,5858000,689558000,False,3
3102,validator_40,79137592980,True,584500000,27515840,612015840,False,2
3103,validator_93,39327695680,True,518200000,3114340,521314340,False,1
3104,validator_14,134519336956,True,706579999,13520320,720100319,True,4
3105,validator_10,214319051760,True,439800000,3979410,443779410,False,6
3106,validator_82,40747579350,True,797800000,1029820,798829820,False,1
3107,validator_8,204749989910,True,756300000,1311830,757611830,False,6
3108,validator_3,335308939680,True,646500000,3334090,649834090,False,10
3109,validator_7,227289065618,True,534539996,18180430,552720426,True,7
3110,validator_4,214567581102,True,541620003,21886880,563506883,True,6
3111,validator_68,40372120249,True,745240007,6157400,751397407,True,1
3112,validator_54,40585626743,True,736500000,3144460,739644460,True,1
3113,validator_34,84779289750,True,641600000,1587650,643187650,False,2
3114,validator_10,214881571660,True,559800000,2719900,562519900,False,6
3115,validator_60,44679956846,True,715800006,9581670,725381676,True,1
3116,validator_92,34705617060,True,770800000,2223460,773023460,False,1
3117,validator_8,205247652620,True,478100000,19562710,497662710,False,6
3118,validator_8,206113686310,True,863900000,2133690,866033690,False,6
3119,validator_6,214853179687,True,851839995,28708100,880548095,True,6
3120,validator_12,119135186179,True,494899999,1281880,496181879,True,3
3121,validator_3,335855901220,True,535600000,11361540,546961540,False,10
3122,validator_52,43482343173,True,740700003,3161200,743861203,True,1
3123,validator_94,41120618050,True,520600000,2401570,523001570,False,1
3124,validator_0,356874238242,True,624260004,33490100,657750104,True,11
3125,validator_36,83514627750,True,530600000,5175500,535775500,False,2
3126,validator_2,339963077970,True,525300000,3200100,528500100,False,10
3127,validator_57,45675633522,True,661440006,9015320,670455326,True,1
3128,validator_23,119523196510,True,497500000,7788490,505288490,False,3
3129,validator_89,42137403260,True,693600000,3829110,697429110,False,1
3130,validator_17,129632621466,True,571939997,36084030,608024027,True,4
3131,validator_3,336607178920,True,750000000,1277700,751277700,False,10
3132,validator_2,340594062770,True,620900000,10084800,630984800,False,10
3133,validator_50,43309794157,True,896939994,22432000,919371994,True,1
3134,validator_1,378686831715,True,824639996,54042190,878682186,True,11
3135,validator_79,41866138310,True,513300000,5518790,518818790,False,1
3136,validator_33,87800417759,True,660439997,45565800,706005797,True,2
3137,validator_96,42031640990,True,734700000,7876530,742576530,False,1
3138,validator_95,38970831360,True,583600000,5949000,589549000,False,1
3139,validator_35,79279234170,True,680500000,9148540,689648540,False,2
3140,validator_7,227897925920,True,570720002,38140300,608860302,True,7
3141,validator_9,220617676530,True,680000000,6177900,686177900,False,6
3142,validator_35,80075985710,True,759700000,37051540,796751540,False,2
3143,validator_18,121049629870,True,774300000,1351480,775651480,False,3
3144,validator_29,85277401765,True,786134000,53117580,839251580,True,2
3145,validator_15,129062967225,True,645159995,10525400,655685395,True,4
3146,validator_6,215358558911,True,499654004,5725220,505379224,True,6
3147,validator_0,357520900181,True,622299999,24361940,646661939,True,11
3148,validator_6,215854336809,True,487839998,7937900,495777898,True,6
3149,validator_17,130254210295,True,613099999,8488830,621588829,True,4
3150,validator_27,82213247858,True,533839992,2945300,536785292,True,2
3151,validator_3,337189271070,True,554100000,27992150,582092150,False,10
3152,validator_5,221926787237,True,667680001,7053900,674733901,True,6
3153,validator_10,215554112390,True,671300000,1240730,672540730,False,6
3154,validator_51,39834168740,True,597899996,4244320,602144316,True,1
3155,validator_27,82708006492,True,467300004,27458630,494758634,True,2
3156,validator_8,206619437350,True,504600000,1151040,505751040,False,6
3157,validator_2,341234078410,True,620800000,19215640,640015640,False,10
3158,validator_19,117476171510,True,590200000,1831580,592031580,False,3
3159,validator_38,81359218590,True,552800000,10816100,563616100,False,2
3160,validator_42,81223659570,True,324300000,19528200,343828200,False,2
3161,validator_71,45352292308,True,723600004,28083920,751683924,True,1
3162,validator_12,120020224875,True,878095996,6942700,885038696,True,3
3163,validator_36,84099521140,True,574500000,10393390,584893390,False,2
3164,validator_2,341895514330,True,655600000,5835920,661435920,False,10
3165,validator_94,41606543690,True,479500000,6425640,485925640,False,1
3166,validator_87,43027607000,True,625700000,27946720,653646720,False,1
3167,validator_17,131082959696,True,796700001,32049400,828749401,True,4
3168,validator_39,87180755370,True,693000000,19325100,712325100,False,2
3169,validator_11,216222020380,True,592900000,3187920,596087920,False,6
3170,validator_96,42629121850,True,577700000,19780860,597480860,False,1
3171,validator_10,216101289970,True,528000000,19177580,547177580,False,6
3172,validator_3,337835290970,True,644500000,1519900,646019900,False,10
3173,validator_66,44317989391,True,509490005,47014100,556504105,True,1
3174,validator_16,123678263169,True,836760001,5639990,842399991,True,3
3175,validator_93,39907552640,True,567900000,11956960,579856960,False,1
3176,validator_1,379276749534,True,552299999,37617820,589917819,True,11
3177,validator_64,43763440973,True,518419995,20089600,538509595,True,1
3178,validator_67,43942706742,True,512699996,9855180,522555176,True,1
3179,validator_85,39898593780,True,806200000,8533000,814733000,False,1
3180,validator_4,215276880782,True,687460000,21839680,709299680,True,6
3181,validator_20,122091399760,True,573800000,7565920,581365920,False,3
3182,validator_1,379988471890,True,710299996,1422360,711722356,True,11
3183,validator_83,45579712300,True,545400000,3457340,548857340,False,1
3184,validator_91,39325304970,True,618800000,3164300,621964300,False,1
3185,validator_9,221284716930,True,650100000,16940400,667040400,False,6
3186,validator_22,127422095640,True,437900000,20194280,458094280,False,3
3187,validator_40,79640364920,True,500300000,2471940,502771940,False,2
3188,validator_35,80592150050,True,505800000,10364340,516164340,False,2
3189,validator_20,122808865020,True,715300000,2165260,717465260,False,3
3190,validator_51,40420911738,True,559439998,27303000,586742998,True,1
3191,validator_91,39859362070,True,525900000,8157100,534057100,False,1
3192,validator_8,207340761250,True,694500000,26823900,721323900,False,6
3193,validator_27,83390529158,True,680799996,1722670,682522666,True,2
3194,validator_1,380714578196,True,710160006,15946300,726106306,True,11
3195,validator_3,338560714840,True,722200000,3223870,725423870,False,10
3196,validator_11,216726942190,True,500400000,4521810,504921810,False,6
3197,validator_69,40457843077,True,725100000,1877540,726977540,True,1
3198,validator_8,207914324470,True,563900000,9663220,573563220,False,6
3199,validator_6,216528064031,True,670199992,3527230,673727222,True,6
3200,validator_76,40423913330,True,299090000,2896760,301986760,False,1
3201,validator_42,81889013100,True,663900000,1453530,665353530,False,2
3202,validator_32,84939473767,True,685299994,8809500,694109494,True,2
3203,validator_10,216710232180,True,599200000,9742210,608942210,False,6
3204,validator_64,44621142871,True,838399998,19301900,857701898,True,1
3205,validator_21,126097382630,True,426300000,898100,427198100,False,3
3206,validator_81,38443422220,True,537400000,11921580,549321580,False,1
3207,validator_34,85398154180,True,596300000,22564430,618864430,False,2
3208,validator_18,121682377670,True,629100000,3647800,632747800,False,3
3209,validator_1,381645395865,True,892839999,37977670,930817669,True,11
3210,validator_33,88469835311,True,662900002,6517550,669417552,True,2
3211,validator_65,39824712128,True,718640006,37873560,756513566,True,1
3212,validator_2,342430086470,True,518200000,16372140,534572140,False,10
3213,validator_0,358171772809,True,618599998,32272630,650872628,True,11
3214,validator_0,359078802800,True,884599991,22430000,907029991,True,11
3215,validator_78,39906146440,True,673300000,3323760,676623760,False,1
3216,validator_5,222604773729,True,629260002,48726490,677986492,True,6
3217,validator_1,382475381768,True,828140003,1845900,829985903,True,11
3218,validator_32,85553755081,True,559099994,55181320,614281314,True,2
3219,validator_26,75983867701,True,437519999,20730300,458250299,True,2
3220,validator_14,135242797388,True,706040002,17420430,723460432,True,4
3221,validator_0,360074180580,True,939920000,55457780,995377780,True,11
3222,validator_1,383109789273,True,615240005,19167500,634407505,True,11
3223,validator_2,343182071050,True,750500000,1484580,751984580,False,10
3224,validator_23,120150198970,True,624100000,2902460,627002460,False,3
3225,validator_0,360852986039,True,734499999,44305460,778805459,True,11
3226,validator_86,41001906220,True,565200000,15678150,580878150,False,1
3227,validator_0,361542582135,True,665135996,24460100,689596096,True,11
3228,validator_7,228458280624,True,521198004,39156700,560354704,True,7
3229,validator_6,217099435824,True,562140003,9231790,571371793,True,6
3230,validator_25,89938692241,True,592260003,19133300,611393303,True,2
3231,validator_66,44926988636,True,572460005,36539240,608999245,True,1
3232,validator_5,223393365024,True,777439995,11151300,788591295,True,6
3233,validator_45,42817559859,True,697339994,20052800,717392794,True,1
3234,validator_2,343794561720,True,603300000,9190670,612490670,False,10
3235,validator_3,339044097820,True,459200000,24182980,483382980,False,10
3236,validator_9,221917707410,True,616600000,16390480,632990480,False,6
3237,validator_4,215914225850,True,624159998,13185070,637345068,True,6
3238,validator_18,122400750880,True,709700000,8673210,718373210,False,3
3239,validator_11,217488606970,True,750300000,11364780,761664780,False,6
3240,validator_56,47030210646,True,583880006,15036400,598916406,True,1
3241,validator_12,120757368809,True,724960004,12183930,737143934,True,3
3242,validator_5,224214254552,True,809799998,11089530,820889528,True,7
3243,validator_44,37390079452,True,695399993,18454500,713854493,True,1
3244,validator_17,131733189664,True,623160008,27069960,650229968,True,4
3245,validator_47,45235988160,True,619840005,2791400,622631405,True,1
3246,validator_0,362001822744,True,446499999,12740610,459240609,True,11
3247,validator_3,339729013140,True,681300000,3615320,684915320,False,10
3248,validator_7,229110573057,True,650300003,1992430,652292433,True,7
3249,validator_37,77761584900,True,598900000,5670370,604570370,False,2
3250,validator_15,129812304260,True,742899995,6437040,749337035,True,4
3251,validator_51,41412048036,True,952339998,38796300,991136298,True,1
3252,validator_56,48074318850,True,1041600004,2508200,1044108204,True,1
3253,validator_1,383675381075,True,562300002,3291800,565591802,True,11
3254,validator_33,89034885494,True,528540003,36510180,565050183,True,2
3255,validator_83,46452828920,True,872300000,816620,873116620,False,1
3256,validator_14,135845811506,True,582399998,20614120,603014118,True,4
3257,validator_17,132477085598,True,742200004,1695930,743895934,True,4
3258,validator_1,384437596192,True,718679997,43535120,762215117,True,12
3259,validator_0,362562205743,True,552759999,7623000,560382999,True,11
3260,validator_3,340334515870,True,603000000,2502730,605502730,False,10
3261,validator_3,340971255970,True,633200000,3540100,636740100,False,10
3262,validator_55,39442123973,True,767159998,57256100,824416098,True,1
3263,validator_17,133164918300,True,641800002,46032700,687832702,True,4
3264,validator_2,344736934840,True,903700000,38673120,942373120,False,10
3265,validator_39,87758104360,True,567600000,9748990,577348990,False,2
3266,validator_11,218238056650,True,741800000,7649680,749449680,False,6
3267,validator_29,85899143864,True,600519999,21222100,621742099,True,2
3268,validator_37,78379777400,True,610200000,7992500,618192500,False,2
3269,validator_44,38068406884,True,670263992,8063440,678327432,True,1
3270,validator_1,385137302390,True,668060008,31646190,699706198,True,12
3271,validator_5,224922234619,True,696119997,11860070,707980067,True,7
3272,validator_3,341455812130,True,480900000,3656160,484556160,False,10
3273,validator_77,40058343720,True,537300000,10150680,547450680,False,1
3274,validator_98,38473735330,True,740500000,9790120,750290120,False,1
3275,validator_20,123323588200,True,488300000,26423180,514723180,False,3
3276,validator_80,38864536450,True,604500000,6067060,610567060,False,1
3277,validator_2,345495077240,True,756500000,1642400,758142400,False,10
3278,validator_13,128484958206,True,799599995,5930940,805530935,True,4
3279,validator_7,229699212959,True,586200002,2439900,588639902,True,7
3280,validator_0,363146355349,True,577139996,7009610,584149606,True,11
3281,validator_6,217850254624,True,721820000,28998800,750818800,True,6
3282,validator_17,133622314951,True,442540001,14856650,457396651,True,4
3283,validator_89,42836438190,True,679800000,19234930,699034930,False,1
3284,validator_99,37442074270,True,576800000,26653130,603453130,False,1
3285,validator_54,41434507918,True,806960005,41921170,848881175,True,1
3286,validator_35,81226525250,True,630300000,4075200,634375200,False,2
3287,validator_42,82574756060,True,670000000,15742960,685742960,False,2
3288,validator_26,76749454205,True,737920004,27666500,765586504,True,2
3289,validator_9,222578310700,True,644300000,16303290,660603290,False,6
3290,validator_99,38074120770,True,620600000,11446500,632046500,False,1
3291,validator_39,88307885830,True,535700000,14081470,549781470,False,2
3292,validator_73,39422541210,True,480000000,5828000,485828000,False,1
3293,validator_72,40576888430,True,831000000,6631630,837631630,False,1
3294,validator_41,84224564890,True,470800000,10100750,480900750,False,2
3295,validator_11,218770657600,True,523000000,9600950,532600950,False,6
3296,validator_79,42445072210,True,576100000,2833900,578933900,False,1
3297,validator_1,385853658477,True,677500007,38856080,716356087,True,12
3298,validator_19,117933480260,True,454940000,2368750,457308750,False,3
3299,validator_34,86035052360,True,635500000,1398180,636898180,False,2
3300,validator_89,43300477040,True,462800000,1238850,464038850,False,1
3301,validator_11,219380453920,True,599800000,9996320,609796320,False,6
3302,validator_25,90593485744,True,612540003,42253500,654793503,True,2
3303,validator_89,43983953340,True,680200000,3276300,683476300,False,1
3304,validator_39,88931618930,True,622300000,1433100,623733100,False,2
3305,validator_41,84935402170,True,708900000,1937280,710837280,False,2
3306,validator_35,81853658250,True,607000000,20133000,627133000,False,2
3307,validator_15,130572862334,True,746897994,13660080,760558074,True,4
3308,validator_75,40888479820,True,412200000,19438890,431638890,False,1
3309,validator_76,41122721120,True,675700000,23107790,698807790,False,1
3310,validator_2,346024036940,True,526900000,2059700,528959700,False,10
3311,validator_49,43213958881,True,683560002,39827580,723387582,True,1
3312,validator_27,84092632369,True,695540001,6563210,702103211,True,2
3313,validator_57,46550425347,True,851339995,23451830,874791825,True,1
3314,validator_24,82743563566,True,720307999,34385230,754693229,True,2
3315,validator_4,216648190250,True,720300000,13664400,733964400,True,6
3316,validator_15,131098891076,True,489314002,36714740,526028742,True,4
3317,validator_40,80414717500,True,770600000,3752580,774352580,False,2
3318,validator_23,120815851950,True,662300000,3352980,665652980,False,3
3319,validator_3,342043884280,True,587000000,1072150,588072150,False,10
3320,validator_22,128155013110,True,724100000,8817470,732917470,False,4
3321,validator_6,218483134278,True,626100004,6779650,632879654,True,6
3322,validator_36,84544685230,True,435800000,9364090,445164090,False,2
3323,validator_4,217227816076,True,559939996,19685830,579625826,True,6
3324,validator_3,342760899560,True,713300000,3715280,717015280,False,10
3325,validator_30,85907159159,True,845399996,2043180,847443176,True,2
3326,validator_11,219933701560,True,546000000,7247640,553247640,False,6
3327,validator_85,40449312660,True,537800000,12918880,550718880,False,1
3328,validator_3,343404319560,True,640100000,3320000,643420000,False,10
3329,validator_76,41799694300,True,656500000,20473180,676973180,False,1
3330,validator_64,45730108764,True,1053599993,55365900,1108965893,True,1
3331,validator_35,82576750680,True,713100000,9992430,723092430,False,2
3332,validator_1,386690896645,True,781879998,55358170,837238168,True,12
3333,validator_32,86354905619,True,774779998,26370540,801150538,True,2
3334,validator_1,387129819629,True,437400004,1522980,438922984,True,12
3335,validator_29,86701792544,True,800600000,2048680,802648680,True,2
3336,validator_1,387847551719,True,697140000,20592090,717732090,True,12
3337,validator_56,48626102760,True,520346000,31437910,551783910,True,1
3338,validator_99,38650434170,True,557400000,18913400,576313400,False,1
3339,validator_2,346598413470,True,571600000,2776530,574376530,False,10
3340,validator_13,129108266489,True,621000003,2308280,623308283,True,4
3341,validator_36,85436787750,True,884100000,8002520,892102520,False,2
3342,validator_4,217948596258,True,681200002,39580180,720780182,True,6
3343,validator_0,363779811881,True,627300002,6156530,633456532,True,11
3344,validator_4,218614680158,True,650300000,15783900,666083900,True,6
3345,validator_7,230497553749,True,789540000,8800790,798340790,True,7
3346,validator_14,136639033604,True,787069998,6152100,793222098,True,4
3347,validator_43,83315165310,True,555800000,1242990,557042990,False,2
3348,validator_16,124280394071,True,594440002,7690900,602130902,True,3
3349,validator_13,129766442688,True,609953999,48222200,658176199,True,4
3350,validator_17,134326514456,True,661660005,42539500,704199505,True,4
3351,validator_1,388568997414,True,693779995,27665700,721445695,True,12
3352,validator_87,43705823490,True,673500000,4716490,678216490,False,1
3353,validator_13,130581062392,True,789180004,25439700,814619704,True,4
3354,validator_26,77298780701,True,541539996,7786500,549326496,True,2
3355,validator_22,128788541910,True,595300000,38228800,633528800,False,4
3356,validator_50,43778511998,True,454300001,14417840,468717841,True,1
3357,validator_1,389083741092,True,508899998,5843680,514743678,True,12
3358,validator_32,87233130925,True,875399996,2825310,878225306,True,2
3359,validator_13,131308319073,True,707800001,19456680,727256681,True,4
3360,validator_98,39096701220,True,604100000,18865890,622965890,False,1
3361,validator_41,85604516290,True,644600000,24514120,669114120,False,2
3362,validator_22,129358755270,True,558500000,11713360,570213360,False,4
3363,validator_18,122960146600,True,549400000,9995720,559395720,False,3
3364,validator_0,364679712609,True,857293998,42606730,899900728,True,11
3365,validator_19,118528591800,True,575300000,19811540,595111540,False,3
3366,validator_8,208557823570,True,622800000,20699100,643499100,False,6
3367,validator_5,225642922357,True,710588008,10099730,720687738,True,7
3368,validator_42,83123041060,True,546940000,1345000,548285000,False,2
3369,validator_34,86633982100,True,579800000,19129740,598929740,False,2
3370,validator_8,209172505170,True,609800000,4881600,614681600,False,6
3371,validator_13,131918029577,True,600220004,9490500,609710504,True,4
3372,validator_2,347141893490,True,539900000,3580020,543480020,False,10
3373,validator_71,46155465219,True,775119991,28052920,803172911,True,1
3374,validator_27,84704630342,True,608840003,3157970,611997973,True,2
3375,validator_14,137312788244,True,647240000,26514640,673754640,True,4
3376,validator_20,124022200000,True,685600000,13011800,698611800,False,3
3377,validator_6,219122955206,True,632919998,6900930,639820928,True,6
3378,validator_11,220516138990,True,567200000,15237430,582437430,False,6
3379,validator_58,44523305292,True,754199996,2506130,756706126,True,1
3380,validator_72,41330692630,True,750200000,3604200,753804200,False,1
3381,validator_48,42747974489,True,813213996,29044600,842258596,True,1
3382,validator_0,365346701344,True,651280005,15708730,666988735,True,11
3383,validator_39,89385065960,True,450200000,3247030,453447030,False,2
3384,validator_90,42442144030,True,415700000,3034930,418734930,False,1
3385,validator_18,123696876180,True,715800000,20929580,736729580,False,3
3386,validator_26,78042279125,True,711140004,32358420,743498424,True,2
3387,validator_2,347920334590,True,758200000,20241100,778441100,False,10
3388,validator_76,42281804210,True,480300000,1809910,482109910,False,1
3389,validator_31,86254004487,True,454914002,22280120,477194122,True,2
3390,validator_92,35418947290,True,693400000,19930230,713330230,False,1
3391,validator_43,83960000850,True,624700000,20135540,644835540,False,2
3392,validator_5,226543595161,True,894366004,6306800,900672804,True,7
3393,validator_60,45498960693,True,803220007,15783840,819003847,True,1
3394,validator_0,366051960782,True,674648008,30611430,705259438,True,11
3395,validator_48,43445078581,True,666079992,31024100,697104092,True,1
3396,validator_4,219287096616,True,662099998,10316460,672416458,True,6
3397,validator_1,389912387982,True,820340000,8306890,828646890,True,12
3398,validator_2,348568510700,True,644400000,3776110,648176110,False,10
3399,validator_43,84530702450,True,564400000,6301600,570701600,False,2
3400,validator_25,91058264709,True,457968005,6810960,464778965,True,2
3401,validator_13,132487082115,True,566920008,2132530,569052538,True,4
3402,validator_21,126803425540,True,701500000,4542910,706042910,False,3
3403,validator_30,86619836878,True,691899999,20777720,712677719,True,2
3404,validator_62,47080570380,True,684599997,773610,685373607,True,1
3405,validator_3,344055931770,True,647900000,3712210,651612210,False,10
3406,validator_54,42211793101,True,775300003,1985180,777285183,True,1
3407,validator_43,85074672930,True,537000000,6970480,543970480,False,2
3408,validator_0,366686284560,True,616579998,17743780,634323778,True,11
3409,validator_14,138128689693,True,783419999,32481450,815901449,True,4
3410,validator_1,390710685883,True,731080001,67217900,798297901,True,12
3411,validator_10,217254500380,True,541500000,2768200,544268200,False,6
3412,validator_12,121538796037,True,779400008,2027220,781427228,True,3
3413,validator_3,344771909670,True,708300000,7677900,715977900,False,10
3414,validator_32,87965526358,True,708400003,23995430,732395433,True,2
3415,validator_94,42218057680,True,609400000,2113990,611513990,False,1
3416,validator_1,391352961386,True,630080003,12195500,642275503,True,12
3417,validator_5,227262456163,True,666116002,52745000,718861002,True,7
3418,validator_19,119281812280,True,750100000,3120480,753220480,False,3
3419,validator_55,40026452705,True,571900002,12428730,584328732,True,1
3420,validator_4,219956613276,True,664860000,4656660,669516660,True,6
3421,validator_9,223060279630,True,472000000,9968930,481968930,False,6
3422,validator_46,41164715844,True,786440002,19531070,805971072,True,1
3423,validator_14,138776850298,True,620839995,27320610,648160605,True,4
3424,validator_41,86267037120,True,624300000,38220830,662520830,False,2
3425,validator_18,124446849230,True,748100000,1873050,749973050,False,3
3426,validator_10,217958081680,True,683200000,20381300,703581300,False,6
3427,validator_7,231352259807,True,823120008,31586050,854706058,True,7
3428,validator_60,46411978813,True,898480000,14538120,913018120,True,1
3429,validator_91,40400015300,True,536100000,4553230,540653230,False,1
3430,validator_21,127198177320,True,383800000,10951780,394751780,False,3
3431,validator_2,349156599100,True,586700000,1388400,588088400,False,10
3432,validator_3,345326361690,True,553700000,752020,554452020,False,10
3433,validator_0,367283268373,True,583939993,13043820,596983813,True,11
3434,validator_63,45444344081,True,899400004,3744370,903144374,True,1
3435,validator_8,209635515750,True,441300000,21710580,463010580,False,6
3436,validator_0,368036119703,True,722594000,30257330,752851330,True,11
3437,validator_43,85671143530,True,588500000,7970600,596470600,False,2
3438,validator_3,345933660170,True,599400000,7898480,607298480,False,10
3439,validator_17,134872340777,True,516540001,29286320,545826321,True,4
3440,validator_31,87081228373,True,802999996,24223890,827223886,True,2
3441,validator_1,392342295664,True,970739998,18594280,989334278,True,12
3442,validator_15,131857901206,True,713406000,45604130,759010130,True,4
3443,validator_1,393228951773,True,829579999,57076110,886656109,True,12
3444,validator_66,45521993188,True,574520002,20484550,595004552,True,1
3445,validator_29,87275658408,True,568640004,5225860,573865864,True,2
3446,validator_0,369007986098,True,925099995,46766400,971866395,True,11
3447,validator_94,43035760720,True,780700000,37003040,817703040,False,1
3448,validator_23,121592475710,True,774000000,2623760,776623760,False,3
3449,validator_15,132570115007,True,701700001,10513800,712213801,True,4
3450,validator_35,83102291580,True,519900000,5640900,525540900,False,2
3451,validator_97,44434078660,True,795400000,1557140,796957140,False,1
3452,validator_49,44099714981,True,882100000,3656100,885756100,True,1
3453,validator_16,124903455203,True,596270002,26791130,623061132,True,3
3454,validator_28,85118529488,True,626500000,21228300,647728300,True,2
3455,validator_2,349594824640,True,430140000,8085540,438225540,False,10
3456,validator_2,350312113710,True,706900000,10389070,717289070,False,10
3457,validator_33,89596734764,True,558320000,3529270,561849270,True,2
3458,validator_5,228208850089,True,918359996,28033930,946393926,True,7
3459,validator_36,85875409980,True,436900000,1722230,438622230,False,2
3460,validator_57,47219434211,True,659780004,9228860,669008864,True,1
3461,validator_5,228707483109,True,496500000,2133020,498633020,True,7
3462,validator_4,220609890774,True,646539998,6737500,653277498,True,6
3463,validator_28,85790342588,True,669400010,2413090,671813100,True,2
3464,validator_77,40516971310,True,454180000,4447590,458627590,False,1
3465,validator_2,350811994900,True,497600000,2281190,499881190,False,10
3466,validator_1,393690952375,True,415160002,46840600,462000602,True,12
3467,validator_84,40350470970,True,531000000,5658040,536658040,False,1
3468,validator_2,351389241640,True,555700000,21546740,577246740,False,10
3469,validator_4,221131268175,True,497146001,24231400,521377401,True,6
3470,validator_11,220937840090,True,418100000,3601100,421701100,False,6
3471,validator_15,133143069699,True,565064002,7890690,572954692,True,4
3472,validator_0,369755495201,True,726580003,20929100,747509103,True,11
3473,validator_3,346462372400,True,525500000,3212230,528712230,False,10
3474,validator_3,347109831420,True,625400000,22059020,647459020,False,10
3475,validator_10,218382732500,True,422700000,1950820,424650820,False,6
3476,validator_16,125796156810,True,861679997,31021610,892701607,True,3
3477,validator_26,78948219407,True,881970002,23970280,905940282,True,2
3478,validator_68,40955268786,True,570539997,12608540,583148537,True,1
3479,validator_48,44107804311,True,658500000,4225730,662725730,True,1
3480,validator_8,210304656770,True,655600000,13541020,669141020,False,6
3481,validator_9,223635323590,True,572800000,2243960,575043960,False,6
3482,validator_31,87769521207,True,684800004,3492830,688292834,True,2
3483,validator_42,83724420260,True,600600000,779200,601379200,False,2
3484,validator_1,394408382379,True,696240004,21190000,717430004,True,12
3485,validator_37,79053716760,True,654000000,19939360,673939360,False,2
3486,validator_11,221452578010,True,494300000,20437920,514737920,False,6
3487,validator_22,129868219610,True,507500000,1964340,509464340,False,4
3488,validator_31,88275078309,True,496500002,9057100,505557102,True,2
3489,validator_52,44376176470,True,890899997,2933300,893833297,True,1
3490,validator_3,347655991220,True,537700000,8459800,546159800,False,10
3491,validator_11,221977420820,True,520900000,3942810,524842810,False,6
3492,validator_1,395136111847,True,724099998,3629470,727729468,True,12
3493,validator_68,41599200016,True,623800000,20131230,643931230,True,1
3494,validator_45,43430232021,True,595840002,16832160,612672162,True,1
3495,validator_78,40395064170,True,476100000,12817730,488917730,False,1
3496,validator_9,224244616190,True,607200000,2092600,609292600,False,7
3497,validator_15,133849373798,True,702539999,3764100,706304099,True,4
3498,validator_81,39164294250,True,708900000,11972030,720872030,False,1
3499,validator_47,45862547728,True,620899998,5659570,626559568,True,1
3500,validator_81,39771173740,True,599100000,7779490,606879490,False,1
3501,validator_24,83324528805,True,572039999,8925240,580965239,True,2
3502,validator_20,124583032400,True,552000000,8832400,560832400,False,3
3503,validator_23,122136462140,True,540900000,3086430,543986430,False,3
3504,validator_4,221759207206,True,603200001,24739030,627939031,True,6
3505,validator_2,351931948270,True,540100000,2606630,542706630,False,10
3506,validator_7,231857487305,True,470929998,34297500,505227498,True,7
3507,validator_32,88763306020,True,717440002,80339660,797779662,True,2
3508,validator_73,39967184080,True,543300000,1342870,544642870,False,1
3509,validator_0,370198902843,True,405520002,37887640,443407642,True,11
3510,validator_3,348347525950,True,660200000,31334730,691534730,False,10
3511,validator_19,119826113310,True,542400000,1901030,544301030,False,3
3512,validator_44,38730425971,True,636368007,25651080,662019087,True,1
3513,validator_58,45272940521,True,743219999,6415230,749635229,True,1
3514,validator_9,224781685760,True,526700000,10369570,537069570,False,7
3515,validator_75,41622979220,True,714200000,20299400,734499400,False,1
3516,validator_9,225416053860,True,608300000,26068100,634368100,False,7
3517,validator_4,222531621003,True,736719997,35693800,772413797,True,6
3518,validator_2,352593108010,True,641000000,20159740,661159740,False,11
3519,validator_7,232698591990,True,805288005,35816680,841104685,True,7
3520,validator_2,353163546910,True,568000000,2438900,570438900,False,11
3521,validator_53,39464696268,True,744760003,39859350,784619353,True,1
3522,validator_40,80888564280,True,471700000,2146780,473846780,False,2
3523,validator_28,86894419301,True,1081320003,22756710,1104076713,True,2
3524,validator_10,219119666060,True,727100000,9833560,736933560,False,6
3525,validator_87,44273537750,True,544000000,23714260,567714260,False,1
3526,validator_89,44576794880,True,585500000,7341540,592841540,False,1
3527,validator_19,120610303950,True,764200000,19990640,784190640,False,3
3528,validator_28,87713561062,True,794639991,24501770,819141761,True,2
3529,validator_48,44816336537,True,676959996,31572230,708532226,True,1
3530,validator_41,86820374250,True,551500000,1837130,553337130,False,2
3531,validator_21,127607634800,True,406500000,2957480,409457480,False,3
3532,validator_62,47836399713,True,752000003,3829330,755829333,True,1
3533,validator_19,121278140510,True,666500000,1336560,667836560,False,3
3534,validator_20,125120933040,True,536600000,1300640,537900640,False,3
3535,validator_15,134593112058,True,713320000,30418260,743738260,True,4
3536,validator_13,133152817748,True,644599993,21135640,665735633,True,4
3537,validator_55,41033314925,True,997200000,9662220,1006862220,True,1
3538,validator_92,35881945230,True,459400000,3597940,462997940,False,1
3539,validator_57,47724147251,True,486966000,17747040,504713040,True,1
3540,validator_5,229517889850,True,779000001,31406740,810406741,True,7
3541,validator_28,88411878067,True,677120005,21197000,698317005,True,2
3542,validator_15,135264973951,True,665267993,6593900,671861893,True,4
3543,validator_21,128384512900,True,774100000,2778100,776878100,False,4
3544,validator_17,135644608104,True,737199997,35067330,772267327,True,4
3545,validator_10,219624322260,True,501400000,3256200,504656200,False,6
3546,validator_6,219886295676,True,760800000,2540470,763340470,True,6
3547,validator_6,220597219198,True,708500002,2423520,710923522,True,6
3548,validator_5,230230036332,True,698320002,13826480,712146482,True,7
3549,validator_99,39305212110,True,653700000,1077940,654777940,False,1
3550,validator_0,370927617287,True,725900004,2814440,728714444,True,11
3551,validator_5,230953645579,True,672560007,51049240,723609247,True,7
3552,validator_93,40498325760,True,589000000,1773120,590773120,False,1
3553,validator_6,221402547686,True,771529998,33798490,805328488,True,6
3554,validator_3,348904793450,True,552000000,5267500,557267500,False,10
3555,validator_11,222410426620,True,428100000,4905800,433005800,False,6
3556,validator_89,45185007250,True,606800000,1412370,608212370,False,1
3557,validator_9,225869509230,True,434200000,19255370,453455370,False,7
3558,validator_22,130527843890,True,652700000,6924280,659624280,False,4
3559,validator_5,231528954001,True,556319992,18988430,575308422,True,7
3560,validator_15,135991179203,True,719519992,6685260,726205252,True,4
3561,validator_7,233203078386,True,493299996,11186400,504486396,True,7
3562,validator_28,88954885571,True,531464004,11543500,543007504,True,2
3563,validator_44,39364997175,True,629300004,5271200,634571204,True,1
3564,validator_64,46626968463,True,889119999,7739700,896859699,True,1
3565,validator_26,79729699863,True,768739996,12740460,781480456,True,2
3566,validator_16,126568124990,True,745074000,26894180,771968180,True,3
3567,validator_66,46169228581,True,625279993,21955400,647235393,True,1
3568,validator_3,349492966890,True,579500000,8673440,588173440,False,10
3569,validator_1,395775371699,True,637000012,2259840,639259852,True,12
3570,validator_15,136552575329,True,541600006,19796120,561396126,True,4
3571,validator_91,40892435200,True,489900000,2519900,492419900,False,1
3572,validator_1,396595768497,True,775799998,44596800,820396798,True,12
3573,validator_13,133798456178,True,639100000,6538430,645638430,True,4
3574,validator_39,89917766490,True,530100000,2600530,532700530,False,2
3575,validator_19,122036243110,True,755300000,2802600,758102600,False,3
3576,validator_2,353772401520,True,581300000,27554610,608854610,False,11
3577,validator_3,349966454130,True,470300000,3187240,473487240,False,10
3578,validator_9,226549516430,True,659000000,21007200,680007200,False,7
3579,validator_0,371550212219,True,597320002,25274930,622594932,True,11
3580,validator_68,42311018318,True,700940002,10878300,711818302,True,1
3581,validator_14,139422887728,True,617360000,28677430,646037430,True,4
3582,validator_42,84368368760,True,606500000,37448500,643948500,False,2
3583,validator_14,140291802029,True,866000001,2914300,868914301,True,4
3584,validator_76,42964802790,True,678800000,4198580,682998580,False,1
3585,validator_35,83867188880,True,762900000,1997300,764897300,False,2
3586,validator_6,222049872264,True,631196008,16128570,647324578,True,6
3587,validator_24,84078399930,True,727539995,26331130,753871125,True,2
3588,validator_21,128819936250,True,415630000,19793350,435423350,False,4
3589,validator_86,41635814730,True,631500000,2408510,633908510,False,1
3590,validator_45,44205391363,True,748896002,26263340,775159342,True,1
3591,validator_3,350634487270,True,666600000,1433140,668033140,False,10
3592,validator_79,42912172990,True,464500000,2600780,467100780,False,1
3593,validator_3,351365418030,True,711600000,19330760,730930760,False,10
3594,validator_89,45719567050,True,530500000,4059800,534559800,False,1
3595,validator_64,47423242363,True,784140000,12133900,796273900,True,1
3596,validator_97,45240332790,True,802200000,4054130,806254130,False,1
3597,validator_80,39422165590,True,556000000,1629140,557629140,False,1
3598,validator_30,87275751169,True,628540001,27374290,655914291,True,2
3599,validator_7,233849195985,True,615099999,31017600,646117599,True,7
3600,validator_2,354340400260,True,546900000,21098740,567998740,False,11
3601,validator_15,137158445731,True,577606002,28264400,605870402,True,4
3602,validator_5,232364238976,True,831000005,4284970,835284975,True,7
3603,validator_66,47071904101,True,894900000,7775520,902675520,True,1
3604,validator_40,81345946780,True,456400000,982500,457382500,False,2
3605,validator_76,43540631430,True,567700000,8128640,575828640,False,1
3606,validator_3,352214350930,True,847300000,1632900,848932900,False,11
3607,validator_88,41842475880,True,517700000,1392030,519092030,False,1
3608,validator_1,397379430120,True,763240003,20421620,783661623,True,12
3609,validator_46,41862453745,True,691900001,5837900,697737901,True,1
3610,validator_11,222866671810,True,452400000,3845190,456245190,False,6
3611,validator_5,233160919541,True,783709995,12970570,796680565,True,7
3612,validator_56,49357226462,True,715598002,15525700,731123702,True,1
3613,validator_33,90243482653,True,616260009,30487880,646747889,True,2
3614,validator_38,81995717490,True,632800000,3698900,636498900,False,2
3615,validator_23,122798122830,True,659100000,2560690,661660690,False,3
3616,validator_25,91700428107,True,615019998,27143400,642163398,True,2
3617,validator_56,50146314461,True,761439999,27648000,789087999,True,1
3618,validator_1,398292062233,True,844643993,67988120,912632113,True,12
3619,validator_41,87458553750,True,622700000,15479500,638179500,False,2
3620,validator_31,89309870742,True,955740003,79052430,1034792433,True,2
3621,validator_6,222840384039,True,779039995,11471780,790511775,True,6
3622,validator_74,39011551770,True,568100000,8696530,576796530,False,1
3623,validator_26,80498941703,True,766900000,2341840,769241840,True,2
3624,validator_20,125780546640,True,618600000,41013600,659613600,False,3
3625,validator_20,126352570440,True,566770000,5253800,572023800,False,3
3626,validator_10,220196793360,True,570500000,1971100,572471100,False,6
3627,validator_33,90916520291,True,649239998,23797640,673037638,True,2
3628,validator_30,87906472568,True,593699999,37021400,630721399,True,2
3629,validator_21,129209754680,True,387550000,2268430,389818430,False,4
3630,validator_1,399229072455,True,908399992,28610230,937010222,True,12
3631,validator_3,352839297230,True,622100000,2846300,624946300,False,11
3632,validator_29,87855112859,True,559500001,19954450,579454451,True,2
3633,validator_73,40569522880,True,587500000,14838800,602338800,False,1
3634,validator_52,45030618663,True,613979993,40462200,654442193,True,1
3635,validator_18,124960824130,True,512060000,1914900,513974900,False,3
3636,validator_0,372314468644,True,737699995,26556430,764256425,True,11
3637,validator_9,227062245150,True,498300000,14428720,512728720,False,7
3638,validator_51,41915328365,True,496639999,6640330,503280329,True,1
3639,validator_3,353381526530,True,540300000,1929300,542229300,False,11
3640,validator_44,40167409708,True,788960013,13452520,802412533,True,1
3641,validator_9,227697830790,True,634200000,1385640,635585640,False,7
3642,validator_3,354009636780,True,626700000,1410250,628110250,False,11
3643,validator_34,87247045870,True,575300000,37763770,613063770,False,2
3644,validator_40,81988879480,True,634600000,8332700,642932700,False,2
3645,validator_76,44100308960,True,553100000,6577530,559677530,False,1
3646,validator_31,90190111638,True,792025996,88214900,880240896,True,2
3647,validator_80,39904791550,True,480100000,2525960,482625960,False,1
3648,validator_3,354671612050,True,641000000,20975270,661975270,False,11
3649,validator_27,85604369688,True,891600006,8139340,899739346,True,2
3650,validator_32,89445480592,True,660799992,21374580,682174572,True,2
3651,validator_63,46266359705,True,815260004,6755620,822015624,True,1
3652,validator_18,125662858890,True,700600000,1434760,702034760,False,3
3653,validator_9,228223549340,True,524400000,1318550,525718550,False,7
3654,validator_11,223531953600,True,654600000,10681790,665281790,False,6
3655,validator_3,355482849390,True,810100000,1137340,811237340,False,11
3656,validator_22,131229084770,True,677900000,23340880,701240880,False,4
3657,validator_7,234602682193,True,721100008,32386200,753486208,True,7
3658,validator_35,84354002090,True,477500000,9313210,486813210,False,2
3659,validator_4,223103567968,True,552453995,19492970,571946965,True,6
3660,validator_1,399936916079,True,665720004,42123620,707843624,True,12
3661,validator_61,46035948536,True,701100003,3444770,704544773,True,1
3662,validator_0,373058121466,True,741700002,1952820,743652822,True,11
3663,validator_56,50772621179,True,612659998,13646720,626306718,True,1
3664,validator_2,354969914790,True,627900000,1614530,629514530,False,11
3665,validator_6,223359887365,True,491099996,28403330,519503326,True,6
3666,validator_14,141172075271,True,825280002,54993240,880273242,True,4
3667,validator_8,210999120300,True,692900000,1563530,694463530,False,6
3668,validator_7,235573224517,True,950140004,20402320,970542324,True,7
3669,validator_14,141983031305,True,784900004,26056030,810956034,True,4
3670,validator_39,90658708790,True,736400000,4542300,740942300,False,2
3671,validator_8,211566441840,True,564400000,2921540,567321540,False,6
3672,validator_38,82548616420,True,551600000,1298930,552898930,False,2
3673,validator_34,87812273440,True,562400000,2827570,565227570,False,2
3674,validator_17,136489878062,True,838799998,6469960,845269958,True,4
3675,validator_18,126213600020,True,538100000,12641130,550741130,False,3
3676,validator_13,134424098073,True,580163995,45477900,625641895,True,4
3677,validator_25,92339128135,True,614499998,24200030,638700028,True,2
3678,validator_5,234137034163,True,927160002,48954620,976114622,True,7
3679,validator_1,400721250079,True,764400000,19934000,784334000,True,12
3680,validator_77,40986593490,True,467400000,2222180,469622180,False,1
3681,validator_0,373588022008,True,515620002,14280540,529900542,True,11
3682,validator_17,137246376141,True,701715999,54782080,756498079,True,4
3683,validator_33,91540406898,True,581670007,42216600,623886607,True,2
3684,validator_7,236182810419,True,594898002,14687900,609585902,True,7
3685,validator_11,224207800820,True,651700000,24147220,675847220,False,7
3686,validator_1,401436755774,True,710440005,5065690,715505695,True,12
3687,validator_2,355639339640,True,666800000,2624850,669424850,False,11
3688,validator_12,122122905343,True,572919996,11189310,584109306,True,3
3689,validator_4,223553631909,True,448400001,1663940,450063941,True,6
3690,validator_20,127050160810,True,683970000,13620370,697590370,False,3
3691,validator_50,44387413028,True,570970000,37931030,608901030,True,1
3692,validator_14,142603726522,True,617559997,3135220,620695217,True,4
3693,validator_70,42182611760,True,672794008,23602220,696396228,True,1
3694,validator_63,47127585529,True,857299994,3925830,861225824,True,1
3695,validator_6,224043952904,True,659859999,24205540,684065539,True,7
3696,validator_59,40007686242,True,607440001,17659000,625099001,True,1
3697,validator_10,220763945270,True,546300000,20851910,567151910,False,6
3698,validator_41,88257681300,True,797600000,1527550,799127550,False,2
3699,validator_43,86286780750,True,608300000,7337220,615637220,False,2
3700,validator_7,236863118651,True,666640002,13668230,680308232,True,7
3701,validator_2,356140766840,True,498100000,3327200,501427200,False,11
3702,validator_43,86876514330,True,589000000,733580,589733580,False,2
3703,validator_94,43600142400,True,558700000,5681680,564381680,False,1
3704,validator_10,221286754850,True,513300000,9509580,522809580,False,6
3705,validator_2,356743044760,True,582900000,19377920,602277920,False,11
3706,validator_21,129737284890,True,523600000,3930210,527530210,False,4
3707,validator_40,82490175580,True,496900000,4396100,501296100,False,2
3708,validator_60,47337756583,True,904500000,21277770,925777770,True,1
3709,validator_1,402296192754,True,852053990,7382990,859436980,True,12
3710,validator_7,237516313150,True,615577999,37616500,653194499,True,7
3711,validator_76,44774251880,True,671200000,2742920,673942920,False,1
3712,validator_34,88416377800,True,601800000,2304360,604104360,False,2
3713,validator_88,42367940700,True,501500000,23964820,525464820,False,1
3714,validator_16,127328271138,True,734819998,25326150,760146148,True,3
3715,validator_14,143307756507,True,673636005,30393980,704029985,True,4
3716,validator_3,356046399430,True,553400000,10150040,563550040,False,11
3717,validator_34,89007613720,True,587000000,4235920,591235920,False,2
3718,validator_13,135206155572,True,752879999,29177500,782057499,True,4
3719,validator_36,86415078880,True,529900000,9768900,539668900,False,2
3720,validator_31,90824452841,True,623726003,10615200,634341203,True,2
3721,validator_24,84810920229,True,729799999,2720300,732520299,True,2
3722,validator_14,143968148308,True,641600001,18791800,660391801,True,4
3723,validator_0,374443787369,True,834720001,21045360,855765361,True,11
3724,validator_46,42382757509,True,509900004,10403760,520303764,True,1
3725,validator_26,81262424403,True,758358000,5124700,763482700,True,2
3726,validator_25,93236731603,True,896100008,1503460,897603468,True,2
3727,validator_75,42343807920,True,709900000,10928700,720828700,False,1
3728,validator_9,228973103050,True,729700000,19853710,749553710,False,7
3729,validator_6,224797224446,True,734480002,18791540,753271542,True,7
3730,validator_3,356680587120,True,613600000,20587690,634187690,False,11
3731,validator_69,41174106578,True,703940001,12323500,716263501,True,1
3732,validator_11,224889631320,True,669800000,12030500,681830500,False,7
3733,validator_29,88700544696,True,808039997,37391840,845431837,True,2
3734,validator_72,41797676200,True,464600000,2383570,466983570,False,1
3735,validator_9,229530237770,True,555700000,1434720,557134720,False,7
3736,validator_58,45956628460,True,645139999,38547940,683687939,True,1
3737,validator_15,137642484531,True,477640000,6398800,484038800,True,4
3738,validator_0,375035461672,True,570460003,21214300,591674303,True,11
3739,validator_45,45077611252,True,840099989,32119900,872219889,True,1
3740,validator_9,230065727650,True,533700000,1789880,535489880,False,7
3741,validator_99,39787257710,True,478700000,3345600,482045600,False,1
3742,validator_58,46590878471,True,593680001,40570010,634250011,True,1
3743,validator_10,221859823550,True,567000000,6068700,573068700,False,6
3744,validator_12,122784810034,True,658140001,3764690,661904691,True,3
3745,validator_33,92181806997,True,624839999,16560100,641400099,True,2
3746,validator_1,403191057417,True,887296003,7568660,894864663,True,12
3747,validator_34,89545753920,True,535400000,2740200,538140200,False,2
3748,validator_12,123574466758,True,766220004,23436720,789656724,True,3
3749,validator_22,132077092290,True,841500000,6507520,848007520,False,4
3750,validator_28,89554725100,True,554535999,45303530,599839529,True,2
3751,validator_73,41121934550,True,547700000,4711670,552411670,False,1
3752,validator_43,87535225570,True,655100000,3611240,658711240,False,2
3753,validator_4,224294832910,True,714000001,27201000,741201001,True,7
3754,validator_39,91196277230,True,517700000,19868440,537568440,False,2
3755,validator_0,375714848863,True,650060001,29327190,679387191,True,11
3756,validator_41,88750569370,True,491700000,1188070,492888070,False,2
3757,validator_3,357365093000,True,681000000,3505880,684505880,False,11
3758,validator_1,403927223335,True,711939998,24225920,736165918,True,12
3759,validator_8,212101927160,True,514500000,20985320,535485320,False,6
3760,validator_72,42489267530,True,688500000,3091330,691591330,False,1
3761,validator_11,225430446830,True,531000000,9815510,540815510,False,7
3762,validator_3,357997873320,True,613300000,19480320,632780320,False,11
3763,validator_79,43429823870,True,506900000,10750880,517650880,False,1
3764,validator_6,225294395592,True,474020006,23151140,497171146,True,7
3765,validator_1,404536444840,True,607500005,1721500,609221505,True,12
3766,validator_3,358505313240,True,504100000,3339920,507439920,False,11
3767,validator_19,122599135840,True,554000000,8892730,562892730,False,3
3768,validator_77,41498112000,True,509800000,1718510,511518510,False,1
3769,validator_10,222419714660,True,557900000,1991110,559891110,False,6
3770,validator_26,81875617906,True,611500003,1693500,613193503,True,2
3771,validator_11,226136767160,True,698500000,7820330,706320330,False,7
3772,validator_56,51419687901,True,627399992,19666730,647066722,True,1
3773,validator_5,234765602606,True,621019993,7548450,628568443,True,7
3774,validator_35,84952382390,True,591600000,6780300,598380300,False,2
3775,validator_22,132446203920,True,365400000,3711630,369111630,False,4
3776,validator_7,238073142994,True,546820004,10009840,556829844,True,7
3777,validator_0,376508223984,True,790900001,2475120,793375121,True,11
3778,validator_41,89347161240,True,592970000,3621870,596591870,False,2
3779,validator_17,137973773244,True,698680003,28717100,727397103,True,4
3780,validator_88,43032210860,True,662500000,1770160,664270160,False,1
3781,validator_4,225074547051,True,743412001,36302140,779714141,True,7
3782,validator_7,238911531298,True,808439994,29948310,838388304,True,7
3783,validator_62,48626388277,True,765020004,24968560,789988564,True,1
3784,validator_1,405311508094,True,772099994,2963260,775063254,True,12
3785,validator_96,43377273470,True,735000000,13151620,748151620,False,1
3786,validator_49,44777750476,True,657179995,20855500,678035495,True,1
3787,validator_19,123295105840,True,687900000,8070000,695970000,False,3
3788,validator_5,235711965482,True,919259996,27102880,946362876,True,7
3789,validator_35,85540740520,True,584300000,4058130,588358130,False,2
3790,validator_2,357233916530,True,453200000,37671770,490871770,False,11
3791,validator_22,133064130580,True,615400000,2526660,617926660,False,4
3792,validator_2,357634113620,True,397400000,2797090,400197090,False,11
3793,validator_37,79632383360,True,576600000,2066600,578666600,False,2
3794,validator_81,40335540680,True,563500000,866940,564366940,False,1
3795,validator_3,358900459930,True,393800000,1346690,395146690,False,11
3796,validator_3,359669614550,True,768200000,954620,769154620,False,11
3797,validator_3,360454849680,True,784500000,735130,785235130,False,11
3798,validator_85,41028070570,True,574700000,4057910,578757910,False,1
3799,validator_30,88808070469,True,843260001,58337900,901597901,True,2
3800,validator_23,123630878250,True,828700000,4055420,832755420,False,3
3801,validator_39,91764694260,True,555800000,12617030,568417030,False,2
3802,validator_26,82329597543,True,430199997,23779640,453979637,True,2
3803,validator_9,230620994220,True,549800000,5466570,555266570,False,7
3804,validator_26,83292840624,True,921860001,41383080,963243081,True,2
3805,validator_93,41154905410,True,623500000,33079650,656579650,False,1
3806,validator_38,83127770120,True,558700000,20453700,579153700,False,2
3807,validator_10,223116555360,True,695300000,1540700,696840700,False,6
3808,validator_4,225838769472,True,756900001,7322420,764222421,True,7
3809,validator_0,377181854922,True,665919998,7710940,673630938,True,11
3810,validator_8,212597940560,True,469890000,26123400,496013400,False,6
3811,validator_1,405921914784,True,609000000,1406690,610406690,True,12
3812,validator_44,41075389417,True,877013999,30965710,907979709,True,1
3813,validator_36,87020592540,True,585600000,19913660,605513660,False,2
3814,validator_35,86092366320,True,520900000,30725800,551625800,False,2
3815,validator_2,358261047190,True,625500000,1433570,626933570,False,11
3816,validator_87,44927630700,True,633200000,20892950,654092950,False,1
3817,validator_21,130340231290,True,594600000,8346400,602946400,False,4
3818,validator_6,226134812233,True,802670001,37746640,840416641,True,7
3819,validator_66,47664503794,True,568719993,23879700,592599693,True,1
3820,validator_2,358903696090,True,622100000,20548900,642648900,False,11
3821,validator_72,42931270470,True,440000000,2002940,442002940,False,1
3822,validator_2,359677955410,True,764400000,9859320,774259320,False,11
3823,validator_22,133536655220,True,468600000,3924640,472524640,False,4
3824,validator_4,226358875768,True,495819996,24286300,520106296,True,7
3825,validator_3,361043766980,True,567900000,21017300,588917300,False,11
3826,validator_1,406711472568,True,757418004,32139780,789557784,True,12
3827,validator_61,46429131260,True,384220004,8962720,393182724,True,1
3828,validator_1,407426547766,True,707899998,7175200,715075198,True,12
3829,validator_71,46886442269,True,727600000,3377050,730977050,True,1
3830,validator_96,43921964940,True,515300000,29391470,544691470,False,1
3831,validator_10,223800771560,True,679100000,5116200,684216200,False,6
3832,validator_33,93046110974,True,808219997,56083980,864303977,True,2
3833,validator_5,236439884674,True,718840002,9079190,727919192,True,7
3834,validator_47,46849881163,True,955877995,31455440,987333435,True,1
3835,validator_37,80257763970,True,618100000,7280610,625380610,False,2
3836,validator_57,48389510983,True,633860002,31503730,665363732,True,1
3837,validator_2,360390372550,True,710400000,2017140,712417140,False,11
3838,validator_2,361033011050,True,634100000,8538500,642638500,False,11
3839,validator_91,41624812230,True,722600000,9777030,732377030,False,1
3840,validator_6,226830016433,True,685600000,9604200,695204200,True,7
3841,validator_23,124216162990,True,582600000,2684740,585284740,False,3
3842,validator_67,44644924565,True,653540003,48677820,702217823,True,1
3843,validator_42,84915074960,True,532840000,13866200,546706200,False,2
3844,validator_98,39798197360,True,698000000,3496140,701496140,False,1
3845,validator_7,239708178925,True,772979997,23667630,796647627,True,7
3846,validator_6,227583566138,True,716504005,37045700,753549705,True,7
3847,validator_24,85578624370,True,740540001,27164140,767704141,True,2
3848,validator_94,44331717670,True,722000000,9575270,731575270,False,1
3849,validator_0,377893569319,True,682859997,28854400,711714397,True,11
3850,validator_1,408219367271,True,735560005,57259500,792819505,True,12
3851,validator_8,213071589950,True,472640000,1009390,473649390,False,6
3852,validator_17,138708119819,True,706120005,28226570,734346575,True,4
3853,validator_3,361823047780,True,775600000,3680800,779280800,False,11
3854,validator_15,138376848164,True,717120003,17243630,734363633,True,4
3855,validator_15,139074759124,True,655339990,42570970,697910960,True,4
3856,validator_4,227234035564,True,831369996,43789800,875159796,True,7
3857,validator_43,88227037510,True,671700000,20111940,691811940,False,2
3858,validator_7,240649793850,True,917040005,24574920,941614925,True,7
3859,validator_0,378543616904,True,624120005,25927580,650047585,True,11
3860,validator_71,47803436866,True,904339997,12654600,916994597,True,1
3861,validator_3,362521644550,True,695000000,3596770,698596770,False,11
3862,validator_25,93927749710,True,688200007,2818100,691018107,True,2
3863,validator_52,45666000705,True,631540002,3842040,635382042,True,1
3864,validator_93,41859462470,True,685000000,19557060,704557060,False,1
3865,validator_4,228211147732,True,943556008,33556160,977112168,True,7
3866,validator_13,135714019713,True,488620001,19244140,507864141,True,4
3867,validator_4,228893058027,True,645059995,36850300,681910295,True,7
3868,validator_4,229489783957,True,565368000,31357930,596725930,True,7
3869,validator_20,127711829870,True,658800000,2869060,661669060,False,3
3870,validator_76,45504976570,True,724600000,6124690,730724690,False,1
3871,validator_1,408933018429,True,673359998,40291160,713651158,True,12
3872,validator_73,41696292250,True,548500000,25857700,574357700,False,1
3873,validator_25,94691143512,True,757120002,6273800,763393802,True,2
3874,validator_4,230328994641,True,799399994,39810690,839210684,True,7
3875,validator_73,42132383110,True,416210000,19880860,436090860,False,1
3876,validator_36,87574312970,True,551000000,2720430,553720430,False,2
3877,validator_3,363131675130,True,608200000,1830580,610030580,False,11
3878,validator_66,48501974144,True,811700000,25770350,837470350,True,1
3879,validator_68,43002205422,True,684739984,6447120,691187104,True,1
3880,validator_21,130839024080,True,496600000,2192790,498792790,False,4
3881,validator_0,379267646560,True,721400006,2629650,724029656,True,11
3882,validator_30,89517422190,True,700780001,8571720,709351721,True,2
3883,validator_4,231191708835,True,842099994,20614200,862714194,True,7
3884,validator_6,228545803442,True,935840004,26397300,962237304,True,7
3885,validator_2,361634738600,True,597700000,4027550,601727550,False,11
3886,validator_76,46219705870,True,705400000,9329300,714729300,False,1
3887,validator_82,41320856750,True,571200000,2077400,573277400,False,1
3888,validator_5,236941984299,True,474984005,27115620,502099625,True,7
3889,validator_11,226828502900,True,686200000,5535740,691735740,False,7
3890,validator_15,139667817167,True,580339993,12718050,593058043,True,4
3891,validator_39,92546378960,True,761200000,20484700,781684700,False,2
3892,validator_11,227476525190,True,643700000,4322290,648022290,False,7
3893,validator_68,43839949946,True,834400004,3344520,837744524,True,1
3894,validator_52,46382764003,True,697119998,19643300,716763298,True,1
3895,validator_88,43671492750,True,633800000,5481890,639281890,False,1
3896,validator_0,379933177855,True,636379995,29151300,665531295,True,11
3897,validator_8,213790728970,True,712000000,7139020,719139020,False,6
3898,validator_3,363823925660,True,660200000,32050530,692250530,False,11
3899,validator_43,88806048230,True,575400000,3610720,579010720,False,2
3900,validator_6,229282437098,True,712059996,24573660,736633656,True,7
3901,validator_66,49303513997,True,796246003,5293850,801539853,True,1
3902,validator_2,362200083030,True,564300000,1044430,565344430,False,11
3903,validator_11,227995921030,True,512500000,6895840,519395840,False,7
3904,validator_36,88196180570,True,618100000,3767600,621867600,False,2
3905,validator_21,131269634670,True,426900000,3710590,430610590,False,4
3906,validator_21,131864293210,True,574200000,20458540,594658540,False,4
3907,validator_5,237682579707,True,708819998,31775410,740595408,True,7
3908,validator_5,238307429181,True,587050004,37799470,624849474,True,7
3909,validator_3,364418824890,True,591700000,3199230,594899230,False,11
3910,validator_13,136391626151,True,664559998,13046440,677606438,True,4
3911,validator_3,365049419200,True,628600000,1994310,630594310,False,11
3912,validator_38,83577392560,True,447000000,2622440,449622440,False,2
3913,validator_43,89362892630,True,549400000,7444400,556844400,False,2
3914,validator_77,42078216930,True,575800000,4304930,580104930,False,1
3915,validator_0,380483657257,True,540196002,10283400,550479402,True,11
3916,validator_0,381167493227,True,670720000,13115970,683835970,True,11
3917,validator_3,365647910140,True,595500000,2990940,598490940,False,11
3918,validator_82,41909296150,True,585900000,2539400,588439400,False,1
3919,validator_6,229973859120,True,667886002,23536020,691422022,True,7
3920,validator_15,140252469338,True,583200001,1452170,584652171,True,4
3921,validator_23,124768618290,True,543100000,9355300,552455300,False,3
3922,validator_16,128107929270,True,752580002,27078130,779658132,True,4
3923,validator_74,39650077450,True,605000000,33525680,638525680,False,1
3924,validator_86,42221308060,True,584430000,1063330,585493330,False,1
3925,validator_84,41078639260,True,716400000,11768290,728168290,False,1
3926,validator_0,381847581055,True,663519998,16567830,680087828,True,11
3927,validator_13,137169993567,True,728259996,50107420,778367416,True,4
3928,validator_22,134086286140,True,539800000,9830920,549630920,False,4
3929,validator_3,366359598980,True,708100000,3588840,711688840,False,11
3930,validator_0,382422460475,True,566579990,8299430,574879420,True,11
3931,validator_34,90084077540,True,503100000,35223620,538323620,False,2
3932,validator_5,238892425122,True,570958001,14037940,584995941,True,7
3933,validator_40,82969056600,True,477100000,1781020,478881020,False,2
3934,validator_97,45842082790,True,580800000,20950000,601750000,False,1
3935,validator_66,49873495814,True,543599997,26381820,569981817,True,1
3936,validator_9,231165565600,True,542800000,1771380,544571380,False,7
3937,validator_1,410051475864,True,1106320005,12137430,1118457435,True,12
3938,validator_15,141165957015,True,906399997,7087680,913487677,True,4
3939,validator_1,410568972508,True,513300004,4196640,517496644,True,12
3940,validator_15,142138717718,True,908936003,63824700,972760703,True,4
3941,validator_86,42900344790,True,676000000,3036730,679036730,False,1
3942,validator_22,134682825080,True,588500000,8038940,596538940,False,4
3943,validator_78,41075139760,True,677700000,2375590,680075590,False,1
3944,validator_4,231856371592,True,647439997,17222760,664662757,True,7
3945,validator_80,40493166650,True,585100000,3275100,588375100,False,1
3946,validator_66,50468770301,True,584599997,10674490,595274487,True,1
3947,validator_68,44384159772,True,500279996,43929830,544209826,True,1
3948,validator_29,89516062131,True,788440005,27077430,815517435,True,2
3949,validator_40,83635691550,True,658600000,8034950,666634950,False,2
3950,validator_1,411467416205,True,878865997,19577700,898443697,True,12
3951,validator_28,90050097084,True,487780004,7591980,495371984,True,2
3952,validator_52,47147520305,True,738504002,26252300,764756302,True,1
3953,validator_9,231743167070,True,574800000,2801470,577601470,False,7
3954,validator_56,52020072119,True,575599998,24784220,600384218,True,1
3955,validator_13,137767432043,True,577540006,19898470,597438476,True,4
3956,validator_54,42808370032,True,563020001,33556930,596576931,True,1
3957,validator_0,383423038652,True,948953997,51624180,1000578177,True,11
3958,validator_46,43251189709,True,831720000,36712200,868432200,True,1
3959,validator_3,366979635320,True,616900000,3136340,620036340,False,11
3960,validator_1,412048500601,True,536799996,44284400,581084396,True,12
3961,validator_14,144607618472,True,628660004,10810160,639470164,True,4
3962,validator_11,228541454760,True,543100000,2433730,545533730,False,7
3963,validator_71,48578172497,True,761480011,13255620,774735631,True,1
3964,validator_21,132583263370,True,716800000,2170160,718970160,False,4
3965,validator_10,224306603380,True,501800000,4031820,505831820,False,7
3966,validator_15,142830294948,True,689040000,2537230,691577230,True,4
3967,validator_2,362576948630,True,367800000,9065600,376865600,False,11
3968,validator_40,84260687970,True,601500000,23496420,624996420,False,2
3969,validator_9,232309764620,True,547400000,19197550,566597550,False,7
3970,validator_51,42581211465,True,659900000,5983100,665883100,True,1
3971,validator_1,412765110618,True,707759987,8850030,716610017,True,12
3972,validator_20,128177930690,True,464700000,1400820,466100820,False,4
3973,validator_1,413439830508,True,636100000,38619890,674719890,True,12
3974,validator_23,125601437720,True,832300000,519430,832819430,False,3
3975,validator_3,367826667950,True,827500000,19532630,847032630,False,11
3976,validator_12,124404860562,True,829600004,793800,830393804,True,3
3977,validator_43,89923698820,True,551500000,9306190,560806190,False,2
3978,validator_15,143465007564,True,590619996,44092620,634712616,True,4
3979,validator_48,45523332070,True,678439993,28555540,706995533,True,1
3980,validator_25,95231639610,True,518959998,21536100,540496098,True,2
3981,validator_0,384009595410,True,562659998,23896760,586556758,True,12
3982,validator_70,42766685886,True,581300006,2774120,584074126,True,1
3983,validator_11,229144830830,True,600500000,2876070,603376070,False,7
3984,validator_80,41041882410,True,546800000,1915760,548715760,False,1
3985,validator_23,126343066460,True,737800000,3828740,741628740,False,3
3986,validator_5,239467853638,True,573300006,2128510,575428516,True,7
3987,validator_42,85598364160,True,679700000,3589200,683289200,False,2
3988,validator_97,46471770140,True,626500000,3187350,629687350,False,1
3989,validator_16,128751078606,True,630139996,13009340,643149336,True,4
3990,validator_92,36660132160,True,758500000,19686930,778186930,False,1
3991,validator_28,90664301484,True,605300000,8904400,614204400,True,2
3992,validator_0,384825476029,True,759979999,55900620,815880619,True,12
3993,validator_6,230763141688,True,760000008,29282560,789282568,True,7
3994,validator_26,83893365733,True,580799999,19725110,600525109,True,2
3995,validator_24,86114497715,True,529999995,5873350,535873345,True,2
3996,validator_17,139575406811,True,821860002,45426990,867286992,True,4
3997,validator_5,240100364875,True,614679997,17831240,632511237,True,7
3998,validator_52,47640989838,True,490540003,2929530,493469533,True,1
3999,validator_32,90071289123,True,613966001,11842530,625808531,True,2
4000,validator_25,95900257715,True,666700005,1918100,668618105,True,2
4001,validator_14,145127256766,True,491679994,27958300,519638294,True,4
4002,validator_18,127029833300,True,811100000,5133280,816233280,False,3
4003,validator_0,385659342736,True,826739997,7126710,833866707,True,12
4004,validator_16,129426193891,True,671099995,4015290,675115285,True,4
4005,validator_21,133183375290,True,593200000,6911920,600111920,False,4
4006,validator_5,240698088673,True,578559998,19163800,597723798,True,7
4007,validator_0,386193002120,True,518780004,14879380,533659384,True,12
4008,validator_6,231529648725,True,738879997,27627040,766507037,True,7
4009,validator_18,127720754800,True,688900000,2021500,690921500,False,3
4010,validator_1,414256206991,True,792340003,24036480,816376483,True,12
4011,validator_2,363287083690,True,671900000,38235060,710135060,False,11
4012,validator_65,40550443994,True,701899996,23831870,725731866,True,1
4013,validator_60,48007192809,True,662440006,6996220,669436226,True,1
4014,validator_1,414925358895,True,655260004,13891900,669151904,True,12
4015,validator_2,363762031220,True,472800000,2147530,474947530,False,11
4016,validator_13,138339120173,True,510334000,61354130,571688130,True,4
4017,validator_12,125032636366,True,624400004,3375800,627775804,True,3
4018,validator_29,90285970927,True,750789996,19118800,769908796,True,2
4019,validator_8,214493235630,True,688000000,14506660,702506660,False,6
4020,validator_8,215134129730,True,629900000,10994100,640894100,False,6
4021,validator_14,145900270261,True,727839995,45173500,773013495,True,4
4022,validator_6,232391868321,True,858399996,3819600,862219596,True,7
4023,validator_21,133773640430,True,588400000,1865140,590265140,False,4
4024,validator_33,93616021963,True,559440009,10470980,569910989,True,2
4025,validator_96,44440221880,True,508900000,9356940,518256940,False,1
4026,validator_60,48653830909,True,639700000,6938100,646638100,True,1
4027,validator_49,45384870315,True,564299999,42819840,607119839,True,1
4028,validator_1,415646319003,True,693540008,27420100,720960108,True,12
4029,validator_27,86104818707,True,493499999,6949020,500449019,True,2
4030,validator_28,91328657109,True,646059995,18295630,664355625,True,2
4031,validator_7,241313072497,True,657099997,6178650,663278647,True,7
4032,validator_8,215843617960,True,660600000,48888230,709488230,False,6
4033,validator_7,241817439532,True,485425995,18941040,504367035,True,7
4034,validator_49,46073576450,True,671268005,17438130,688706135,True,1
4035,validator_17,140351526254,True,750240003,25879440,776119443,True,4
4036,validator_7,242745986915,True,884700003,43847380,928547383,True,7
4037,validator_10,225012188010,True,703800000,1784630,705584630,False,7
4038,validator_14,146670561640,True,757099999,13191380,770291379,True,4
4039,validator_66,50978845507,True,486578006,23497200,510075206,True,1
4040,validator_42,86256578360,True,655000000,3214200,658214200,False,2
4041,validator_32,90673910958,True,552759995,49861840,602621835,True,2
4042,validator_9,232822952870,True,497800000,15388250,513188250,False,7
4043,validator_2,364308514720,True,540000000,6483500,546483500,False,11
4044,validator_3,368419637540,True,590000000,2969590,592969590,False,11
4045,validator_89,46217199650,True,478900000,18732600,497632600,False,1
4046,validator_69,41796248980,True,607640012,14502390,622142402,True,1
4047,validator_11,229618305830,True,472300000,1175000,473475000,False,7
4048,validator_19,123772664050,True,474400000,3158210,477558210,False,3
4049,validator_5,241224708165,True,505839992,20779500,526619492,True,7
4050,validator_10,225572527730,True,559300000,1039720,560339720,False,7
4051,validator_1,416312169137,True,650120004,15730130,665850134,True,13
4052,validator_40,84806740380,True,536500000,9552410,546052410,False,2
4053,validator_1,416815270269,True,496280002,6821130,503101132,True,13
4054,validator_99,40315141140,True,518300000,9583430,527883430,False,1
4055,validator_1,417372009380,True,538340001,18399110,556739111,True,13
4056,validator_16,130056394947,True,627039996,3161060,630201056,True,4
4057,validator_37,80874034210,True,614400000,1870240,616270240,False,2
4058,validator_42,86648363660,True,389600000,2185300,391785300,False,2
4059,validator_30,89995680079,True,473739999,4517890,478257889,True,2
4060,validator_92,37250618060,True,586500000,3985900,590485900,False,1
4061,validator_1,418251233287,True,870239997,8983910,879223907,True,13
4062,validator_24,86594293249,True,470359994,9435540,479795534,True,2
4063,validator_35,86688195250,True,593400000,2428930,595828930,False,2
4064,validator_15,144153566662,True,686999988,1559110,688559098,True,4
4065,validator_9,233516472770,True,692400000,1119900,693519900,False,7
4066,validator_13,139041257501,True,690380008,11757320,702137328,True,4
4067,validator_8,216386059460,True,536500000,5941500,542441500,False,6
4068,validator_29,90895041753,True,606340006,2730820,609070826,True,2
4069,validator_2,365151194820,True,835200000,7480100,842680100,False,11
4070,validator_10,226293252310,True,719400000,1324580,720724580,False,7
4071,validator_1,418942485618,True,676960001,14292330,691252331,True,13
4072,validator_14,147432478742,True,735866002,26051100,761917102,True,4
4073,validator_77,42748795210,True,666400000,4178280,670578280,False,1
4074,validator_8,216933599680,True,545300000,2240220,547540220,False,6
4075,validator_22,135548434580,True,851500000,14109500,865609500,False,4
4076,validator_3,369020299280,True,599200000,1461740,600661740,False,11
4077,validator_21,134554948570,True,778200000,3108140,781308140,False,4
4078,validator_21,135240947860,True,683100000,2899290,685999290,False,4
4079,validator_0,387123091614,True,910040004,20049490,930089494,True,12
4080,validator_88,44273730650,True,600400000,1837900,602237900,False,1
4081,validator_46,43832000053,True,564960004,15850340,580810344,True,1
4082,validator_28,91832224149,True,481560000,22007040,503567040,True,2
4083,validator_6,233119667336,True,712599995,15199020,727799015,True,7
4084,validator_18,128199147170,True,471600000,6792370,478392370,False,4
4085,validator_54,43546024563,True,714199991,23454540,737654531,True,1
4086,validator_5,242015277973,True,768779998,21789810,790569808,True,7
4087,validator_15,144825798860,True,653979998,18252200,672232198,True,4
4088,validator_14,148280860575,True,837520003,10861830,848381833,True,4
4089,validator_1,419549288482,True,580179994,26622870,606802864,True,13
4090,validator_2,365881496550,True,720300000,10001730,730301730,False,11
4091,validator_29,91475876649,True,555959996,24874900,580834896,True,2
4092,validator_4,232583463983,True,710446001,16646390,727092391,True,7
4093,validator_65,41149376309,True,577740005,21192310,598932315,True,1
4094,validator_2,366539797320,True,647800000,10500770,658300770,False,11
4095,validator_72,43564052340,True,630900000,1881870,632781870,False,1
4096,validator_10,226905712020,True,602500000,9959710,612459710,False,7
4097,validator_10,227419051100,True,506400000,6939080,513339080,False,7
4098,validator_11,230287120930,True,666600000,2215100,668815100,False,7
4099,validator_9,234152949600,True,607500000,28976830,636476830,False,7
4100,validator_88,44904472210,True,621000000,9741560,630741560,False,1
4101,validator_27,86532291708,True,407420001,20053000,427473001,True,2
4102,validator_10,227965720020,True,545000000,1668920,546668920,False,7
4103,validator_72,44277420530,True,708500000,4868190,713368190,False,1
4104,validator_10,228702530250,True,731400000,5410230,736810230,False,7
4105,validator_1,420425688783,True,840090001,36310300,876400301,True,13
4106,validator_16,130834289492,True,740800005,37094540,777894545,True,4
4107,validator_4,233277639715,True,684340002,9835730,694175732,True,7
4108,validator_7,243557808913,True,797599998,14222000,811821998,True,7
4109,validator_61,46950493899,True,516099999,5262640,521362639,True,1
4110,validator_18,128845449540,True,629200000,17102370,646302370,False,4
4111,validator_42,87181761380,True,512800000,20597720,533397720,False,2
4112,validator_74,40362128750,True,710800000,1251300,712051300,False,1
4113,validator_11,230767197330,True,472100000,7976400,480076400,False,7
4114,validator_1,421080308784,True,653000001,1620000,654620001,True,13
4115,validator_25,96665300512,True,740879997,24162800,765042797,True,3
4116,validator_44,41746206912,True,667999995,2817500,670817495,True,1
4117,validator_60,49258179116,True,590480007,13868200,604348207,True,1
4118,validator_1,421844881181,True,711119997,53452400,764572397,True,13
4119,validator_6,233828340337,True,677320001,31353000,708673001,True,7
4120,validator_18,129594986370,True,721800000,27736830,749536830,False,4
4121,validator_1,422785807530,True,930919999,10006350,940926349,True,13
4122,validator_9,234658212400,True,490200000,15062800,505262800,False,7
4123,validator_72,45108334410,True,824300000,6613880,830913880,False,1
4124,validator_42,87907522520,True,713900000,11861140,725761140,False,2
4125,validator_4,234285493401,True,997579996,10273690,1007853686,True,7
4126,validator_8,217607115680,True,666900000,6616000,673516000,False,6
4127,validator_0,387743634320,True,609660006,10882700,620542706,True,12
4128,validator_60,49905766208,True,624339992,23247100,647587092,True,1
4129,validator_2,367108683730,True,559100000,9786410,568886410,False,11
4130,validator_23,127050977720,True,704600000,3311260,707911260,False,3
4131,validator_34,90775652680,True,687040000,4535140,691575140,False,2
4132,validator_15,145600050040,True,772300000,1951180,774251180,True,4
4133,validator_20,128644892160,True,460100000,6861470,466961470,False,4
4134,validator_0,388294795745,True,542899995,8261430,551161425,True,12
4135,validator_12,125711584709,True,677340003,1608340,678948343,True,3
4136,validator_19,124361540450,True,585700000,3176400,588876400,False,3
4137,validator_3,369555045860,True,531300000,3446580,534746580,False,11
4138,validator_46,44454363153,True,617320000,5043100,622363100,True,1
4139,validator_5,242765880396,True,711738003,38864420,750602423,True,7
4140,validator_25,97524430871,True,856799999,2330360,859130359,True,3
4141,validator_5,243373769428,True,601900002,5989030,607889032,True,7
4142,validator_43,90659333370,True,717800000,17834550,735634550,False,2
4143,validator_2,367654069960,True,539700000,5686230,545386230,False,11
4144,validator_2,368129892760,True,473400000,2422800,475822800,False,11
4145,validator_1,423331136964,True,543800004,1529430,545329434,True,13
4146,validator_9,235328566500,True,667800000,2554100,670354100,False,7
4147,validator_54,44264467861,True,693239998,25203300,718443298,True,1
4148,validator_19,124960895950,True,596600000,2755500,599355500,False,3
4149,validator_5,244114737413,True,717939995,23027990,740967985,True,7
4150,validator_33,94230211874,True,603919991,10269920,614189911,True,2
4151,validator_6,234568747653,True,711943996,28463320,740407316,True,7
4152,validator_5,244765230399,True,647499996,2992990,650492986,True,7
4153,validator_0,388941394581,True,615426006,31172830,646598836,True,12
4154,validator_60,50492910145,True,579200007,7943930,587143937,True,1
4155,validator_14,149007183515,True,685496000,40826940,726322940,True,4
4156,validator_31,91643563936,True,815099995,4011100,819111095,True,2
4157,validator_18,130088139540,True,490700000,2453170,493153170,False,4
4158,validator_4,235002645130,True,687497999,29653730,717151729,True,7
4159,validator_18,130648168040,True,551570000,8458500,560028500,False,4
4160,validator_32,91411993487,True,706059999,32022530,738082529,True,2
4161,validator_6,235153018088,True,550400005,33870430,584270435,True,7
4162,validator_28,92492512358,True,640119999,20168210,660288209,True,2
4163,validator_25,98609326318,True,1062060007,22835440,1084895447,True,3
4164,validator_64,48280767280,True,855799997,1724920,857524917,True,1
4165,validator_42,88534917820,True,619400000,7995300,627395300,False,2
4166,validator_8,218338252680,True,725800000,5337000,731137000,False,6
4167,validator_5,245323649400,True,554020001,4399000,558419001,True,7
4168,validator_96,45028302680,True,562900000,25180800,588080800,False,1
4169,validator_17,140986712477,True,616490003,18696220,635186223,True,4
4170,validator_8,219099811150,True,759900000,1658470,761558470,False,6
4171,validator_21,135901112800,True,658300000,1864940,660164940,False,4
4172,validator_23,127695737750,True,635600000,9160030,644760030,False,3
4173,validator_40,85527895400,True,718400000,2755020,721155020,False,2
4174,validator_3,370187332800,True,630100000,2186940,632286940,False,11
4175,validator_7,244032475722,True,465719999,8946810,474666809,True,7
4176,validator_3,370684192270,True,487400000,9459470,496859470,False,11
4177,validator_25,99307991991,True,647340003,51325670,698665673,True,3
4178,validator_1,423954057333,True,607859999,15060370,622920369,True,13
4179,validator_4,235508721599,True,485439999,20636470,506076469,True,7
4180,validator_5,245915197100,True,574140000,17407700,591547700,True,7
4181,validator_1,424981145262,True,1025099999,1987930,1027087929,True,13
4182,validator_60,51163978274,True,608555999,62512130,671068129,True,1
4183,validator_7,245024254561,True,984859999,6918840,991778839,True,7
4184,validator_32,92041775990,True,551700003,78082500,629782503,True,2
4185,validator_11,231174864120,True,404970000,2696790,407666790,False,7
4186,validator_34,91337865410,True,551300000,10912730,562212730,False,2
4187,validator_14,149751215373,True,681659998,62371860,744031858,True,4
4188,validator_34,91903286790,True,563800000,1621380,565421380,False,2
4189,validator_36,88791216960,True,563500000,31536390,595036390,False,2
4190,validator_23,128237177850,True,532600000,8840100,541440100,False,4
4191,validator_10,229267730760,True,561300000,3900510,565200510,False,7
4192,validator_1,425720407145,True,727604003,11657880,739261883,True,13
4193,validator_11,231957401920,True,779200000,3337800,782537800,False,7
4194,validator_35,87149822550,True,460600000,1027300,461627300,False,2
4195,validator_89,46741526350,True,517700000,6626700,524326700,False,1
4196,validator_7,245496346868,True,465379997,6712310,472092307,True,7
4197,validator_14,150609081911,True,823619998,34246540,857866538,True,4
4198,validator_1,426321339179,True,578960004,21972030,600932034,True,13
4199,validator_6,235819867900,True,638000002,28849810,666849812,True,7
4200,validator_57,48990338980,True,589639997,11188000,600827997,True,1
4201,validator_23,128913515780,True,666900000,9437930,676337930,False,4
4202,validator_3,371272438990,True,584800000,3446720,588246720,False,11
4203,validator_82,42532770450,True,621800000,1674300,623474300,False,1
4204,validator_15,146095344777,True,489839997,5454740,495294737,True,4
4205,validator_5,246556916428,True,637959998,3759330,641719328,True,7
4206,validator_67,45170105268,True,513840003,11340700,525180703,True,1
4207,validator_22,136130386190,True,562200000,19751610,581951610,False,4
4208,validator_15,146752766701,True,619020004,38401920,657421924,True,4
4209,validator_21,136533724660,True,629700000,2911860,632611860,False,4
4210,validator_2,368667830960,True,536800000,1138200,537938200,False,11
4211,validator_14,151472420858,True,858999997,4338950,863338947,True,4
4212,validator_84,41522996790,True,437800000,6557530,444357530,False,1
4213,validator_81,41000854120,True,655400000,9913440,665313440,False,1
4214,validator_9,235979320930,True,647300000,3454430,650754430,False,7
4215,validator_27,87158420706,True,588259998,37869000,626128998,True,2
4216,validator_33,94930670849,True,691680005,8778970,700458975,True,2
4217,validator_2,369326130960,True,654900000,3400000,658300000,False,11
4218,validator_9,236613808240,True,632800000,1687310,634487310,False,7
4219,validator_1,427021911019,True,682240000,18331840,700571840,True,13
4220,validator_1,427611898330,True,569120001,20867310,589987311,True,13
4221,validator_2,369919057760,True,573000000,19926800,592926800,False,11
4222,validator_44,42544632483,True,790300001,8125570,798425571,True,1
4223,validator_15,147380347528,True,616939997,10640830,627580827,True,4
4224,validator_2,370410132720,True,486600000,4474960,491074960,False,11
4225,validator_90,43016338030,True,572000000,2194000,574194000,False,1
4226,validator_71,49410388577,True,830300000,1916080,832216080,True,1
4227,validator_34,92292407560,True,387900000,1220770,389120770,False,2
4228,validator_3,372131035110,True,856000000,2596120,858596120,False,11
4229,validator_4,236265780398,True,747099999,9958800,757058799,True,7
4230,validator_0,389755912713,True,788540002,25978130,814518132,True,12
4231,validator_5,247369868164,True,779659996,33291740,812951736,True,7
4232,validator_21,137130303350,True,585800000,10778690,596578690,False,4
4233,validator_32,92720431090,True,670420000,8235100,678655100,True,2
4234,validator_13,139664387504,True,598880003,24250000,623130003,True,4
4235,validator_3,372721061240,True,570900000,19126130,590026130,False,11
4236,validator_8,219652991740,True,550100000,3080590,553180590,False,6
4237,validator_18,131258279410,True,603500000,6611370,610111370,False,4
4238,validator_2,371063189020,True,649700000,3356300,653056300,False,11
4239,validator_45,45505049561,True,418758009,8680300,427438309,True,1
4240,validator_94,45100493970,True,766400000,2376300,768776300,False,1
4241,validator_17,141657356378,True,668900001,1743900,670643901,True,4
4242,validator_31,92285039752,True,613119996,28355820,641475816,True,2
4243,validator_20,129396211480,True,713300000,38019320,751319320,False,4
4244,validator_54,45005996752,True,723220001,18308890,741528891,True,1
4245,validator_6,236649750843,True,827000003,2882940,829882943,True,7
4246,validator_26,84321103632,True,409837999,17899900,427737899,True,2
4247,validator_8,220215400140,True,559600000,2808400,562408400,False,6
4248,validator_7,246243363941,True,735640003,11377070,747017073,True,7
4249,validator_34,92871089490,True,563900000,14781930,578681930,False,2
4250,validator_2,371743708100,True,678700000,1819080,680519080,False,11
4251,validator_26,85192536468,True,850799996,20632840,871432836,True,2
4252,validator_6,237215493976,True,543259993,22483140,565743133,True,7
4253,validator_4,236914888199,True,621700001,27407800,649107801,True,7
4254,validator_22,136835396080,True,672600000,32409890,705009890,False,4
4255,validator_87,45514156040,True,583200000,3325340,586525340,False,1
4256,validator_11,232569911820,True,608800000,3709900,612509900,False,7
4257,validator_3,373456960850,True,703300000,32599610,735899610,False,11
4258,validator_26,86040333463,True,817479995,30317000,847796995,True,2
4259,validator_77,43223040400,True,450900000,23345190,474245190,False,1
4260,validator_74,41053594240,True,689600000,1865490,691465490,False,1
4261,validator_65,41854792711,True,698600002,6816400,705416402,True,1
4262,validator_87,46240831710,True,723600000,3075670,726675670,False,1
4263,validator_22,137432300780,True,595100000,1804700,596904700,False,4
4264,validator_16,131403866630,True,517057998,52519140,569577138,True,4
4265,validator_28,93061411266,True,565500008,3398900,568898908,True,2
4266,validator_13,140436606102,True,759299998,12918600,772218598,True,4
4267,validator_2,372485329740,True,733200000,8421640,741621640,False,11
4268,validator_25,100015446635,True,643050004,64404640,707454644,True,3
4269,validator_5,248226419566,True,846296002,10255400,856551402,True,7
4270,validator_30,90760368704,True,755999995,8688630,764688625,True,2
4271,validator_11,233100832680,True,519600000,11320860,530920860,False,7
4272,validator_11,233608234520,True,479000000,28401840,507401840,False,7
4273,validator_6,238123754749,True,850060003,58200770,908260773,True,7
4274,validator_11,234321294920,True,691500000,21560400,713060400,False,7
4275,validator_11,234883563120,True,519400000,42868200,562268200,False,7
4276,validator_78,41622765700,True,522400000,25225940,547625940,False,1
4277,validator_62,49314882778,True,674274001,14220500,688494501,True,1
4278,validator_5,249010107573,True,755160007,28528000,783688007,True,7
4279,validator_1,428297234656,True,677468006,7868320,685336326,True,13
4280,validator_17,142427479995,True,745899997,24223620,770123617,True,4
4281,validator_32,93419058911,True,678980001,19647820,698627821,True,2
4282,validator_23,129443031420,True,514400000,15115640,529515640,False,4
4283,validator_35,87712503180,True,552200000,10480630,562680630,False,2
4284,validator_37,81493412810,True,617400000,1978600,619378600,False,2
4285,validator_1,428900597076,True,589500000,13862420,603362420,True,13
4286,validator_5,249644496657,True,623800004,10589080,634389084,True,7
4287,validator_82,43048944670,True,514200000,1974220,516174220,False,1
4288,validator_2,373065368060,True,558700000,21338320,580038320,False,11
4289,validator_10,229963390460,True,683000000,12659700,695659700,False,7
4290,validator_15,148180792059,True,797100001,3344530,800444531,True,4
4291,validator_81,41524448220,True,514700000,8894100,523594100,False,1
4292,validator_4,237584433990,True,650059991,19485800,669545791,True,7
4293,validator_1,429784297852,True,867199996,16500780,883700776,True,13
4294,validator_42,89020360470,True,480300000,5142650,485442650,False,2
4295,validator_20,129984420060,True,578600000,9608580,588208580,False,4
4296,validator_21,137793541380,True,653700000,9538030,663238030,False,4
4297,validator_63,47920837908,True,785139999,8112380,793252379,True,1
4298,validator_86,43567089420,True,664000000,2744630,666744630,False,1
4299,validator_35,88227447120,True,512300000,2643940,514943940,False,2
4300,validator_3,374011792350,True,552500000,2331500,554831500,False,11
4301,validator_7,247038295948,True,765640007,29292000,794932007,True,7
4302,validator_72,45712493460,True,601800000,2359050,604159050,False,1
4303,validator_1,430781984719,True,942319997,55366870,997686867,True,13
4304,validator_24,87203168063,True,535640004,73234810,608874814,True,2
4305,validator_41,89888497780,True,539000000,2336540,541336540,False,2
4306,validator_4,238322349401,True,734800011,3115400,737915411,True,7
4307,validator_25,100750762574,True,714079999,21235940,735315939,True,3
4308,validator_18,131782307530,True,521300000,2728120,524028120,False,4
4309,validator_10,230607872940,True,618100000,26382480,644482480,False,7
4310,validator_10,231114934080,True,506300000,761140,507061140,False,7
4311,validator_3,374592731330,True,570600000,10338980,580938980,False,11
4312,validator_3,375103532820,True,495200000,15601490,510801490,False,11
4313,validator_53,39964311757,True,466639999,32975490,499615489,True,1
4314,validator_6,238711200551,True,577380002,10065800,587445802,True,7
4315,validator_56,52738108520,True,708920011,9116390,718036401,True,1
4316,validator_19,125620198580,True,657800000,1502630,659302630,False,3
4317,validator_56,53233170354,True,479100004,15961830,495061834,True,1
4318,validator_0,390318777616,True,561400003,1464900,562864903,True,12
4319,validator_7,247618117726,True,566599998,13221780,579821778,True,7
4320,validator_92,37788996290,True,518700000,19678230,538378230,False,1
4321,validator_32,94067461317,True,645820006,2582400,648402406,True,2
4322,validator_1,431283515620,True,494520011,7010890,501530901,True,13
4323,validator_86,44083094470,True,508100000,7905050,516005050,False,1
4324,validator_2,373860942660,True,794000000,1574600,795574600,False,11
4325,validator_10,231755980570,True,634800000,6246490,641046490,False,7
4326,validator_1,432177885632,True,893000002,1370010,894370012,True,13
4327,validator_67,45874807490,True,666140002,38562220,704702222,True,1
4328,validator_24,87810109758,True,595439995,11501700,606941695,True,2
4329,validator_98,40460308590,True,644800000,17311230,662111230,False,1
4330,validator_13,141059570592,True,616400000,6564490,622964490,True,4
4331,validator_6,239451718835,True,719300004,21218280,740518284,True,7
4332,validator_45,46421569709,True,847159998,69360150,916520148,True,1
4333,validator_12,126531517908,True,816100009,3833190,819933199,True,3
4334,validator_36,89346069960,True,551670000,3183000,554853000,False,2
4335,validator_0,390740596616,True,367090000,54729000,421819000,True,12
4336,validator_2,374444311500,True,576700000,6668840,583368840,False,11
4337,validator_54,45690678592,True,653560000,31121840,684681840,True,1
4338,validator_27,87716329795,True,538839999,19069090,557909089,True,2
4339,validator_61,47668289122,True,687180003,30615220,717795223,True,1
4340,validator_54,46627839387,True,903759995,33400800,937160795,True,1
4341,validator_87,46936070010,True,692000000,3238300,695238300,False,1
4342,validator_44,43216782076,True,662019993,10129600,672149593,True,1
4343,validator_61,48686512424,True,981670002,36553300,1018223302,True,1
4344,validator_10,232432535090,True,673100000,3454520,676554520,False,7
4345,validator_79,44139266740,True,699900000,9542870,709442870,False,1
4346,validator_94,45686846350,True,583700000,2652380,586352380,False,1
4347,validator_3,375510861060,True,400900000,6428240,407328240,False,11
4348,validator_8,220641916010,True,422200000,4315870,426515870,False,6
4349,validator_42,89555264450,True,511400000,23503980,534903980,False,2
4350,validator_3,376083368000,True,569000000,3506940,572506940,False,11
4351,validator_1,433092961732,True,904064000,11012100,915076100,True,13
4352,validator_0,391522580968,True,779399992,2584360,781984352,True,12
4353,validator_21,138359940410,True,563400000,2999030,566399030,False,4
4354,validator_0,392004653498,True,441780010,40292520,482072530,True,12
4355,validator_25,101568491057,True,798100003,19628480,817728483,True,3
4356,validator_38,83921601760,True,342700000,1509200,344209200,False,2
4357,validator_1,433675239760,True,571499998,10778030,582278028,True,13
4358,validator_1,434391583462,True,698966002,17377700,716343702,True,13
4359,validator_42,90156235090,True,598400000,2570640,600970640,False,2
4360,validator_6,240068647225,True,589840000,27088390,616928390,True,7
4361,validator_88,45660914890,True,754100000,2342680,756442680,False,1
4362,validator_20,130488313140,True,483340000,20553080,503893080,False,4
4363,validator_1,435238718112,True,826899990,20234660,847134650,True,13
4364,validator_1,435987840665,True,719204003,29918550,749122553,True,13
4365,validator_42,90787917730,True,629500000,2182640,631682640,False,2
4366,validator_3,376654974430,True,569400000,2206430,571606430,False,11
4367,validator_1,436762523127,True,739213992,35468470,774682462,True,13
4368,validator_9,237126385240,True,503300000,9277000,512577000,False,7
4369,validator_3,377129806570,True,455050000,19782140,474832140,False,11
4370,validator_19,126166043910,True,543200000,2645330,545845330,False,3
4371,validator_53,40756419201,True,741160004,50947440,792107444,True,1
4372,validator_7,248392728038,True,752760002,21850310,774610312,True,7
4373,validator_55,41667224902,True,623399997,10509980,633909977,True,1
4374,validator_84,42182600490,True,648900000,10703700,659603700,False,1
4375,validator_38,84475697680,True,528800000,25295920,554095920,False,2
4376,validator_28,93934124189,True,838236003,34476920,872712923,True,2
4377,validator_53,41279834114,True,502100003,21314910,523414913,True,1
4378,validator_1,437632547603,True,861799996,8224480,870024476,True,13
4379,validator_20,131306986220,True,812500000,6173080,818673080,False,4
4380,validator_23,129989091120,True,542500000,3559700,546059700,False,4
4381,validator_33,95719986922,True,749320003,39996070,789316073,True,2
4382,validator_1,438205780654,True,548640001,24593050,573233051,True,13
4383,validator_9,237758128340,True,623000000,8743100,631743100,False,7
4384,validator_67,46713962074,True,833800004,5354580,839154584,True,1
4385,validator_2,375040493600,True,572500000,23682100,596182100,False,11
4386,validator_19,126747461810,True,575700000,5717900,581417900,False,3
4387,validator_18,132313566930,True,529400000,1859400,531259400,False,4
4388,validator_23,130566860060,True,574500000,3268940,577768940,False,4
4389,validator_7,249170017070,True,753400002,23889030,777289032,True,7
4390,validator_17,143267584894,True,809480009,30624890,840104899,True,4
4391,validator_80,41655361250,True,604200000,9278840,613478840,False,1
4392,validator_9,238363100750,True,595600000,9372410,604972410,False,7
4393,validator_14,152114875289,True,615440001,27014430,642454431,True,4
4394,validator_2,375548234680,True,504900000,2841080,507741080,False,11
4395,validator_0,392517613701,True,485460003,27500200,512960203,True,12
4396,validator_5,250147189793,True,490900006,11793130,502693136,True,7
4397,validator_38,85165442740,True,686700000,3045060,689745060,False,2
4398,validator_16,132232283678,True,792120008,36297040,828417048,True,4
4399,validator_80,42301505340,True,636700000,9444090,646144090,False,1
4400,validator_8,221366297790,True,687200000,37181780,724381780,False,6
4401,validator_26,86715929717,True,674299994,1296260,675596254,True,2
4402,validator_98,40869281420,True,400850000,8122830,408972830,False,1
4403,validator_8,222108284190,True,740100000,1886400,741986400,False,6
4404,validator_66,51552963350,True,554800003,19317840,574117843,True,1
4405,validator_9,239138525440,True,771600000,3824690,775424690,False,7
4406,validator_30,91349916178,True,555779994,33767480,589547474,True,2
4407,validator_1,438938695895,True,700280001,32635240,732915241,True,13
4408,validator_23,131132877350,True,563800000,2217290,566017290,False,4
4409,validator_86,44536277950,True,443790000,9393480,453183480,False,1
4410,validator_8,223185279190,True,1056200000,20795000,1076995000,False,6
4411,validator_64,49052287821,True,734800001,36720540,771520541,True,1
4412,validator_44,43835436452,True,606699996,11954380,618654376,True,1
4413,validator_8,223676334310,True,488400000,2655120,491055120,False,6
4414,validator_4,238935640103,True,609800002,3490700,613290702,True,7
4415,validator_73,42762314470,True,625800000,4131360,629931360,False,1
4416,validator_40,86136118040,True,579300000,28922640,608222640,False,2
4417,validator_17,143845890333,True,555899999,22405440,578305439,True,4
4418,validator_14,152869276330,True,714864001,39537040,754401041,True,4
4419,validator_25,102370359199,True,798520002,3348140,801868142,True,3
4420,validator_56,53903870357,True,654140003,16560000,670700003,True,1
4421,validator_27,88636963202,True,865480007,55153400,920633407,True,2
4422,validator_3,377711430270,True,573700000,7923700,581623700,False,11
4423,validator_17,144616330308,True,756799995,13639980,770439975,True,4
4424,validator_28,94618698389,True,678540000,6034200,684574200,True,2
4425,validator_2,375969925720,True,405170000,16521040,421691040,False,11
4426,validator_25,103151499138,True,778499999,2639940,781139939,True,3
4427,validator_2,376604744560,True,616700000,18118840,634818840,False,11
4428,validator_85,41613558940,True,583100000,2388370,585488370,False,1
4429,validator_6,240753993252,True,647240007,38106020,685346027,True,7
4430,validator_36,89822787960,True,473200000,3518000,476718000,False,2
4431,validator_24,88536833056,True,713199998,13523300,726723298,True,2
4432,validator_22,138038420840,True,601300000,4820060,606120060,False,4
4433,validator_17,145423043482,True,794859994,11853180,806713174,True,4
4434,validator_8,224409468600,True,724100000,9034290,733134290,False,7
4435,validator_17,146182574081,True,732099999,27430600,759530599,True,4
4436,validator_8,225197038680,True,783500000,4070080,787570080,False,7
4437,validator_53,41854193000,True,536319996,38038890,574358886,True,1
4438,validator_33,96657161020,True,917999998,19174100,937174098,True,3
4439,validator_1,439810965075,True,846500000,25769180,872269180,True,13
4440,validator_57,49664980163,True,673200003,1441180,674641183,True,1
4441,validator_31,92963124454,True,626146002,51938700,678084702,True,2
4442,validator_16,132867358556,True,623139998,11934880,635074878,True,4
4443,validator_4,239440509201,True,489909998,14959100,504869098,True,7
4444,validator_4,240116218311,True,662240000,13469110,675709110,True,7
4445,validator_63,48539965938,True,593740000,25388030,619128030,True,1
4446,validator_44,44441732540,True,558316008,47980080,606296088,True,1
4447,validator_12,127217517411,True,684100003,1899500,685999503,True,3
4448,validator_8,225818805420,True,620400000,1366740,621766740,False,7
4449,validator_39,93038800880,True,491900000,521920,492421920,False,2
4450,validator_7,250161058325,True,972579995,18461260,991041255,True,7
4451,validator_21,139089546210,True,728500000,1105800,729605800,False,4
4452,validator_1,440550192027,True,720700002,18526950,739226952,True,13
4453,validator_41,90483504450,True,575300000,19706670,595006670,False,2
4454,validator_22,138606401740,True,564400000,3580900,567980900,False,4
4455,validator_13,142101249067,True,999820005,41858470,1041678475,True,4
4456,validator_81,42211263450,True,684000000,2815230,686815230,False,1
4457,validator_0,392986148493,True,466799992,1734800,468534792,True,12
4458,validator_3,378356949280,True,643400000,2119010,645519010,False,11
4459,validator_6,241511041444,True,729859992,27188200,757048192,True,7
4460,validator_30,92254952010,True,900900012,4135820,905035832,True,2
4461,validator_4,240785959351,True,652320000,17421040,669741040,True,7
4462,validator_96,45523220490,True,484300000,10617810,494917810,False,1
4463,validator_79,44579709960,True,432200000,8243220,440443220,False,1
4464,validator_65,42447333716,True,565220005,27321000,592541005,True,1
4465,validator_54,47416426867,True,784500000,4087480,788587480,True,1
4466,validator_2,377248518480,True,641900000,1873920,643773920,False,11
4467,validator_75,42948453550,True,602100000,2545630,604645630,False,1
4468,validator_29,92030194240,True,540960001,13357590,554317591,True,2
4469,validator_88,46261865530,True,594100000,6850640,600950640,False,1
4470,validator_14,153583099429,True,696779999,17043100,713823099,True,4
4471,validator_16,133391386489,True,489580003,34447930,524027933,True,4
4472,validator_13,142948306259,True,844699992,2357200,847057192,True,4
4473,validator_1,441484496998,True,888004001,46300970,934304971,True,13
4474,validator_24,89221900614,True,683359998,1707560,685067558,True,2
4475,validator_6,242054219912,True,523899998,19278470,543178468,True,7
4476,validator_0,393655882294,True,660860001,8873800,669733801,True,12
4477,validator_33,97413124357,True,713177997,42785340,755963337,True,3
4478,validator_29,92912564034,True,847039994,35329800,882369794,True,2
4479,validator_17,146936257178,True,747839997,5843100,753683097,True,4
4480,validator_59,40839903053,True,783985991,48230820,832216811,True,1
4481,validator_11,235662071470,True,747900000,30608350,778508350,False,7
4482,validator_6,242675669831,True,619200009,2249910,621449919,True,7
4483,validator_3,378740180880,True,375090000,8141600,383231600,False,11
4484,validator_7,250954035910,True,784540005,8437580,792977585,True,7
4485,validator_26,87340379805,True,604939998,19510090,624450088,True,2
4486,validator_0,394252887390,True,537339996,59665100,597005096,True,12
4487,validator_20,132060281280,True,746300000,6995060,753295060,False,4
4488,validator_66,52212635608,True,621527998,38144260,659672258,True,1
4489,validator_33,98168505924,True,736519997,18861570,755381567,True,3
4490,validator_18,132880175720,True,564600000,2008790,566608790,False,4
4491,validator_42,91473960970,True,679800000,6243240,686043240,False,2
4492,validator_73,43248104610,True,482740000,3050140,485790140,False,1
4493,validator_22,139153723540,True,544800000,2521800,547321800,False,4
4494,validator_26,87913207705,True,525974000,46853900,572827900,True,2
4495,validator_53,42727828546,True,869099996,4535550,873635546,True,1
4496,validator_64,49706446718,True,588705997,65452900,654158897,True,1
4497,validator_82,43635997500,True,576700000,10352830,587052830,False,1
4498,validator_1,442221230779,True,706608001,30125780,736733781,True,13
4499,validator_1,442816223554,True,580039995,14952780,594992775,True,13
4500,validator_10,232988510910,True,554200000,1775820,555975820,False,7
4501,validator_15,148663812878,True,477119999,5900820,483020819,True,4
4502,validator_89,47479886270,True,735400000,2959920,738359920,False,1
4503,validator_2,377699596840,True,439700000,11378360,451078360,False,11
4504,validator_10,233556175110,True,560300000,7364200,567664200,False,7
4505,validator_12,128010271201,True,782320000,10433790,792753790,True,4
4506,validator_24,89773035840,True,523779996,27355230,551135226,True,2
4507,validator_10,234174072730,True,611900000,5997620,617897620,False,7
4508,validator_35,88849692530,True,612900000,9345410,622245410,False,2
4509,validator_0,394907617990,True,650400000,4330600,654730600,True,12
4510,validator_39,93560926180,True,497500000,24625300,522125300,False,2
4511,validator_35,89419222030,True,566800000,2729500,569529500,False,2
4512,validator_85,42192805480,True,569500000,9746540,579246540,False,1
4513,validator_74,41701139420,True,638200000,9345180,647545180,False,1
4514,validator_42,92010533930,True,523100000,13472960,536572960,False,2
4515,validator_33,98924473904,True,727140000,28827980,755967980,True,3
4516,validator_3,379199053500,True,455300000,3572620,458872620,False,11
4517,validator_78,42263765000,True,633100000,7899300,640999300,False,1
4518,validator_0,395755930886,True,810939996,37372900,848312896,True,12
4519,validator_12,128700123105,True,663600004,26251900,689851904,True,4
4520,validator_86,45033656030,True,495500000,1878080,497378080,False,1
4521,validator_11,236402081830,True,737300000,2710360,740010360,False,7
4522,validator_3,379902936360,True,701000000,2882860,703882860,False,11
4523,validator_3,380517237610,True,611400000,2901250,614301250,False,11
4524,validator_10,234893759110,True,710400000,9286380,719686380,False,7
4525,validator_26,88677567198,True,753639993,10719500,764359493,True,2
4526,validator_9,239794178270,True,654100000,1552830,655652830,False,7
4527,validator_51,43330217965,True,721640000,27366500,749006500,True,1
4528,validator_37,82030465290,True,530100000,6952480,537052480,False,2
4529,validator_22,139567739020,True,400600000,13415480,414015480,False,4
4530,validator_0,396490530119,True,716020003,18579230,734599233,True,12
4531,validator_20,132746798770,True,666400000,20117490,686517490,False,4
4532,validator_9,240434421500,True,632800000,7443230,640243230,False,7
4533,validator_86,45725378420,True,672000000,19722390,691722390,False,1
4534,validator_21,139545215550,True,451100000,4569340,455669340,False,4
4535,validator_9,241047727290,True,612400000,905790,613305790,False,7
4536,validator_20,133265466660,True,497300000,21367890,518667890,False,4
4537,validator_69,42454261665,True,627063995,30948690,658012685,True,1
4538,validator_67,47274427675,True,538160001,22305600,560465601,True,1
4539,validator_6,243547142225,True,836139994,35332400,871472394,True,7
4540,validator_2,378255274980,True,553000000,2678140,555678140,False,11
4541,validator_61,49160018566,True,454440002,19066140,473506142,True,1
4542,validator_43,91104443170,True,444500000,609800,445109800,False,2
4543,validator_68,45084146379,True,680420007,19566600,699986607,True,1
4544,validator_1,443573635152,True,742739998,14671600,757411598,True,13
4545,validator_83,47000499120,True,541000000,6670200,547670200,False,1
4546,validator_74,42225118420,True,521900000,2079000,523979000,False,1
4547,validator_9,241604297870,True,554500000,2070580,556570580,False,7
4548,validator_3,381150286810,True,631700000,1349200,633049200,False,11
4549,validator_73,43755825840,True,505700000,2021230,507721230,False,1
4550,validator_0,397071414018,True,553539999,27343900,580883899,True,12
4551,validator_20,134069902800,True,798800000,5636140,804436140,False,4
4552,validator_39,94013959010,True,442800000,10232830,453032830,False,2
4553,validator_35,90034401860,True,606900000,8279830,615179830,False,2
4554,validator_2,378942105270,True,683500000,3330290,686830290,False,11
4555,validator_4,241543589081,True,731688000,25941730,757629730,True,7
4556,validator_70,43347254267,True,554900001,25668380,580568381,True,1
4557,validator_1,444398998466,True,803039994,22323320,825363314,True,13
4558,validator_40,86814486000,True,674300000,4067960,678367960,False,2
4559,validator_2,379494337870,True,531100000,21132600,552232600,False,11
4560,validator_4,242398493974,True,813494003,41410890,854904893,True,7
4561,validator_21,140198009140,True,649500000,3293590,652793590,False,4
4562,validator_70,43987479559,True,606139992,34085300,640225292,True,1
4563,validator_90,43819632730,True,794700000,8594700,803294700,False,1
4564,validator_71,50267098817,True,826040010,30670230,856710240,True,1
4565,validator_3,381704403590,True,551600000,2516780,554116780,False,11
4566,validator_2,380073750150,True,575800000,3612280,579412280,False,11
4567,validator_18,133475735200,True,583000000,12559480,595559480,False,4
4568,validator_11,237086398650,True,680600000,3716820,684316820,False,7
4569,validator_6,244214650625,True,664800000,2708400,667508400,True,7
4570,validator_21,140728372420,True,527300000,3063280,530363280,False,4
4571,validator_7,251662960430,True,707700000,1224520,708924520,True,7
4572,validator_34,93519093690,True,628600000,19404200,648004200,False,2
4573,validator_6,245113146428,True,866100003,32395800,898495803,True,7
4574,validator_12,129484680948,True,770980003,13577840,784557843,True,4
4575,validator_33,99857547375,True,912780001,20293470,933073471,True,3
4576,validator_15,149450294105,True,784599997,1881230,786481227,True,4
4577,validator_61,49628064699,True,464699993,3346140,468046133,True,1
4578,validator_10,235415476090,True,490400000,31316980,521716980,False,7
4579,validator_1,444890016446,True,470499990,20517990,491017980,True,13
4580,validator_86,46355475910,True,624700000,5397490,630097490,False,1
4581,validator_1,445453831992,True,521543996,42271550,563815546,True,13
4582,validator_12,130156603530,True,660940002,10982580,671922582,True,4
4583,validator_5,250992867914,True,843900001,1778120,845678121,True,7
4584,validator_42,92591702360,True,575700000,5468430,581168430,False,2
4585,validator_8,226264531750,True,438100000,7626330,445726330,False,7
4586,validator_47,47773993557,True,920520004,3592390,924112394,True,1
4587,validator_10,236232687710,True,816200000,1011620,817211620,False,7
4588,validator_3,382325559660,True,614000000,7156070,621156070,False,11
4589,validator_1,446176223309,True,696519997,25871320,722391317,True,13
4590,validator_63,49421769960,True,852880002,28924020,881804022,True,1
4591,validator_19,127522752710,True,773000000,2290900,775290900,False,3
4592,validator_80,42985309190,True,674600000,9203850,683803850,False,1
4593,validator_2,380963690970,True,880300000,9640820,889940820,False,11
4594,validator_1,446817744810,True,613600001,27921500,641521501,True,13
4595,validator_1,447489250909,True,643320009,28186090,671506099,True,13
4596,validator_38,85773654350,True,600100000,8111610,608211610,False,2
4597,validator_7,252237848833,True,567840003,7048400,574888403,True,7
4598,validator_67,47825639303,True,524579998,26631630,551211628,True,1
4599,validator_11,237648323560,True,559400000,2524910,561924910,False,7
4600,validator_42,93112242820,True,501400000,19140460,520540460,False,2
4601,validator_44,45182566435,True,711863995,28969900,740833895,True,1
4602,validator_17,147625095680,True,677280002,11558500,688838502,True,4
4603,validator_2,381573187380,True,607700000,1796410,609496410,False,11
4604,validator_29,93544407348,True,585139994,46703320,631843314,True,2
4605,validator_51,44216551964,True,857019999,29314000,886333999,True,1
4606,validator_3,382810670150,True,481900000,3210490,485110490,False,11
4607,validator_64,50522641477,True,787519999,28674760,816194759,True,1
4608,validator_99,40843997140,True,523300000,5556000,528856000,False,1
4609,validator_76,47019978570,True,798700000,1572700,800272700,False,1
4610,validator_14,154516714626,True,914483997,19131200,933615197,True,4
4611,validator_7,253057258316,True,760939993,58469490,819409483,True,7
4612,validator_29,94290228447,True,743299999,2521100,745821099,True,2
4613,validator_14,155152211933,True,631700007,3797300,635497307,True,4
4614,validator_8,226706851950,True,421800000,20520200,442320200,False,7
4615,validator_41,91172258030,True,685700000,3053580,688753580,False,2
4616,validator_35,90612777060,True,559300000,19075200,578375200,False,2
4617,validator_18,133947191590,True,465440000,6016390,471456390,False,4
4618,validator_0,397662147730,True,562459992,28273720,590733712,True,12
4619,validator_86,47006455110,True,648360000,2619200,650979200,False,1
4620,validator_11,238139330460,True,484800000,6206900,491006900,False,7
4621,validator_7,253761231815,True,669539999,34433500,703973499,True,7
4622,validator_10,236678681220,True,443900000,2093510,445993510,False,7
4623,validator_41,91702932940,True,497400000,33274910,530674910,False,2
4624,validator_32,94647156609,True,576319992,3375300,579695292,True,2
4625,validator_58,47337206903,True,725854002,20474430,746328432,True,1
4626,validator_4,243358471068,True,933760004,26217090,959977094,True,7
4627,validator_4,244012206776,True,650700008,3035700,653735708,True,7
4628,validator_38,86405354860,True,610100000,21600510,631700510,False,2
4629,validator_1,448231668134,True,729599995,12817230,742417225,True,14
4630,validator_18,134464868490,True,509200000,8476900,517676900,False,4
4631,validator_6,245699401122,True,543624004,42630690,586254694,True,7
4632,validator_36,90353077480,True,511500000,18789520,530289520,False,2
4633,validator_16,134094672074,True,680480005,22805580,703285585,True,4
4634,validator_44,45860041621,True,661680006,15795180,677475186,True,1
4635,validator_9,242325365270,True,711400000,9667400,721067400,False,7
4636,validator_55,42297270927,True,616164005,13882020,630046025,True,1
4637,validator_4,244788758596,True,770200000,6351820,776551820,True,7
4638,validator_8,227407255040,True,692400000,8003090,700403090,False,7
4639,validator_70,44660450021,True,662840002,10130460,672970462,True,1
4640,validator_35,91091196440,True,474700000,3719380,478419380,False,2
4641,validator_9,242842107110,True,495500000,21241840,516741840,False,7
4642,validator_29,95011753964,True,701519997,20005520,721525517,True,2
4643,validator_33,100603246812,True,744099997,1599440,745699437,True,3
4644,validator_29,95578671906,True,528640002,38277940,566917942,True,2
4645,validator_57,50397582684,True,688478001,44124520,732602521,True,1
4646,validator_65,43057443210,True,570345994,39763500,610109494,True,1
4647,validator_88,46840956610,True,555800000,23291080,579091080,False,1
4648,validator_11,238862622990,True,722300000,992530,723292530,False,7
4649,validator_25,103680130126,True,525899998,2730990,528630988,True,3
4650,validator_1,448944751308,True,676160004,36923170,713083174,True,14
4651,validator_1,449662542489,True,707140001,10651180,717791181,True,14
4652,validator_10,237463083660,True,773600000,10802440,784402440,False,7
4653,validator_13,143644030960,True,685820001,9904700,695724701,True,4
4654,validator_83,47529090130,True,526400000,2191010,528591010,False,1
4655,validator_2,382165710680,True,591300000,1223300,592523300,False,11
4656,validator_0,398451968008,True,764899998,24920280,789820278,True,12
4657,validator_13,144360478759,True,702739999,13707800,716447799,True,4
4658,validator_6,246561626720,True,839739998,22485600,862225598,True,7
4659,validator_24,90638092992,True,840020002,25037150,865057152,True,2
4660,validator_17,148312774986,True,655120006,32559300,687679306,True,4
4661,validator_39,94665137850,True,650300000,878840,651178840,False,2
4662,validator_1,450473205093,True,775580004,35082600,810662604,True,14
4663,validator_9,243344608210,True,497100000,5401100,502501100,False,7
4664,validator_30,93156823832,True,893240002,8631820,901871822,True,2
4665,validator_2,382744784560,True,576500000,2573880,579073880,False,11
4666,validator_96,46238024870,True,712000000,2804380,714804380,False,1
4667,validator_8,228148832740,True,738300000,3277700,741577700,False,7
4668,validator_33,101188823025,True,564240003,21336210,585576213,True,3
4669,validator_9,243831184900,True,485100000,1476690,486576690,False,7
4670,validator_77,43841613010,True,608900000,9672610,618572610,False,1
4671,validator_32,95280791112,True,632000003,1634500,633634503,True,2
4672,validator_87,47533148430,True,587200000,9878420,597078420,False,1
4673,validator_28,95559952380,True,912400001,28853990,941253991,True,2
4674,validator_9,244462329730,True,629600000,1544830,631144830,False,7
4675,validator_6,247191761650,True,624140000,5994930,630134930,True,7
4676,validator_22,140133264150,True,546100000,19425130,565525130,False,4
4677,validator_16,134619735302,True,505699998,19363230,525063228,True,4
4678,validator_2,383349924060,True,602300000,2839500,605139500,False,11
4679,validator_93,42411350350,True,548970000,2917880,551887880,False,1
4680,validator_17,149113440083,True,777499997,23165100,800665097,True,4
4681,validator_10,238383594090,True,898900000,21610430,920510430,False,7
4682,validator_7,254378470436,True,595720001,21518620,617238621,True,7
4683,validator_79,45158380280,True,551100000,27570320,578670320,False,1
4684,validator_19,128344293230,True,816500000,5040520,821540520,False,4
4685,validator_0,399214292854,True,714576006,47748840,762324846,True,12
4686,validator_14,155813636509,True,645160006,16264570,661424576,True,4
4687,validator_96,46858992560,True,618900000,2067690,620967690,False,1
4688,validator_0,399867048551,True,635245997,17509700,652755697,True,12
4689,validator_41,92279469840,True,567300000,9236900,576536900,False,2
4690,validator_0,400627548281,True,735679990,24819740,760499730,True,12
4691,validator_41,92981891560,True,682300000,20121720,702421720,False,2
4692,validator_33,101862798303,True,634673998,39301280,673975278,True,3
4693,validator_39,95276281940,True,600300000,10844090,611144090,False,2
4694,validator_4,245327312749,True,534220003,4334150,538554153,True,7
4695,validator_10,238850402510,True,465300000,1508420,466808420,False,7
4696,validator_17,149919688580,True,798539997,7708500,806248497,True,4
4697,validator_7,255072668461,True,666460005,27738020,694198025,True,7
4698,validator_1,451082065266,True,569840003,39020170,608860173,True,14
4699,validator_7,255770637026,True,696900005,1068560,697968565,True,7
4700,validator_7,256750432523,True,969899997,9895500,979795497,True,8
4701,validator_18,135114568800,True,647700000,2000310,649700310,False,4
4702,validator_1,451809836413,True,718340007,9431140,727771147,True,14
4703,validator_97,47096554240,True,600500000,24284100,624784100,False,1
4704,validator_13,145157932591,True,780140002,17313830,797453832,True,4
4705,validator_5,251797785456,True,791440002,13477540,804917542,True,7
4706,validator_21,141407449470,True,677500000,1577050,679077050,False,4
4707,validator_22,140687637230,True,550200000,4173080,554373080,False,4
4708,validator_3,383506079590,True,691600000,3809440,695409440,False,11
4709,validator_7,257645777922,True,891799999,3545400,895345399,True,8
4710,validator_0,401537127056,True,884800005,24778770,909578775,True,12
4711,validator_2,384057084990,True,698300000,8860930,707160930,False,12
4712,validator_64,51119002486,True,582599999,13761010,596361009,True,1
4713,validator_73,44520333430,True,762400000,2107590,764507590,False,1
4714,validator_9,244902197260,True,438000000,1867530,439867530,False,7
4715,validator_43,91728201410,True,616500000,7258240,623758240,False,2
4716,validator_62,50260474818,True,939800000,5792040,945592040,True,1
4717,validator_28,96247320564,True,660120004,27248180,687368184,True,3
4718,validator_9,245509789250,True,603700000,3891990,607591990,False,7
4719,validator_12,130816264525,True,652939995,6721000,659660995,True,4
4720,validator_2,384541286570,True,482700000,1501580,484201580,False,12
4721,validator_14,156661133326,True,828199997,19296820,847496817,True,4
4722,validator_15,150257708198,True,758026003,49388090,807414093,True,4
4723,validator_9,246066811980,True,554400000,2622730,557022730,False,7
4724,validator_3,384199748610,True,682400000,11269020,693669020,False,12
4725,validator_2,385136898970,True,592500000,3112400,595612400,False,12
4726,validator_2,385813561550,True,671400000,5262580,676662580,False,12
4727,validator_25,104110217367,True,398940001,31147240,430087241,True,3
4728,validator_33,102518416801,True,629139998,26478500,655618498,True,3
4729,validator_9,246708972790,True,640600000,1560810,642160810,False,7
4730,validator_17,150823268886,True,873066006,30514300,903580306,True,4
4731,validator_11,239415564760,True,550100000,2841770,552941770,False,7
4732,validator_3,384927395530,True,691200000,36446920,727646920,False,12
4733,validator_20,134734299660,True,655700000,8696860,664396860,False,4
4734,validator_65,43815004608,True,730039998,27521400,757561398,True,1
4735,validator_2,386281335210,True,466400000,1373660,467773660,False,12
4736,validator_1,452590434293,True,740998000,39599880,780597880,True,14
4737,validator_69,42938474756,True,474040001,10173090,484213091,True,1
4738,validator_41,93646234190,True,647900000,16442630,664342630,False,2
4739,validator_68,45978503799,True,876820000,17537420,894357420,True,1
4740,validator_44,46762382630,True,893440009,8901000,902341009,True,1
4741,validator_9,247325179390,True,610500000,5706600,616206600,False,7
4742,validator_1,453168981104,True,558240001,20306810,578546811,True,14
4743,validator_31,93805226519,True,840900005,1202060,842102065,True,2
4744,validator_3,385423662930,True,475000000,21267400,496267400,False,12
4745,validator_33,103308400680,True,764379999,25603880,789983879,True,3
4746,validator_62,51054736070,True,774100002,20161250,794261252,True,1
4747,validator_3,385867775760,True,441600000,2512830,444112830,False,12
4748,validator_45,47014068638,True,573339999,19158930,592498929,True,1
4749,validator_22,141262537440,True,573100000,1800210,574900210,False,4
4750,validator_11,240297990500,True,873400000,9025740,882425740,False,7
4751,validator_25,104683222701,True,563200004,9805330,573005334,True,3
4752,validator_5,252541308395,True,727979999,15542940,743522939,True,7
4753,validator_30,93772888410,True,594819998,21244580,616064578,True,2
4754,validator_44,47681753657,True,890399997,28971030,919371027,True,1
4755,validator_95,39552084760,True,578600000,2653400,581253400,False,1
4756,validator_13,145883326807,True,724099996,1294220,725394216,True,4
4757,validator_11,240888558500,True,588300000,2268000,590568000,False,7
4758,validator_8,228804296490,True,653700000,1763750,655463750,False,7
4759,validator_23,131624447470,True,485880000,5690120,491570120,False,4
4760,validator_9,247793039690,True,456700000,11160300,467860300,False,7
4761,validator_39,95911020670,True,630600000,4138730,634738730,False,2
4762,validator_9,248631494690,True,837400000,1055000,838455000,False,7
4763,validator_29,96194748907,True,612400001,3677000,616077001,True,3
4764,validator_8,229477408460,True,670900000,2211970,673111970,False,7
4765,validator_80,43900724810,True,908000000,7415620,915415620,False,1
4766,validator_1,453699989609,True,527900005,3108500,531008505,True,14
4767,validator_48,46072840772,True,539840002,9668700,549508702,True,1
4768,validator_6,247819170047,True,598399997,29008400,627408397,True,7
4769,validator_60,52172446972,True,987439998,21028700,1008468698,True,1
4770,validator_10,239348841510,True,483600000,14839000,498439000,False,7
4771,validator_16,135260858588,True,599507996,41615290,641123286,True,4
4772,validator_43,92322693850,True,581500000,12992440,594492440,False,2
4773,validator_16,135834204133,True,571800005,1545540,573345545,True,4
4774,validator_34,94039252470,True,500000000,20158780,520158780,False,2
4775,validator_62,51949430494,True,869180004,25514420,894694424,True,1
4776,validator_86,47667264610,True,634500000,26309500,660809500,False,1
4777,validator_7,258264123838,True,597799996,20545920,618345916,True,8
4778,validator_5,253290458241,True,720700006,28449840,749149846,True,7
4779,validator_3,386400409080,True,528500000,4133320,532633320,False,12
4780,validator_38,86840871780,True,433300000,2216920,435516920,False,2
4781,validator_72,46417169580,True,702600000,2076120,704676120,False,1
4782,validator_8,230083642560,True,595100000,11134100,606234100,False,7
4783,validator_23,132186463270,True,524600000,37415800,562015800,False,4
4784,validator_0,402359745233,True,789079997,33538180,822618177,True,12
4785,validator_31,94405033311,True,543338002,56468790,599806792,True,2
4786,validator_61,50341392178,True,692599999,20727480,713327479,True,1
4787,validator_2,386973256780,True,689700000,2221570,691921570,False,12
4788,validator_0,403040593042,True,648100009,32747800,680847809,True,12
4789,validator_9,249429865870,True,763100000,35271180,798371180,False,7
4790,validator_0,403647229173,True,579440001,27196130,606636131,True,12
4791,validator_25,105385602530,True,700299999,2079830,702379829,True,3
4792,validator_1,454706136210,True,995640001,10506600,1006146601,True,14
4793,validator_43,92834791790,True,511000000,1097940,512097940,False,2
4794,validator_6,248592841089,True,752540002,21131040,773671042,True,7
4795,validator_30,94575758549,True,800799999,2070140,802870139,True,2
4796,validator_5,254041115695,True,729240004,21417450,750657454,True,7
4797,validator_2,387620011410,True,637700000,9054630,646754630,False,12
4798,validator_73,45259591720,True,728800000,10458290,739258290,False,1
4799,validator_14,157536522657,True,867590001,7799330,875389331,True,4
4800,validator_45,47869627469,True,828266001,27292830,855558831,True,1
4801,validator_29,96792578926,True,528458009,69372010,597830019,True,3
4802,validator_83,48288806730,True,753800000,5916600,759716600,False,1
4803,validator_7,258885935801,True,614699993,7111970,621811963,True,8
4804,validator_1,455361865809,True,647319999,8409600,655729599,True,14
4805,validator_5,254516335321,True,448939996,26279630,475219626,True,7
4806,validator_71,51029623243,True,752757996,9766430,762524426,True,1
4807,validator_5,255361794418,True,800819997,44639100,845459097,True,7
4808,validator_97,47827559540,True,728500000,2505300,731005300,False,1
4809,validator_1,456185342411,True,788040002,35436600,823476602,True,14
4810,validator_18,135569901910,True,446800000,8533110,455333110,False,4
4811,validator_9,249919869060,True,486900000,3103190,490003190,False,7
4812,validator_7,259353628007,True,448400006,19292200,467692206,True,8
4813,validator_19,129246752310,True,900400000,2059080,902459080,False,4
4814,validator_7,260263078245,True,884546008,24904230,909450238,True,8
4815,validator_32,95760648938,True,451280006,28577820,479857826,True,2
4816,validator_13,146682529641,True,777768004,21434830,799202834,True,4
4817,validator_29,97442161521,True,624139995,25442600,649582595,True,3
4818,validator_38,87600822880,True,757600000,2351100,759951100,False,2
4819,validator_70,45507566998,True,822565997,24550980,847116977,True,1
4820,validator_29,98119617113,True,638059992,39395600,677455592,True,3
4821,validator_80,44600385010,True,695100000,4560200,699660200,False,1
4822,validator_16,136655986224,True,769579991,52202100,821782091,True,4
4823,validator_28,96919521510,True,630420006,41780940,672200946,True,3
4824,validator_9,250521983080,True,581400000,20714020,602114020,False,7
4825,validator_37,82548304880,True,497900000,19939590,517839590,False,2
4826,validator_54,47969616038,True,540900001,12289170,553189171,True,1
4827,validator_4,246254377278,True,864919999,62144530,927064529,True,7
4828,validator_4,246850926047,True,558880009,37668760,596548769,True,7
4829,validator_9,251108378410,True,579590000,6805330,586395330,False,7
4830,validator_27,89301218430,True,655599998,8655230,664255228,True,2
4831,validator_69,43645348981,True,700440005,6434220,706874225,True,1
4832,validator_8,230748808460,True,638200000,26965900,665165900,False,7
4833,validator_1,457112055191,True,895880000,30832780,926712780,True,14
4834,validator_8,231559678260,True,798800000,12069800,810869800,False,7
4835,validator_85,42872087050,True,654300000,24981570,679281570,False,1
4836,validator_48,46810385974,True,710860002,26685200,737545202,True,1
4837,validator_6,249367959789,True,771900000,3218700,775118700,True,7
4838,validator_20,135194345360,True,454700000,5345700,460045700,False,4
4839,validator_0,404407707661,True,742699998,17778490,760478488,True,12
4840,validator_2,388176666090,True,548600000,8054680,556654680,False,12
4841,validator_5,255938107990,True,563019992,13293580,576313572,True,7
4842,validator_67,48435854086,True,603840003,6374780,610214783,True,1
4843,validator_12,131605476027,True,767560002,21651500,789211502,True,4
4844,validator_42,93678914420,True,563300000,3371600,566671600,False,2
4845,validator_23,132801758350,True,595400000,19895080,615295080,False,4
4846,validator_40,87425326290,True,606900000,3940290,610840290,False,2
4847,validator_5,256599404087,True,658899997,2396100,661296097,True,8
4848,validator_6,250358409528,True,976339999,14109740,990449739,True,7
4849,validator_2,388757159110,True,579400000,1093020,580493020,False,12
4850,validator_5,257273866467,True,660770000,13692380,674462380,True,8
4851,validator_1,457797241491,True,671298000,13888300,685186300,True,14
4852,validator_27,89994783063,True,677865993,15698640,693564633,True,2
4853,validator_42,94314931640,True,634600000,1417220,636017220,False,2
4854,validator_45,48413360432,True,538300003,5432960,543732963,True,1
4855,validator_6,251046945193,True,667899995,20635670,688535665,True,7
4856,validator_0,404971215901,True,532500000,31008240,563508240,True,12
4857,validator_43,93352325490,True,515100000,2433700,517533700,False,2
4858,validator_20,135857402550,True,660800000,2257190,663057190,False,4
4859,validator_61,51093661282,True,713900004,38369100,752269104,True,1
4860,validator_10,239986517510,True,601000000,36676000,637676000,False,7
4861,validator_21,142006254850,True,597100000,1705380,598805380,False,4
4862,validator_32,96620795461,True,857319993,2826530,860146523,True,3
4863,validator_91,42097250540,True,470700000,1738310,472438310,False,1
4864,validator_8,232106869550,True,542600000,4591290,547191290,False,7
4865,validator_7,260853812245,True,573580000,17154000,590734000,True,8
4866,validator_4,247545807569,True,688239992,6641530,694881522,True,7
4867,validator_48,47451271150,True,618220006,22665170,640885176,True,1
4868,validator_83,48822526660,True,531600000,2119930,533719930,False,1
4869,validator_3,386866958250,True,447500000,19049170,466549170,False,12
4870,validator_29,98813025424,True,683700001,9708310,693408311,True,3
4871,validator_42,94960591530,True,641200000,4459890,645659890,False,2
4872,validator_27,90645775404,True,621660001,29332340,650992341,True,2
4873,validator_11,241614553290,True,724700000,1294790,725994790,False,7
4874,validator_60,52997319339,True,809439997,15432370,824872367,True,1
4875,validator_43,93966738690,True,613400000,1013200,614413200,False,2
4876,validator_5,257950888064,True,655039997,21981600,677021597,True,8
4877,validator_49,46885089580,True,774680000,36833130,811513130,True,1
4878,validator_18,136140894410,True,561500000,9492500,570992500,False,4
4879,validator_8,232586397690,True,476700000,2828140,479528140,False,7
4880,validator_23,133287658760,True,473900000,12000410,485900410,False,4
4881,validator_9,251519789030,True,403800000,7610620,411410620,False,7
4882,validator_1,458552307221,True,738180000,16885730,755065730,True,14
4883,validator_64,51948057272,True,809299996,19754790,829054786,True,1
4884,validator_38,88120819020,True,513780000,6216140,519996140,False,2
4885,validator_64,52565459222,True,604180010,13221940,617401950,True,1
4886,validator_9,252034218540,True,494500000,19929510,514429510,False,7
4887,validator_67,49025173284,True,569839998,19479200,589319198,True,1
4888,validator_68,46613919919,True,625399990,10016130,635416120,True,1
4889,validator_2,389394779530,True,622600000,15020420,637620420,False,12
4890,validator_34,94709160900,True,662200000,7708430,669908430,False,2
4891,validator_2,389943241070,True,545800000,2661540,548461540,False,12
4892,validator_3,387529241640,True,658400000,3883390,662283390,False,12
4893,validator_7,261498909767,True,583800002,61297520,645097522,True,8
4894,validator_5,258461903595,True,489899991,21115540,511015531,True,8
4895,validator_9,252662188040,True,621300000,6669500,627969500,False,7
4896,validator_6,251747868365,True,689840002,11083170,700923172,True,7
4897,validator_0,405767175300,True,784699999,11259400,795959399,True,12
4898,validator_2,390699843970,True,755400000,1202900,756602900,False,12
4899,validator_1,459313554020,True,736819999,24426800,761246799,True,14
4900,validator_29,99536145809,True,691400005,31720380,723120385,True,3
4901,validator_0,406559526317,True,791199997,1151020,792351017,True,12
4902,validator_7,261998480067,True,495400000,4170300,499570300,True,8
4903,validator_82,44282622140,True,619100000,27524640,646624640,False,1
4904,validator_9,253184455950,True,519500000,2767910,522267910,False,7
4905,validator_3,387808278880,True,268490000,10547240,279037240,False,12
4906,validator_22,141891695310,True,627400000,1757870,629157870,False,4
4907,validator_25,106094733534,True,666979994,42151010,709131004,True,3
4908,validator_3,388422659250,True,610000000,4380370,614380370,False,12
4909,validator_4,248682867010,True,1111774001,25285440,1137059441,True,7
4910,validator_31,94989256997,True,561300006,22923680,584223686,True,2
4911,validator_1,459989189223,True,640404003,35231200,675635203,True,14
4912,validator_78,42890786080,True,621300000,5721080,627021080,False,1
4913,validator_7,262673468166,True,653557999,21430100,674988099,True,8
4914,validator_2,391444480770,True,735400000,9236800,744636800,False,12
4915,validator_0,407306838230,True,734400003,12911910,747311913,True,12
4916,validator_49,47704352699,True,799399999,19863120,819263119,True,1
4917,validator_20,136250741950,True,390800000,2539400,393339400,False,4
4918,validator_1,460820942415,True,788979992,42773200,831753192,True,14
4919,validator_25,106948060210,True,835554006,17772670,853326676,True,3
4920,validator_89,48125043310,True,638100000,7057040,645157040,False,1
4921,validator_2,392042289860,True,553800000,44009090,597809090,False,12
4922,validator_29,100397076209,True,844040000,16890400,860930400,True,3
4923,validator_25,107367444473,True,389080003,30304260,419384263,True,3
4924,validator_1,461577710520,True,728960005,27808100,756768105,True,14
4925,validator_0,408137039562,True,820600002,9601330,830201332,True,12
4926,validator_12,132382936514,True,731520007,45940480,777460487,True,4
4927,validator_9,253809418780,True,623600000,1362830,624962830,False,7
4928,validator_23,133927544700,True,573900000,65985940,639885940,False,4
4929,validator_15,150948511612,True,674095994,16707420,690803414,True,4
4930,validator_5,259217422297,True,748020002,7498700,755518702,True,8
4931,validator_38,88671967220,True,542200000,8948200,551148200,False,2
4932,validator_0,408744772010,True,573559998,34172450,607732448,True,12
4933,validator_64,53384464649,True,766600007,52405420,819005427,True,1
4934,validator_49,48374800101,True,624760002,45687400,670447402,True,1
4935,validator_6,252514804373,True,763419998,3516010,766936008,True,7
4936,validator_34,95177852930,True,466900000,1792030,468692030,False,2
4937,validator_3,389059575650,True,635500000,1416400,636916400,False,12
4938,validator_6,253334071228,True,815800005,3466850,819266855,True,7
4939,validator_3,389617904430,True,530500000,27828780,558328780,False,12
4940,validator_41,94230784690,True,582200000,2350500,584550500,False,2
4941,validator_4,249310002871,True,625000001,2135860,627135861,True,7
4942,validator_28,97401047255,True,479099995,2425750,481525745,True,3
4943,validator_6,254093752059,True,738000001,21680830,759680831,True,7
4944,validator_3,390301821730,True,673700000,10217300,683917300,False,12
4945,validator_23,134570778280,True,622000000,21233580,643233580,False,4
4946,validator_0,409737398975,True,967100005,25526960,992626965,True,12
4947,validator_7,263281604326,True,555928000,52208160,608136160,True,8
4948,validator_20,136793800590,True,539800000,3258640,543058640,False,4
4949,validator_1,462573471488,True,960639998,35120970,995760968,True,14
4950,validator_1,463250167049,True,657640001,19055560,676695561,True,14
4951,validator_26,89264938608,True,585600000,1771410,587371410,True,2
4952,validator_1,463901154245,True,624459996,26527200,650987196,True,14
4953,validator_2,392612481360,True,526400000,43791500,570191500,False,12
4954,validator_10,240554775100,True,566300000,1957590,568257590,False,7
4955,validator_11,242253604020,True,635800000,3250730,639050730,False,7
4956,validator_4,250071327736,True,754420005,6904860,761324865,True,7
4957,validator_0,410724819839,True,975940004,11480860,987420864,True,12
4958,validator_5,259816005500,True,584800003,13783200,598583203,True,8
4959,validator_74,43007093570,True,771400000,10575150,781975150,False,1
4960,validator_33,103903987482,True,578288002,17298800,595586802,True,3
4961,validator_60,53608802737,True,594539998,16943400,611483398,True,1
4962,validator_82,44703046840,True,417600000,2824700,420424700,False,1
4963,validator_77,44508239810,True,656700000,9926800,666626800,False,1
4964,validator_0,411288962853,True,539799994,24343020,564143014,True,12
4965,validator_33,104446108869,True,477459997,64661390,542121387,True,3
4966,validator_11,242879004850,True,617460000,7940830,625400830,False,7
4967,validator_24,91215730389,True,573999997,3637400,577637397,True,2
4968,validator_6,254942212481,True,819939992,28520430,848460422,True,7
4969,validator_36,90876335210,True,502200000,21057730,523257730,False,2
4970,validator_2,393126412150,True,512900000,1030790,513930790,False,12
4971,validator_41,94879827450,True,647700000,1342760,649042760,False,2
4972,validator_0,411978429224,True,636560001,52906370,689466371,True,12
4973,validator_12,133136953869,True,697560005,56457350,754017355,True,4
4974,validator_1,464484591558,True,568839993,14597320,583437313,True,14
4975,validator_14,158390574091,True,818734004,35317430,854051434,True,4
4976,validator_16,137383778424,True,690420000,37372200,727792200,True,4
4977,validator_27,91312094629,True,644800005,21519220,666319225,True,2
4978,validator_10,241122720290,True,566300000,1645190,567945190,False,7
4979,validator_0,412649223146,True,650520002,20273920,670793922,True,12
4980,validator_2,393740112020,True,611000000,2699870,613699870,False,12
4981,validator_0,413547296465,True,896799999,1273320,898073319,True,12
4982,validator_6,255603493175,True,652700004,8580690,661280694,True,7
4983,validator_1,465149435863,True,651020005,13824300,664844305,True,14
4984,validator_2,394530980420,True,787300000,3568400,790868400,False,12
4985,validator_5,260491635639,True,649539999,26090140,675630139,True,8
4986,validator_12,133911437968,True,744999999,29484100,774484099,True,4
4987,validator_6,256341282768,True,729199993,8589600,737789593,True,8
4988,validator_0,414122433298,True,556500003,18636830,575136833,True,12
4989,validator_69,44314999081,True,624780000,44870100,669650100,True,1
4990,validator_7,264248776247,True,959600001,7571920,967171921,True,8
4991,validator_1,465868830036,True,718800003,594170,719394173,True,14
4992,validator_34,95673760860,True,470980000,24927930,495907930,False,2
4993,validator_3,390883333580,True,560600000,20911850,581511850,False,12
4994,validator_40,88034069310,True,603000000,5743020,608743020,False,2
4995,validator_83,49324584510,True,482100000,19957850,502057850,False,1
4996,validator_2,395473968040,True,941300000,1687620,942987620,False,12
4997,validator_31,95614594539,True,576220002,49117540,625337542,True,2
4998,validator_25,108020011451,True,625363998,27202980,652566978,True,3
4999,validator_36,91393276810,True,506400000,10541600,516941600,False,2
5000,validator_15,151660929387,True,703740005,8677770,712417775,True,4
5001,validator_31,96459051041,True,842800002,1656500,844456502,True,3
5002,validator_38,89183758850,True,510800000,991630,511791630,False,2
5003,validator_0,414789719205,True,641463997,25821910,667285907,True,12
5004,validator_4,251061339002,True,968939996,21071270,990011266,True,7
5005,validator_2,395958125150,True,482700000,1457110,484157110,False,12
5006,validator_0,415770971444,True,924479999,56772240,981252239,True,12
5007,validator_80,45253014130,True,647600000,5029120,652629120,False,1
5008,validator_39,96394810570,True,476700000,7089900,483789900,False,3
5009,validator_9,254325628700,True,513570000,2639920,516209920,False,7
5010,validator_21,142410074960,True,401400000,2420110,403820110,False,4
5011,validator_8,233253058690,True,657000000,9661000,666661000,False,7
5012,validator_4,251705537015,True,631120003,13078010,644198013,True,7
5013,validator_15,152574438422,True,901140005,12369030,913509035,True,4
5014,validator_4,252414059993,True,663739998,44782980,708522978,True,7
5015,validator_6,257373490959,True,1000620001,31588190,1032208191,True,8
5016,validator_29,101076739594,True,651640005,28023380,679663385,True,3
5017,validator_23,135159195180,True,580700000,7716900,588416900,False,4
5018,validator_19,129929935410,True,672900000,10283100,683183100,False,4
5019,validator_9,255053828620,True,727100000,1099920,728199920,False,7
5020,validator_31,97101584050,True,628540009,13993000,642533009,True,3
5021,validator_40,88523523750,True,485600000,3854440,489454440,False,2
5022,validator_23,135860967480,True,695800000,5972300,701772300,False,4
5023,validator_1,466661462318,True,790000002,2632280,792632282,True,14
5024,validator_42,95453227870,True,490300000,2336340,492636340,False,2
5025,validator_77,45214668010,True,704400000,2028200,706428200,False,1
5026,validator_18,136754135830,True,586700000,26541420,613241420,False,4
5027,validator_6,258042982269,True,654100000,15391310,669491310,True,8
5028,validator_50,44893036768,True,478280000,27343740,505623740,True,1
5029,validator_19,130373025930,True,442000000,1090520,443090520,False,4
5030,validator_28,98133602851,True,707939996,24615600,732555596,True,3
5031,validator_6,258696052164,True,610479995,42589900,653069895,True,8
5032,validator_39,96947753570,True,541900000,11043000,552943000,False,3
5033,validator_2,396622360160,True,636000000,28235010,664235010,False,12
5034,validator_58,48294083795,True,949987992,6888900,956876892,True,1
5035,validator_3,391590092820,True,701000000,5759240,706759240,False,12
5036,validator_9,255541383290,True,485300000,2254670,487554670,False,7
5037,validator_6,259304828970,True,581546006,27230800,608776806,True,8
5038,validator_18,137406133910,True,649700000,2298080,651998080,False,4
5039,validator_38,89933509470,True,747900000,1850620,749750620,False,2
5040,validator_27,91899499826,True,573159997,14245200,587405197,True,2
5041,validator_73,45721196450,True,453400000,8204730,461604730,False,1
5042,validator_4,253061881608,True,638399995,9421620,647821615,True,7
5043,validator_7,265248049763,True,988319996,10953520,999273516,True,8
5044,validator_1,467426202349,True,762000001,2740030,764740031,True,14
5045,validator_5,261143033973,True,622439994,28958340,651398334,True,8
5046,validator_14,159013855525,True,619899994,3381440,623281434,True,4
5047,validator_42,96001957200,True,528760000,19969330,548729330,False,3
5048,validator_32,97370576351,True,740000000,9780890,749780890,True,3
5049,validator_33,105215654672,True,760500003,9045800,769545803,True,3
5050,validator_22,142398766810,True,477500000,29571500,507071500,False,4
5051,validator_3,392088702890,True,495440000,3170070,498610070,False,12
5052,validator_1,468187729187,True,752120008,9406830,761526838,True,14
5053,validator_43,94546505520,True,575300000,4466830,579766830,False,2
5054,validator_3,392732917090,True,641800000,2414200,644214200,False,12
5055,validator_1,468863397804,True,659439997,16228620,675668617,True,14
5056,validator_37,83145718880,True,577700000,19714000,597414000,False,2
5057,validator_12,134621348568,True,674600000,35310600,709910600,True,4
5058,validator_75,43452932340,True,495700000,8778790,504478790,False,1
5059,validator_8,233887082030,True,611400000,22623340,634023340,False,7
5060,validator_41,95521037100,True,622300000,18909650,641209650,False,2
5061,validator_59,41572377362,True,717379999,15094310,732474309,True,1
5062,validator_1,469568974383,True,697499999,8076580,705576579,True,14
5063,validator_12,135191692752,True,556764004,13580180,570344184,True,4
5064,validator_31,97852548505,True,722999995,27964460,750964455,True,3
5065,validator_38,90637995060,True,694300000,10185590,704485590,False,2
5066,validator_9,256325907230,True,774000000,10523940,784523940,False,8
5067,validator_71,51743818332,True,681039999,33155090,714195089,True,1
5068,validator_65,44702034509,True,847400001,39629900,887029901,True,1
5069,validator_72,47056243160,True,618100000,20973580,639073580,False,1
5070,validator_8,234526128520,True,630000000,9046490,639046490,False,7
5071,validator_71,52275692160,True,525199998,6673830,531873828,True,1
5072,validator_34,96276517160,True,589800000,12956300,602756300,False,3
5073,validator_73,46207509080,True,483700000,2612630,486312630,False,1
5074,validator_32,98095418250,True,679169999,45671900,724841899,True,3
5075,validator_0,416380236345,True,590340001,18924900,609264901,True,13
5076,validator_22,142996768170,True,587500000,10501360,598001360,False,4
5077,validator_13,147400372484,True,714240003,3602840,717842843,True,4
5078,validator_20,137377668120,True,567300000,16567530,583867530,False,4
5079,validator_1,470228861474,True,640740001,19147090,659887091,True,14
5080,validator_3,393490009590,True,749900000,7192500,757092500,False,12
5081,validator_1,471115792580,True,855620006,31311100,886931106,True,14
5082,validator_68,47202765696,True,569299997,19545780,588845777,True,1
5083,validator_96,47404377890,True,521200000,24185330,545385330,False,1
5084,validator_2,397185895590,True,558000000,5535430,563535430,False,12
5085,validator_0,417062909224,True,673199999,9472880,682672879,True,13
5086,validator_18,138143468940,True,735800000,1535030,737335030,False,4
5087,validator_8,235176660480,True,647200000,3331960,650531960,False,7
5088,validator_72,47796202750,True,734700000,5259590,739959590,False,1
5089,validator_30,95407807623,True,812199994,19849080,832049074,True,2
5090,validator_6,260026254360,True,683100000,38325390,721425390,True,8
5091,validator_87,48153624570,True,615100000,5376140,620476140,False,1
5092,validator_9,257164098310,True,836300000,1891080,838191080,False,8
5093,validator_0,417773196244,True,667820000,42467020,710287020,True,13
5094,validator_94,46200830750,True,482500000,31484400,513984400,False,1
5095,validator_47,48485766898,True,687760001,24013340,711773341,True,1
5096,validator_6,260596109582,True,559820002,10035220,569855222,True,8
5097,validator_19,130904002310,True,526200000,4776380,530976380,False,4
5098,validator_10,241662846970,True,538300000,1826680,540126680,False,7
5099,validator_28,98997871503,True,853939992,10328660,864268652,True,3
5100,validator_44,48346615975,True,662899998,1962320,664862318,True,1
5101,validator_12,135725413480,True,528239998,5480730,533720728,True,4
5102,validator_21,143029555290,True,617600000,1880330,619480330,False,4
5103,validator_31,98782301597,True,910400002,19353090,929753092,True,3
5104,validator_71,52809007959,True,524199999,9115800,533315799,True,1
5105,validator_5,261719420765,True,537393992,38992800,576386792,True,8
5106,validator_86,48313829500,True,627800000,18764890,646564890,False,1
5107,validator_1,471829849584,True,673319994,40737010,714057004,True,14
5108,validator_16,138059156107,True,658560003,16817680,675377683,True,4
5109,validator_7,265787285569,True,527339996,11895810,539235806,True,8
5110,validator_89,48712019690,True,583600000,3376380,586976380,False,1
5111,validator_16,138698900528,True,604120001,35624420,639744421,True,4
5112,validator_1,472309057317,True,431180003,48027730,479207733,True,14
5113,validator_15,153506136125,True,921760003,9937700,931697703,True,4
5114,validator_1,473186444994,True,861859997,15527680,877387677,True,14
5115,validator_9,257742741550,True,575700000,2943240,578643240,False,8
5116,validator_17,151810045460,True,951885994,34890580,986776574,True,4
5117,validator_27,92601307971,True,680339995,21468150,701808145,True,2
5118,validator_28,99596408798,True,589299995,9237300,598537295,True,3
5119,validator_18,138737260580,True,590800000,2991640,593791640,False,4
5120,validator_24,91992366112,True,769960003,6675720,776635723,True,2
5121,validator_55,42993416383,True,685595996,10549460,696145456,True,1
5122,validator_4,253795052171,True,730100003,3070560,733170563,True,7
5123,validator_9,258336827400,True,590600000,3485850,594085850,False,8
5124,validator_19,131464871600,True,559500000,1369290,560869290,False,4
5125,validator_60,54211916723,True,600540006,2573980,603113986,True,1
5126,validator_3,394004917090,True,504600000,10307500,514907500,False,12
5127,validator_54,48741277038,True,744040000,27621000,771661000,True,1
5128,validator_0,418546550766,True,763600002,9754520,773354522,True,13
5129,validator_9,259033473780,True,691100000,5546380,696646380,False,8
5130,validator_16,139503185070,True,793740002,10544540,804284542,True,4
5131,validator_54,49400597701,True,651760003,7560660,659320663,True,1
5132,validator_12,136496584484,True,729700004,41471000,771171004,True,4
5133,validator_12,137297090510,True,769488006,31018020,800506026,True,4
5134,validator_82,45190237500,True,485700000,1490660,487190660,False,1
5135,validator_16,140071227937,True,563520007,4522860,568042867,True,4
5136,validator_1,473874924420,True,643779996,44699430,688479426,True,14
5137,validator_22,143609186340,True,593500000,18918170,612418170,False,4
5138,validator_2,397678745390,True,487900000,4949800,492849800,False,12
5139,validator_9,259421187230,True,386000000,1713450,387713450,False,8
5140,validator_3,394566817060,True,559200000,2699970,561899970,False,12
5141,validator_1,474598770154,True,687900004,35945730,723845734,True,14
5142,validator_29,101852063299,True,711514005,63809700,775323705,True,3
5143,validator_5,262421323090,True,682559995,19342330,701902325,True,8
5144,validator_75,44142340220,True,668300000,21107880,689407880,False,1
5145,validator_3,395206423370,True,637200000,2406310,639606310,False,12
5146,validator_44,48973240879,True,603500004,23124900,626624904,True,1
5147,validator_3,395982749810,True,773900000,2426440,776326440,False,12
5148,validator_27,93192247403,True,584620002,6319430,590939432,True,2
5149,validator_0,418955299004,True,382140008,26608230,408748238,True,13
5150,validator_31,99452834812,True,652999995,17533220,670533215,True,3
5151,validator_69,45075449472,True,740140001,20310390,760450391,True,1
5152,validator_1,475133489050,True,532539996,2178900,534718896,True,14
5153,validator_10,242133977640,True,469700000,1430670,471130670,False,7
5154,validator_25,108755791513,True,722300002,13480060,735780062,True,3
5155,validator_7,266607498363,True,777439994,42772800,820212794,True,8
5156,validator_1,475632942538,True,471739998,27713490,499453488,True,14
5157,validator_0,419500000462,True,509183998,35517460,544701458,True,13
5158,validator_11,243423785650,True,542300000,2480800,544780800,False,7
5159,validator_1,476130780584,True,488799996,9038050,497838046,True,14
5160,validator_60,54878508408,True,620160005,46431680,666591685,True,1
5161,validator_31,100192339416,True,723020004,16484600,739504604,True,3
5162,validator_76,47457207970,True,434900000,2329400,437229400,False,1
5163,validator_58,49062358801,True,766300006,1975000,768275006,True,1
5164,validator_57,51165719233,True,758620009,9516540,768136549,True,1
5165,validator_0,420314479792,True,748920000,65559330,814479330,True,13
5166,validator_20,138024685740,True,627500000,19517620,647017620,False,4
5167,validator_16,140990486531,True,892040004,27218590,919258594,True,4
5168,validator_8,235613012800,True,428200000,8152320,436352320,False,7
5169,validator_10,242753214040,True,613000000,6236400,619236400,False,7
5170,validator_29,102487344473,True,633700004,1581170,635281174,True,3
5171,validator_34,96901692590,True,624100000,1075430,625175430,False,3
5172,validator_15,154212627720,True,696799995,9691600,706491595,True,4
5173,validator_15,154984988093,True,745340003,27020370,772360373,True,4
5174,validator_42,96593652160,True,573000000,18694960,591694960,False,3
5175,validator_17,152381129931,True,565920001,5164470,571084471,True,4
5176,validator_90,44405050130,True,566300000,19117400,585417400,False,1
5177,validator_20,138778604540,True,732500000,21418800,753918800,False,4
5178,validator_63,50285788049,True,841873999,22144090,864018089,True,1
5179,validator_9,260028107770,True,581000000,25920540,606920540,False,8
5180,validator_0,420947267889,True,600039997,32748100,632788097,True,13
5181,validator_4,254482436995,True,680600004,6784820,687384824,True,7
5182,validator_3,396512193410,True,527500000,1943600,529443600,False,12
5183,validator_0,421347010355,True,392399996,7342470,399742466,True,13
5184,validator_2,398425215550,True,743500000,2970160,746470160,False,12
5185,validator_15,155627979704,True,639600001,3391610,642991611,True,4
5186,validator_3,397099072110,True,578200000,8678700,586878700,False,12
5187,validator_31,100806363649,True,599900003,14124230,614024233,True,3
5188,validator_92,38357590290,True,566400000,2194000,568594000,False,1
5189,validator_39,97554509080,True,602800000,3955510,606755510,False,3
5190,validator_67,49727239612,True,700199998,1866330,702066328,True,1
5191,validator_75,44891312740,True,739500000,9472520,748972520,False,1
5192,validator_67,50491126213,True,752058001,11828600,763886601,True,1
5193,validator_25,109355360961,True,577099998,22469450,599569448,True,3
5194,validator_61,51906968914,True,780740002,32567630,813307632,True,1
5195,validator_37,83969900480,True,814000000,10181600,824181600,False,2
5196,validator_47,49182329820,True,687440002,9122920,696562922,True,1
5197,validator_55,43600443917,True,568059994,38967540,607027534,True,1
5198,validator_95,40059694400,True,500400000,7209640,507609640,False,1
5199,validator_14,159757420928,True,740400003,3165400,743565403,True,4
5200,validator_3,397630012200,True,528100000,2840090,530940090,False,12
5201,validator_22,144109716440,True,494000000,6530100,500530100,False,4
5202,validator_5,263147795085,True,670439995,56032000,726471995,True,8
5203,validator_6,261372658257,True,773199995,3348680,776548675,True,8
5204,validator_17,153065600949,True,677539998,6931020,684471018,True,4
5205,validator_3,398230956470,True,598700000,2244270,600944270,False,12
5206,validator_1,476643338524,True,496200000,16357940,512557940,True,14
5207,validator_87,48645473910,True,488800000,3049340,491849340,False,1
5208,validator_1,477395449358,True,745400004,6710830,752110834,True,14
5209,validator_0,422211372639,True,850696004,13666280,864362284,True,13
5210,validator_15,156385120749,True,725885995,31255050,757141045,True,4
5211,validator_5,263848604661,True,689499996,11309580,700809576,True,8
5212,validator_7,267156152163,True,534100000,14553800,548653800,True,8
5213,validator_5,264668421223,True,813100002,6716560,819816562,True,8
5214,validator_79,45667328080,True,505600000,3347800,508947800,False,1
5215,validator_27,93826274305,True,625940002,8086900,634026902,True,2
5216,validator_20,139368742550,True,588800000,1338010,590138010,False,4
5217,validator_31,101793970357,True,961539998,26066710,987606708,True,3
5218,validator_39,98022709140,True,465200000,3000060,468200060,False,3
5219,validator_31,102689902893,True,873700006,22232530,895932536,True,3
5220,validator_8,236270014570,True,636800000,20201770,657001770,False,7
5221,validator_8,236754681760,True,481700000,2967190,484667190,False,7
5222,validator_12,137969804510,True,651840000,20874000,672714000,True,4
5223,validator_0,422864534179,True,620760000,32401540,653161540,True,13
5224,validator_5,265368769089,True,690900006,9447860,700347866,True,8
5225,validator_71,53790850604,True,963340005,18502640,981842645,True,1
5226,validator_2,398884331950,True,448600000,10516400,459116400,False,12
5227,validator_36,91999391220,True,586200000,19914410,606114410,False,2
5228,validator_2,399473044480,True,567400000,21312530,588712530,False,12
5229,validator_8,237325833750,True,561300000,9851990,571151990,False,7
5230,validator_20,140045641650,True,674900000,1999100,676899100,False,4
5231,validator_39,98582553960,True,559000000,844820,559844820,False,3
5232,validator_0,423515677479,True,619800000,31343300,651143300,True,13
5233,validator_89,49390311430,True,674600000,3691740,678291740,False,1
5234,validator_44,49547183866,True,571799997,2142990,573942987,True,1
5235,validator_2,400094834350,True,614200000,7589870,621789870,False,12
5236,validator_12,138670783715,True,699100005,1879200,700979205,True,4
5237,validator_9,260702522680,True,672800000,1614910,674414910,False,8
5238,validator_18,139211097650,True,458200000,15637070,473837070,False,4
5239,validator_13,148101039977,True,651159993,49507500,700667493,True,4
5240,validator_52,48367924130,True,720000002,6934290,726934292,True,1
5241,validator_37,84642571070,True,652100000,20570590,672670590,False,2
5242,validator_13,148641861483,True,517719996,23101510,540821506,True,4
5243,validator_46,45167500771,True,691859998,21277620,713137618,True,1
5244,validator_47,49669092199,True,464439989,22322390,486762379,True,1
5245,validator_12,139222329574,True,527939999,23605860,551545859,True,4
5246,validator_89,50200447930,True,801100000,9036500,810136500,False,1
5247,validator_3,398700314000,True,464300000,5057530,469357530,False,12
5248,validator_32,98769171491,True,656020001,17733240,673753241,True,3
5249,validator_53,43636426629,True,877279993,31318090,908598083,True,1
5250,validator_18,139854552240,True,635300000,8154590,643454590,False,4
5251,validator_3,399436033230,True,728800000,6919230,735719230,False,12
5252,validator_1,478127882012,True,697695994,34736660,732432654,True,14
5253,validator_18,140362441320,True,501000000,6889080,507889080,False,4
5254,validator_3,400087393540,True,640300000,11060310,651360310,False,12
5255,validator_8,237911269040,True,579500000,5935290,585435290,False,7
5256,validator_61,52711320552,True,802099998,2251640,804351638,True,1
5257,validator_86,48997123940,True,681000000,2294440,683294440,False,1
5258,validator_3,400641680160,True,551600000,2686620,554286620,False,12
5259,validator_12,139895996377,True,670900003,2766800,673666803,True,4
5260,validator_27,94951395373,True,1122599998,2521070,1125121068,True,2
5261,validator_10,243477053280,True,721800000,2039240,723839240,False,7
5262,validator_92,38892267220,True,528100000,6576930,534676930,False,1
5263,validator_20,140586964660,True,531900000,9423010,541323010,False,4
5264,validator_29,103173906026,True,676799993,9761560,686561553,True,3
5265,validator_2,400904433480,True,799600000,9999130,809599130,False,12
5266,validator_56,54764486122,True,833300005,27315760,860615765,True,1
5267,validator_30,96065565946,True,604806003,52952320,657758323,True,3
5268,validator_32,99372343510,True,526277999,76894020,603172019,True,3
5269,validator_60,55445580628,True,549440000,17632220,567072220,True,1
5270,validator_31,103237714281,True,521119998,26691390,547811388,True,3
5271,validator_93,42919460570,True,500600000,7510220,508110220,False,1
5272,validator_66,53068430963,True,833540005,22255350,855795355,True,1
5273,validator_66,53777115481,True,704299998,4384520,708684518,True,1
5274,validator_1,478730186156,True,572840004,29464140,602304144,True,14
5275,validator_1,479357754897,True,600414001,27154740,627568741,True,14
5276,validator_90,45052599970,True,645700000,1849840,647549840,False,1
5277,validator_2,401544539860,True,629000000,11106380,640106380,False,12
5278,validator_65,45460965245,True,757599996,1330740,758930736,True,1
5279,validator_13,149459926540,True,811899997,6165060,818065057,True,4
5280,validator_23,136445452110,True,582300000,2184630,584484630,False,4
5281,validator_21,143656833770,True,624900000,2378480,627278480,False,4
5282,validator_54,50154997936,True,729760005,24640230,754400235,True,1
5283,validator_73,46806348320,True,595700000,3139240,598839240,False,1
5284,validator_3,401262827070,True,616400000,4746910,621146910,False,12
5285,validator_3,401687063350,True,423140000,1096280,424236280,False,12
5286,validator_23,137088607400,True,627400000,15755290,643155290,False,4
5287,validator_31,103864027580,True,606339999,19973300,626313299,True,3
5288,validator_10,244203394350,True,720600000,5741070,726341070,False,7
5289,validator_7,267612325766,True,431340003,24833600,456173603,True,8
5290,validator_9,261323268380,True,618400000,2345700,620745700,False,8
5291,validator_9,261939549780,True,612200000,4081400,616281400,False,8
5292,validator_7,268231284410,True,608890004,10068640,618958644,True,8
5293,validator_67,51387883359,True,880099996,16657150,896757146,True,1
5294,validator_5,266040814888,True,662259999,9785800,672045799,True,8
5295,validator_34,97446373890,True,544300000,381300,544681300,False,3
5296,validator_90,45847476470,True,792600000,2276500,794876500,False,1
5297,validator_39,99184014060,True,598400000,3060100,601460100,False,3
5298,validator_17,153653635687,True,564319998,23714740,588034738,True,4
5299,validator_3,402254331580,True,547200000,20068230,567268230,False,12
5300,validator_3,402897724500,True,640700000,2692920,643392920,False,12
5301,validator_1,480089213099,True,722300002,9158200,731458202,True,15
5302,validator_13,150155534699,True,680613999,14994160,695608159,True,4
5303,validator_42,97398042220,True,802900000,1490060,804390060,False,3
5304,validator_8,238536804070,True,624200000,1335030,625535030,False,7
5305,validator_38,91152492160,True,511020000,3477100,514497100,False,2
5306,validator_18,141027174130,True,662900000,1832810,664732810,False,4
5307,validator_12,140700176576,True,775739999,28440200,804180199,True,4
5308,validator_28,100262748692,True,663899994,2439900,666339894,True,3
5309,validator_25,110414483056,True,1034299995,24822100,1059122095,True,3
5310,validator_42,98126579330,True,726900000,1637110,728537110,False,3
5311,validator_22,144915328860,True,779100000,26512420,805612420,False,4
5312,validator_7,268902544611,True,627140001,44120200,671260201,True,8
5313,validator_3,403605156130,True,698600000,8831630,707431630,False,12
5314,validator_2,402205777680,True,659100000,2137820,661237820,False,12
5315,validator_55,44261912495,True,648179998,13288580,661468578,True,1
5316,validator_41,96059652940,True,535700000,2915840,538615840,False,3
5317,validator_0,424280790506,True,747760007,17353020,765113027,True,13
5318,validator_28,100892782630,True,623019998,7013940,630033938,True,3
5319,validator_11,243973492110,True,549000000,706460,549706460,False,7
5320,validator_54,50802021461,True,628659995,18363530,647023525,True,1
5321,validator_23,137778472700,True,668700000,21165300,689865300,False,4
5322,validator_3,404055246550,True,439900000,10190420,450090420,False,12
5323,validator_13,150680667477,True,522999998,2132780,525132778,True,4
5324,validator_9,262528026880,True,585400000,3077100,588477100,False,8
5325,validator_9,263153091580,True,617000000,8064700,625064700,False,8
5326,validator_0,425214128241,True,908839995,24497740,933337735,True,13
5327,validator_55,45004557293,True,711367998,31276800,742644798,True,1
5328,validator_23,138326855630,True,545500000,2882930,548382930,False,4
5329,validator_9,263722904200,True,567900000,1912620,569812620,False,8
5330,validator_7,269631943904,True,702799993,26599300,729399293,True,8
5331,validator_2,402903153590,True,695300000,2075910,697375910,False,12
5332,validator_11,244570201550,True,586100000,10609440,596709440,False,7
5333,validator_9,264312571090,True,584600000,5066890,589666890,False,8
5334,validator_69,45742867402,True,640940000,26477930,667417930,True,1
5335,validator_2,403464230270,True,559700000,1376680,561076680,False,12
5336,validator_13,151314158779,True,614120002,19371300,633491302,True,4
5337,validator_1,480643435144,True,537420005,16802040,554222045,True,15
5338,validator_41,96541746270,True,481500000,593330,482093330,False,3
5339,validator_14,160362896977,True,599100009,6376040,605476049,True,5
5340,validator_71,54598014571,True,744439997,62723970,807163967,True,1
5341,validator_29,103776455919,True,594499993,8049900,602549893,True,3
5342,validator_0,425738413541,True,518440000,5845300,524285300,True,13
5343,validator_70,46215448177,True,668419999,39461180,707881179,True,1
5344,validator_2,404074804880,True,601700000,8874610,610574610,False,12
5345,validator_38,91590545660,True,436670000,1383500,438053500,False,2
5346,validator_3,404642410070,True,565900000,21263520,587163520,False,12
5347,validator_4,255074308722,True,553480007,38391720,591871727,True,7
5348,validator_7,270343256350,True,680940006,30372440,711312446,True,8
5349,validator_11,245207064090,True,630700000,6162540,636862540,False,7
5350,validator_14,160958216233,True,588620006,6699250,595319256,True,5
5351,validator_72,48415721550,True,614600000,4918800,619518800,False,1
5352,validator_8,239156682220,True,600000000,19878150,619878150,False,7
5353,validator_20,141136933560,True,545900000,4068900,549968900,False,4
5354,validator_7,271158031581,True,789640001,25135230,814775231,True,8
5355,validator_27,95589339583,True,607080000,30864210,637944210,True,2
5356,validator_7,271817294388,True,647800007,11462800,659262807,True,8
5357,validator_40,89254544070,True,727800000,3220320,731020320,False,2
5358,validator_20,141649104490,True,484700000,27470930,512170930,False,4
5359,validator_42,98674353770,True,546700000,1074440,547774440,False,3
5360,validator_2,404610455100,True,528800000,6850220,535650220,False,12
5361,validator_35,91805299750,True,690600000,23503310,714103310,False,2
5362,validator_19,132203293800,True,735600000,2822200,738422200,False,4
5363,validator_23,138829399100,True,500100000,2443470,502543470,False,4
5364,validator_10,244870919530,True,665200000,2325180,667525180,False,7
5365,validator_17,154447424022,True,740040005,53748330,793788335,True,4
5366,validator_33,105975452619,True,729539997,30257950,759797947,True,3
5367,validator_5,266707953788,True,635944000,31194900,667138900,True,8
5368,validator_82,45794423840,True,576200000,27986340,604186340,False,1
5369,validator_1,481494326847,True,824567993,26323710,850891703,True,15
5370,validator_5,267325954281,True,616700003,1300490,618000493,True,8
5371,validator_5,268013515084,True,671570003,15990800,687560803,True,8
5372,validator_26,90203828989,True,937200001,1690380,938890381,True,2
5373,validator_19,133060223090,True,844900000,12029290,856929290,False,4
5374,validator_7,272549631858,True,713480000,18857470,732337470,True,8
5375,validator_35,92241132450,True,435000000,832700,435832700,False,2
5376,validator_17,154946199505,True,489520003,9255480,498775483,True,4
5377,validator_18,141478675040,True,449600000,1900910,451500910,False,4
5378,validator_1,482177150033,True,652899996,29923190,682823186,True,15
5379,validator_69,46569943545,True,800600003,26476140,827076143,True,1
5380,validator_80,45823461750,True,568100000,2347620,570447620,False,1
5381,validator_62,52738516899,True,779358005,9728400,789086405,True,1
5382,validator_39,99921283350,True,735100000,2169290,737269290,False,3
5383,validator_6,262162729660,True,776500003,13571400,790071403,True,8
5384,validator_3,405184648170,True,540900000,1338100,542238100,False,12
5385,validator_21,144129543530,True,469200000,3509760,472709760,False,4
5386,validator_8,239528236550,True,369300000,2254330,371554330,False,7
5387,validator_33,106700086426,True,706440007,18193800,724633807,True,3
5388,validator_11,246238183020,True,990400000,40718930,1031118930,False,7
5389,validator_87,49449422410,True,803400000,548500,803948500,False,1
5390,validator_1,482939058858,True,742019995,19888830,761908825,True,15
5391,validator_71,55220537502,True,617860001,4662930,622522931,True,1
5392,validator_28,101686402748,True,775167998,18452120,793620118,True,3
5393,validator_2,405280370700,True,667700000,2215600,669915600,False,12
5394,validator_2,405879718560,True,596600000,2747860,599347860,False,12
5395,validator_3,405820176410,True,615800000,19728240,635528240,False,12
5396,validator_11,246961864120,True,712500000,11181100,723681100,False,7
5397,validator_11,247681278790,True,717500000,1914670,719414670,False,7
5398,validator_35,92787129770,True,543600000,2397320,545997320,False,2
5399,validator_4,255941473213,True,818920001,48244490,867164491,True,7
5400,validator_97,48312481180,True,478200000,6721640,484921640,False,1
5401,validator_26,90865875553,True,634379994,27666570,662046564,True,2
5402,validator_20,142301953310,True,642600000,10248820,652848820,False,4
5403,validator_17,155842840803,True,825759998,70881300,896641298,True,4
5404,validator_42,99360361270,True,671200000,14807500,686007500,False,3
5405,validator_3,406314548780,True,473600000,20772370,494372370,False,12
5406,validator_11,248282183070,True,563300000,37604280,600904280,False,7
5407,validator_20,142969957810,True,665100000,2904500,668004500,False,4
5408,validator_1,483423781926,True,472039998,12683070,484723068,True,15
5409,validator_10,245652143660,True,744900000,36324130,781224130,False,7
5410,validator_41,97151263950,True,607300000,2217680,609517680,False,3
5411,validator_1,484106499232,True,665820006,16897300,682717306,True,15
5412,validator_3,406876406710,True,557900000,3957930,561857930,False,12
5413,validator_9,264794579550,True,479400000,2608460,482008460,False,8
5414,validator_1,484808228235,True,695596003,6133000,701729003,True,15
5415,validator_22,145492979980,True,557200000,20451120,577651120,False,4
5416,validator_0,426625071560,True,876639999,10018020,886658019,True,13
5417,validator_64,54141816510,True,726280011,31071850,757351861,True,1
5418,validator_76,48036116010,True,558100000,20808040,578908040,False,1
5419,validator_29,104514469417,True,735199998,2813500,738013498,True,3
5420,validator_17,156560388733,True,689440000,28107930,717547930,True,4
5421,validator_22,146093599180,True,594300000,6319200,600619200,False,4
5422,validator_1,485606205440,True,770446005,27531200,797977205,True,15
5423,validator_59,42337095302,True,710480000,54237940,764717940,True,1
5424,validator_41,97735052040,True,546400000,37388090,583788090,False,3
5425,validator_70,47233417649,True,980668002,37301470,1017969472,True,1
5426,validator_8,240097528260,True,559500000,9791710,569291710,False,7
5427,validator_10,246339965330,True,668200000,19621670,687821670,False,7
5428,validator_10,246898997760,True,557900000,1132430,559032430,False,7
5429,validator_60,56217731329,True,768100001,4050700,772150701,True,1
5430,validator_99,41416855870,True,568700000,4158730,572858730,False,1
5431,validator_22,146427066530,True,331000000,2467350,333467350,False,4
5432,validator_6,262990099882,True,824400002,2970220,827370222,True,8
5433,validator_12,141659100579,True,914900003,44024000,958924003,True,4
5434,validator_0,427270540201,True,627820001,17648640,645468641,True,13
5435,validator_11,249048959990,True,765200000,1576920,766776920,False,7
5436,validator_6,263322703246,True,326640004,5963360,332603364,True,8
5437,validator_37,85105320470,True,461300000,1449400,462749400,False,2
5438,validator_32,100033406585,True,658499995,2563080,661063075,True,3
5439,validator_62,53632125802,True,832964003,60644900,893608903,True,1
5440,validator_1,486257678638,True,616279998,35193200,651473198,True,15
5441,validator_29,105260855835,True,691757998,54628420,746386418,True,3
5442,validator_84,42743682610,True,557200000,3882120,561082120,False,1
5443,validator_28,102382258409,True,693140001,2715660,695855661,True,3
5444,validator_81,42962854580,True,742200000,9391130,751591130,False,1
5445,validator_7,273391037032,True,826440004,14965170,841405174,True,8
5446,validator_12,142260551586,True,598499997,2951010,601451007,True,4
5447,validator_91,42387476440,True,287200000,3025900,290225900,False,1
5448,validator_5,268468654876,True,430199992,24939800,455139792,True,8
5449,validator_36,92386881080,True,376600000,10889860,387489860,False,2
5450,validator_9,265456943190,True,646000000,16363640,662363640,False,8
5451,validator_17,157259090717,True,691200004,7501980,698701984,True,4
5452,validator_85,43406903030,True,531400000,3415980,534815980,False,1
5453,validator_88,47590491210,True,693400000,56134600,749534600,False,1
5454,validator_6,264151826318,True,809020002,20103070,829123072,True,8
5455,validator_25,111126960559,True,679386003,33091500,712477503,True,3
5456,validator_32,100763493420,True,679997995,50088840,730086835,True,3
5457,validator_42,99876562160,True,512200000,4000890,516200890,False,3
5458,validator_14,161570426834,True,599700001,12510600,612210601,True,5
5459,validator_17,157968580588,True,640816001,68673870,709489871,True,4
5460,validator_12,142894476174,True,623939998,9984590,633924588,True,4
5461,validator_6,265174420209,True,990310001,32283890,1022593891,True,8
5462,validator_31,104385099549,True,496639999,24431970,521071969,True,3
5463,validator_1,486892420768,True,621080000,13662130,634742130,True,15
5464,validator_9,266153030180,True,678400000,17686990,696086990,False,8
5465,validator_42,100637035860,True,741600000,18873700,760473700,False,3
5466,validator_17,158730562592,True,730880004,31102000,761982004,True,4
5467,validator_30,96611557786,True,529100000,16891840,545991840,True,3
5468,validator_19,133631706200,True,569800000,1683110,571483110,False,4
5469,validator_49,49089492895,True,699677994,15014800,714692794,True,1
5470,validator_68,47762229600,True,556300004,3163900,559463904,True,1
5471,validator_20,143565164350,True,593400000,1806540,595206540,False,4
5472,validator_3,407462595840,True,578100000,8089130,586189130,False,12
5473,validator_60,57067289230,True,825600001,23957900,849557901,True,1
5474,validator_29,105999793831,True,704527996,34410000,738937996,True,3
5475,validator_95,40706102790,True,641600000,4808390,646408390,False,1
5476,validator_3,408018803770,True,545600000,10607930,556207930,False,12
5477,validator_30,97297194204,True,657679998,27956420,685636418,True,3
5478,validator_1,487531339268,True,637600010,1318490,638918500,True,15
5479,validator_18,142085436240,True,597800000,8961200,606761200,False,4
5480,validator_1,487961863508,True,413034000,17490240,430524240,True,15
5481,validator_9,266848264420,True,668900000,26334240,695234240,False,8
5482,validator_21,144871256280,True,740000000,1712750,741712750,False,4
5483,validator_41,98300206560,True,562480000,2674520,565154520,False,3
5484,validator_19,134257474300,True,622900000,2868100,625768100,False,4
5485,validator_72,48939248730,True,518900000,4627180,523527180,False,1
5486,validator_74,43682404520,True,672600000,2710950,675310950,False,1
5487,validator_17,159550009394,True,794160002,25286800,819446802,True,4
5488,validator_14,162116914735,True,540400001,6087900,546487901,True,5
5489,validator_21,145375313830,True,502800000,1257550,504057550,False,4
5490,validator_5,269091683174,True,611999998,11028300,623028298,True,8
5491,validator_72,49727727710,True,778800000,9678980,788478980,False,1
5492,validator_17,160116185083,True,543199999,22975690,566175689,True,5
5493,validator_2,406576384300,True,689400000,7265740,696665740,False,12
5494,validator_11,249593961130,True,536600000,8401140,545001140,False,7
5495,validator_7,274158008126,True,729499994,37471100,766971094,True,8
5496,validator_56,55397003017,True,626639995,5876900,632516895,True,1
5497,validator_6,266084223609,True,884400000,25403400,909803400,True,8
5498,validator_3,408726797690,True,695800000,12193920,707993920,False,12
5499,validator_14,162918129737,True,800000002,1215000,801215002,True,5
5500,validator_20,144378452860,True,797500000,15788510,813288510,False,4
5501,validator_0,427946548407,True,611606006,64402200,676008206,True,13
5502,validator_12,143531729375,True,630700001,6553200,637253201,True,4
5503,validator_82,46598329140,True,800800000,3105300,803905300,False,1
5504,validator_1,488865922238,True,861419990,42638740,904058730,True,15
5505,validator_5,270209041114,True,1101758000,15599940,1117357940,True,8
5506,validator_97,48857246880,True,543100000,1665700,544765700,False,1
5507,validator_8,240629368900,True,530000000,1840640,531840640,False,7
5508,validator_82,47215140170,True,614700000,2111030,616811030,False,1
5509,validator_75,45625595640,True,732800000,1482900,734282900,False,1
5510,validator_39,100665291320,True,736100000,7907970,744007970,False,3
5511,validator_35,93332774990,True,527900000,17745220,545645220,False,2
5512,validator_71,55899465946,True,634440004,44488440,678928444,True,1
5513,validator_17,160900234036,True,739760003,44288950,784048953,True,5
5514,validator_33,107303514888,True,576480002,26948460,603428462,True,3
5515,validator_3,409619549790,True,873600000,19152100,892752100,False,12
5516,validator_2,407227119190,True,644500000,6234890,650734890,False,12
5517,validator_61,53227812659,True,508720007,7772100,516492107,True,1
5518,validator_4,256765433140,True,780315997,43643930,823959927,True,8
5519,validator_11,250183664940,True,557400000,32303810,589703810,False,7
5520,validator_43,95098481820,True,545800000,6176300,551976300,False,2
5521,validator_60,57611495582,True,541120002,3086350,544206352,True,1
5522,validator_1,489346383038,True,471200000,9260800,480460800,True,15
5523,validator_1,490264066072,True,841049994,76633040,917683034,True,15
5524,validator_3,410475348470,True,817300000,38498680,855798680,False,12
5525,validator_23,139639216090,True,805500000,4316990,809816990,False,4
5526,validator_52,49307887601,True,914639991,25323480,939963471,True,1
5527,validator_22,147075296460,True,644800000,3429930,648229930,False,4
5528,validator_19,134881615940,True,617500000,6641640,624141640,False,4
5529,validator_6,266652691902,True,546700003,21768290,568468293,True,8
5530,validator_2,407788238730,True,524700000,36419540,561119540,False,12
5531,validator_22,147724256970,True,645900000,3060510,648960510,False,4
5532,validator_34,98030522750,True,575000000,9148860,584148860,False,3
5533,validator_82,47684858970,True,464100000,5618800,469718800,False,1
5534,validator_29,106571008157,True,560639996,10574330,571214326,True,3
5535,validator_41,98788367140,True,467900000,20260580,488160580,False,3
5536,validator_16,141734491438,True,733186007,10818900,744004907,True,4
5537,validator_1,491128869971,True,844559999,20243900,864803899,True,15
5538,validator_46,45802973559,True,614040008,21432780,635472788,True,1
5539,validator_73,47411121160,True,602500000,2272840,604772840,False,1
5540,validator_28,102928543500,True,503840001,42445090,546285091,True,3
5541,validator_7,274891923422,True,725599996,8315300,733915296,True,8
5542,validator_92,39535828220,True,638700000,4861000,643561000,False,1
5543,validator_99,42004070640,True,581000000,6214770,587214770,False,1
5544,validator_81,43544412340,True,577300000,4257760,581557760,False,1
5545,validator_5,271030254716,True,796134002,25079600,821213602,True,8
5546,validator_11,250925496000,True,715100000,26731060,741831060,False,7
5547,validator_93,43681268390,True,734200000,27607820,761807820,False,1
5548,validator_5,271875130641,True,843299995,1575930,844875925,True,8
5549,validator_19,135704742620,True,814100000,9026680,823126680,False,4
5550,validator_82,48345048730,True,643300000,16889760,660189760,False,1
5551,validator_20,144801397060,True,406100000,16844200,422944200,False,4
5552,validator_23,140262511420,True,619700000,3595330,623295330,False,4
5553,validator_4,257243544963,True,470660003,7451820,478111823,True,8
5554,validator_39,101372484720,True,693600000,13593400,707193400,False,3
5555,validator_31,104973001170,True,560386001,27515620,587901621,True,3
5556,validator_1,491946729150,True,810799999,7059180,817859179,True,15
5557,validator_19,136531145040,True,805800000,20602420,826402420,False,4
5558,validator_56,55990518451,True,583219994,10295440,593515434,True,1
5559,validator_14,163695652480,True,756700003,20822740,777522743,True,5
5560,validator_1,492628881157,True,679000007,3152000,682152007,True,15
5561,validator_25,112034785976,True,877159997,30665420,907825417,True,3
5562,validator_1,493207258437,True,538780000,39597280,578377280,True,15
5563,validator_26,91572602015,True,674434002,32292460,706726462,True,2
5564,validator_2,408634157670,True,835100000,10818940,845918940,False,12
5565,validator_1,493750096854,True,515299997,27538420,542838417,True,15
5566,validator_9,267357037430,True,505500000,3273010,508773010,False,8
5567,validator_1,494432766067,True,675480003,7189210,682669213,True,15
5568,validator_30,97843022944,True,506760000,39068740,545828740,True,3
5569,validator_12,144068683497,True,516600002,20354120,536954122,True,4
5570,validator_64,54833707407,True,665039997,26850900,691890897,True,1
5571,validator_34,98579257150,True,538300000,10434400,548734400,False,3
5572,validator_3,411108769910,True,605100000,28321440,633421440,False,12
5573,validator_76,48640771320,True,595000000,9655310,604655310,False,1
5574,validator_81,44141807340,True,589300000,8095000,597395000,False,1
5575,validator_1,495311292793,True,783979996,94546730,878526726,True,15
5576,validator_4,257875111375,True,603040002,28526410,631566412,True,8
5577,validator_0,428625834787,True,647260000,32026380,679286380,True,13
5578,validator_31,105585554906,True,591539996,21013740,612553736,True,3
5579,validator_8,241151004700,True,512500000,9135800,521635800,False,7
5580,validator_13,151887694007,True,564429998,9105230,573535228,True,4
5581,validator_71,56612243267,True,663978001,48799320,712777321,True,1
5582,validator_13,152750020088,True,851740001,10586080,862326081,True,4
5583,validator_6,267116084007,True,460800005,2592100,463392105,True,8
5584,validator_27,96018217118,True,403440005,25437530,428877535,True,3
5585,validator_9,267866659110,True,503400000,6221680,509621680,False,8
5586,validator_50,45618353007,True,716639999,8676240,725316239,True,1
5587,validator_21,145899914730,True,506900000,17700900,524600900,False,4
5588,validator_29,107524170858,True,935616001,17546700,953162701,True,3
5589,validator_43,95781662320,True,662300000,20880500,683180500,False,2
5590,validator_18,142586835480,True,499500000,1899240,501399240,False,4
5591,validator_31,106282027289,True,686070003,10402380,696472383,True,3
5592,validator_2,409163501000,True,518400000,10943330,529343330,False,12
5593,validator_1,495955767720,True,632799997,11674930,644474927,True,15
5594,validator_14,164430138284,True,732100004,2385800,734485804,True,5
5595,validator_13,153855916288,True,1092379990,13516210,1105896200,True,4
5596,validator_1,496786294892,True,805420002,25107170,830527172,True,15
5597,validator_8,241942338610,True,788300000,3033910,791333910,False,7
5598,validator_0,429309288006,True,666059999,17393220,683453219,True,13
5599,validator_30,98647525281,True,793919997,10582340,804502337,True,3
5600,validator_13,154329633588,True,441936000,31781300,473717300,True,4
5601,validator_5,272542764579,True,642435998,25197940,667633938,True,8
5602,validator_72,50352073070,True,621600000,2745360,624345360,False,1
5603,validator_22,148511267390,True,769100000,17910420,787010420,False,4
5604,validator_3,411797597340,True,680000000,8827430,688827430,False,12
5605,validator_13,155112732109,True,744600001,38498520,783098521,True,4
5606,validator_74,44370169340,True,659700000,28064820,687764820,False,1
5607,validator_1,497391808877,True,577080005,28433980,605513985,True,15
5608,validator_7,275472603893,True,538560001,42120470,580680471,True,8
5609,validator_33,107976945488,True,643700000,29730600,673430600,True,3
5610,validator_5,273274171496,True,694185997,37220920,731406917,True,8
5611,validator_18,143532215510,True,943400000,1980030,945380030,False,4
5612,validator_2,409709563920,True,542900000,3162920,546062920,False,12
5613,validator_28,103603754855,True,633346005,41865350,675211355,True,3
5614,validator_9,268491101410,True,622800000,1642300,624442300,False,8
5615,validator_2,410420741550,True,701700000,9477630,711177630,False,12
5616,validator_8,242561716820,True,580800000,38578210,619378210,False,7
5617,validator_30,99362971899,True,708099998,7346620,715446618,True,3
5618,validator_33,108485346198,True,506900000,1500710,508400710,True,3
5619,validator_40,89954334620,True,672400000,27390550,699790550,False,2
5620,validator_19,137156606050,True,622700000,2761010,625461010,False,4
5621,validator_15,157186421250,True,771400001,29900500,801300501,True,4
5622,validator_7,276106630710,True,609519997,24506820,634026817,True,8
5623,validator_10,247382076740,True,468000000,15078980,483078980,False,7
5624,validator_13,155694585589,True,543600000,38253480,581853480,True,4
5625,validator_94,46828241330,True,625300000,2110580,627410580,False,1
5626,validator_43,96378463100,True,594900000,1900780,596800780,False,3
5627,validator_41,99274163770,True,478200000,7596630,485796630,False,3
5628,validator_94,47595272810,True,752500000,14531480,767031480,False,1
5629,validator_2,410935000790,True,511600000,2659240,514259240,False,12
5630,validator_11,251423145230,True,493600000,4049230,497649230,False,7
5631,validator_14,164880254182,True,409339998,40775900,450115898,True,5
5632,validator_20,145407881540,True,598100000,8384480,606484480,False,4
5633,validator_1,497900384976,True,491137999,17438100,508576099,True,15
5634,validator_18,143984668250,True,450400000,2052740,452452740,False,4
5635,validator_5,274019846792,True,719999996,25675300,745675296,True,8
5636,validator_4,258587827777,True,659714002,53002400,712716402,True,8
5637,validator_59,43107597905,True,764660003,5842600,770502603,True,1
5638,validator_60,58261581308,True,634819996,15265730,650085726,True,1
5639,validator_11,251901902640,True,475300000,3457410,478757410,False,7
5640,validator_8,243047598900,True,461100000,24782080,485882080,False,7
5641,validator_0,430092228139,True,763960003,18980130,782940133,True,13
5642,validator_4,259308439258,True,699600001,21011480,720611481,True,8
5643,validator_1,498648800854,True,731979998,16435880,748415878,True,15
5644,validator_23,140924524450,True,637000000,25013030,662013030,False,4
5645,validator_49,49914534435,True,790920000,34121540,825041540,True,1
5646,validator_3,412441616340,True,638400000,5619000,644019000,False,12
5647,validator_11,252536610520,True,633100000,1607880,634707880,False,7
5648,validator_21,146469636120,True,567800000,1921390,569721390,False,4
5649,validator_1,499127928554,True,445440000,33687700,479127700,True,15
5650,validator_16,142528629857,True,788399999,5738420,794138419,True,4
5651,validator_9,269080901450,True,581690000,8110040,589800040,False,8
5652,validator_1,499789236386,True,638140002,23167830,661307832,True,15
5653,validator_47,50297301333,True,622500004,5709130,628209134,True,1
5654,validator_1,500414255054,True,605979998,19038670,625018668,True,15
5655,validator_95,41388733200,True,662000000,20630410,682630410,False,1
5656,validator_31,106823855722,True,532020003,9808430,541828433,True,3
5657,validator_14,165426799284,True,533900002,12645100,546545102,True,5
5658,validator_43,96970633800,True,591000000,1170700,592170700,False,3
5659,validator_3,412800261140,True,356800000,1844800,358644800,False,12
5660,validator_36,92968805680,True,579200000,2724600,581924600,False,2
5661,validator_18,144606561790,True,613000000,8893540,621893540,False,4
5662,validator_31,107861761836,True,1016020004,21886110,1037906114,True,3
5663,validator_7,276762411979,True,635839999,19941270,655781269,True,8
5664,validator_12,144567581480,True,491296003,7601980,498897983,True,4
5665,validator_48,48211912015,True,715789995,44850870,760640865,True,1
5666,validator_79,46279946160,True,610260000,2358080,612618080,False,1
5667,validator_11,253231130660,True,687300000,7220140,694520140,False,7
5668,validator_29,108127100456,True,556593998,46335600,602929598,True,3
5669,validator_30,100088344997,True,716399998,8973100,725373098,True,3
5670,validator_63,51166166188,True,838215999,42162140,880378139,True,1
5671,validator_6,267799672629,True,681800002,1788620,683588622,True,8
5672,validator_5,274736162986,True,698479994,17836200,716316194,True,8
5673,validator_6,268431562856,True,607519997,24370230,631890227,True,8
5674,validator_0,430685687937,True,590899998,2559800,593459798,True,13
5675,validator_31,108421146856,True,549576000,9809020,559385020,True,3
5676,validator_29,108784978360,True,630800004,27077900,657877904,True,3
5677,validator_82,48998864500,True,643600000,10215770,653815770,False,1
5678,validator_9,269781617280,True,698800000,1915830,700715830,False,8
5679,validator_3,413303322430,True,501600000,1461290,503061290,False,12
5680,validator_77,45671843840,True,455300000,1875830,457175830,False,1
5681,validator_20,146220289740,True,809200000,3208200,812408200,False,4
5682,validator_69,47496117226,True,908300001,17873680,926173681,True,1
5683,validator_17,161728131290,True,826699994,1197260,827897254,True,5
5684,validator_24,92630185311,True,594959999,42859200,637819199,True,2
5685,validator_69,48139433423,True,607589997,35726200,643316197,True,1
5686,validator_27,96705869520,True,645860002,41792400,687652402,True,3
5687,validator_88,48053062190,True,460950000,1620980,462570980,False,1
5688,validator_79,46974120460,True,690700000,3474300,694174300,False,1
5689,validator_95,41896558500,True,503400000,4425300,507825300,False,1
5690,validator_86,49614472430,True,615300000,2048490,617348490,False,1
5691,validator_11,253773042360,True,519900000,22011700,541911700,False,7
5692,validator_93,44257642820,True,573800000,2574430,576374430,False,1
5693,validator_33,108998779088,True,493719990,19712900,513432890,True,3
5694,validator_11,254510689260,True,734500000,3146900,737646900,False,7
5695,validator_4,259941075489,True,615280001,17356230,632636231,True,8
5696,validator_31,108945960556,True,504760000,20053700,524813700,True,3
5697,validator_41,100030827570,True,755500000,1163800,756663800,False,3
5698,validator_1,501160165384,True,698500000,47410330,745910330,True,15
5699,validator_31,109493020354,True,533019998,14039800,547059798,True,3
5700,validator_94,48124687650,True,525500000,3914840,529414840,False,1
5701,validator_8,243676521240,True,618100000,10822340,628922340,False,7
5702,validator_50,46422986006,True,779941999,24691000,804632999,True,1
5703,validator_7,277468113778,True,692505999,13195800,705701799,True,8
5704,validator_66,54479756296,True,669059995,33580820,702640815,True,1
5705,validator_22,149130524030,True,617700000,1556640,619256640,False,4
5706,validator_0,431432665878,True,714486001,32491940,746977941,True,13
5707,validator_43,97697282280,True,716300000,10348480,726648480,False,3
5708,validator_3,413864101660,True,557700000,3079230,560779230,False,12
5709,validator_0,432208487269,True,754200001,21621390,775821391,True,13
5710,validator_3,414396331030,True,530100000,2129370,532229370,False,12
5711,validator_18,145261595690,True,648000000,7033900,655033900,False,4
5712,validator_11,254966256520,True,449100000,6467260,455567260,False,7
5713,validator_8,244448157540,True,768300000,3336300,771636300,False,7
5714,validator_66,55089451193,True,599659997,10034900,609694897,True,1
5715,validator_1,501738759844,True,552880000,25714460,578594460,True,15
5716,validator_73,47911831660,True,497000000,3710500,500710500,False,1
5717,validator_34,99136958780,True,555400000,2301630,557701630,False,3
5718,validator_45,48949221834,True,529670002,6191400,535861402,True,1
5719,validator_41,100764265070,True,731500000,1937500,733437500,False,3
5720,validator_0,432739686599,True,476679990,54519340,531199330,True,13
5721,validator_19,137737848390,True,561300000,19942340,581242340,False,4
5722,validator_12,145471354383,True,895400003,8372900,903772903,True,4
5723,validator_0,433812914020,True,1045840001,27387420,1073227421,True,13
5724,validator_2,411710448290,True,750500000,24947500,775447500,False,12
5725,validator_63,51878237667,True,684263999,27807480,712071479,True,1
5726,validator_5,275540379487,True,740966001,63250500,804216501,True,8
5727,validator_22,149686660700,True,518900000,37236670,556136670,False,4
5728,validator_5,276343595902,True,794553995,8662420,803216415,True,8
5729,validator_4,260409288886,True,415039997,53173400,468213397,True,8
5730,validator_34,99821250790,True,682200000,2092010,684292010,False,3
5731,validator_13,156248139261,True,551900002,1653670,553553672,True,4
5732,validator_36,93565292220,True,589700000,6786540,596486540,False,2
5733,validator_17,162564552320,True,805360000,31061030,836421030,True,5
5734,validator_25,112958077764,True,913500008,9791780,923291788,True,3
5735,validator_2,412219250280,True,506800000,2001990,508801990,False,12
5736,validator_92,40039372720,True,496500000,7044500,503544500,False,1
5737,validator_15,157728905667,True,538999997,3484420,542484417,True,4
5738,validator_3,414858480620,True,460000000,2149590,462149590,False,12
5739,validator_23,141508880350,True,582200000,2155900,584355900,False,4
5740,validator_2,412736573800,True,515600000,1723520,517323520,False,12
5741,validator_42,101206991890,True,545950000,24006030,569956030,False,3
5742,validator_0,434447485116,True,607519996,27051100,634571096,True,13
5743,validator_35,93901130990,True,555640000,12716000,568356000,False,2
5744,validator_0,435141127732,True,691799996,1842620,693642616,True,13
5745,validator_31,110313519302,True,763379998,57118950,820498948,True,3
5746,validator_25,113595701393,True,630263999,7359630,637623629,True,3
5747,validator_1,502465929118,True,709059994,18109280,727169274,True,15
5748,validator_6,269209532260,True,749676004,28293400,777969404,True,8
5749,validator_30,100520739272,True,420899995,11494280,432394275,True,3
5750,validator_24,93446591551,True,795496000,20910240,816406240,True,2
5751,validator_11,255495753460,True,526200000,3296940,529496940,False,7
5752,validator_4,261075575490,True,624740004,41546600,666286604,True,8
5753,validator_3,415368629240,True,508300000,1848620,510148620,False,12
5754,validator_34,100290748410,True,462400000,7097620,469497620,False,3
5755,validator_15,158562236142,True,819820005,13510470,833330475,True,4
5756,validator_7,278424753174,True,946399996,10239400,956639396,True,8
5757,validator_34,101020660600,True,727100000,2812190,729912190,False,3
5758,validator_47,51387034632,True,1062939999,26793300,1089733299,True,1
5759,validator_11,256106283890,True,608000000,2530430,610530430,False,8
5760,validator_17,163163583425,True,580780005,18251100,599031105,True,5
5761,validator_95,42605504810,True,706100000,2846310,708946310,False,1
5762,validator_9,270446303510,True,640300000,24386230,664686230,False,8
5763,validator_19,138258186820,True,517800000,2538430,520338430,False,4
5764,validator_8,244991217720,True,537300000,5760180,543060180,False,7
5765,validator_29,109298191098,True,511699998,1512740,513212738,True,3
5766,validator_3,416041916140,True,670300000,2986900,673286900,False,13
5767,validator_24,94021523359,True,549729998,25201810,574931808,True,2
5768,validator_1,503281137499,True,782760001,32448380,815208381,True,15
5769,validator_1,503949291943,True,622580004,45574440,668154444,True,15
5770,validator_8,245647072700,True,618900000,36954980,655854980,False,7
5771,validator_3,416812432940,True,768100000,2416800,770516800,False,13
5772,validator_12,146313705566,True,839799993,2551190,842351183,True,4
5773,validator_9,270994338430,True,546000000,2034920,548034920,False,8
5774,validator_4,261688548018,True,579859988,33112540,612972528,True,8
5775,validator_97,49509829430,True,649200000,3382550,652582550,False,1
5776,validator_35,94572666730,True,669500000,2035740,671535740,False,2
5777,validator_49,50591641468,True,622200003,54907030,677107033,True,1
5778,validator_0,435710331424,True,536339992,32863700,569203692,True,13
5779,validator_4,262426106213,True,721739995,15818200,737558195,True,8
5780,validator_4,263297105412,True,849699999,21299200,870999199,True,8
5781,validator_28,104190164954,True,581599999,4810100,586410099,True,3
5782,validator_35,95150660010,True,574300000,3693280,577993280,False,2
5783,validator_9,271821883810,True,826200000,1345380,827545380,False,8
5784,validator_9,272424463610,True,600400000,2179800,602579800,False,8
5785,validator_1,504822916377,True,869799994,3824440,873624434,True,15
5786,validator_60,59215280345,True,925295997,28403040,953699037,True,1
5787,validator_3,417621455520,True,785400000,23622580,809022580,False,13
5788,validator_0,436386838321,True,649519997,26986900,676506897,True,13
5789,validator_0,436931366517,True,523269996,21258200,544528196,True,13
5790,validator_1,506022405694,True,1139879997,59609320,1199489317,True,15
5791,validator_26,92140393342,True,565499997,2291330,567791327,True,2
5792,validator_88,48731241190,True,652300000,25879000,678179000,False,1
5793,validator_15,159101801526,True,496614004,42951380,539565384,True,4
5794,validator_29,109881650222,True,581700004,1759120,583459124,True,3
5795,validator_6,269859063233,True,594480003,55050970,649530973,True,8
5796,validator_65,46011403047,True,463486002,86951800,550437802,True,1
5797,validator_9,273020431210,True,582000000,13967600,595967600,False,8
5798,validator_13,157073309487,True,814499996,10670230,825170226,True,4
5799,validator_1,507034037948,True,989587994,22044260,1011632254,True,15
5800,validator_32,101379460735,True,605000005,10967310,615967315,True,3
5801,validator_4,263945998541,True,627536009,21357120,648893129,True,8
5802,validator_8,246370650010,True,717300000,6277310,723577310,False,7
5803,validator_11,256736032830,True,628000000,1748940,629748940,False,8
5804,validator_27,97421038530,True,707140000,8029010,715169010,True,3
5805,validator_2,413488184780,True,739500000,12110980,751610980,False,12
5806,validator_32,102187509661,True,783813996,24234930,808048926,True,3
5807,validator_6,270418209625,True,514798002,44348390,559146392,True,8
5808,validator_3,418021307860,True,389400000,10452340,399852340,False,13
5809,validator_6,270859213716,True,424000001,17004090,441004091,True,8
5810,validator_5,277688908998,True,1331479996,13833100,1345313096,True,8
5811,validator_7,279034203470,True,570739996,38710300,609450296,True,8
5812,validator_38,92064186250,True,454200000,19440590,473640590,False,2
5813,validator_43,98288575480,True,564500000,26793200,591293200,False,3
5814,validator_1,507731266776,True,673659998,23568830,697228828,True,15
5815,validator_34,101854136140,True,832400000,1075540,833475540,False,3
5816,validator_53,44555804935,True,893600006,25778300,919378306,True,1
5817,validator_32,102874503095,True,665920004,21073430,686993434,True,3
5818,validator_0,437510571913,True,539659996,39545400,579205396,True,13
5819,validator_8,247052229050,True,679100000,2479040,681579040,False,7
5820,validator_10,248055891820,True,652900000,20915080,673815080,False,7
5821,validator_97,50171108100,True,653000000,8278670,661278670,False,1
5822,validator_17,163877859425,True,681064000,33212000,714276000,True,5
5823,validator_0,438126119963,True,595840000,19708050,615548050,True,13
5824,validator_27,98215910162,True,780600002,14271630,794871632,True,3
5825,validator_59,43960149197,True,820940002,31611290,852551292,True,1
5826,validator_1,508410442138,True,659940002,19235360,679175362,True,15
5827,validator_1,509090665160,True,635739992,44483030,680223022,True,15
5828,validator_28,104750893433,True,529635999,31092480,560728479,True,3
5829,validator_21,147275450160,True,804500000,1314040,805814040,False,4
5830,validator_32,103735180698,True,851100003,9577600,860677603,True,3
5831,validator_95,43214454540,True,602800000,6149730,608949730,False,1
5832,validator_9,273728126740,True,705500000,2195530,707695530,False,8
5833,validator_81,44633041800,True,487400000,3834460,491234460,False,1
5834,validator_5,278312034534,True,603399996,19725540,623125536,True,8
5835,validator_11,257155468670,True,416080000,3355840,419435840,False,8
5836,validator_14,166108182714,True,567482000,113901430,681383430,True,5
5837,validator_8,247617463950,True,562500000,2734900,565234900,False,7
5838,validator_14,166795544828,True,677939994,9422120,687362114,True,5
5839,validator_41,101672639620,True,907200000,1174550,908374550,False,3
5840,validator_34,102278471940,True,420600000,3735800,424335800,False,3
5841,validator_0,438843693144,True,678560001,39013180,717573181,True,13
5842,validator_35,95602051450,True,447500000,3891440,451391440,False,2
5843,validator_0,439436019305,True,590400001,1926160,592326161,True,13
5844,validator_9,274211810150,True,482400000,1283410,483683410,False,8
5845,validator_10,248742336380,True,671600000,14844560,686444560,False,7
5846,validator_23,141987071280,True,476200000,1990930,478190930,False,4
5847,validator_0,440044983306,True,607100001,1864000,608964001,True,13
5848,validator_35,96244696600,True,640100000,2545150,642645150,False,3
5849,validator_0,440754114812,True,607153996,101977510,709131506,True,13
5850,validator_2,414211567810,True,698700000,24683030,723383030,False,12
5851,validator_15,159889710723,True,785099997,2809200,787909197,True,4
5852,validator_75,46356862690,True,728300000,2967050,731267050,False,1
5853,validator_25,114368861791,True,752599998,20560400,773160398,True,3
5854,validator_28,105411833432,True,645713999,15226000,660939999,True,3
5855,validator_1,509885246071,True,762046001,32534910,794580911,True,15
5856,validator_0,441454047304,True,665730002,34202490,699932492,True,13
5857,validator_40,90483574850,True,518700000,10540230,529240230,False,2
5858,validator_76,49230292360,True,581400000,8121040,589521040,False,1
5859,validator_0,441958270228,True,464875984,39346940,504222924,True,13
5860,validator_2,414660120110,True,444000000,4552300,448552300,False,12
5861,validator_98,41389441170,True,518200000,1959750,520159750,False,1
5862,validator_6,271712677633,True,836119997,17343920,853463917,True,8
5863,validator_3,418471265050,True,437600000,12357190,449957190,False,13
5864,validator_97,50901450220,True,722500000,7842120,730342120,False,1
5865,validator_9,274873687240,True,652000000,9877090,661877090,False,8
5866,validator_30,101156366873,True,628900001,6727600,635627601,True,3
5867,validator_79,47429636100,True,446400000,9115640,455515640,False,1
5868,validator_1,510586341315,True,690620004,10475240,701095244,True,15
5869,validator_84,43496406670,True,736400000,16324060,752724060,False,1
5870,validator_33,109529161083,True,488559995,41822000,530381995,True,3
5871,validator_22,150540673230,True,850500000,3512530,854012530,False,4
5872,validator_3,419206847430,True,730400000,5182380,735582380,False,13
5873,validator_20,146779049700,True,557000000,1759960,558759960,False,4
5874,validator_10,249143053080,True,399700000,1016700,400716700,False,7
5875,validator_11,257662393900,True,505600000,1325230,506925230,False,8
5876,validator_1,511311621133,True,706399998,18879820,725279818,True,15
5877,validator_5,278893765467,True,549780003,31950930,581730933,True,8
5878,validator_81,45168524580,True,529500000,5982780,535482780,False,1
5879,validator_65,46627486728,True,605264001,10819680,616083681,True,1
5880,validator_35,96962694730,True,711900000,6098130,717998130,False,3
5881,validator_3,419920696920,True,704100000,9749490,713849490,False,13
5882,validator_8,248121604600,True,501200000,2940650,504140650,False,7
5883,validator_15,160577835790,True,686499997,1625070,688125067,True,5
5884,validator_42,101833292090,True,613200000,13100200,626300200,False,3
5885,validator_29,110748461402,True,844020000,22791180,866811180,True,3
5886,validator_16,143108023687,True,565000000,14393830,579393830,True,4
5887,validator_47,51963414926,True,575099994,1280300,576380294,True,1
5888,validator_51,44796000283,True,554999999,24448320,579448319,True,1
5889,validator_11,258241499120,True,577800000,1305220,579105220,False,8
5890,validator_13,157625838446,True,535339999,17188960,552528959,True,4
5891,validator_10,249679053450,True,525300000,10700370,536000370,False,7
5892,validator_12,146969292368,True,652700002,2886800,655586802,True,4
5893,validator_1,512046154651,True,712439998,22093520,734533518,True,16
5894,validator_37,85845645260,True,736700000,3624790,740324790,False,2
5895,validator_43,98875539610,True,583300000,3664130,586964130,False,3
5896,validator_29,111296756808,True,540700006,7595400,548295406,True,3
5897,validator_26,93262538732,True,1107719990,14425400,1122145390,True,2
5898,validator_8,248672120060,True,546500000,4015460,550515460,False,7
5899,validator_34,103003962600,True,705500000,19990660,725490660,False,3
5900,validator_0,442788446128,True,827400000,2775900,830175900,True,13
5901,validator_45,49655196533,True,699245999,6728700,705974699,True,1
5902,validator_82,49685161100,True,659000000,27296600,686296600,False,1
5903,validator_95,43754261090,True,538600000,1206550,539806550,False,1
5904,validator_22,151106217450,True,558900000,6644220,565544220,False,4
5905,validator_77,46174759740,True,498200000,4715900,502915900,False,1
5906,validator_2,415038499010,True,376000000,2378900,378378900,False,12
5907,validator_53,45193408933,True,633399998,4204000,637603998,True,1
5908,validator_1,512735488220,True,669679999,19653570,689333569,True,16
5909,validator_25,115166669876,True,784839995,12968090,797808085,True,3
5910,validator_1,513587750047,True,841699997,10561830,852261827,True,16
5911,validator_3,420746635720,True,818300000,7638800,825938800,False,13
5912,validator_8,249394622090,True,718400000,4102030,722502030,False,7
5913,validator_42,102402271130,True,568600000,379040,568979040,False,3
5914,validator_9,275510536960,True,635500000,1349720,636849720,False,8
5915,validator_32,104813326373,True,1051564005,26581670,1078145675,True,3
5916,validator_29,111876620009,True,566240001,13623200,579863201,True,3
5917,validator_0,443627444570,True,820054002,18944440,838998442,True,13
5918,validator_0,444389818058,True,741300008,21073480,762373488,True,13
5919,validator_18,146043999370,True,778600000,3803680,782403680,False,4
5920,validator_1,514276030779,True,682900002,5380730,688280732,True,16
5921,validator_58,49739021273,True,648839992,27822480,676662472,True,1
5922,validator_49,51338630607,True,739899999,7089140,746989139,True,1
5923,validator_38,92690790350,True,625000000,1604100,626604100,False,2
5924,validator_7,279717144999,True,675469999,7471530,682941529,True,8
5925,validator_12,147788459542,True,809620004,9547170,819167174,True,4
5926,validator_7,280536233649,True,792440000,26648650,819088650,True,8
5927,validator_7,281460516579,True,862480000,61802930,924282930,True,8
5928,validator_2,415749369040,True,706000000,4870030,710870030,False,12
5929,validator_7,282072461783,True,602540004,9405200,611945204,True,8
5930,validator_87,50093005990,True,640200000,3383580,643583580,False,1
5931,validator_94,48786309070,True,658400000,3221420,661621420,False,1
5932,validator_65,47271114686,True,611239998,32387960,643627958,True,1
5933,validator_13,158381046724,True,724639998,30568280,755208278,True,4
5934,validator_40,91191618680,True,702600000,5443830,708043830,False,2
5935,validator_23,142698749110,True,708600000,3077830,711677830,False,4
5936,validator_85,43942214340,True,532500000,2811310,535311310,False,1
5937,validator_55,45581767415,True,563220002,13990120,577210122,True,1
5938,validator_4,264743646242,True,767520001,30127700,797647701,True,8
5939,validator_11,258896662240,True,632400000,22763120,655163120,False,8
5940,validator_20,147208549510,True,428400000,1099810,429499810,False,4
5941,validator_2,416380741720,True,628900000,2472680,631372680,False,13
5942,validator_6,272317864334,True,597400001,7786700,605186701,True,8
5943,validator_10,250283475870,True,602100000,2322420,604422420,False,7
5944,validator_6,273039905567,True,660560003,61481230,722041233,True,8
5945,validator_1,514967258276,True,687399997,3827500,691227497,True,16
5946,validator_76,50012811120,True,752400000,30118760,782518760,False,1
5947,validator_21,148084960070,True,800100000,9409910,809509910,False,4
5948,validator_97,51619134470,True,715000000,2684250,717684250,False,1
5949,validator_43,99563398810,True,684470000,3389200,687859200,False,3
5950,validator_63,52367988812,True,479800005,9951140,489751145,True,1
5951,validator_5,279639902854,True,709299997,36837390,746137387,True,8
5952,validator_41,102304000950,True,611700000,19661330,631361330,False,3
5953,validator_74,45049602280,True,676700000,2732940,679432940,False,1
5954,validator_64,55500949109,True,639346002,27895700,667241702,True,1
5955,validator_4,265251120460,True,499699998,7774220,507474218,True,8
5956,validator_2,416967209450,True,585100000,1367730,586467730,False,13
5957,validator_12,148590401275,True,766040003,35901730,801941733,True,4
5958,validator_29,112503161539,True,603160000,23381530,626541530,True,3
5959,validator_4,265956966339,True,697563999,8281880,705845879,True,8
5960,validator_0,445236004608,True,825120000,21066550,846186550,True,13
5961,validator_2,417507112290,True,538410000,1492840,539902840,False,13
5962,validator_69,48843415163,True,697500000,6481740,703981740,True,1
5963,validator_87,50761269920,True,667400000,863930,668263930,False,1
5964,validator_35,97340422380,True,369100000,8627650,377727650,False,3
5965,validator_50,47080748135,True,648699999,9062130,657762129,True,1
5966,validator_6,273998677251,True,945500004,13271680,958771684,True,8
5967,validator_23,143311468400,True,575200000,37519290,612719290,False,4
5968,validator_23,144163230940,True,832400000,19362540,851762540,False,4
5969,validator_33,110075915416,True,516220003,30534330,546754333,True,3
5970,validator_3,421077513840,True,324030000,6848120,330878120,False,13
5971,validator_43,100404368710,True,833800000,7169900,840969900,False,3
5972,validator_11,259454867460,True,554400000,3805220,558205220,False,8
5973,validator_56,56792923508,True,771799997,30605060,802405057,True,1
5974,validator_34,103542827800,True,535100000,3765200,538865200,False,3
5975,validator_52,50082664106,True,764700005,10076500,774776505,True,1
5976,validator_0,446022835096,True,776299998,10530490,786830488,True,13
5977,validator_10,250995808500,True,703500000,8832630,712332630,False,7
5978,validator_78,43407325060,True,512900000,3638980,516538980,False,1
5979,validator_1,515950624469,True,960359993,23006200,983366193,True,16
5980,validator_56,57686737508,True,869660000,24154000,893814000,True,1
5981,validator_18,146632059370,True,586500000,1560000,588060000,False,4
5982,validator_70,47892628188,True,655900009,3310530,659210539,True,1
5983,validator_15,161352332851,True,753980001,20517060,774497061,True,5
5984,validator_23,144748219780,True,565300000,19688840,584988840,False,4
5985,validator_13,159286857250,True,864260006,41550520,905810526,True,4
5986,validator_31,111148559741,True,826039999,9000440,835040439,True,3
5987,validator_7,282895977778,True,798619995,24896000,823515995,True,8
5988,validator_6,274716571507,True,698200006,19694250,717894256,True,8
5989,validator_43,101197074670,True,769500000,23205960,792705960,False,3
5990,validator_8,250047843010,True,652100000,1120920,653220920,False,7
5991,validator_10,251492160840,True,492700000,3652340,496352340,False,7
5992,validator_7,283559676175,True,658199997,5498400,663698397,True,8
5993,validator_7,284087780775,True,497980000,30124600,528104600,True,8
5994,validator_7,284765986881,True,675300006,2906100,678206106,True,8
5995,validator_16,143679162522,True,550519995,20618840,571138835,True,4
5996,validator_2,418256192570,True,729700000,19380280,749080280,False,13
5997,validator_21,148671701870,True,585200000,1541800,586741800,False,4
5998,validator_60,59970744329,True,726999994,28463990,755463984,True,1
5999,validator_27,99053751107,True,800220005,37620940,837840945,True,3
6000,validator_10,252140232920,True,645000000,3072080,648072080,False,7
6001,validator_88,49197228370,True,457200000,8787180,465987180,False,1
6002,validator_4,266873759423,True,902966004,13827080,916793084,True,8
6003,validator_85,44504086560,True,559600000,2272220,561872220,False,1
6004,validator_61,54083723934,True,837140005,18771270,855911275,True,1
6005,validator_4,267759851061,True,878439998,7651640,886091638,True,8
6006,validator_9,276154884130,True,635100000,9247170,644347170,False,8
6007,validator_31,111724020755,True,566239994,9221020,575461014,True,3
6008,validator_39,101827653150,True,452400000,2768430,455168430,False,3
6009,validator_79,48039273130,True,592000000,17637030,609637030,False,1
6010,validator_15,162160116449,True,797199998,10583600,807783598,True,5
6011,validator_76,50712514520,True,697100000,2603400,699703400,False,1
6012,validator_40,91855759840,True,662900000,1241160,664141160,False,2
6013,validator_90,46449862270,True,577200000,25185800,602385800,False,1
6014,validator_17,164622373149,True,735700004,8813720,744513724,True,5
6015,validator_9,276629940930,True,468080000,6976800,475056800,False,8
6016,validator_1,516550337318,True,597499999,2212850,599712849,True,16
6017,validator_22,152042277650,True,883500000,52560200,936060200,False,4
6018,validator_5,280393664462,True,749499998,4261610,753761608,True,8
6019,validator_73,48439834090,True,524400000,3602430,528002430,False,1
6020,validator_8,250810835030,True,759500000,3492020,762992020,False,7
6021,validator_87,51386749450,True,605200000,20279530,625479530,False,1
6022,validator_9,277180475650,True,539000000,11534720,550534720,False,8
6023,validator_90,47001965670,True,548100000,4003400,552103400,False,1
6024,validator_3,421557276110,True,473600000,6162270,479762270,False,13
6025,validator_0,446786862496,True,762000000,2027400,764027400,True,13
6026,validator_38,93549678690,True,856900000,1988340,858888340,False,2
6027,validator_42,102968710560,True,516300000,50139430,566439430,False,3
6028,validator_2,418833558860,True,570100000,7266290,577366290,False,13
6029,validator_22,152597356970,True,552800000,2279320,555079320,False,4
6030,validator_3,422056364400,True,495900000,3188290,499088290,False,13
6031,validator_95,44314251520,True,557500000,2490430,559990430,False,1
6032,validator_14,167630412848,True,830400000,4468020,834868020,True,5
6033,validator_97,52283003770,True,644200000,19669300,663869300,False,1
6034,validator_23,145500595950,True,737100000,15276170,752376170,False,4
6035,validator_17,165298855341,True,672699992,3782200,676482192,True,5
6036,validator_7,285454170295,True,674340004,13843410,688183414,True,8
6037,validator_30,101894092363,True,706718010,31007480,737725490,True,3
6038,validator_22,153145832370,True,546100000,2375400,548475400,False,4
6039,validator_2,419486210220,True,651000000,1651360,652651360,False,13
6040,validator_31,112546721117,True,821700002,1000360,822700362,True,3
6041,validator_9,277790987150,True,589800000,20711500,610511500,False,8
6042,validator_9,278475727950,True,665200000,19540800,684740800,False,8
6043,validator_23,146120544120,True,614800000,5148170,619948170,False,4
6044,validator_77,46748240980,True,569400000,4081240,573481240,False,1
6045,validator_39,102351645240,True,518000000,5992090,523992090,False,3
6046,validator_1,517363650198,True,786020000,27292880,813312880,True,16
6047,validator_10,252765205700,True,622000000,2972780,624972780,False,7
6048,validator_12,149355843976,True,733820001,31622700,765442701,True,4
6049,validator_59,44566387765,True,569639998,36598570,606238568,True,1
6050,validator_38,94172064390,True,619400000,2985700,622385700,False,2
6051,validator_30,102600802960,True,705399997,1310600,706710597,True,3
6052,validator_37,86474475290,True,624000000,4830030,628830030,False,2
6053,validator_14,168385032729,True,732560001,22059880,754619881,True,5
6054,validator_16,144260355977,True,557339995,23853460,581193455,True,4
6055,validator_0,447619794243,True,822720007,10211740,832931747,True,13
6056,validator_20,147779980370,True,550400000,21030860,571430860,False,4
6057,validator_12,150088206057,True,704780001,27582080,732362081,True,4
6058,validator_45,50422104303,True,751020000,15887770,766907770,True,1
6059,validator_11,260191537650,True,723500000,13170190,736670190,False,8
6060,validator_86,50118582430,True,493600000,10510000,504110000,False,1
6061,validator_81,45935109180,True,764500000,2084600,766584600,False,1
6062,validator_15,163030445129,True,860320000,10008680,870328680,True,5
6063,validator_3,422561215490,True,500400000,4451090,504851090,False,13
6064,validator_73,49096579590,True,654500000,2245500,656745500,False,1
6065,validator_2,420090325120,True,591100000,13014900,604114900,False,13
6066,validator_12,150776783359,True,679520002,9057300,688577302,True,4
6067,validator_11,260629228490,True,418100000,19590840,437690840,False,8
6068,validator_13,160133715545,True,809919995,36938300,846858295,True,5
6069,validator_47,52594020629,True,622600003,8005700,630605703,True,1
6070,validator_24,94647693227,True,620719998,5449870,626169868,True,2
6071,validator_10,253272114660,True,465200000,41708960,506908960,False,7
6072,validator_0,448410089690,True,766439997,23855450,790295447,True,14
6073,validator_3,423107449090,True,526200000,20033600,546233600,False,13
6074,validator_94,49207380090,True,413900000,7171020,421071020,False,1
6075,validator_51,45493829813,True,656780000,41049530,697829530,True,1
6076,validator_7,286252909613,True,786760008,11979310,798739318,True,8
6077,validator_0,448824219043,True,403600003,10529350,414129353,True,14
6078,validator_12,151743495697,True,945300008,21412330,966712338,True,4
6079,validator_27,99820079934,True,762239997,4088830,766328827,True,3
6080,validator_20,148318866700,True,536400000,2486330,538886330,False,4
6081,validator_19,138805754610,True,537300000,10267790,547567790,False,4
6082,validator_83,49859945800,True,532700000,2661290,535361290,False,1
6083,validator_20,148919179430,True,596200000,4112730,600312730,False,4
6084,validator_0,449574418372,True,730579999,19619330,750199329,True,14
6085,validator_10,253841046260,True,564800000,4131600,568931600,False,7
6086,validator_41,102977781480,True,671400000,2380530,673780530,False,3
6087,validator_9,279072622980,True,595300000,1595030,596895030,False,8
6088,validator_39,103013714880,True,646800000,15269640,662069640,False,3
6089,validator_3,423654928290,True,533000000,14479200,547479200,False,13
6090,validator_20,149460998810,True,536300000,5519380,541819380,False,4
6091,validator_14,169271052827,True,874439998,11580100,886020098,True,5
6092,validator_63,53004951416,True,625899994,11062610,636962604,True,1
6093,validator_30,103235633920,True,592920000,41910960,634830960,True,3
6094,validator_6,275447734203,True,723099996,8062700,731162696,True,8
6095,validator_3,424355361050,True,661300000,39132760,700432760,False,13
6096,validator_19,139348241940,True,534700000,7787330,542487330,False,4
6097,validator_14,170039654556,True,758199999,10401730,768601729,True,5
6098,validator_39,103501276610,True,469440000,18121730,487561730,False,3
6099,validator_23,146701798850,True,579100000,2154730,581254730,False,4
6100,validator_17,166122052111,True,803660000,19536770,823196770,True,5
6101,validator_0,450305988282,True,720700000,10869910,731569910,True,14
6102,validator_33,110783477528,True,686640002,20922110,707562112,True,3
6103,validator_1,518018383120,True,630700002,24032920,654732922,True,16
6104,validator_26,94022025146,True,745800004,13686410,759486414,True,2
6105,validator_3,424906005320,True,546900000,3744270,550644270,False,13
6106,validator_11,261120471590,True,481700000,9543100,491243100,False,8
6107,validator_11,262025523870,True,898200000,6852280,905052280,False,8
6108,validator_20,150058313450,True,576000000,21314640,597314640,False,4
6109,validator_12,152873257688,True,1112700001,17061990,1129761991,True,4
6110,validator_2,420648872980,True,537400000,21147860,558547860,False,13
6111,validator_10,254446348770,True,598900000,6402510,605302510,False,7
6112,validator_36,94256625090,True,673000000,18332870,691332870,False,2
6113,validator_66,55956203020,True,820140007,46611820,866751827,True,1
6114,validator_12,153602467203,True,722199995,7009520,729209515,True,4
6115,validator_13,161069477554,True,868458009,67304000,935762009,True,5
6116,validator_3,425709008020,True,800700000,2302700,803002700,False,13
6117,validator_11,262466431240,True,432060000,8847370,440907370,False,8
6118,validator_9,279804846980,True,727000000,5224000,732224000,False,8
6119,validator_7,286842273635,True,586599992,2764030,589364022,True,8
6120,validator_9,280409381580,True,582100000,22434600,604534600,False,8
6121,validator_3,426232131940,True,520400000,2723920,523123920,False,13
6122,validator_88,49766358070,True,558000000,11129700,569129700,False,1
6123,validator_6,276072063808,True,574180005,50149600,624329605,True,8
6124,validator_81,46489616180,True,548600000,5907000,554507000,False,1
6125,validator_60,60785902196,True,795600007,19557860,815157867,True,1
6126,validator_51,46354456607,True,826979994,33646800,860626794,True,1
6127,validator_54,51580161605,True,729174004,48966140,778140144,True,1
6128,validator_19,139927501730,True,558500000,20759790,579259790,False,4
6129,validator_41,103730691920,True,751000000,1910440,752910440,False,3
6130,validator_33,111674774058,True,865100000,26196530,891296530,True,3
6131,validator_63,53907651284,True,863919998,38779870,902699868,True,1
6132,validator_3,426860097500,True,626800000,1165560,627965560,False,13
6133,validator_81,47286999760,True,793600000,3783580,797383580,False,1
6134,validator_66,56486781257,True,519439997,11138240,530578237,True,1
6135,validator_65,48054974587,True,763574001,20285900,783859901,True,1
6136,validator_8,251496972430,True,669100000,17037400,686137400,False,7
6137,validator_11,262975309360,True,506200000,2678120,508878120,False,8
6138,validator_30,104062959598,True,816319998,11005680,827325678,True,3
6139,validator_20,150711620550,True,644500000,8807100,653307100,False,4
6140,validator_22,153950980670,True,802900000,2248300,805148300,False,4
6141,validator_15,163792286121,True,698859992,62981000,761840992,True,5
6142,validator_41,104391798210,True,659200000,1906290,661106290,False,3
6143,validator_4,268397311962,True,596660001,40800900,637460901,True,8
6144,validator_10,255080464370,True,629000000,5115600,634115600,False,7
6145,validator_65,48840423786,True,781299999,4149200,785449199,True,1
6146,validator_15,164641819672,True,823540001,25993550,849533551,True,5
6147,validator_25,115923653477,True,719090001,37893600,756983601,True,3
6148,validator_86,50714533660,True,593400000,2551230,595951230,False,1
6149,validator_45,51253644828,True,814240005,17300520,831540525,True,1
6150,validator_6,276732780711,True,629580003,31136900,660716903,True,8
6151,validator_4,269215843294,True,793500002,25031330,818531332,True,8
6152,validator_68,48347647607,True,568760007,16658000,585418007,True,1
6153,validator_8,251971206730,True,470900000,3334300,474234300,False,7
6154,validator_16,144991242897,True,728099990,2786930,730886920,True,4
6155,validator_31,113309430039,True,721120002,41588920,762708922,True,3
6156,validator_4,270075267412,True,830153998,29270120,859424118,True,8
6157,validator_66,56949683776,True,442339999,20562520,462902519,True,1
6158,validator_43,101784931780,True,581200000,6657110,587857110,False,3
6159,validator_60,61305532211,True,493199995,26430020,519630015,True,1
6160,validator_27,100544710163,True,721899999,2730230,724630229,True,3
6161,validator_11,263424752390,True,430300000,19143030,449443030,False,8
6162,validator_24,95390758397,True,720220000,22845170,743065170,True,2
6163,validator_52,50734611021,True,643839995,8106920,651946915,True,1
6164,validator_3,427451786610,True,572200000,19489110,591689110,False,13
6165,validator_38,94727647390,True,535500000,20083000,555583000,False,2
6166,validator_70,48405991538,True,487700000,25663350,513363350,True,1
6167,validator_10,255542820350,True,456200000,6155980,462355980,False,7
6168,validator_71,57486896963,True,827840006,46813690,874653696,True,1
6169,validator_3,427920778540,True,431100000,37891930,468991930,False,13
6170,validator_15,165339797714,True,678730002,19248040,697978042,True,5
6171,validator_67,52105571570,True,657960001,59728210,717688211,True,1
6172,validator_11,263939906400,True,512200000,2954010,515154010,False,8
6173,validator_31,113805745934,True,494599995,1715900,496315895,True,3
6174,validator_4,270677351010,True,582719998,19363600,602083598,True,8
6175,validator_43,102274655080,True,470600000,19123300,489723300,False,3
6176,validator_38,95497555390,True,767200000,2708000,769908000,False,2
6177,validator_10,256138436430,True,592100000,3516080,595616080,False,8
6178,validator_23,147260315050,True,539570000,18946200,558516200,False,4
6179,validator_43,102951984640,True,674400000,2929560,677329560,False,3
6180,validator_1,518904811533,True,883500003,2928410,886428413,True,16
6181,validator_33,112477299288,True,763600000,38925230,802525230,True,3
6182,validator_31,114637053982,True,822200008,9108040,831308048,True,3
6183,validator_4,271386821109,True,702919999,6550100,709470099,True,8
6184,validator_26,94781437043,True,738399997,21011900,759411897,True,2
6185,validator_8,252674069070,True,692800000,10062340,702862340,False,7
6186,validator_7,287416228578,True,564020003,9934940,573954943,True,8
6187,validator_21,149301535150,True,618900000,10933280,629833280,False,4
6188,validator_6,277585610149,True,824879998,27949440,852829438,True,8
6189,validator_10,256834912960,True,693800000,2676530,696476530,False,8
6190,validator_38,96078994090,True,562700000,18738700,581438700,False,3
6191,validator_1,519446031942,True,538699999,2520410,541220409,True,16
6192,validator_19,140467977470,True,533900000,6575740,540475740,False,4
6193,validator_24,96127582121,True,713420004,23403720,736823724,True,3
6194,validator_3,428574673380,True,652700000,1194840,653894840,False,13
6195,validator_3,429475684460,True,897700000,3311080,901011080,False,13
6196,validator_3,430256960180,True,778600000,2675720,781275720,False,13
6197,validator_11,264466990740,True,495400000,31684340,527084340,False,8
6198,validator_92,40592525840,True,549300000,3853120,553153120,False,1
6199,validator_42,103804979460,True,816300000,19968900,836268900,False,3
6200,validator_37,87213520110,True,733200000,5844820,739044820,False,2
6201,validator_1,520129737972,True,653140000,30566030,683706030,True,16
6202,validator_1,520781242461,True,609879999,41624490,651504489,True,16
6203,validator_20,151362441670,True,644200000,6621120,650821120,False,4
6204,validator_3,430915810780,True,654500000,4350600,658850600,False,13
6205,validator_93,44797693580,True,531500000,8550760,540050760,False,1
6206,validator_42,104522127240,True,714100000,3047780,717147780,False,3
6207,validator_40,92400610840,True,543800000,1051000,544851000,False,2
6208,validator_7,288082365221,True,663700003,2436640,666136643,True,9
6209,validator_51,47015623800,True,636120003,25047190,661167193,True,1
6210,validator_10,257436041330,True,581700000,19428370,601128370,False,8
6211,validator_9,281129810000,True,716000000,4428420,720428420,False,8
6212,validator_9,281879593650,True,709300000,40483650,749783650,False,8
6213,validator_38,96603309090,True,523200000,1115000,524315000,False,3
6214,validator_36,94975477090,True,717500000,1352000,718852000,False,2
6215,validator_18,147248322070,True,596600000,19662700,616262700,False,4
6216,validator_9,282560873940,True,650400000,30880290,681280290,False,8
6217,validator_32,105477120203,True,616264000,47529830,663793830,True,3
6218,validator_12,154226986519,True,595845996,28673320,624519316,True,4
6219,validator_39,104017599990,True,506100000,10223380,516323380,False,3
6220,validator_0,451173642883,True,803640001,64014600,867654601,True,14
6221,validator_11,265140804390,True,662000000,11813650,673813650,False,8
6222,validator_11,265959677520,True,816900000,1973130,818873130,False,8
6223,validator_77,47350098880,True,588100000,13757900,601857900,False,1
6224,validator_7,288746927726,True,661200005,3362500,664562505,True,9
6225,validator_6,278130335364,True,514960005,29765210,544725215,True,8
6226,validator_5,280990528921,True,577495999,19368460,596864459,True,8
6227,validator_2,421160146700,True,501500000,9773720,511273720,False,13
6228,validator_9,283154353220,True,589600000,3879280,593479280,False,8
6229,validator_78,44110343590,True,664400000,38618530,703018530,False,1
6230,validator_23,147878573050,True,615700000,2558000,618258000,False,4
6231,validator_8,253242960000,True,550900000,17990930,568890930,False,7
6232,validator_13,161736457453,True,631023999,35955900,666979899,True,5
6233,validator_68,48884552616,True,502800009,34105000,536905009,True,1
6234,validator_98,42004300870,True,613900000,959700,614859700,False,1
6235,validator_2,421822456240,True,652600000,9709540,662309540,False,13
6236,validator_1,521354547664,True,571120003,2185200,573305203,True,16
6237,validator_40,93041434310,True,633000000,7823470,640823470,False,2
6238,validator_70,49127291131,True,719299993,1999600,721299593,True,1
6239,validator_2,422437156620,True,610600000,4100380,614700380,False,13
6240,validator_0,451821042486,True,632540003,14859600,647399603,True,14
6241,validator_21,149880941350,True,574600000,4806200,579406200,False,4
6242,validator_6,278845080062,True,704019998,10724700,714744698,True,8
6243,validator_26,95268567880,True,471580007,15550830,487130837,True,2
6244,validator_71,58262990962,True,765699999,10394000,776093999,True,1
6245,validator_37,87882864180,True,667500000,1844070,669344070,False,2
6246,validator_14,170765867385,True,715739999,10472830,726212829,True,5
6247,validator_9,283579254960,True,417500000,7401740,424901740,False,8
6248,validator_12,154948943473,True,720300004,1656950,721956954,True,4
6249,validator_2,422923120830,True,484200000,1764210,485964210,False,13
6250,validator_40,93492302050,True,448900000,1967740,450867740,False,2
6251,validator_62,54191501008,True,511170006,48205200,559375206,True,1
6252,validator_0,452461261363,True,629840007,10378870,640218877,True,14
6253,validator_46,46466762961,True,652974002,10815400,663789402,True,1
6254,validator_81,47948215560,True,621500000,39715800,661215800,False,1
6255,validator_13,162503289316,True,758300003,8531860,766831863,True,5
6256,validator_90,47549384990,True,518500000,28919320,547419320,False,1
6257,validator_4,272108469748,True,691259999,30388640,721648639,True,8
6258,validator_1,522234497446,True,834577992,45371790,879949782,True,16
6259,validator_33,112976164087,True,492299999,6564800,498864799,True,3
6260,validator_78,44834925240,True,707500000,17081650,724581650,False,1
6261,validator_43,103698645820,True,736300000,10361180,746661180,False,3
6262,validator_16,145880028119,True,862860002,25925220,888785222,True,4
6263,validator_22,154583254790,True,619000000,13274120,632274120,False,4
6264,validator_66,57802950174,True,838459998,14806400,853266398,True,1
6265,validator_1,522840694408,True,566600002,39596960,606196962,True,16
6266,validator_43,104292197750,True,591000000,2551930,593551930,False,3
6267,validator_30,104772769401,True,705640003,4169800,709809803,True,3
6268,validator_28,106130790366,True,695980004,22976930,718956934,True,3
6269,validator_1,523438025047,True,595099999,2230640,597330639,True,16
6270,validator_0,452948387990,True,485999997,1126630,487126627,True,14
6271,validator_16,146670309801,True,776499992,13781690,790281682,True,4
6272,validator_33,113470166276,True,465799999,28202190,494002189,True,3
6273,validator_7,289443146929,True,695500003,719200,696219203,True,9
6274,validator_2,423494828910,True,568700000,3008080,571708080,False,13
6275,validator_40,94230866350,True,727300000,11264300,738564300,False,2
6276,validator_10,258211771670,True,773300000,2430340,775730340,False,8
6277,validator_12,155796889808,True,827539995,20406340,847946335,True,4
6278,validator_69,49587258088,True,739400005,4442920,743842925,True,1
6279,validator_60,62066711842,True,691338001,69841630,761179631,True,1
6280,validator_10,258820354570,True,606000000,2582900,608582900,False,8
6281,validator_64,56238631928,True,695959999,41722820,737682819,True,1
6282,validator_39,104439278960,True,402500000,19178970,421678970,False,3
6283,validator_72,51078193180,True,723800000,2320110,726120110,False,1
6284,validator_7,290098470041,True,652699992,2623120,655323112,True,9
6285,validator_12,156622486828,True,804039990,21557030,825597020,True,4
6286,validator_19,141060447730,True,590000000,2470260,592470260,False,4
6287,validator_5,281723026466,True,707945995,24551550,732497545,True,8
6288,validator_73,49661749410,True,562300000,2869820,565169820,False,1
6289,validator_11,266788148020,True,817800000,10670500,828470500,False,8
6290,validator_66,58378051512,True,561139998,13961340,575101338,True,1
6291,validator_1,524120114113,True,655739996,26349070,682089066,True,16
6292,validator_1,524779255916,True,648900003,10241800,659141803,True,16
6293,validator_8,253686000730,True,440600000,2440730,443040730,False,7
6294,validator_3,431453740120,True,536500000,1429340,537929340,False,13
6295,validator_37,88667294180,True,780000000,4430000,784430000,False,2
6296,validator_11,267498403740,True,700800000,9455720,710255720,False,8
6297,validator_10,259382282860,True,559000000,2928290,561928290,False,8
6298,validator_39,105119382060,True,678000000,2103100,680103100,False,3
6299,validator_22,155241582370,True,654800000,3527580,658327580,False,4
6300,validator_6,279764164828,True,886499996,32584770,919084766,True,8
6301,validator_3,432223914350,True,764700000,5474230,770174230,False,13
6302,validator_6,280536804234,True,765000006,7639400,772639406,True,8
6303,validator_1,525427095017,True,641740001,6099100,647839101,True,16
6304,validator_7,290887602242,True,775100001,14032200,789132201,True,9
6305,validator_55,46310328695,True,723700000,4861280,728561280,True,1
6306,validator_34,104174296680,True,628900000,2568880,631468880,False,3
6307,validator_17,166968024948,True,817919997,28052840,845972837,True,5
6308,validator_19,141697736390,True,623100000,14188660,637288660,False,4
6309,validator_71,59205062145,True,937600003,4471180,942071183,True,1
6310,validator_73,50223070510,True,559300000,2021100,561321100,False,1
6311,validator_60,62669954939,True,579159997,24083100,603243097,True,1
6312,validator_7,291522696839,True,632699997,2394600,635094597,True,9
6313,validator_14,171318136115,True,540920000,11348730,552268730,True,5
6314,validator_70,49874367334,True,708980003,38096200,747076203,True,1
6315,validator_36,95610070520,True,631400000,3193430,634593430,False,2
6316,validator_11,268127601180,True,618900000,10297440,629197440,False,8
6317,validator_30,105381208712,True,565940001,42499310,608439311,True,3
6318,validator_1,525986463785,True,528585998,30782770,559368768,True,16
6319,validator_0,453826856778,True,857999998,20468790,878468788,True,14
6320,validator_33,114044697874,True,568599998,5931600,574531598,True,3
6321,validator_8,254343446870,True,652600000,4846140,657446140,False,7
6322,validator_4,272812902016,True,686160008,18272260,704432268,True,8
6323,validator_7,292338168441,True,813200002,2271600,815471602,True,9
6324,validator_90,48180725090,True,628800000,2540100,631340100,False,1
6325,validator_18,147895695870,True,619900000,27473800,647373800,False,4
6326,validator_77,47952303020,True,600300000,1904140,602204140,False,1
6327,validator_28,106877356550,True,728500004,18066180,746566184,True,3
6328,validator_0,454298620312,True,456120004,15643530,471763534,True,14
6329,validator_2,424234281080,True,729800000,9652170,739452170,False,13
6330,validator_26,96118516502,True,826440002,23508620,849948622,True,3
6331,validator_1,526643356486,True,617820001,39072700,656892701,True,16
6332,validator_35,97820786910,True,478400000,1964530,480364530,False,3
6333,validator_8,255016259300,True,643100000,29712430,672812430,False,7
6334,validator_22,155958826500,True,714900000,2344130,717244130,False,4
6335,validator_2,424946573140,True,707400000,4892060,712292060,False,13
6336,validator_14,172031013865,True,691000000,21877750,712877750,True,5
6337,validator_28,107626683630,True,740340000,8987080,749327080,True,3
6338,validator_11,268875649290,True,745700000,2348110,748048110,False,8
6339,validator_39,105744076890,True,608500000,16194830,624694830,False,3
6340,validator_0,454965873513,True,639668001,27585200,667253201,True,14
6341,validator_13,163236551418,True,719420002,13842100,733262102,True,5
6342,validator_5,282297613705,True,570399999,4187240,574587239,True,8
6343,validator_2,425663644660,True,692400000,24671520,717071520,False,13
6344,validator_36,96288403730,True,652900000,25433210,678333210,False,3
6345,validator_14,172871981850,True,818339995,22627990,840967985,True,5
6346,validator_7,293168248030,True,787279999,42799590,830079589,True,9
6347,validator_86,51334553880,True,617700000,2320220,620020220,False,1
6348,validator_7,293881029725,True,698500005,14281690,712781695,True,9
6349,validator_96,47854801900,True,446900000,3524010,450424010,False,1
6350,validator_1,527275080861,True,626020005,5704370,631724375,True,16
6351,validator_1,527978084370,True,692799999,10203510,703003509,True,16
6352,validator_20,152021221290,True,657300000,1479620,658779620,False,4
6353,validator_7,294555671860,True,668280005,6362130,674642135,True,9
6354,validator_85,45111248720,True,600500000,6662160,607162160,False,1
6355,validator_27,101273036684,True,700680001,27646520,728326521,True,3
6356,validator_42,105111649760,True,587600000,1922520,589522520,False,3
6357,validator_3,432894022650,True,656500000,13608300,670108300,False,13
6358,validator_49,51976559205,True,635599998,2328600,637928598,True,1
6359,validator_5,283319849428,True,1018999993,3235730,1022235723,True,8
6360,validator_68,49565232016,True,641820000,38859400,680679400,True,1
6361,validator_3,433509342690,True,613000000,2320040,615320040,False,13
6362,validator_61,54773058864,True,681266000,8068930,689334930,True,1
6363,validator_22,156427919600,True,467100000,1993100,469093100,False,4
6364,validator_38,97382825020,True,752200000,27315930,779515930,False,3
6365,validator_42,105628229180,True,507900000,8679420,516579420,False,3
6366,validator_1,528615865667,True,617399997,20381300,637781297,True,16
6367,validator_55,46996561956,True,648560001,37673260,686233261,True,1
6368,validator_6,281249914131,True,701719997,11389900,713109897,True,8
6369,validator_95,44949583420,True,625100000,10231900,635331900,False,1
6370,validator_14,173541174346,True,636617996,32574500,669192496,True,5
6371,validator_5,283897923629,True,535760001,42314200,578074201,True,8
6372,validator_13,163832477782,True,580980004,14946360,595926364,True,5
6373,validator_4,273512101636,True,697500000,1699620,699199620,True,8
6374,validator_38,97917345560,True,532500000,2020540,534520540,False,3
6375,validator_43,104950822150,True,657300000,1324400,658624400,False,3
6376,validator_1,529395714166,True,776899999,2948500,779848499,True,16
6377,validator_2,426272106520,True,598900000,9561860,608461860,False,13
6378,validator_29,113256122064,True,731019995,21940530,752960525,True,3
6379,validator_13,164586676863,True,743480001,10719080,754199081,True,5
6380,validator_7,295203760199,True,604619999,43468340,648088339,True,9
6381,validator_69,50227096586,True,610439998,29398500,639838498,True,1
6382,validator_5,284477075360,True,576900001,2251730,579151731,True,8
6383,validator_0,455869296814,True,889040001,14383300,903423301,True,14
6384,validator_10,259935749490,True,545100000,8366630,553466630,False,8
6385,validator_8,255535136370,True,511900000,6977070,518877070,False,7
6386,validator_9,283995988560,True,392100000,24633600,416733600,False,8
6387,validator_9,284694367740,True,694400000,3979180,698379180,False,8
6388,validator_2,426948093120,True,654900000,21086600,675986600,False,13
6389,validator_15,166208177473,True,852059999,16319760,868379759,True,5
6390,validator_22,157210000880,True,763700000,18381280,782081280,False,4
6391,validator_28,108302234173,True,647800003,27750540,675550543,True,3
6392,validator_5,285271430597,True,790299997,4055240,794355237,True,8
6393,validator_76,51132847110,True,418880000,1452590,420332590,False,1
6394,validator_29,113993192879,True,705380005,31690810,737070815,True,3
6395,validator_2,427490041620,True,517500000,24448500,541948500,False,13
6396,validator_98,42684346990,True,670900000,9146120,680046120,False,1
6397,validator_4,274048266614,True,499499998,36664980,536164978,True,8
6398,validator_13,165161265769,True,560620006,13968900,574588906,True,5
6399,validator_15,166931852281,True,703340008,20334800,723674808,True,5
6400,validator_11,269541322480,True,655200000,10473190,665673190,False,8
6401,validator_30,106003922080,True,608670008,14043360,622713368,True,3
6402,validator_73,50859403510,True,633000000,3333000,636333000,False,1
6403,validator_11,269938244120,True,389440000,7481640,396921640,False,8
6404,validator_2,428186145110,True,677300000,18803490,696103490,False,13
6405,validator_56,58349754708,True,589480000,73537200,663017200,True,1
6406,validator_84,44155645230,True,653400000,5838560,659238560,False,1
6407,validator_11,270577636860,True,617700000,21692740,639392740,False,8
6408,validator_65,49809862695,True,947033999,22404910,969438909,True,1
6409,validator_83,50402345400,True,538200000,4199600,542399600,False,1
6410,validator_27,101936533027,True,635760003,27736340,663496343,True,3
6411,validator_16,147379472144,True,677859993,31302350,709162343,True,4
6412,validator_20,152586415940,True,542200000,22994650,565194650,False,4
6413,validator_18,148608560100,True,711400000,1464230,712864230,False,4
6414,validator_55,48078687656,True,1078300000,3825700,1082125700,True,1
6415,validator_6,281866155339,True,614599998,1641210,616241208,True,8
6416,validator_31,115224846085,True,577800003,9992100,587792103,True,3
6417,validator_92,41188349870,True,590100000,5724030,595824030,False,1
6418,validator_26,96649503956,True,507400004,23587450,530987454,True,3
6419,validator_9,285217211890,True,520900000,1944150,522844150,False,8
6420,validator_14,174360563717,True,792958001,26431370,819389371,True,5
6421,validator_33,114734080076,True,686300002,3082200,689382202,True,3
6422,validator_17,167595287042,True,599999994,27262100,627262094,True,5
6423,validator_90,48745342960,True,563000000,1617870,564617870,False,1
6424,validator_99,42558682270,True,539300000,15311630,554611630,False,1
6425,validator_1,529957525367,True,558420001,3391200,561811201,True,16
6426,validator_7,295900546771,True,677300002,19486570,696786572,True,9
6427,validator_8,256162660780,True,625100000,2424410,627524410,False,8
6428,validator_6,282756577180,True,858740001,31681840,890421841,True,8
6429,validator_18,149288986370,True,661400000,19026270,680426270,False,4
6430,validator_9,285938063480,True,717300000,3551590,720851590,False,8
6431,validator_0,456522030617,True,623036003,29697800,652733803,True,14
6432,validator_31,115872581904,True,633379999,14355820,647735819,True,3
6433,validator_0,457389366817,True,825680000,41656200,867336200,True,14
6434,validator_4,274719230562,True,628240008,42723940,670963948,True,8
6435,validator_34,104662512410,True,469790000,18425730,488215730,False,3
6436,validator_14,174987505284,True,608439997,18501570,626941567,True,5
6437,validator_96,48564563240,True,698800000,10961340,709761340,False,1
6438,validator_26,97399968960,True,740240004,10225000,750465004,True,3
6439,validator_14,175769686661,True,760149997,22031380,782181377,True,5
6440,validator_24,96973362177,True,818919996,26860060,845780056,True,3
6441,validator_9,286543206600,True,598300000,6843120,605143120,False,8
6442,validator_73,51557996410,True,691200000,7392900,698592900,False,1
6443,validator_6,283628171678,True,837039998,34554500,871594498,True,8
6444,validator_21,150434101730,True,549700000,3460380,553160380,False,4
6445,validator_39,106453644320,True,707200000,2367430,709567430,False,3
6446,validator_3,434090284770,True,573700000,7242080,580942080,False,13
6447,validator_2,428596824810,True,406100000,4579700,410679700,False,13
6448,validator_20,153359426250,True,770800000,2210310,773010310,False,4
6449,validator_6,284319355782,True,647320004,43864100,691184104,True,8
6450,validator_0,458171574141,True,755079994,27127330,782207324,True,14
6451,validator_6,285060742873,True,711665991,29721100,741387091,True,8
6452,validator_8,256779765120,True,613000000,4104340,617104340,False,8
6453,validator_40,95115846050,True,883400000,1579700,884979700,False,2
6454,validator_30,106668039197,True,638220007,25897110,664117117,True,3
6455,validator_73,52207930410,True,630300000,19634000,649934000,False,1
6456,validator_2,429281554810,True,670300000,14430000,684730000,False,13
6457,validator_9,287185053700,True,626200000,15647100,641847100,False,8
6458,validator_1,530554024965,True,570899998,25599600,596499598,True,16
6459,validator_11,271131964090,True,550800000,3527230,554327230,False,8
6460,validator_22,157750322010,True,538800000,1521130,540321130,False,4
6461,validator_1,531075587013,True,485079988,36482060,521562048,True,16
6462,validator_81,48413075960,True,461700000,3160400,464860400,False,1
6463,validator_8,257556105520,True,755400000,20940400,776340400,False,8
6464,validator_7,296528860415,True,604360004,23953640,628313644,True,9
6465,validator_2,430076457660,True,791400000,3502850,794902850,False,13
6466,validator_93,45289018380,True,490100000,1224800,491324800,False,1
6467,validator_3,434706144340,True,613500000,2359570,615859570,False,13
6468,validator_81,49039387180,True,621900000,4411220,626311220,False,1
6469,validator_41,104874070300,True,462300000,19972090,482272090,False,3
6470,validator_1,531762801201,True,661539988,25674200,687214188,True,16
6471,validator_8,258082044540,True,506200000,19739020,525939020,False,8
6472,validator_19,142251995290,True,553600000,658900,554258900,False,4
6473,validator_2,430659102380,True,580800000,1844720,582644720,False,13
6474,validator_3,435329332530,True,615500000,7688190,623188190,False,13
6475,validator_26,98382395062,True,975800002,6626100,982426102,True,3
6476,validator_8,258695876930,True,589500000,24332390,613832390,False,8
6477,validator_0,458840124464,True,657940003,10610320,668550323,True,14
6478,validator_12,157280484231,True,608020003,49977400,657997403,True,4
6479,validator_7,296997259833,True,442879998,25519420,468399418,True,9
6480,validator_1,532380726090,True,608319999,9604890,617924889,True,16
6481,validator_53,45717396872,True,505399999,18587940,523987939,True,1
6482,validator_41,105566960620,True,689200000,3690320,692890320,False,3
6483,validator_33,115334022003,True,556840007,43101920,599941927,True,3
6484,validator_69,50760181187,True,503460001,29624600,533084601,True,1
6485,validator_9,287658043600,True,449300000,23689900,472989900,False,8
6486,validator_8,259282719270,True,565400000,21442340,586842340,False,8
6487,validator_7,297586406258,True,562439995,26706430,589146425,True,9
6488,validator_3,435838908830,True,507300000,2276300,509576300,False,13
6489,validator_24,97678421592,True,680299995,24759420,705059415,True,3
6490,validator_7,298436448755,True,834495997,15546500,850042497,True,9
6491,validator_14,176477763701,True,688300000,19777040,708077040,True,5
6492,validator_8,259892289170,True,602800000,6769900,609569900,False,8
6493,validator_18,149850487630,True,553800000,7701260,561501260,False,4
6494,validator_29,114657557260,True,631780001,32584380,664364381,True,3
6495,validator_11,271643607460,True,504500000,7143370,511643370,False,8
6496,validator_14,177206154522,True,718920001,9470820,728390821,True,5
6497,validator_1,533149868882,True,742270002,26872790,769142792,True,16
6498,validator_19,142755446740,True,483300000,20151450,503451450,False,4
6499,validator_10,260509370790,True,559700000,13921300,573621300,False,8
6500,validator_3,436241489670,True,397100000,5480840,402580840,False,13
6501,validator_86,51947839620,True,602900000,10385740,613285740,False,1
6502,validator_22,158265655910,True,511200000,4133900,515333900,False,4
6503,validator_4,275408026159,True,687399997,1395600,688795597,True,8
6504,validator_3,436963655880,True,711700000,10466210,722166210,False,13
6505,validator_26,99133780586,True,742757994,8627530,751385524,True,3
6506,validator_24,98338591516,True,635806004,24363920,660169924,True,3
6507,validator_2,431382692570,True,714300000,9290190,723590190,False,13
6508,validator_25,116606039376,True,657519999,24865900,682385899,True,3
6509,validator_48,48726801022,True,484899997,29989010,514889007,True,1
6510,validator_11,272128602340,True,484100000,894880,484994880,False,8
6511,validator_91,43216983080,True,826000000,3506640,829506640,False,1
6512,validator_6,285679511841,True,615810008,2958960,618768968,True,8
6513,validator_6,286585274472,True,899320001,6442630,905762631,True,8
6514,validator_2,432015827610,True,630500000,2635040,633135040,False,13
6515,validator_33,116004242585,True,657768002,12452580,670220582,True,3
6516,validator_10,261156754450,True,644500000,2883660,647383660,False,8
6517,validator_23,148576612890,True,670200000,27839840,698039840,False,4
6518,validator_42,106274447430,True,643500000,2718250,646218250,False,3
6519,validator_38,98624750790,True,701900000,5505230,707405230,False,3
6520,validator_5,286000367034,True,722919997,6016440,728936437,True,8
6521,validator_2,432843378390,True,787900000,39650780,827550780,False,13
6522,validator_32,106059124704,True,552920001,29084500,582004501,True,3
6523,validator_9,288256219900,True,596300000,1876300,598176300,False,9
6524,validator_38,99146843420,True,515300000,6792630,522092630,False,3
6525,validator_43,105487038230,True,534000000,2216080,536216080,False,3
6526,validator_4,276154785254,True,710859995,35899100,746759095,True,8
6527,validator_95,45489910550,True,537500000,2827130,540327130,False,1
6528,validator_50,47715116476,True,631200001,3168340,634368341,True,1
6529,validator_0,459539245442,True,691059998,8060980,699120978,True,14
6530,validator_99,43022408200,True,460700000,3025930,463725930,False,1
6531,validator_1,533776134285,True,618380003,7885400,626265403,True,16
6532,validator_58,50287015013,True,519510000,28483740,547993740,True,1
6533,validator_35,98319039440,True,477800000,20452530,498252530,False,3
6534,validator_9,288767573890,True,510100000,1253990,511353990,False,9
6535,validator_1,534559434304,True,780019999,3280020,783300019,True,16
6536,validator_1,535207520986,True,627320002,20766680,648086682,True,16
6537,validator_4,276694363857,True,528120003,11458600,539578603,True,8
6538,validator_36,96787612490,True,491400000,7808760,499208760,False,3
6539,validator_38,99612423460,True,458200000,7380040,465580040,False,3
6540,validator_9,289251412160,True,476300000,7538270,483838270,False,9
6541,validator_2,433432397920,True,580300000,8719530,589019530,False,13
6542,validator_10,261796788050,True,635800000,4233600,640033600,False,8
6543,validator_3,437502081120,True,518000000,20425240,538425240,False,13
6544,validator_19,143285006870,True,527700000,1860130,529560130,False,4
6545,validator_49,52739217619,True,742000004,20658410,762658414,True,1
6546,validator_20,153873250550,True,503000000,10824300,513824300,False,4
6547,validator_2,433882742680,True,446520000,3824760,450344760,False,13
6548,validator_0,460212713577,True,656246005,17222130,673468135,True,14
6549,validator_95,45982913590,True,472700000,20303040,493003040,False,1
6550,validator_2,434488177300,True,602600000,2834620,605434620,False,13
6551,validator_16,147944848541,True,540559997,24816400,565376397,True,4
6552,validator_8,260472405670,True,577600000,2516500,580116500,False,8
6553,validator_83,50871455100,True,462700000,6409700,469109700,False,1
6554,validator_18,150458718580,True,600500000,7730950,608230950,False,4
6555,validator_49,53283759690,True,535600001,8942070,544542071,True,1
6556,validator_25,117550971720,True,935899994,9032350,944932344,True,3
6557,validator_22,158802636170,True,534800000,2180260,536980260,False,4
6558,validator_29,115408998719,True,732299999,19141460,751441459,True,3
6559,validator_11,272676612940,True,545800000,2210600,548010600,False,8
6560,validator_13,165799673967,True,618954008,19454190,638408198,True,5
6561,validator_2,435021858980,True,531000000,2681680,533681680,False,13
6562,validator_8,261174642810,True,672500000,29737140,702237140,False,8
6563,validator_2,435591488080,True,566100000,3529100,569629100,False,13
6564,validator_14,178068202024,True,850700002,11347500,862047502,True,5
6565,validator_2,436340639880,True,747300000,1851800,749151800,False,13
6566,validator_4,277335703738,True,634046001,7293880,641339881,True,8
6567,validator_65,50551243410,True,724263995,17116720,741380715,True,1
6568,validator_6,287190412148,True,595399996,9737680,605137676,True,8
6569,validator_9,289855146140,True,584700000,19033980,603733980,False,9
6570,validator_2,437123687680,True,749700000,33347800,783047800,False,13
6571,validator_62,54851749614,True,638140006,22108600,660248606,True,1
6572,validator_51,47674594036,True,654340006,4630230,658970236,True,1
6573,validator_38,100296594550,True,683400000,771090,684171090,False,3
6574,validator_10,262383220440,True,548000000,38432390,586432390,False,8
6575,validator_54,52088495800,True,486039995,22294200,508334195,True,1
6576,validator_14,178687823647,True,589219993,30401630,619621623,True,5
6577,validator_96,49113406170,True,540170000,8672930,548842930,False,1
6578,validator_7,298783146223,True,322419998,24277470,346697468,True,9
6579,validator_19,144048174200,True,743300000,19867330,763167330,False,4
6580,validator_6,287820436638,True,628100000,1924490,630024490,True,8
6581,validator_10,262840255720,True,453400000,3635280,457035280,False,8
6582,validator_32,106908044437,True,791320003,57599730,848919733,True,3
6583,validator_8,261626479410,True,449400000,2436600,451836600,False,8
6584,validator_4,278197020080,True,782144002,79172340,861316342,True,8
6585,validator_38,100783344580,True,484810000,1940030,486750030,False,3
6586,validator_35,98905478520,True,584600000,1839080,586439080,False,3
6587,validator_95,46447498990,True,461200000,3385400,464585400,False,1
6588,validator_37,89491924140,True,786900000,37729960,824629960,False,2
6589,validator_8,262142201640,True,510700000,5022230,515722230,False,8
6590,validator_19,144468949400,True,393700000,27075200,420775200,False,4
6591,validator_38,101401252220,True,615400000,2507640,617907640,False,3
6592,validator_16,148688799479,True,705179998,38770940,743950938,True,4
6593,validator_20,154309863870,True,433900000,2713320,436613320,False,4
6594,validator_21,151157757050,True,716500000,7155320,723655320,False,4
6595,validator_76,51574420510,True,428400000,13173400,441573400,False,1
6596,validator_47,53307596930,True,689200001,24376300,713576301,True,1
6597,validator_17,168508479351,True,906100009,7092300,913192309,True,5
6598,validator_2,437944709080,True,806400000,14621400,821021400,False,13
6599,validator_37,90047028520,True,551800000,3304380,555104380,False,2
6600,validator_0,460956225737,True,722500000,21012160,743512160,True,14
6601,validator_28,109126374588,True,811179995,12960420,824140415,True,3
6602,validator_11,273137482940,True,432000000,28870000,460870000,False,8
6603,validator_9,290384543340,True,521500000,7897200,529397200,False,9
6604,validator_21,151877525350,True,709100000,10668300,719768300,False,4
6605,validator_8,262629337350,True,485300000,1835710,487135710,False,8
6606,validator_7,299445506386,True,655399993,6960170,662360163,True,9
6607,validator_17,169137809692,True,585780001,43550340,629330341,True,5
6608,validator_0,461822962859,True,842763992,23973130,866737122,True,14
6609,validator_1,535985814685,True,766857999,11435700,778293699,True,16
6610,validator_1,536830841121,True,829519996,15506440,845026436,True,16
6611,validator_7,300127235887,True,666520001,15209500,681729501,True,9
6612,validator_26,99888579486,True,718740000,36058900,754798900,True,3
6613,validator_2,438535098340,True,587900000,2489260,590389260,False,13
6614,validator_8,263279335650,True,641300000,8698300,649998300,False,8
6615,validator_38,101981940710,True,576900000,3788490,580688490,False,3
6616,validator_14,179376828229,True,671270002,17734580,689004582,True,5
6617,validator_8,263852499690,True,570500000,2664040,573164040,False,8
6618,validator_18,151021991080,True,560600000,2672500,563272500,False,4
6619,validator_12,157896474231,True,581748000,34242000,615990000,True,4
6620,validator_54,52748866184,True,641199994,19170390,660370384,True,1
6621,validator_34,105258287210,True,574700000,21074800,595774800,False,3
6622,validator_40,95627266950,True,509570000,1850900,511420900,False,2
6623,validator_40,96130905150,True,483800000,19838200,503638200,False,3
6624,validator_92,41779807000,True,588900000,2557130,591457130,False,1
6625,validator_4,278734392813,True,531999993,5372740,537372733,True,8
6626,validator_16,149238834702,True,529399993,20635230,550035223,True,4
6627,validator_68,50264729834,True,616267998,83229820,699497818,True,1
6628,validator_3,438199167350,True,695100000,1986230,697086230,False,13
6629,validator_12,158688916197,True,786199996,6241970,792441966,True,4
6630,validator_38,102649467250,True,666000000,1526540,667526540,False,3
6631,validator_3,438746373980,True,513700000,33506630,547206630,False,13
6632,validator_10,263425156720,True,574500000,10401000,584901000,False,8
6633,validator_11,273541726640,True,395700000,8543700,404243700,False,8
6634,validator_4,279400597802,True,636699999,29504990,666204989,True,8
6635,validator_10,264035065850,True,608600000,1309130,609909130,False,8
6636,validator_20,154923563550,True,611200000,2499680,613699680,False,4
6637,validator_10,264653881490,True,600100000,18715640,618815640,False,8
6638,validator_40,96784120250,True,617600000,35615100,653215100,False,3
6639,validator_4,279993911822,True,572800000,20514020,593314020,True,8
6640,validator_1,537360386111,True,504296000,25248990,529544990,True,16
6641,validator_6,288535912237,True,703899999,11575600,715475599,True,9
6642,validator_29,116105577917,True,696099998,479200,696579198,True,3
6643,validator_2,439067135230,True,529900000,2136890,532036890,False,13
6644,validator_66,59048347423,True,650500001,19795910,670295911,True,1
6645,validator_0,462684637258,True,850319999,11354400,861674399,True,14
6646,validator_32,107761560623,True,836380006,17136180,853516186,True,3
6647,validator_1,538118240426,True,743679995,14174320,757854315,True,16
6648,validator_87,51838799840,True,432800000,19250390,452050390,False,1
6649,validator_6,289216191928,True,662040001,18239690,680279691,True,9
6650,validator_12,159366206618,True,665380001,11910420,677290421,True,4
6651,validator_3,439188078500,True,432000000,9704520,441704520,False,13
6652,validator_5,286922766605,True,896218001,26181570,922399571,True,8
6653,validator_7,300770494408,True,621920001,21338520,643258521,True,9
6654,validator_32,108439591241,True,672300008,5730610,678030618,True,3
6655,validator_3,440021715000,True,831100000,2536500,833636500,False,13
6656,validator_22,159235471700,True,431500000,1335530,432835530,False,4
6657,validator_10,265235464610,True,578900000,2683120,581583120,False,8
6658,validator_6,289925350823,True,692163995,16994900,709158895,True,9
6659,validator_99,43580483320,True,538700000,19375120,558075120,False,1
6660,validator_55,48751524081,True,667499995,5336430,672836425,True,1
6661,validator_21,152443796100,True,562800000,3470750,566270750,False,4
6662,validator_14,180354212921,True,975099992,2284700,977384692,True,5
6663,validator_27,102629973657,True,685940000,7500630,693440630,True,3
6664,validator_16,149890869881,True,649299999,2735180,652035179,True,4
6665,validator_64,56777926970,True,519700002,19595040,539295042,True,1
6666,validator_86,52915646400,True,965300000,2506780,967806780,False,1
6667,validator_0,463218443703,True,509080005,24726440,533806445,True,14
6668,validator_1,538829209795,True,669819999,41149370,710969369,True,16
6669,validator_36,97345490090,True,545500000,12377600,557877600,False,3
6670,validator_39,107012532460,True,555900000,2988140,558888140,False,3
6671,validator_15,167640808087,True,698500006,10455800,708955806,True,5
6672,validator_8,264359463790,True,501100000,5864100,506964100,False,8
6673,validator_0,463974340032,True,717597999,38298330,755896329,True,14
6674,validator_26,100574392284,True,665999998,19812800,685812798,True,3
6675,validator_83,51481896430,True,589400000,21041330,610441330,False,1
6676,validator_21,152835279020,True,387500000,3982920,391482920,False,4
6677,validator_36,97832381390,True,483400000,3491300,486891300,False,3
6678,validator_62,55507010108,True,618915994,36344500,655260494,True,1
6679,validator_58,51049084415,True,752300002,9769400,762069402,True,1
6680,validator_36,98464379370,True,628100000,3897980,631997980,False,3
6681,validator_62,56317327450,True,782640002,27677340,810317342,True,1
6682,validator_27,103392781363,True,749400006,13407700,762807706,True,3
6683,validator_74,45567164370,True,516100000,1462090,517562090,False,1
6684,validator_1,539680228991,True,802279996,48739200,851019196,True,16
6685,validator_41,106105607620,True,524920000,13727000,538647000,False,3
6686,validator_1,540252735962,True,563720001,8786970,572506971,True,16
6687,validator_3,440481951350,True,457700000,2536350,460236350,False,13
6688,validator_10,265857600750,True,614600000,7536140,622136140,False,8
6689,validator_3,440893035690,True,408630000,2454340,411084340,False,13
6690,validator_39,107460818540,True,443600000,4686080,448286080,False,3
6691,validator_31,116529848476,True,611820002,45446570,657266572,True,3
6692,validator_0,464584861237,True,600300005,10221200,610521205,True,14
6693,validator_38,103210217780,True,550900000,9850530,560750530,False,3
6694,validator_0,465184943438,True,596740001,3342200,600082201,True,14
6695,validator_1,541090538083,True,770823991,66978130,837802121,True,16
6696,validator_24,99137950438,True,774020002,25338920,799358922,True,3
6697,validator_7,301403484862,True,593260004,39730450,632990454,True,9
6698,validator_34,105970675650,True,710100000,2288440,712388440,False,3
6699,validator_38,103799520460,True,563800000,25502680,589302680,False,3
6700,validator_94,49863948590,True,647300000,9268500,656568500,False,1
6701,validator_22,159899618520,True,663000000,1146820,664146820,False,4
6702,validator_36,98938857410,True,464420000,10058040,474478040,False,3
6703,validator_72,51679866460,True,592900000,8773280,601673280,False,1
6704,validator_6,290535232847,True,594019994,15862030,609882024,True,9
6705,validator_28,109721155817,True,558559999,36221230,594781229,True,3
6706,validator_9,290832343740,True,446300000,1500400,447800400,False,9
6707,validator_7,302176275590,True,751239988,21550740,772790728,True,9
6708,validator_98,43240721030,True,504900000,51474040,556374040,False,1
6709,validator_3,441393312470,True,495700000,4576780,500276780,False,13
6710,validator_31,117149935222,True,598900006,21186740,620086746,True,3
6711,validator_2,439746920600,True,677100000,2685370,679785370,False,13
6712,validator_49,53993451730,True,703040000,6652040,709692040,True,1
6713,validator_31,117893697905,True,738760003,5002680,743762683,True,3
6714,validator_82,50306054920,True,618600000,2293820,620893820,False,1
6715,validator_22,160683218970,True,781200000,2400450,783600450,False,5
6716,validator_65,51291879803,True,714340003,26296390,740636393,True,1
6717,validator_36,99602455810,True,654200000,9398400,663598400,False,3
6718,validator_13,166311350066,True,500499999,11176100,511676099,True,5
6719,validator_14,180981487946,True,572259995,55015030,627275025,True,5
6720,validator_23,149112849840,True,530500000,5736950,536236950,False,4
6721,validator_0,465960805395,True,740099997,35761960,775861957,True,14
6722,validator_7,302783246295,True,593140005,13830700,606970705,True,9
6723,validator_8,264913667620,True,551800000,2403830,554203830,False,8
6724,validator_3,441937405770,True,534700000,9393300,544093300,False,13
6725,validator_2,440217573160,True,468000000,2652560,470652560,False,13
6726,validator_81,49576381970,True,535700000,1294790,536994790,False,1
6727,validator_21,153587415060,True,749300000,2836040,752136040,False,4
6728,validator_69,51391931364,True,613099997,18650180,631750177,True,1
6729,validator_7,303503493568,True,675979993,44267280,720247273,True,9
6730,validator_9,291471164270,True,637200000,1620530,638820530,False,9
6731,validator_10,266341874820,True,472800000,11474070,484274070,False,8
6732,validator_5,287772186485,True,839220000,10199880,849419880,True,8
6733,validator_13,166729780369,True,382120003,36310300,418430303,True,5
6734,validator_28,110374066137,True,623020000,29890320,652910320,True,3
6735,validator_42,106787393420,True,504800000,8145990,512945990,False,3
6736,validator_5,288489846588,True,697700003,19960100,717660103,True,9
6737,validator_1,541789611083,True,689940000,9133000,699073000,True,16
6738,validator_7,304399283599,True,879836001,15954030,895790031,True,9
6739,validator_50,48382187798,True,656960002,10111320,667071322,True,1
6740,validator_52,51263624414,True,518279993,10733400,529013393,True,1
6741,validator_24,99766920208,True,602120000,26849770,628969770,True,3
6742,validator_14,181614041544,True,618699998,13853600,632553598,True,5
6743,validator_34,106677699280,True,700300000,6723630,707023630,False,3
6744,validator_34,107374502250,True,676000000,20802970,696802970,False,3
6745,validator_18,151604039810,True,572800000,9248730,582048730,False,4
6746,validator_7,305143195593,True,725520004,18391990,743911994,True,9
6747,validator_8,265367748160,True,435200000,18880540,454080540,False,8
6748,validator_7,306089305921,True,926699998,19410330,946110328,True,9
6749,validator_25,118048438508,True,490899998,6566790,497466788,True,3
6750,validator_65,52232163532,True,937300009,2983720,940283729,True,1
6751,validator_16,150767042084,True,872900003,3272200,876172203,True,4
6752,validator_38,104416601880,True,615800000,1281420,617081420,False,3
6753,validator_7,306749801194,True,628320003,32175270,660495273,True,9
6754,validator_2,440985011460,True,760800000,6638300,767438300,False,13
6755,validator_55,49444997677,True,690499996,2973600,693473596,True,1
6756,validator_1,542333234219,True,534689996,8933140,543623136,True,16
6757,validator_1,543279871580,True,911620001,35017360,946637361,True,16
6758,validator_42,107344350920,True,540100000,16857500,556957500,False,3
6759,validator_24,100424688305,True,618275997,39492100,657768097,True,3
6760,validator_2,441486838390,True,499800000,2026930,501826930,False,13
6761,validator_43,106251008360,True,726000000,37970130,763970130,False,3
6762,validator_1,543809290182,True,497078002,32340600,529418602,True,16
6763,validator_56,59013685706,True,638619998,25311000,663930998,True,1
6764,validator_5,289127283331,True,631640003,5796740,637436743,True,9
6765,validator_5,289899411635,True,755020004,17108300,772128304,True,9
6766,validator_11,274058492230,True,514100000,2665590,516765590,False,8
6767,validator_5,290484888875,True,562760000,22717240,585477240,True,9
6768,validator_4,280721732524,True,705300002,22520700,727820702,True,8
6769,validator_0,466728831935,True,748340000,19686540,768026540,True,14
6770,validator_3,442507781740,True,562800000,7575970,570375970,False,13
6771,validator_5,291146620478,True,659320003,2411600,661731603,True,9
6772,validator_18,152267994790,True,658000000,5954980,663954980,False,4
6773,validator_36,100117144640,True,512200000,2488830,514688830,False,3
6774,validator_5,291892008430,True,744000002,1387950,745387952,True,9
6775,validator_8,265787678460,True,413200000,6730300,419930300,False,8
6776,validator_15,168100364795,True,457239998,2316710,459556708,True,5
6777,validator_27,104337928170,True,894298007,50848800,945146807,True,3
6778,validator_10,266873123440,True,521900000,9348620,531248620,False,8
6779,validator_15,168859563246,True,744840001,14358450,759198451,True,5
6780,validator_8,266270075140,True,468700000,13696680,482396680,False,8
6781,validator_34,107946948160,True,569500000,2945910,572445910,False,3
6782,validator_21,154039777930,True,446900000,5462870,452362870,False,4
6783,validator_0,467365100203,True,626800008,9468260,636268268,True,14
6784,validator_11,274560306960,True,491100000,10714730,501814730,False,8
6785,validator_6,291216657054,True,679899997,1524210,681424207,True,9
6786,validator_10,267474004760,True,596800000,4081320,600881320,False,8
6787,validator_41,106599419050,True,487500000,6311430,493811430,False,3
6788,validator_1,544387678684,True,575160002,3228500,578388502,True,17
6789,validator_15,169636609788,True,754504002,22542540,777046542,True,5
6790,validator_10,268074738590,True,578900000,21833830,600733830,False,8
6791,validator_59,45153523364,True,580399999,6735600,587135599,True,1
6792,validator_47,54049081353,True,733700003,7784420,741484423,True,1
6793,validator_11,275029318560,True,466210000,2801600,469011600,False,8
6794,validator_1,545241333579,True,789979995,63674900,853654895,True,17
6795,validator_49,54656637248,True,661599998,1585520,663185518,True,1
6796,validator_6,291996480961,True,774600007,5223900,779823907,True,9
6797,validator_0,468298148945,True,920780002,12268740,933048742,True,14
6798,validator_58,51586315774,True,513957999,23273360,537231359,True,1
6799,validator_45,52011451940,True,703099992,54707120,757807112,True,1
6800,validator_34,108553721860,True,596000000,10773700,606773700,False,3
6801,validator_27,104895476670,True,556100000,1448500,557548500,True,3
6802,validator_96,49810498640,True,672300000,24792470,697092470,False,1
6803,validator_0,469053656019,True,731906004,23601070,755507074,True,14
6804,validator_20,155476593710,True,543800000,9230160,553030160,False,4
6805,validator_49,55444721749,True,778100001,9984500,788084501,True,1
6806,validator_3,443063449190,True,548400000,7267450,555667450,False,13
6807,validator_23,149580023690,True,464400000,2773850,467173850,False,4
6808,validator_9,292130924470,True,648600000,11160200,659760200,False,9
6809,validator_0,469706808724,True,633920005,19232700,653152705,True,14
6810,validator_10,269010321230,True,919400000,16182640,935582640,False,8
6811,validator_21,154537497080,True,454600000,43119150,497719150,False,4
6812,validator_22,161253786400,True,567340000,3227430,570567430,False,5
6813,validator_79,48762957670,True,722600000,1084540,723684540,False,1
6814,validator_17,169744871187,True,582559995,24501500,607061495,True,5
6815,validator_6,292625623010,True,570659999,58482050,629142049,True,9
6816,validator_28,111287678238,True,908900001,4712100,913612101,True,3
6817,validator_1,546052585028,True,797400009,13851440,811251449,True,17
6818,validator_19,145386466860,True,896000000,21517460,917517460,False,4
6819,validator_30,107382650334,True,693299997,21311140,714611137,True,3
6820,validator_15,170246517688,True,593740000,16167900,609907900,True,5
6821,validator_90,49527580190,True,761200000,21037230,782237230,False,1
6822,validator_35,99470745320,True,564100000,1166800,565266800,False,3
6823,validator_14,182272028149,True,625912005,32074600,657986605,True,5
6824,validator_23,150268438790,True,650500000,37915100,688415100,False,4
6825,validator_71,59863537768,True,655699993,2775630,658475623,True,1
6826,validator_29,117144967720,True,1017940003,21449800,1039389803,True,3
6827,validator_94,50487808530,True,620400000,3459940,623859940,False,1
6828,validator_59,45788782596,True,627800002,7459230,635259232,True,1
6829,validator_4,281493176253,True,739939999,31503730,771443729,True,8
6830,validator_31,118485391925,True,565806000,25888020,591694020,True,3
6831,validator_53,46437426875,True,695920003,24110000,720030003,True,1
6832,validator_7,307548316659,True,733904005,64611460,798515465,True,9
6833,validator_90,50201327570,True,670100000,3647380,673747380,False,1
6834,validator_15,171109109410,True,857220002,5371720,862591722,True,5
6835,validator_3,443575238310,True,509000000,2789120,511789120,False,13
6836,validator_74,46115808470,True,546300000,2344100,548644100,False,1
6837,validator_26,101108179584,True,523080000,10707300,533787300,True,3
6838,validator_5,292560061430,True,656000000,12053000,668053000,True,9
6839,validator_40,97326142780,True,519800000,22222530,542022530,False,3
6840,validator_1,546834153614,True,702379996,79188590,781568586,True,17
6841,validator_11,275479619760,True,443700000,6601200,450301200,False,8
6842,validator_39,107929597970,True,444500000,24279430,468779430,False,3
6843,validator_49,56201397287,True,722763998,33911540,756675538,True,1
6844,validator_57,51903562908,True,732240005,5603670,737843675,True,1
6845,validator_53,46964583795,True,519819990,7336930,527156920,True,1
6846,validator_9,292554475010,True,420200000,3350540,423550540,False,9
6847,validator_17,170419503627,True,646340000,28292440,674632440,True,5
6848,validator_16,151501084368,True,723599994,10442290,734042284,True,4
6849,validator_38,105246906060,True,828500000,1804180,830304180,False,3
6850,validator_1,548091041513,True,1237899999,18987900,1256887899,True,17
6851,validator_18,153036668930,True,765500000,3174140,768674140,False,4
6852,validator_44,50245028966,True,687400000,10445100,697845100,True,1
6853,validator_98,43947672650,True,705000000,1951620,706951620,False,1
6854,validator_0,470341046829,True,595160005,39078100,634238105,True,14
6855,validator_33,116797621595,True,765200010,28179000,793379010,True,3
6856,validator_63,54435309254,True,521020000,6637970,527657970,True,1
6857,validator_30,107990534045,True,574620001,33263710,607883711,True,3
6858,validator_36,100630323440,True,512200000,978800,513178800,False,3
6859,validator_31,119155930266,True,610458001,60080340,670538341,True,3
6860,validator_18,153626187520,True,580300000,9218590,589518590,False,4
6861,validator_16,152327549065,True,816919997,9544700,826464697,True,4
6862,validator_32,109158768322,True,698340001,20837080,719177081,True,3
6863,validator_5,293423323670,True,854700000,8562240,863262240,True,9
6864,validator_22,161901898230,True,645500000,2611830,648111830,False,5
6865,validator_5,293948868191,True,505420001,20124520,525544521,True,9
6866,validator_3,444157658750,True,571700000,10720440,582420440,False,13
6867,validator_0,471171063123,True,827899994,2116300,830016294,True,14
6868,validator_3,444780653050,True,613700000,9294300,622994300,False,13
6869,validator_81,50147612790,True,565500000,5730820,571230820,False,1
6870,validator_25,118837216130,True,758813992,29963630,788777622,True,3
6871,validator_99,44124404420,True,541100000,2821100,543921100,False,1
6872,validator_0,471867360978,True,671106005,25191850,696297855,True,14
6873,validator_2,442101202720,True,604800000,9564330,614364330,False,13
6874,validator_2,442692740980,True,589000000,2538260,591538260,False,13
6875,validator_34,109143865220,True,589030000,1113360,590143360,False,3
6876,validator_4,282398606757,True,895740004,9690500,905430504,True,8
6877,validator_9,293274262530,True,716500000,3287520,719787520,False,9
6878,validator_4,283277138340,True,834899993,43631590,878531583,True,8
6879,validator_22,162591481840,True,684300000,5283610,689583610,False,5
6880,validator_15,171844777097,True,732939997,2727690,735667687,True,5
6881,validator_41,107251717770,True,641700000,10598720,652298720,False,3
6882,validator_0,472596378769,True,700819991,28197800,729017791,True,14
6883,validator_32,109871354116,True,699620004,12965790,712585794,True,3
6884,validator_46,47212571879,True,741900008,3908910,745808918,True,1
6885,validator_87,52572192490,True,732100000,1292650,733392650,False,1
6886,validator_15,172591364726,True,711388009,35199620,746587629,True,5
6887,validator_29,117870922098,True,723399998,2554380,725954378,True,3
6888,validator_98,44559984850,True,611200000,1112200,612312200,False,1
6889,validator_8,266965973370,True,694500000,1398230,695898230,False,8
6890,validator_22,163192819990,True,599100000,2238150,601338150,False,5
6891,validator_13,167388769841,True,656500002,2489470,658989472,True,5
6892,validator_67,52644311406,True,510600006,28139830,538739836,True,1
6893,validator_47,54724989143,True,673399990,2507800,675907790,True,1
6894,validator_1,548797619119,True,692140006,14437600,706577606,True,17
6895,validator_1,549329858718,True,520439999,11799600,532239599,True,17
6896,validator_84,44648293210,True,482000000,10647980,492647980,False,1
6897,validator_4,283768781881,True,488300001,3343540,491643541,True,8
6898,validator_23,150920848690,True,631500000,20909900,652409900,False,4
6899,validator_74,47034128470,True,895300000,23020000,918320000,False,1
6900,validator_18,154326651900,True,691700000,8764380,700464380,False,4
6901,validator_5,294600861897,True,650200006,1793700,651993706,True,9
6902,validator_11,276317309720,True,826800000,10889960,837689960,False,8
6903,validator_8,267550198740,True,581300000,2925370,584225370,False,8
6904,validator_27,105539556770,True,637920000,6160100,644080100,True,3
6905,validator_13,168146764415,True,729340004,28654570,757994574,True,5
6906,validator_96,50295627820,True,480800000,4329180,485129180,False,1
6907,validator_56,59769107708,True,721306002,34116000,755422002,True,1
6908,validator_35,99874269950,True,396300000,7224630,403524630,False,3
6909,validator_30,108683819474,True,636225999,57059430,693285429,True,3
6910,validator_8,268192461060,True,632400000,9862320,642262320,False,8
6911,validator_11,277002591990,True,684000000,1282270,685282270,False,8
6912,validator_22,163719483810,True,523100000,3563820,526663820,False,5
6913,validator_52,52086051719,True,774840005,47587300,822427305,True,1
6914,validator_28,111911550311,True,599960003,23912070,623872073,True,3
6915,validator_46,47829346402,True,595600003,21174520,616774523,True,1
6916,validator_95,47127024700,True,676900000,2625710,679525710,False,1
6917,validator_19,145928269890,True,538800000,3003030,541803030,False,4
6918,validator_4,284552247423,True,762600002,20865540,783465542,True,8
6919,validator_5,295450765598,True,800060001,49843700,849903701,True,9
6920,validator_8,268909927390,True,698700000,18766330,717466330,False,8
6921,validator_43,106789920840,True,532900000,6012480,538912480,False,3
6922,validator_23,151691388300,True,754700000,15839610,770539610,False,4
6923,validator_51,48402384696,True,719340000,8450660,727790660,True,1
6924,validator_4,285125605019,True,555000006,18357590,573357596,True,8
6925,validator_3,445354200050,True,570400000,3147000,573547000,False,13
6926,validator_3,446010961530,True,634500000,22261480,656761480,False,13
6927,validator_23,152334193400,True,641400000,1405100,642805100,False,4
6928,validator_6,293211670750,True,583200000,2847740,586047740,True,9
6929,validator_22,164283932810,True,544600000,19849000,564449000,False,5
6930,validator_65,53136967240,True,884919998,19883710,904803708,True,1
6931,validator_0,473193856298,True,550943999,46533530,597477529,True,14
6932,validator_20,156242392590,True,758700000,7098880,765798880,False,4
6933,validator_84,45404381940,True,753800000,2288730,756088730,False,1
6934,validator_8,269552275090,True,629200000,13147700,642347700,False,8
6935,validator_12,160204894061,True,805886003,32801440,838687443,True,5
6936,validator_35,100466061340,True,591000000,791390,591791390,False,3
6937,validator_74,47514850860,True,478600000,2122390,480722390,False,1
6938,validator_0,474029486560,True,795510002,40120260,835630262,True,14
6939,validator_0,474681689765,True,631820005,20383200,652203205,True,14
6940,validator_37,90890155510,True,841100000,2026990,843126990,False,2
6941,validator_34,109679677760,True,526200000,9612540,535812540,False,3
6942,validator_32,110530206274,True,638779998,20072160,658852158,True,3
6943,validator_15,173221501920,True,620357994,9779200,630137194,True,5
6944,validator_55,49967553728,True,512200001,10356050,522556051,True,1
6945,validator_6,294057847552,True,837000002,9176800,846176802,True,9
6946,validator_6,294767447242,True,697500000,12099690,709599690,True,9
6947,validator_1,550063601486,True,732599998,1142770,733742768,True,17
6948,validator_89,50817773360,True,590100000,27225430,617325430,False,1
6949,validator_34,110271951370,True,590300000,1973610,592273610,False,3
6950,validator_51,49155508921,True,721600005,31524220,753124225,True,1
6951,validator_5,296236026800,True,782340002,2921200,785261202,True,9
6952,validator_32,110927777575,True,395140001,2431300,397571301,True,3
6953,validator_7,308228886853,True,656139994,24430200,680570194,True,9
6954,validator_2,443176874980,True,483200000,934000,484134000,False,13
6955,validator_10,269531944890,True,519700000,1923660,521623660,False,8
6956,validator_7,308702966172,True,472199999,1879320,474079319,True,9
6957,validator_3,446830175240,True,816100000,3113710,819213710,False,13
6958,validator_70,50705519304,True,792200000,38951970,831151970,True,1
6959,validator_12,160771007408,True,547200007,18913340,566113347,True,5
6960,validator_8,270160996900,True,600700000,8021810,608721810,False,8
6961,validator_64,57631316864,True,828953994,24435900,853389894,True,1
6962,validator_26,101668848299,True,519463995,41204720,560668715,True,3
6963,validator_2,443893862110,True,714100000,2887130,716987130,False,13
6964,validator_12,161420719206,True,626389998,23321800,649711798,True,5
6965,validator_3,447509650320,True,652400000,27075080,679475080,False,13
6966,validator_22,165049266020,True,761800000,3533210,765333210,False,5
6967,validator_3,448099764320,True,584000000,6114000,590114000,False,14
6968,validator_18,154852684970,True,524800000,1233070,526033070,False,4
6969,validator_3,448667209520,True,530000000,37445200,567445200,False,14
6970,validator_6,295694434856,True,906300004,20687610,926987614,True,9
6971,validator_2,444371281150,True,459900000,17519040,477419040,False,13
6972,validator_53,47586167644,True,557799999,63783850,621583849,True,1
6973,validator_81,50901773750,True,745300000,8860960,754160960,False,1
6974,validator_48,49166236529,True,433840007,5595500,439435507,True,1
6975,validator_1,550708389382,True,602305996,42481900,644787896,True,17
6976,validator_7,309597272464,True,816948002,77358290,894306292,True,9
6977,validator_44,51212058335,True,960579999,6449370,967029369,True,1
6978,validator_10,270146505460,True,607700000,6860570,614560570,False,8
6979,validator_60,63437696336,True,730639997,37101400,767741397,True,1
6980,validator_34,110948647560,True,673200000,3496190,676696190,False,3
6981,validator_6,296372117760,True,668180004,9502900,677682904,True,9
6982,validator_13,168900734801,True,741099996,12870390,753970386,True,5
6983,validator_16,152950777382,True,582068007,41160310,623228317,True,4
6984,validator_39,108492382470,True,554000000,8784500,562784500,False,3
6985,validator_23,153047943740,True,711100000,2650340,713750340,False,4
6986,validator_98,45400008570,True,835600000,4423720,840023720,False,1
6987,validator_11,277685950210,True,680600000,2758220,683358220,False,8
6988,validator_3,449185714050,True,497900000,20604530,518504530,False,14
6989,validator_16,153775819279,True,807263997,17777900,825041897,True,4
6990,validator_3,449978581090,True,784700000,8167040,792867040,False,14
6991,validator_21,155110188480,True,571600000,1091400,572691400,False,4
6992,validator_29,118597325671,True,722500003,3903570,726403573,True,3
6993,validator_6,296789752506,True,397280006,20354740,417634746,True,9
6994,validator_0,475469893032,True,756139997,32063270,788203267,True,14
6995,validator_18,155371907870,True,514600000,4622900,519222900,False,4
6996,validator_11,278266839910,True,569900000,10989700,580889700,False,8
6997,validator_7,310315566845,True,691240001,27054380,718294381,True,9
6998,validator_9,293791797740,True,508000000,9535210,517535210,False,9
6999,validator_6,297394500342,True,568035996,36711840,604747836,True,9
7000,validator_25,119604708332,True,716900002,50592200,767492202,True,3
7001,validator_20,156657460720,True,412200000,2868130,415068130,False,4
7002,validator_0,476131055430,True,634439998,26722400,661162398,True,14
7003,validator_64,58212801764,True,540620000,40864900,581484900,True,1
7004,validator_0,476839439611,True,660040001,48344180,708384181,True,14
7005,validator_21,155709845200,True,578600000,21056720,599656720,False,4
7006,validator_70,51334694648,True,606144004,23031340,629175344,True,1
7007,validator_1,551185430618,True,468159996,8881240,477041236,True,17
7008,validator_3,450727495320,True,726300000,22614230,748914230,False,14
7009,validator_6,298125228673,True,724000001,6728330,730728331,True,9
7010,validator_17,171113394825,True,669339998,24551200,693891198,True,5
7011,validator_17,171590673436,True,443019991,34258620,477278611,True,5
7012,validator_0,477591313218,True,732354007,19519600,751873607,True,14
7013,validator_46,48459693113,True,600200001,30146710,630346711,True,1
7014,validator_52,52761223396,True,639159997,36011680,675171677,True,1
7015,validator_46,49231461847,True,751199994,20568740,771768734,True,1
7016,validator_25,120454720537,True,808244005,41768200,850012205,True,3
7017,validator_36,101366776190,True,733200000,3252750,736452750,False,3
7018,validator_27,106072881002,True,500540002,32784230,533324232,True,3
7019,validator_32,111467116755,True,516440000,22899180,539339180,True,3
7020,validator_55,50504213471,True,533200003,3459740,536659743,True,1
7021,validator_1,551668117336,True,475759998,6926720,482686718,True,17
7022,validator_41,107827391970,True,571700000,3974200,575674200,False,3
7023,validator_16,154531581611,True,688656002,67106330,755762332,True,4
7024,validator_34,111605080960,True,654300000,2133400,656433400,False,3
7025,validator_1,552368709970,True,668908004,31684630,700592634,True,17
7026,validator_10,271148427520,True,1000600000,1322060,1001922060,False,8
7027,validator_21,156347946040,True,617700000,20400840,638100840,False,4
7028,validator_11,278895537540,True,611900000,16797630,628697630,False,8
7029,validator_3,451317530470,True,574300000,15735150,590035150,False,14
7030,validator_0,478533332709,True,934900001,7119490,942019491,True,14
7031,validator_3,451882528960,True,544200000,20798490,564998490,False,14
7032,validator_17,172507040939,True,892974003,23393500,916367503,True,5
7033,validator_86,53559630790,True,635000000,8984390,643984390,False,1
7034,validator_26,102156710281,True,479640002,8221980,487861982,True,3
7035,validator_1,552904529398,True,520039998,15779430,535819428,True,17
7036,validator_19,146442599460,True,511200000,3129570,514329570,False,4
7037,validator_0,479169860253,True,622300004,14227540,636527544,True,14
7038,validator_18,155939653570,True,559200000,8545700,567745700,False,4
7039,validator_5,296991980290,True,742740000,13213490,755953490,True,9
7040,validator_78,45377469360,True,539500000,3044120,542544120,False,1
7041,validator_1,553552402894,True,638899996,8973500,647873496,True,17
7042,validator_8,270678494180,True,515000000,2497280,517497280,False,8
7043,validator_1,554338172399,True,782900005,2869500,785769505,True,17
7044,validator_28,112630613244,True,716099993,2962940,719062933,True,3
7045,validator_12,162131023606,True,706000000,4304400,710304400,True,5
7046,validator_9,294296741230,True,484000000,20943490,504943490,False,9
7047,validator_13,169406666700,True,497439999,8491900,505931899,True,5
7048,validator_2,444897460030,True,504300000,21878880,526178880,False,13
7049,validator_42,107880881460,True,532600000,3930540,536530540,False,3
7050,validator_21,156825483940,True,471500000,6037900,477537900,False,4
7051,validator_79,49403624670,True,631700000,8967000,640667000,False,1
7052,validator_13,170113689000,True,703100000,3922300,707022300,True,5
7053,validator_21,157413767540,True,586600000,1683600,588283600,False,4
7054,validator_74,48016081700,True,491800000,9430840,501230840,False,1
7055,validator_43,107363088340,True,571300000,1867500,573167500,False,3
7056,validator_2,445425735220,True,525700000,2575190,528275190,False,13
7057,validator_96,50982944030,True,674100000,13216210,687316210,False,1
7058,validator_3,452686516610,True,769800000,34187650,803987650,False,14
7059,validator_1,555377401593,True,1026299994,12929200,1039229194,True,17
7060,validator_64,58848982547,True,607820003,28360780,636180783,True,1
7061,validator_0,479999605873,True,826800000,2945620,829745620,True,14
7062,validator_65,53856393244,True,681640004,37786000,719426004,True,1
7063,validator_22,165549682760,True,494800000,5616740,500416740,False,5
7064,validator_1,556345857906,True,930540003,37916310,968456313,True,17
7065,validator_18,156643493690,True,692900000,10940120,703840120,False,4
7066,validator_92,42503953470,True,721200000,2946470,724146470,False,1
7067,validator_14,182982021891,True,660999992,48993750,709993742,True,5
7068,validator_3,453430003130,True,740200000,3286520,743486520,False,14
7069,validator_0,480873969116,True,838440003,35923240,874363243,True,15
7070,validator_21,158119188440,True,684900000,20520900,705420900,False,4
7071,validator_53,48367104844,True,779100000,1837200,780937200,True,1
7072,validator_1,557000463407,True,649620001,4985500,654605501,True,17
7073,validator_22,166210810340,True,659800000,1327580,661127580,False,5
7074,validator_13,170771796103,True,634180003,23927100,658107103,True,5
7075,validator_4,285866245038,True,698057999,42582020,740640019,True,8
7076,validator_21,158494287000,True,372000000,3098560,375098560,False,4
7077,validator_36,102033643270,True,662800000,4067080,666867080,False,3
7078,validator_18,157409622010,True,758100000,8028320,766128320,False,4
7079,validator_9,294985804250,True,687500000,1563020,689063020,False,9
7080,validator_4,286322156958,True,445120000,10791920,455911920,True,8
7081,validator_45,53068750548,True,1031300008,25998600,1057298608,True,1
7082,validator_27,106543209009,True,434108007,36220000,470328007,True,3
7083,validator_2,445997138520,True,569200000,2203300,571403300,False,13
7084,validator_28,113546736330,True,900900006,15223080,916123086,True,3
7085,validator_18,157904743020,True,492600000,2521010,495121010,False,4
7086,validator_11,279602923620,True,706200000,1186080,707386080,False,8
7087,validator_11,280149509550,True,545700000,885930,546585930,False,8
7088,validator_15,173970934754,True,741000004,8432830,749432834,True,5
7089,validator_7,311134953175,True,801940000,17446330,819386330,True,9
7090,validator_97,52775613810,True,485200000,7410040,492610040,False,1
7091,validator_20,157220483150,True,550600000,12422430,563022430,False,4
7092,validator_15,174772337797,True,791020003,10383040,801403043,True,5
7093,validator_29,119278369525,True,666259994,14783860,681043854,True,3
7094,validator_25,121030848801,True,553039994,23088270,576128264,True,3
7095,validator_15,175474786911,True,685354004,17095110,702449114,True,5
7096,validator_16,155650099739,True,1107199998,11318130,1118518128,True,4
7097,validator_21,159246393740,True,731300000,20806740,752106740,False,4
7098,validator_15,176274474805,True,796599994,3087900,799687894,True,5
7099,validator_1,557855931693,True,852499996,2968290,855468286,True,17
7100,validator_1,558446213297,True,578499994,11781610,590281604,True,17
7101,validator_14,183800325792,True,806660001,11643900,818303901,True,5
7102,validator_22,167026369250,True,812300000,3258910,815558910,False,5
7103,validator_23,153690730610,True,631900000,10886870,642786870,False,4
7104,validator_8,271225639080,True,538200000,8944900,547144900,False,8
7105,validator_35,101022834410,True,546700000,10073070,556773070,False,3
7106,validator_11,280733396140,True,581900000,1986590,583886590,False,8
7107,validator_8,271956313580,True,728200000,2474500,730674500,False,8
7108,validator_27,107231439732,True,677920003,10310720,688230723,True,3
7109,validator_40,97826208340,True,497000000,3065560,500065560,False,3
7110,validator_21,159987498120,True,737900000,3204380,741104380,False,4
7111,validator_15,176914024323,True,631339998,8209520,639549518,True,5
7112,validator_11,281404032940,True,668600000,2036800,670636800,False,8
7113,validator_12,162972667641,True,827979995,13664040,841644035,True,5
7114,validator_12,163809598639,True,835199998,1731000,836930998,True,5
7115,validator_25,121840433942,True,794180001,15405140,809585141,True,3
7116,validator_14,184683894888,True,849339996,34229100,883569096,True,5
7117,validator_9,295811373970,True,803000000,22569720,825569720,False,9
7118,validator_89,51430770230,True,609900000,3096870,612996870,False,1
7119,validator_2,446662700410,True,652300000,13261890,665561890,False,13
7120,validator_82,50908124920,True,599100000,2970000,602070000,False,1
7121,validator_29,120134467568,True,854300003,1798040,856098043,True,3
7122,validator_23,154262988510,True,553100000,19157900,572257900,False,4
7123,validator_33,117361468024,True,549339989,14506440,563846429,True,3
7124,validator_9,296345328240,True,532100000,1854270,533954270,False,9
7125,validator_18,158654926500,True,744100000,6083480,750183480,False,4
7126,validator_3,454061815060,True,622600000,9211930,631811930,False,14
7127,validator_93,45800041890,True,509900000,1123510,511023510,False,1
7128,validator_3,454545272640,True,481500000,1957580,483457580,False,14
7129,validator_43,107993120740,True,626100000,3932400,630032400,False,3
7130,validator_4,287058788540,True,718668002,17963580,736631582,True,8
7131,validator_1,559189064035,True,732200008,10650730,742850738,True,17
7132,validator_4,287897910193,True,823220003,15901650,839121653,True,8
7133,validator_11,282087860080,True,677300000,6527140,683827140,False,8
7134,validator_7,311773053633,True,626279998,11820460,638100458,True,9
7135,validator_9,296968594870,True,617800000,5466630,623266630,False,9
7136,validator_39,109114165790,True,612100000,9683320,621783320,False,3
7137,validator_86,54205200060,True,632600000,12969270,645569270,False,1
7138,validator_7,312212344229,True,432139996,7150600,439290596,True,9
7139,validator_2,447341211530,True,674400000,4111120,678511120,False,13
7140,validator_11,282674296610,True,575500000,10936530,586436530,False,8
7141,validator_28,114186989535,True,628780005,11473200,640253205,True,3
7142,validator_9,297515929310,True,545700000,1634440,547334440,False,9
7143,validator_3,455249868110,True,703000000,1595470,704595470,False,14
7144,validator_13,171536121400,True,755719997,8605300,764325297,True,5
7145,validator_1,559885251310,True,694000005,2187270,696187275,True,17
7146,validator_33,118140497395,True,748000001,31029370,779029371,True,3
7147,validator_52,53447995977,True,673660001,13112580,686772581,True,1
7148,validator_15,177807893250,True,891999997,1868930,893868927,True,5
7149,validator_55,51333515983,True,825499992,3802520,829302512,True,1
7150,validator_54,53583980244,True,803264000,31850060,835114060,True,1
7151,validator_6,298924732638,True,797600005,1903960,799503965,True,9
7152,validator_18,159219757200,True,562700000,2130700,564830700,False,4
7153,validator_9,298008482210,True,489620000,2932900,492552900,False,9
7154,validator_98,46124736950,True,705700000,19028380,724728380,False,1
7155,validator_17,172946105478,True,428839999,10224540,439064539,True,5
7156,validator_13,172262007029,True,701299999,24585630,725885629,True,5
7157,validator_3,456012170880,True,759400000,2902770,762302770,False,14
7158,validator_84,45921636030,True,516400000,854090,517254090,False,1
7159,validator_71,60516321917,True,638439999,14344150,652784149,True,1
7160,validator_9,298677301530,True,664400000,4419320,668819320,False,9
7161,validator_2,448125841920,True,746100000,38530390,784630390,False,14
7162,validator_0,481647299817,True,750460001,22870700,773330701,True,15
7163,validator_17,173449731154,True,489455996,14169680,503625676,True,5
7164,validator_0,482153662321,True,485160004,21202500,506362504,True,15
7165,validator_78,46030291570,True,624700000,28122210,652822210,False,1
7166,validator_4,288568382793,True,661500000,8972600,670472600,True,9
7167,validator_2,448913235300,True,785600000,1793380,787393380,False,14
7168,validator_9,299105873530,True,422100000,6472000,428572000,False,9
7169,validator_19,147072760530,True,601600000,28561070,630161070,False,4
7170,validator_40,98566889680,True,701800000,38881340,740681340,False,3
7171,validator_8,272545185250,True,585700000,3171670,588871670,False,8
7172,validator_20,158032357450,True,791700000,20174300,811874300,False,4
7173,validator_32,112191969073,True,658579998,66272320,724852318,True,3
7174,validator_0,482754233518,True,592999997,7571200,600571197,True,15
7175,validator_3,456756423820,True,743000000,1252940,744252940,False,14
7176,validator_37,91484354750,True,585900000,8299240,594199240,False,2
7177,validator_14,185523047431,True,833200003,5952540,839152543,True,5
7178,validator_16,156395017117,True,724619998,20297380,744917378,True,4
7179,validator_97,53382656610,True,604100000,2942800,607042800,False,1
7180,validator_4,289183596933,True,583184000,32030140,615214140,True,9
7181,validator_26,102746689160,True,577200009,12778870,589978879,True,3
7182,validator_41,108575157910,True,746500000,1265940,747765940,False,3
7183,validator_75,46985639080,True,627800000,976390,628776390,False,1
7184,validator_0,483517168742,True,745240004,17695220,762935224,True,15
7185,validator_36,102722344690,True,686300000,2401420,688701420,False,3
7186,validator_18,159755112440,True,529400000,5955240,535355240,False,4
7187,validator_8,273147901740,True,598800000,3916490,602716490,False,8
7188,validator_43,108714546410,True,719100000,2325670,721425670,False,3
7189,validator_3,457359200220,True,589900000,12876400,602776400,False,14
7190,validator_37,92160680850,True,648300000,28026100,676326100,False,2
7191,validator_9,299830797930,True,718300000,6624400,724924400,False,9
7192,validator_25,122579106840,True,733399998,5272900,738672898,True,3
7193,validator_91,43902714420,True,681400000,4331340,685731340,False,1
7194,validator_3,457907828910,True,529000000,19628690,548628690,False,14
7195,validator_9,300361266470,True,521200000,9268540,530468540,False,9
7196,validator_3,458356206710,True,445200000,3177800,448377800,False,14
7197,validator_25,123183888184,True,564420004,40361340,604781344,True,3
7198,validator_9,300976348170,True,608800000,6281700,615081700,False,9
7199,validator_33,118704350112,True,550519997,13332720,563852717,True,3
7200,validator_7,312811624049,True,593008000,6271820,599279820,True,9
7201,validator_29,120679826679,True,500039991,45319120,545359111,True,3
7202,validator_57,52700846792,True,794100004,3183880,797283884,True,1
7203,validator_8,273712633070,True,561700000,3031330,564731330,False,8
7204,validator_42,108358056220,True,472270000,4904760,477174760,False,3
7205,validator_5,297596572054,True,583640004,20951760,604591764,True,9
7206,validator_4,289853214341,True,631500008,38117400,669617408,True,9
7207,validator_27,107955146452,True,702799990,20906730,723706720,True,3
7208,validator_12,164400333643,True,570600004,20135000,590735004,True,5
7209,validator_34,112349400780,True,741300000,3019820,744319820,False,3
7210,validator_68,51146783829,True,837339995,44714000,882053995,True,1
7211,validator_8,274178101360,True,459100000,6368290,465468290,False,8
7212,validator_39,109776199320,True,660200000,1833530,662033530,False,3
7213,validator_9,301575577670,True,592200000,7029500,599229500,False,9
7214,validator_12,165014496240,True,597407997,16754600,614162597,True,5
7215,validator_1,560679786989,True,755893999,38641680,794535679,True,17
7216,validator_76,52171850470,True,589700000,7729960,597429960,False,1
7217,validator_33,119194890337,True,482620005,7920220,490540225,True,3
7218,validator_31,119919432211,True,724240005,39261940,763501945,True,3
7219,validator_23,154871383010,True,598300000,10094500,608394500,False,4
7220,validator_5,298165979336,True,507720002,61687280,569407282,True,9
7221,validator_84,46546129840,True,620600000,3893810,624493810,False,1
7222,validator_22,167686435000,True,639700000,20365750,660065750,False,5
7223,validator_1,561123572184,True,441599995,2185200,443785195,True,17
7224,validator_75,47713009210,True,725100000,2270130,727370130,False,1
7225,validator_1,561757994186,True,632100002,2322000,634422002,True,17
7226,validator_11,283287108360,True,611800000,1011750,612811750,False,8
7227,validator_28,114924847468,True,729800003,8057930,737857933,True,3
7228,validator_62,57129904511,True,785060001,27517060,812577061,True,1
7229,validator_27,108627511653,True,663320001,9045200,672365201,True,3
7230,validator_22,168447127030,True,741200000,19492030,760692030,False,5
7231,validator_57,53567304226,True,828220004,38237430,866457434,True,1
7232,validator_34,112957904100,True,587900000,20603320,608503320,False,3
7233,validator_52,54326884426,True,838289999,40598450,878888449,True,1
7234,validator_8,274842221060,True,662000000,2119700,664119700,False,8
7235,validator_39,110514414860,True,714300000,23915540,738215540,False,3
7236,validator_34,113687369600,True,718500000,10965500,729465500,False,3
7237,validator_30,109317952097,True,608100003,26032620,634132623,True,3
7238,validator_24,101202232508,True,755220003,22324200,777544203,True,3
7239,validator_1,562545364587,True,782140001,5230400,787370401,True,17
7240,validator_2,449495631530,True,574500000,7896230,582396230,False,14
7241,validator_63,55196297585,True,745740001,15248330,760988331,True,1
7242,validator_84,47086542780,True,504000000,36412940,540412940,False,1
7243,validator_41,109102409750,True,507600000,19651840,527251840,False,3
7244,validator_85,45448726520,True,336300000,1177800,337477800,False,1
7245,validator_11,283982116000,True,692700000,2307640,695007640,False,8
7246,validator_1,563254393290,True,671140003,37888700,709028703,True,17
7247,validator_21,160621192560,True,632100000,1594440,633694440,False,5
7248,validator_30,109867133337,True,534666000,14515240,549181240,True,3
7249,validator_5,298872296335,True,690929999,15387000,706316999,True,9
7250,validator_4,290421440418,True,551953997,16272080,568226077,True,9
7251,validator_3,458838501920,True,466800000,15495210,482295210,False,14
7252,validator_0,484268691139,True,730719997,20802400,751522397,True,15
7253,validator_78,46701650020,True,651500000,19858450,671358450,False,1
7254,validator_27,109311327584,True,679999991,3815940,683815931,True,3
7255,validator_78,47146736290,True,441640000,3446270,445086270,False,1
7256,validator_22,169202108010,True,754100000,880980,754980980,False,5
7257,validator_1,563978791630,True,717660000,6738340,724398340,True,17
7258,validator_1,564910747864,True,907860004,24096230,931956234,True,17
7259,validator_8,275473690380,True,629200000,2269320,631469320,False,8
7260,validator_11,284587159990,True,594000000,11043990,605043990,False,8
7261,validator_97,53915943310,True,531100000,2186700,533286700,False,1
7262,validator_40,99283190870,True,713900000,2401190,716301190,False,3
7263,validator_12,165599916110,True,582599990,2819880,585419870,True,5
7264,validator_6,299447138376,True,508899998,13505740,522405738,True,9
7265,validator_30,110530361025,True,650079998,13147690,663227688,True,3
7266,validator_1,565737311570,True,812500006,14063700,826563706,True,17
7267,validator_2,449909367500,True,411820000,1915970,413735970,False,14
7268,validator_99,44663032950,True,517920000,20708530,538628530,False,1
7269,validator_0,484974637917,True,652239998,53706780,705946778,True,15
7270,validator_16,157030501847,True,585660000,49824730,635484730,True,4
7271,validator_18,160317523680,True,535900000,26511240,562411240,False,5
7272,validator_62,57829613536,True,682240005,17469020,699709025,True,1
7273,validator_4,291282038860,True,818700002,41898440,860598442,True,9
7274,validator_22,169922060110,True,718200000,1752100,719952100,False,5
7275,validator_47,55491794240,True,753139997,13665100,766805097,True,1
7276,validator_42,108939510280,True,579900000,1554060,581454060,False,3
7277,validator_25,123957340615,True,745240001,28212430,773452431,True,3
7278,validator_90,50894403570,True,689500000,3576000,693076000,False,1
7279,validator_13,172772056150,True,499160001,10889120,510049121,True,5
7280,validator_0,485683968913,True,689300006,20030990,709330996,True,15
7281,validator_0,486136969600,True,413759997,39240690,453000687,True,15
7282,validator_32,113135072449,True,901119996,41983380,943103376,True,3
7283,validator_1,566508628411,True,746620001,24696840,771316841,True,17
7284,validator_30,111187779681,True,648319996,9098660,657418656,True,3
7285,validator_10,271686459200,True,537100000,931680,538031680,False,8
7286,validator_5,299545260942,True,643700007,29264600,672964607,True,9
7287,validator_4,292071807835,True,718199995,71568980,789768975,True,9
7288,validator_25,124544296519,True,579640004,7315900,586955904,True,3
7289,validator_7,313356204186,True,536299997,8280140,544580137,True,9
7290,validator_5,300113299340,True,557399998,10638400,568038398,True,9
7291,validator_12,166427725809,True,819399999,8409700,827809699,True,5
7292,validator_72,52178854370,True,494800000,4187910,498987910,False,1
7293,validator_68,51933066059,True,777440000,8842230,786282230,True,1
7294,validator_26,103398629961,True,641300001,10640800,651940801,True,3
7295,validator_94,51320345070,True,822100000,10436540,832536540,False,1
7296,validator_9,302159957590,True,564200000,20179920,584379920,False,9
7297,validator_23,155484920740,True,611100000,2437730,613537730,False,4
7298,validator_8,276031241900,True,554700000,2851520,557551520,False,8
7299,validator_1,567305608416,True,771540005,25440000,796980005,True,17
7300,validator_3,459439652510,True,598300000,2850590,601150590,False,14
7301,validator_8,276611859780,True,578800000,1817880,580617880,False,8
7302,validator_57,54301394622,True,706687996,27402400,734090396,True,1
7303,validator_4,292700005304,True,618519999,9677470,628197469,True,9
7304,validator_18,160941986550,True,622200000,2262870,624462870,False,5
7305,validator_31,120546449513,True,625700002,1317300,627017302,True,3
7306,validator_35,101624346730,True,581100000,20412320,601512320,False,3
7307,validator_25,125221248782,True,656700003,20252260,676952263,True,3
7308,validator_29,121194576723,True,491093994,23656050,514750044,True,3
7309,validator_31,121175969742,True,597619999,31900230,629520229,True,3
7310,validator_92,43053634750,True,520400000,29281280,549681280,False,1
7311,validator_92,43677006980,True,618500000,4872230,623372230,False,1
7312,validator_55,52041827765,True,673080002,35231780,708311782,True,1
7313,validator_8,277295991280,True,681100000,3031500,684131500,False,8
7314,validator_1,567981601904,True,634679998,41313490,675993488,True,17
7315,validator_17,174067445456,True,598220002,19494300,617714302,True,5
7316,validator_98,46820690080,True,688300000,7653130,695953130,False,1
7317,validator_5,300752391443,True,603940003,35152100,639092103,True,9
7318,validator_10,272355558460,True,642600000,26499260,669099260,False,8
7319,validator_26,104134396656,True,721499995,14266700,735766695,True,3
7320,validator_3,460092348870,True,651000000,1696360,652696360,False,14
7321,validator_13,173302112746,True,518399996,11656600,530056596,True,5
7322,validator_40,99835098870,True,546100000,5808000,551908000,False,3
7323,validator_4,293527642882,True,817819998,9817580,827637578,True,9
7324,validator_18,161415611030,True,453500000,20124480,473624480,False,5
7325,validator_13,174243067778,True,925200002,15755030,940955032,True,5
7326,validator_23,156171729940,True,660400000,26409200,686809200,False,4
7327,validator_2,450595603270,True,683500000,2735770,686235770,False,14
7328,validator_1,568700482797,True,697199993,21680900,718880893,True,17
7329,validator_9,302946000890,True,757800000,28243300,786043300,False,9
7330,validator_24,102177358350,True,959068002,16057840,975125842,True,3
7331,validator_17,174917017394,True,844699998,4871940,849571938,True,5
7332,validator_96,51512155030,True,527100000,2111000,529211000,False,1
7333,validator_28,115648547671,True,716134003,7566200,723700203,True,3
7334,validator_39,111164253540,True,645600000,4238680,649838680,False,3
7335,validator_9,303488566930,True,536100000,6466040,542566040,False,9
7336,validator_2,451180771590,True,572200000,12968320,585168320,False,14
7337,validator_53,49127467743,True,751999999,8362900,760362899,True,1
7338,validator_3,460723759790,True,625400000,6010920,631410920,False,14
7339,validator_10,272943295660,True,573100000,14637200,587737200,False,8
7340,validator_26,104935393855,True,762219999,38777200,800997199,True,3
7341,validator_30,111947093981,True,713740000,45574300,759314300,True,3
7342,validator_21,161370282360,True,747100000,1989800,749089800,False,5
7343,validator_2,451574174430,True,385000000,8402840,393402840,False,14
7344,validator_22,170488152140,True,558600000,7492030,566092030,False,5
7345,validator_1,569550530048,True,816414001,33633250,850047251,True,17
7346,validator_52,54953426521,True,608704005,17838090,626542095,True,1
7347,validator_21,162095387660,True,724300000,805300,725105300,False,5
7348,validator_46,49742296344,True,477239997,33594500,510834497,True,1
7349,validator_25,125944554398,True,688000006,35305610,723305616,True,3
7350,validator_1,570237617345,True,602129997,84957300,687087297,True,17
7351,validator_25,126695382144,True,730399996,20427750,750827746,True,3
7352,validator_49,57155603672,True,920620005,33586380,954206385,True,1
7353,validator_10,273563034520,True,611200000,8538860,619738860,False,8
7354,validator_1,570745672484,True,501499999,6555140,508055139,True,17
7355,validator_27,109900594339,True,587199995,2066760,589266755,True,3
7356,validator_2,452166075480,True,575100000,16801050,591901050,False,14
7357,validator_2,452734552800,True,552910000,15567320,568477320,False,14
7358,validator_9,304084435310,True,588900000,6968380,595868380,False,9
7359,validator_34,114236991290,True,540700000,8921690,549621690,False,3
7360,validator_75,48287272810,True,571000000,3263600,574263600,False,1
7361,validator_17,175504311025,True,577840001,9453630,587293631,True,5
7362,validator_21,162600038640,True,485800000,18850980,504650980,False,5
7363,validator_20,158710271280,True,656500000,21413830,677913830,False,4
7364,validator_12,167039722106,True,600339997,11656300,611996297,True,5
7365,validator_20,159420632610,True,709000000,1361330,710361330,False,4
7366,validator_59,46419360597,True,621660001,8918000,630578001,True,1
7367,validator_29,121899198342,True,688219999,16401620,704621619,True,3
7368,validator_17,176169490959,True,658340004,6839930,665179934,True,5
7369,validator_9,304652146070,True,565000000,2710760,567710760,False,9
7370,validator_3,461402975630,True,676100000,3115840,679215840,False,14
7371,validator_7,314112374628,True,746100002,10070440,756170442,True,9
7372,validator_14,185981801177,True,445600006,13153740,458753746,True,5
7373,validator_14,186562670381,True,575300004,5569200,580869204,True,5
7374,validator_33,119771542139,True,551980002,24671800,576651802,True,3
7375,validator_1,571304815411,True,537059997,22082930,559142927,True,17
7376,validator_87,53332525450,True,757600000,2732960,760332960,False,1
7377,validator_3,461923573060,True,517900000,2697430,520597430,False,14
7378,validator_16,157707517349,True,666540002,10475500,677015502,True,4
7379,validator_2,453341122730,True,588300000,18269930,606569930,False,14
7380,validator_20,159983883530,True,554200000,9050920,563250920,False,4
7381,validator_16,158250400156,True,540199997,2682810,542882807,True,4
7382,validator_26,105627757580,True,648379995,43983730,692363725,True,3
7383,validator_15,178717472467,True,857439997,52139220,909579217,True,5
7384,validator_4,294287425284,True,731660002,28122400,759782402,True,9
7385,validator_59,46986773018,True,553980001,13432420,567412421,True,1
7386,validator_82,51286020520,True,367700000,10195600,377895600,False,1
7387,validator_20,160456204000,True,465300000,7020470,472320470,False,5
7388,validator_1,571916633811,True,558560000,53258400,611818400,True,17
7389,validator_0,486984271700,True,826252000,21050100,847302100,True,15
7390,validator_9,305469775320,True,815100000,2529250,817629250,False,9
7391,validator_43,109085368460,True,367240000,3582050,370822050,False,3
7392,validator_1,572600144142,True,677158001,6352330,683510331,True,17
7393,validator_3,462540603890,True,615400000,1630830,617030830,False,14
7394,validator_83,52174290830,True,669600000,22794400,692394400,False,1
7395,validator_62,58396919461,True,542145995,25159930,567305925,True,1
7396,validator_3,463209061290,True,667700000,757400,668457400,False,14
7397,validator_14,187131259487,True,548740006,19849100,568589106,True,5
7398,validator_34,114809468460,True,568700000,3777170,572477170,False,3
7399,validator_16,159102082117,True,842464001,9217960,851681961,True,4
7400,validator_29,122692471644,True,751360002,41913300,793273302,True,3
7401,validator_13,174940500874,True,670940006,26493090,697433096,True,5
7402,validator_14,187874441208,True,726820001,16361720,743181721,True,5
7403,validator_9,305955137220,True,481400000,3961900,485361900,False,9
7404,validator_3,463839508020,True,627000000,3446730,630446730,False,14
7405,validator_47,56145787045,True,616720005,37272800,653992805,True,1
7406,validator_10,274263671760,True,698400000,2237240,700637240,False,8
7407,validator_0,487472566109,True,449309999,38984410,488294409,True,15
7408,validator_0,488039034595,True,544480006,21988480,566468486,True,15
7409,validator_73,53146201380,True,934200000,4070970,938270970,False,1
7410,validator_83,52734064890,True,529600000,30174060,559774060,False,1
7411,validator_3,464535952220,True,676900000,19544200,696444200,False,14
7412,validator_41,109697502790,True,594000000,1093040,595093040,False,3
7413,validator_4,295284564420,True,947959996,49179140,997139136,True,9
7414,validator_33,120955390435,True,1159999996,23848300,1183848296,True,3
7415,validator_20,161114909100,True,656300000,2405100,658705100,False,5
7416,validator_62,59262275642,True,863900001,1456180,865356181,True,1
7417,validator_82,51787433400,True,484200000,17212880,501412880,False,1
7418,validator_5,301309417439,True,549799996,7226000,557025996,True,9
7419,validator_23,156698483540,True,507100000,19653600,526753600,False,4
7420,validator_2,453826489020,True,484400000,966290,485366290,False,14
7421,validator_15,179410638258,True,680080001,13085790,693165791,True,5
7422,validator_30,112671659039,True,696919998,27645060,724565058,True,3
7423,validator_90,51498959000,True,578400000,26155430,604555430,False,1
7424,validator_29,123683937242,True,949839998,41625600,991465598,True,3
7425,validator_90,52210892700,True,708900000,3033700,711933700,False,1
7426,validator_30,113485332863,True,796119994,17553830,813673824,True,3
7427,validator_3,465247409520,True,690700000,20757300,711457300,False,14
7428,validator_48,49979597158,True,789667999,23692630,813360629,True,1
7429,validator_1,573272208338,True,644159996,27904200,672064196,True,17
7430,validator_28,116517918390,True,841380009,27990710,869370719,True,3
7431,validator_5,301773168979,True,456933990,6817550,463751540,True,9
7432,validator_41,110130233890,True,405700000,27031100,432731100,False,3
7433,validator_34,115424073140,True,610300000,4304680,614604680,False,3
7434,validator_84,47588691310,True,491800000,10348530,502148530,False,1
7435,validator_68,52704323901,True,743600002,27657840,771257842,True,1
7436,validator_21,163168799370,True,564700000,4060730,568760730,False,5
7437,validator_23,157340171360,True,637300000,4387820,641687820,False,4
7438,validator_1,574157455329,True,863300001,21946990,885246991,True,17
7439,validator_29,124394293637,True,699099995,11256400,710356395,True,3
7440,validator_41,110787818350,True,654800000,2784460,657584460,False,3
7441,validator_2,454611711660,True,783000000,2222640,785222640,False,14
7442,validator_33,121632866377,True,655340002,22135940,677475942,True,3
7443,validator_85,46087243820,True,638000000,517300,638517300,False,1
7444,validator_66,59585249147,True,498840004,38061720,536901724,True,1
7445,validator_28,117199659685,True,649159995,32581300,681741295,True,3
7446,validator_78,47701897290,True,548100000,7061000,555161000,False,1
7447,validator_12,167734181808,True,674196002,20263700,694459702,True,5
7448,validator_14,188574159724,True,686679996,13038520,699718516,True,5
7449,validator_3,465873842660,True,600800000,25633140,626433140,False,14
7450,validator_97,54614608000,True,697500000,1164690,698664690,False,1
7451,validator_2,455366667610,True,753500000,1455950,754955950,False,14
7452,validator_0,488595085239,True,529840004,26210640,556050644,True,15
7453,validator_10,274964743580,True,677100000,23971820,701071820,False,8
7454,validator_11,285155111410,True,564240000,3711420,567951420,False,8
7455,validator_6,300117449401,True,643752005,26559020,670311025,True,9
7456,validator_25,127419375215,True,692080001,31913070,723993071,True,3
7457,validator_15,180202973258,True,717080000,75255000,792335000,True,5
7458,validator_3,466521744360,True,644400000,3501700,647901700,False,14
7459,validator_8,277941950980,True,638300000,7659700,645959700,False,8
7460,validator_0,489272156464,True,650740005,26331220,677071225,True,15
7461,validator_4,295885719100,True,566160000,34994680,601154680,True,9
7462,validator_10,275445596350,True,461000000,19852770,480852770,False,8
7463,validator_32,113674074942,True,537099993,1902500,539002493,True,3
7464,validator_34,115923747320,True,491100000,8574180,499674180,False,3
7465,validator_21,163697318050,True,525400000,3118680,528518680,False,5
7466,validator_62,59829605937,True,524539995,42790300,567330295,True,1
7467,validator_62,60322730559,True,490399992,2724630,493124622,True,1
7468,validator_75,48871172330,True,575750000,8149520,583899520,False,1
7469,validator_1,574840171645,True,677819996,4896320,682716316,True,17
7470,validator_22,171033085120,True,536400000,8532980,544932980,False,5
7471,validator_33,122288931840,True,649640003,6425460,656065463,True,3
7472,validator_0,490004925500,True,728200006,4569030,732769036,True,15
7473,validator_18,162134865100,True,717500000,1754070,719254070,False,5
7474,validator_8,278519501920,True,575900000,1650940,577550940,False,8
7475,validator_2,455708203300,True,333800000,7735690,341535690,False,14
7476,validator_2,456243290660,True,528500000,6587360,535087360,False,14
7477,validator_21,164344213530,True,629100000,17795480,646895480,False,5
7478,validator_28,117994585510,True,791999995,2925830,794925825,True,3
7479,validator_64,59386845549,True,503360002,34503000,537863002,True,1
7480,validator_76,52720846600,True,547100000,1896130,548996130,False,1
7481,validator_29,124983243038,True,574658001,14291400,588949401,True,3
7482,validator_24,102963028832,True,778900002,6770480,785670482,True,3
7483,validator_1,575354976885,True,506520000,8285240,514805240,True,17
7484,validator_89,51889123060,True,448000000,10352830,458352830,False,1
7485,validator_5,302486316505,True,688439996,24707530,713147526,True,9
7486,validator_6,300752295819,True,597579998,37266420,634846418,True,9
7487,validator_10,275900544950,True,452200000,2748600,454948600,False,8
7488,validator_8,278976943620,True,419700000,37741700,457441700,False,8
7489,validator_3,467217817960,True,676900000,19173600,696073600,False,14
7490,validator_3,467712749560,True,492800000,2131600,494931600,False,14
7491,validator_36,103160893330,True,431300000,7248640,438548640,False,3
7492,validator_45,53861701148,True,784060000,8890600,792950600,True,1
7493,validator_0,490544635071,True,526740001,12969570,539709571,True,15
7494,validator_53,49706770942,True,568399999,10903200,579303199,True,1
7495,validator_11,285684195960,True,527800000,1284550,529084550,False,8
7496,validator_46,50393894390,True,644399996,7198050,651598046,True,1
7497,validator_27,110476418226,True,539159997,36663890,575823887,True,3
7498,validator_4,296478768922,True,590200002,2849820,593049822,True,9
7499,validator_1,576280491040,True,923199995,2314160,925514155,True,18
7500,validator_0,491321355722,True,744839991,31880660,776720651,True,15
7501,validator_27,111314139357,True,815060001,22661130,837721131,True,3
7502,validator_8,279741295220,True,762100000,2251600,764351600,False,8
7503,validator_22,171659267300,True,622000000,4182180,626182180,False,5
7504,validator_25,128153748559,True,713600004,20773340,734373344,True,4
7505,validator_0,492000160261,True,639999999,38804540,678804539,True,15
7506,validator_97,55238657390,True,619900000,4149390,624049390,False,1
7507,validator_38,105864124600,True,609200000,8018540,617218540,False,3
7508,validator_9,306594221870,True,638700000,384650,639084650,False,9
7509,validator_68,53372698815,True,634845994,33528920,668374914,True,1
7510,validator_10,276601785330,True,697000000,4240380,701240380,False,8
7511,validator_0,492535200258,True,533800007,1239990,535039997,True,15
7512,validator_6,301349112183,True,567059994,29756370,596816364,True,9
7513,validator_9,307118321560,True,482900000,41199690,524099690,False,9
7514,validator_21,165003194630,True,631600000,27381100,658981100,False,5
7515,validator_7,314835291052,True,721000004,1916420,722916424,True,9
7516,validator_21,165610205830,True,604600000,2411200,607011200,False,5
7517,validator_93,46381658890,True,573100000,8517000,581617000,False,1
7518,validator_53,50378971965,True,646940003,25261020,672201023,True,1
7519,validator_83,53303189680,True,543500000,25624790,569124790,False,1
7520,validator_34,116486218840,True,555000000,7471520,562471520,False,3
7521,validator_0,493431330486,True,859159998,36970230,896130228,True,15
7522,validator_0,494328526735,True,879139999,18056250,897196249,True,15
7523,validator_14,189131851729,True,551920005,5772000,557692005,True,5
7524,validator_7,315499151385,True,631080003,32780330,663860333,True,9
7525,validator_84,48139891730,True,545000000,6200420,551200420,False,1
7526,validator_53,51511628199,True,1103500004,29156230,1132656234,True,1
7527,validator_2,456827864040,True,576300000,8273380,584573380,False,14
7528,validator_40,100552329240,True,715900000,1330370,717230370,False,3
7529,validator_77,48549566730,True,589100000,8163710,597263710,False,1
7530,validator_8,280430302740,True,664000000,25007520,689007520,False,8
7531,validator_6,301874182328,True,506400005,18670140,525070145,True,9
7532,validator_6,302699852802,True,818820004,6850470,825670474,True,9
7533,validator_40,101229019030,True,671900000,4789790,676689790,False,3
7534,validator_8,280947666370,True,514900000,2463630,517363630,False,8
7535,validator_51,49983348634,True,815860003,11979710,827839713,True,1
7536,validator_9,307829974370,True,692400000,19252810,711652810,False,9
7537,validator_2,457262501490,True,431900000,2737450,434637450,False,14
7538,validator_20,161539520730,True,422100000,2511630,424611630,False,5
7539,validator_12,168893388440,True,1155700002,3506630,1159206632,True,5
7540,validator_23,157742851290,True,400300000,2379930,402679930,False,4
7541,validator_8,281530800790,True,581200000,1934420,583134420,False,8
7542,validator_8,282140286210,True,607500000,1985420,609485420,False,8
7543,validator_12,169533288901,True,632400001,7500460,639900461,True,5
7544,validator_1,576937564520,True,646120000,10953480,657073480,True,18
7545,validator_6,303556861485,True,843040003,13968680,857008683,True,9
7546,validator_46,51085160557,True,670119997,21146170,691266167,True,1
7547,validator_2,458107736590,True,843400000,1835100,845235100,False,14
7548,validator_12,170093078877,True,536500006,23289970,559789976,True,5
7549,validator_68,54152352123,True,760399998,19253310,779653308,True,1
7550,validator_65,54432535264,True,560820000,15322020,576142020,True,1
7551,validator_39,111714738680,True,518000000,32485140,550485140,False,3
7552,validator_46,51660731011,True,566674004,8896450,575570454,True,1
7553,validator_40,101795201920,True,558800000,7382890,566182890,False,3
7554,validator_39,112257812120,True,542300000,773440,543073440,False,3
7555,validator_5,303405775807,True,912120002,7339300,919459302,True,9
7556,validator_6,304395298205,True,817980000,20456720,838436720,True,9
7557,validator_27,112164646552,True,840839995,9667200,850507195,True,3
7558,validator_9,308234109000,True,398900000,5234630,404134630,False,9
7559,validator_17,176887376378,True,694479999,23405420,717885419,True,5
7560,validator_41,111405311070,True,615000000,2492720,617492720,False,3
7561,validator_29,125620166867,True,613019999,23903830,636923829,True,3
7562,validator_2,458692694420,True,581400000,3557830,584957830,False,14
7563,validator_1,577683415988,True,739169998,6681470,745851468,True,18
7564,validator_41,111990446600,True,575100000,10035530,585135530,False,3
7565,validator_96,52135137190,True,621400000,1582160,622982160,False,1
7566,validator_11,286212017750,True,525600000,2221790,527821790,False,8
7567,validator_17,177507445207,True,612659999,7408830,620068829,True,5
7568,validator_1,578423214719,True,720248001,19550730,739798731,True,18
7569,validator_13,175439742110,True,469633996,29607240,499241236,True,5
7570,validator_37,92824468750,True,649000000,14787900,663787900,False,2
7571,validator_97,56051474500,True,811800000,1017110,812817110,False,1
7572,validator_37,93575805540,True,749400000,1936790,751336790,False,2
7573,validator_3,468282078400,True,560600000,8728840,569328840,False,14
7574,validator_72,52683773750,True,498500000,6419380,504919380,False,1
7575,validator_7,316297836118,True,760400003,38284730,798684733,True,9
7576,validator_1,579140387318,True,715099999,2072600,717172599,True,18
7577,validator_1,579779743285,True,630739997,8615970,639355967,True,18
7578,validator_8,282668404580,True,527000000,1118370,528118370,False,8
7579,validator_1,580456023601,True,618439996,57840320,676280316,True,18
7580,validator_20,162320457030,True,778800000,2136300,780936300,False,5
7581,validator_32,114381252153,True,696100011,11077200,707177211,True,3
7582,validator_33,122981256354,True,684999994,7324520,692324514,True,3
7583,validator_51,50549407728,True,504760004,61299090,566059094,True,1
7584,validator_15,180941019577,True,686859999,51186320,738046319,True,5
7585,validator_31,122074952363,True,868130001,30852620,898982621,True,3
7586,validator_9,308749163110,True,513400000,1654110,515054110,False,9
7587,validator_34,117262241220,True,756700000,19322380,776022380,False,3
7588,validator_44,51987570283,True,733120008,42391940,775511948,True,1
7589,validator_57,54928627222,True,609100000,18132600,627232600,True,1
7590,validator_74,48719040190,True,700500000,2458490,702958490,False,1
7591,validator_3,468881437700,True,589300000,10059300,599359300,False,14
7592,validator_22,172239678790,True,578000000,2411490,580411490,False,5
7593,validator_1,580932119933,True,474700002,1396330,476096332,True,18
7594,validator_4,297147673645,True,661320003,7584720,668904723,True,9
7595,validator_9,309419758500,True,668700000,1895390,670595390,False,9
7596,validator_7,316769041702,True,462920004,8285580,471205584,True,9
7597,validator_19,147758544930,True,681600000,4184400,685784400,False,4
7598,validator_1,581601700755,True,659120002,10460820,669580822,True,18
7599,validator_15,181564705819,True,603740002,19946240,623686242,True,5
7600,validator_5,304084246611,True,671239994,7230810,678470804,True,9
7601,validator_95,47684261370,True,554900000,2336670,557236670,False,1
7602,validator_17,178259895048,True,692640001,59809840,752449841,True,5
7603,validator_1,582190819741,True,583099986,6019000,589118986,True,18
7604,validator_43,109674305360,True,586400000,2536900,588936900,False,3
7605,validator_23,158672329890,True,889100000,40378600,929478600,False,4
7606,validator_95,48372579650,True,642300000,46018280,688318280,False,1
7607,validator_4,297916312289,True,741958004,26680640,768638644,True,9
7608,validator_1,582969161240,True,756399999,21941500,778341499,True,18
7609,validator_3,469525796960,True,642700000,1659260,644359260,False,14
7610,validator_0,495128986137,True,780660002,19799400,800459402,True,15
7611,validator_7,317235816445,True,459500003,7274740,466774743,True,9
7612,validator_3,470148890760,True,619100000,3993800,623093800,False,14
7613,validator_31,122906863857,True,827699994,4211500,831911494,True,3
7614,validator_21,166216250310,True,601300000,4744480,606044480,False,5
7615,validator_93,47041999190,True,632800000,27540300,660340300,False,1
7616,validator_17,179041982368,True,744400000,37687320,782087320,True,5
7617,validator_73,53626798980,True,478500000,2097600,480597600,False,1
7618,validator_91,44514383350,True,609800000,1868930,611668930,False,1
7619,validator_1,583938783576,True,959899996,9722340,969622336,True,18
7620,validator_31,123516058787,True,579260000,29934930,609194930,True,3
7621,validator_5,304872438271,True,768700000,19491660,788191660,True,9
7622,validator_12,170801495017,True,659940000,48476140,708416140,True,5
7623,validator_45,54377371342,True,505800004,9870190,515670194,True,1
7624,validator_34,117911688120,True,646400000,3046900,649446900,False,3
7625,validator_18,162665438640,True,527000000,3573540,530573540,False,5
7626,validator_34,118466871600,True,551900000,3283480,555183480,False,3
7627,validator_9,310011199200,True,589200000,2240700,591440700,False,9
7628,validator_0,496128535470,True,975700003,23849330,999549333,True,15
7629,validator_16,159673117244,True,560239997,10795130,571035127,True,4
7630,validator_18,163280930740,True,609700000,5792100,615492100,False,5
7631,validator_1,584693292124,True,752200008,2308540,754508548,True,18
7632,validator_44,52567776460,True,550893997,29312180,580206177,True,1
7633,validator_50,49002178338,True,615900000,4090540,619990540,True,1
7634,validator_18,163953946780,True,669300000,3716040,673016040,False,5
7635,validator_36,103704157480,True,533300000,9964150,543264150,False,3
7636,validator_35,102176674580,True,545600000,6727850,552327850,False,3
7637,validator_22,172791390990,True,549600000,2112200,551712200,False,5
7638,validator_1,585319356103,True,619699999,6363980,626063979,True,18
7639,validator_18,164455381040,True,499300000,2134260,501434260,False,5
7640,validator_20,162830971170,True,501600000,8914140,510514140,False,5
7641,validator_3,470881421220,True,723300000,9230460,732530460,False,14
7642,validator_44,53336111760,True,757700000,10635300,768335300,True,1
7643,validator_99,45507928210,True,836100000,8795260,844895260,False,1
7644,validator_4,298529351260,True,601540001,11498970,613038971,True,9
7645,validator_8,283328501080,True,658000000,2096500,660096500,False,8
7646,validator_28,118762898559,True,740339999,27973050,768313049,True,3
7647,validator_66,60245414466,True,657799999,2365320,660165319,True,1
7648,validator_91,45131070940,True,609900000,6787590,616687590,False,1
7649,validator_12,171519324057,True,696760000,21069040,717829040,True,5
7650,validator_4,299211200946,True,636299996,45549690,681849686,True,9
7651,validator_14,190005663233,True,871000004,2811500,873811504,True,5
7652,validator_86,54784561720,True,577200000,2161660,579361660,False,1
7653,validator_35,102638706380,True,458900000,3131800,462031800,False,3
7654,validator_20,163224528330,True,366700000,26857160,393557160,False,5
7655,validator_1,585938966587,True,604539994,15070490,619610484,True,18
7656,validator_8,283917746660,True,588600000,645580,589245580,False,8
7657,validator_39,113106773860,True,840500000,8461740,848961740,False,3
7658,validator_9,310570726040,True,556600000,2926840,559526840,False,9
7659,validator_8,284485889260,True,564500000,3642600,568142600,False,8
7660,validator_97,56574986350,True,515700000,7811850,523511850,False,1
7661,validator_16,160601243213,True,887719999,40405970,928125969,True,5
7662,validator_38,106172223450,True,287100000,20998850,308098850,False,3
7663,validator_0,497053413515,True,904939995,19938050,924878045,True,15
7664,validator_9,311133803640,True,554200000,8877600,563077600,False,9
7665,validator_3,471431623420,True,544340000,5862200,550202200,False,14
7666,validator_8,285028115930,True,540700000,1526670,542226670,False,8
7667,validator_88,50507656920,True,737500000,3798850,741298850,False,1
7668,validator_20,163862964880,True,618000000,20436550,638436550,False,5
7669,validator_11,286730012650,True,510200000,7794900,517994900,False,8
7670,validator_0,497788224789,True,707099994,27711280,734811274,True,15
7671,validator_56,60339899506,True,549799998,20991800,570791798,True,1
7672,validator_3,471969796960,True,535400000,2773540,538173540,False,14
7673,validator_2,459308667660,True,612900000,3073240,615973240,False,14
7674,validator_10,277318557680,True,715200000,1572350,716772350,False,8
7675,validator_0,498310625929,True,490800000,31601140,522401140,True,15
7676,validator_10,277994886260,True,657400000,18928580,676328580,False,8
7677,validator_7,317918928950,True,668100005,15012500,683112505,True,9
7678,validator_19,148265789990,True,482900000,24345060,507245060,False,4
7679,validator_36,104258175140,True,552800000,1217660,554017660,False,3
7680,validator_42,109633471580,True,691000000,2961300,693961300,False,3
7681,validator_36,104894692630,True,633500000,3017490,636517490,False,3
7682,validator_25,128900908259,True,745800000,1359700,747159700,True,4
7683,validator_2,459768011170,True,448700000,10643510,459343510,False,14
7684,validator_0,498976058433,True,644100004,21332500,665432504,True,15
7685,validator_2,460393475770,True,623500000,1964600,625464600,False,14
7686,validator_22,173518511890,True,719700000,7420900,727120900,False,5
7687,validator_26,106226727771,True,556714001,42256190,598970191,True,3
7688,validator_11,287356381730,True,578400000,47969080,626369080,False,8
7689,validator_3,472536067090,True,556300000,9970130,566270130,False,14
7690,validator_35,103262671110,True,620000000,3964730,623964730,False,3
7691,validator_21,166859392140,True,641500000,1641830,643141830,False,5
7692,validator_25,129503192234,True,593660005,8623970,602283975,True,4
7693,validator_32,115012829289,True,626240006,5337130,631577136,True,3
7694,validator_5,305566071933,True,690200002,3433660,693633662,True,9
7695,validator_65,55386492491,True,935719997,18237230,953957227,True,1
7696,validator_11,287912630260,True,546800000,9448530,556248530,False,8
7697,validator_38,106696129820,True,514200000,9706370,523906370,False,3
7698,validator_15,182237469352,True,659796003,12967530,672763533,True,5
7699,validator_87,53985107710,True,643000000,9582260,652582260,False,1
7700,validator_2,460917305050,True,503900000,19929280,523829280,False,14
7701,validator_3,473189676130,True,650600000,3009040,653609040,False,14
7702,validator_38,107324643460,True,627200000,1313640,628513640,False,3
7703,validator_15,182821829691,True,542379999,41980340,584360339,True,5
7704,validator_38,107877040640,True,549900000,2497180,552397180,False,3
7705,validator_1,586713587456,True,730283999,44336870,774620869,True,18
7706,validator_20,164477313010,True,612500000,1848130,614348130,False,5
7707,validator_72,53403250100,True,718700000,776350,719476350,False,1
7708,validator_16,161111020339,True,507200006,2577120,509777126,True,5
7709,validator_67,53308236212,True,661300006,2624800,663924806,True,1
7710,validator_68,55047994153,True,863680000,31962030,895642030,True,1
7711,validator_61,55288425192,True,496419998,18946330,515366328,True,1
7712,validator_66,61032510562,True,763939996,23156100,787096096,True,1
7713,validator_19,149075798390,True,799000000,11008400,810008400,False,4
7714,validator_33,123659125003,True,675800009,2068640,677868649,True,3
7715,validator_13,176209168103,True,729753993,39672000,769425993,True,5
7716,validator_1,587552117944,True,788339998,50190490,838530488,True,18
7717,validator_10,278723398360,True,724000000,4512100,728512100,False,8
7718,validator_79,49941892690,True,521870000,16398020,538268020,False,1
7719,validator_4,299842285742,True,617079996,14004800,631084796,True,9
7720,validator_32,115559279725,True,520845996,25604440,546450436,True,3
7721,validator_3,473835362130,True,643400000,2286000,645686000,False,14
7722,validator_16,162018137161,True,883040002,24076820,907116822,True,5
7723,validator_9,311703259760,True,566200000,3256120,569456120,False,9
7724,validator_11,288530538360,True,615400000,2508100,617908100,False,9
7725,validator_77,49078146470,True,501800000,26779740,528579740,False,1
7726,validator_2,461477135370,True,550470000,9360320,559830320,False,14
7727,validator_34,119001823030,True,515300000,19651430,534951430,False,3
7728,validator_17,179691658857,True,603597999,46078490,649676489,True,5
7729,validator_20,165054614800,True,574900000,2401790,577301790,False,5
7730,validator_6,304946816140,True,521524005,29993930,551517935,True,9
7731,validator_3,474320309930,True,478700000,6247800,484947800,False,14
7732,validator_54,54330766292,True,730200008,16586040,746786048,True,1
7733,validator_20,165622606220,True,564100000,3891420,567991420,False,5
7734,validator_16,162637758835,True,596639994,22981680,619621674,True,5
7735,validator_13,176835481184,True,623240001,3073080,626313081,True,5
7736,validator_38,108464199460,True,584400000,2758820,587158820,False,3
7737,validator_6,305632626798,True,645179998,40630660,685810658,True,9
7738,validator_16,163234865230,True,579900005,17206390,597106395,True,5
7739,validator_25,130217107038,True,696580004,17334800,713914804,True,4
7740,validator_18,165087286340,True,625300000,6605300,631905300,False,5
7741,validator_2,462131712650,True,650700000,3877280,654577280,False,14
7742,validator_3,474882820040,True,561300000,1210110,562510110,False,14
7743,validator_2,462836469150,True,701700000,3056500,704756500,False,14
7744,validator_34,119843029730,True,814200000,27006700,841206700,False,3
7745,validator_37,94149965420,True,571300000,2859880,574159880,False,2
7746,validator_10,279487561560,True,761500000,2663200,764163200,False,8
7747,validator_1,588081971482,True,522939998,6913540,529853538,True,18
7748,validator_93,47529285020,True,449300000,37985830,487285830,False,1
7749,validator_3,475607382070,True,721300000,3262030,724562030,False,14
7750,validator_3,476255250070,True,645700000,2168000,647868000,False,14
7751,validator_32,116171555558,True,592940003,19335830,612275833,True,3
7752,validator_40,102505526420,True,679700000,30624500,710324500,False,3
7753,validator_1,589028971948,True,941339996,5660470,947000466,True,18
7754,validator_25,130954366437,True,735599999,1659400,737259399,True,4
7755,validator_1,589752541881,True,681179993,42389940,723569933,True,18
7756,validator_30,114347994207,True,833574004,29087340,862661344,True,3
7757,validator_6,306271356385,True,615079997,23649590,638729587,True,9
7758,validator_11,289124536830,True,591400000,2598470,593998470,False,9
7759,validator_72,53922294040,True,512200000,6843940,519043940,False,1
7760,validator_3,476826854150,True,566900000,4704080,571604080,False,14
7761,validator_5,306446421156,True,843500003,36849220,880349223,True,9
7762,validator_1,590629268468,True,852159997,24566590,876726587,True,18
7763,validator_3,477524095510,True,686800000,10441360,697241360,False,14
7764,validator_94,52096545910,True,765700000,10500840,776200840,False,1
7765,validator_96,52831302270,True,688700000,7465080,696165080,False,1
7766,validator_6,306879459738,True,582860003,25243350,608103353,True,9
7767,validator_38,108936413300,True,434720000,37493840,472213840,False,3
7768,validator_46,52391113282,True,722140001,8242270,730382271,True,1
7769,validator_1,591369866931,True,733700003,6898460,740598463,True,18
7770,validator_5,307036248179,True,569709993,20117030,589827023,True,9
7771,validator_23,159375039320,True,701100000,1609430,702709430,False,4
7772,validator_1,592009622732,True,619520001,20235800,639755801,True,18
7773,validator_1,592779450851,True,759779999,10048120,769828119,True,18
7774,validator_15,183734411257,True,904940006,7641560,912581566,True,5
7775,validator_9,312181376390,True,458000000,20116630,478116630,False,9
7776,validator_29,126472656156,True,840173999,12315290,852489289,True,3
7777,validator_5,307706220160,True,650320001,19651980,669971981,True,9
7778,validator_7,318617673446,True,692199996,6544500,698744496,True,9
7779,validator_51,51406029619,True,821258001,35363890,856621891,True,1
7780,validator_43,110194995060,True,518900000,1789700,520689700,False,3
7781,validator_82,52603422010,True,812400000,3588610,815988610,False,1
7782,validator_52,55645791614,True,664639993,27725100,692365093,True,1
7783,validator_15,184306116087,True,537720000,33984830,571704830,True,5
7784,validator_4,300802931635,True,926019993,34625900,960645893,True,9
7785,validator_85,46608883410,True,498800000,22839590,521639590,False,1
7786,validator_2,463562757950,True,717100000,9188800,726288800,False,14
7787,validator_34,120619049860,True,774100000,1920130,776020130,False,3
7788,validator_1,593342640449,True,549719998,13469600,563189598,True,18
7789,validator_12,172057418285,True,509379998,28714230,538094228,True,5
7790,validator_5,308227862534,True,519699994,1942380,521642374,True,9
7791,validator_92,44327921440,True,648500000,2414460,650914460,False,1
7792,validator_3,478269590150,True,742300000,3194640,745494640,False,14
7793,validator_13,177214088778,True,366519994,12087600,378607594,True,5
7794,validator_5,309017223332,True,782219998,7140800,789360798,True,9
7795,validator_0,499652760228,True,675099995,1601800,676701795,True,15
7796,validator_8,285729831810,True,675300000,26415880,701715880,False,8
7797,validator_77,49717958730,True,619100000,20712260,639812260,False,1
7798,validator_37,94781948880,True,629100000,2883460,631983460,False,2
7799,validator_7,319241929529,True,616700003,7556080,624256083,True,9
7800,validator_41,112696983020,True,705000000,1536420,706536420,False,3
7801,validator_35,103818655540,True,553500000,2484430,555984430,False,3
7802,validator_6,307557636772,True,675500004,2677030,678177034,True,9
7803,validator_22,174226119990,True,705300000,2308100,707608100,False,5
7804,validator_12,172762802887,True,679560002,25824600,705384602,True,5
7805,validator_10,280179306200,True,688400000,3344640,691744640,False,8
7806,validator_7,319929187704,True,675519995,11738180,687258175,True,9
7807,validator_14,190723881028,True,692739995,25477800,718217795,True,5
7808,validator_12,173530719950,True,761800003,6117060,767917063,True,5
7809,validator_4,301303702931,True,490440006,10331290,500771296,True,9
7810,validator_18,165675053760,True,568800000,18967420,587767420,False,5
7811,validator_3,479214272700,True,934000000,10682550,944682550,False,14
7812,validator_8,286432656040,True,692200000,10624230,702824230,False,8
7813,validator_28,119334055666,True,568199997,2957110,571157107,True,3
7814,validator_6,308411981369,True,828665997,25678600,854344597,True,9
7815,validator_1,594074213446,True,729199997,2373000,731572997,True,18
7816,validator_2,464162379490,True,579600000,20021540,599621540,False,14
7817,validator_10,280775149980,True,574500000,21343780,595843780,False,8
7818,validator_25,131811569850,True,819260003,37943410,857203413,True,4
7819,validator_66,61884350940,True,848100008,3740370,851840378,True,1
7820,validator_91,45888783890,True,751600000,6112950,757712950,False,1
7821,validator_39,113768046070,True,659100000,2172210,661272210,False,3
7822,validator_3,479909464690,True,693300000,1891990,695191990,False,14
7823,validator_15,185366555114,True,1027599997,32839030,1060439027,True,5
7824,validator_49,57815154972,True,625320000,34231300,659551300,True,1
7825,validator_22,174843642790,True,608800000,8722800,617522800,False,5
7826,validator_54,54984877594,True,630820002,23291300,654111302,True,1
7827,validator_31,124439356008,True,887460001,35837220,923297221,True,3
7828,validator_8,287148149460,True,714400000,1093420,715493420,False,8
7829,validator_20,166291495360,True,648600000,20289140,668889140,False,5
7830,validator_38,109442531100,True,495500000,10617800,506117800,False,3
7831,validator_2,464840341050,True,675200000,2761560,677961560,False,14
7832,validator_11,289894051660,True,766800000,2714830,769514830,False,9
7833,validator_3,480586147620,True,655600000,21082930,676682930,False,15
7834,validator_4,302034510687,True,707046006,23761750,730807756,True,9
7835,validator_41,113151661760,True,451500000,3178740,454678740,False,3
7836,validator_70,52044128570,True,700900002,8533920,709433922,True,1
7837,validator_43,110701855560,True,487000000,19860500,506860500,False,3
7838,validator_7,320510929737,True,559760003,21982030,581742033,True,10
7839,validator_4,302809138391,True,743484004,31143700,774627704,True,9
7840,validator_22,175346218770,True,499100000,3475980,502575980,False,5
7841,validator_39,114222281010,True,445500000,8734940,454234940,False,3
7842,validator_11,290438464060,True,542500000,1912400,544412400,False,9
7843,validator_4,303640199322,True,814936001,16124930,831060931,True,9
7844,validator_49,58418276007,True,584254005,18867030,603121035,True,1
7845,validator_0,500332887925,True,635953997,44173700,680127697,True,15
7846,validator_8,287787124750,True,636600000,2375290,638975290,False,8
7847,validator_7,321390668484,True,844400007,35338740,879738747,True,10
7848,validator_1,594654099677,True,553460001,26426230,579886231,True,18
7849,validator_36,105486426300,True,570500000,21233670,591733670,False,3
7850,validator_30,114936147058,True,579600001,8552850,588152851,True,3
7851,validator_28,120412345727,True,1075400001,2890060,1078290061,True,3
7852,validator_17,180297033112,True,577963995,27410260,605374255,True,5
7853,validator_4,304199324744,True,557300002,1825420,559125422,True,9
7854,validator_31,125327854043,True,885400005,3098030,888498035,True,3
7855,validator_10,281555815920,True,772100000,8565940,780665940,False,8
7856,validator_40,103187795940,True,679700000,2569520,682269520,False,3
7857,validator_21,167356915540,True,493400000,4123400,497523400,False,5
7858,validator_32,116969286902,True,787220004,10511340,797731344,True,3
7859,validator_16,163848897127,True,592999997,21031900,614031897,True,5
7860,validator_53,52126281871,True,588920002,25733670,614653672,True,1
7861,validator_2,465573930450,True,731600000,1989400,733589400,False,14
7862,validator_11,290952773570,True,512700000,1609510,514309510,False,9
7863,validator_51,52057015488,True,648139999,2845870,650985869,True,1
7864,validator_1,595189987228,True,511379991,24507560,535887551,True,18
7865,validator_24,104057095847,True,1092399995,1667020,1094067015,True,3
7866,validator_79,50386105590,True,442600000,1612900,444212900,False,1
7867,validator_43,111342781130,True,621700000,19225570,640925570,False,3
7868,validator_10,282249276260,True,691600000,1860340,693460340,False,8
7869,validator_1,596064373867,True,846203999,28182640,874386639,True,18
7870,validator_16,164841120754,True,960669997,31553630,992223627,True,5
7871,validator_14,191408675997,True,681699999,3094970,684794969,True,5
7872,validator_7,322086207484,True,675400000,20139000,695539000,True,10
7873,validator_13,177846029977,True,621099999,10841200,631941199,True,5
7874,validator_15,186226563723,True,825225999,34782610,860008609,True,5
7875,validator_3,481147400550,True,551800000,9452930,561252930,False,15
7876,validator_1,596629689165,True,530039998,35275300,565315298,True,18
7877,validator_18,166459823020,True,781000000,3769260,784769260,False,5
7878,validator_7,322747131924,True,610320000,50604440,660924440,True,10
7879,validator_82,53158072710,True,551800000,2850700,554650700,False,1
7880,validator_18,167038529860,True,576000000,2706840,578706840,False,5
7881,validator_9,312845790910,True,661600000,2814520,664414520,False,9
7882,validator_35,104310147050,True,488790000,2701510,491491510,False,3
7883,validator_59,47655202901,True,662100003,6329880,668429883,True,1
7884,validator_25,132453231779,True,603399999,38261930,641661929,True,4
7885,validator_18,167622093060,True,564300000,19263200,583563200,False,5
7886,validator_15,187042284432,True,786520009,29200700,815720709,True,5
7887,validator_51,52779255880,True,702800002,19440390,722240392,True,1
7888,validator_25,133226689181,True,753120002,20337400,773457402,True,4
7889,validator_23,159844658720,True,468300000,1319400,469619400,False,4
7890,validator_6,309153057307,True,732239998,8835940,741075938,True,9
7891,validator_95,48992846870,True,613800000,6467220,620267220,False,1
7892,validator_9,313434227250,True,564100000,24336340,588436340,False,9
7893,validator_41,113845322580,True,691400000,2260820,693660820,False,3
7894,validator_29,127160274652,True,641657996,45960500,687618496,True,3
7895,validator_23,160495393050,True,631900000,18834330,650734330,False,5
7896,validator_28,121118528095,True,697939998,8242370,706182368,True,3
7897,validator_90,52943737260,True,711200000,21644560,732844560,False,1
7898,validator_57,55700945418,True,732359996,39958200,772318196,True,1
7899,validator_79,50943757110,True,555300000,2351520,557651520,False,1
7900,validator_3,481912451850,True,763300000,1751300,765051300,False,15
7901,validator_31,126157076747,True,802500004,26722700,829222704,True,3
7902,validator_21,168143286350,True,783500000,2870810,786370810,False,5
7903,validator_20,166869967360,True,577000000,1472000,578472000,False,5
7904,validator_14,191989189497,True,578000000,2513500,580513500,True,5
7905,validator_49,58878384457,True,430439990,29668460,460108450,True,1
7906,validator_9,313993592320,True,549730000,9635070,559365070,False,9
7907,validator_15,187806281880,True,748859998,15137450,763997448,True,5
7908,validator_49,59483233150,True,560758003,44090690,604848693,True,1
7909,validator_64,60113157153,True,719000004,7311600,726311604,True,1
7910,validator_8,288695648860,True,899600000,8924110,908524110,False,9
7911,validator_42,110161926600,True,526400000,2055020,528455020,False,3
7912,validator_92,44978219460,True,648400000,1898020,650298020,False,1
7913,validator_7,323511604565,True,754160001,10312640,764472641,True,10
7914,validator_21,168839255670,True,694900000,1069320,695969320,False,5
7915,validator_21,169512505930,True,671100000,2150260,673250260,False,5
7916,validator_1,597283467464,True,642199999,11578300,653778299,True,18
7917,validator_3,482545449950,True,630300000,2698100,632998100,False,15
7918,validator_39,114703290720,True,471200000,9809710,481009710,False,3
7919,validator_1,597699704279,True,414300005,1936810,416236815,True,18
7920,validator_1,598345918054,True,624660005,21553770,646213775,True,18
7921,validator_23,161163673010,True,647500000,20779960,668279960,False,5
7922,validator_7,324290124960,True,758639995,19880400,778520395,True,10
7923,validator_17,180889744716,True,572080004,20631600,592711604,True,5
7924,validator_53,52867430789,True,713019998,28128920,741148918,True,1
7925,validator_14,192800454298,True,796700001,14564800,811264801,True,6
7926,validator_1,599060780455,True,705896001,8966400,714862401,True,18
7927,validator_1,599663495555,True,593820000,8895100,602715100,True,18
7928,validator_10,282796976160,True,544900000,2799900,547699900,False,8
7929,validator_16,165500592523,True,632399999,27071770,659471769,True,5
7930,validator_89,52418285310,True,526000000,3162250,529162250,False,1
7931,validator_8,289179903990,True,483100000,1155130,484255130,False,9
7932,validator_22,175996230890,True,648100000,1912120,650012120,False,5
7933,validator_23,161902983810,True,732100000,7210800,739310800,False,5
7934,validator_8,290011494030,True,790300000,41290040,831590040,False,9
7935,validator_8,290906474370,True,891200000,3780340,894980340,False,9
7936,validator_10,283321299960,True,513000000,11323800,524323800,False,8
7937,validator_22,176620251500,True,615500000,8520610,624020610,False,5
7938,validator_7,325065062064,True,773100004,1837100,774937104,True,10
7939,validator_93,48059284350,True,527700000,2299330,529999330,False,1
7940,validator_15,188541858553,True,706979993,28596680,735576673,True,5
7941,validator_8,291559858970,True,651200000,2184600,653384600,False,9
7942,validator_13,178472365615,True,607099998,19235640,626335638,True,5
7943,validator_0,501014323251,True,631219996,50215330,681435326,True,15
7944,validator_23,162487664300,True,582300000,2380490,584680490,False,5
7945,validator_1,600243985909,True,526616004,53874350,580490354,True,18
7946,validator_42,110828845970,True,658600000,8319370,666919370,False,3
7947,validator_7,325929727921,True,793939997,70725860,864665857,True,10
7948,validator_74,49183441420,True,460100000,4301230,464401230,False,1
7949,validator_26,106860750273,True,613200002,20822500,634022502,True,3
7950,validator_7,326777368825,True,821300004,26340900,847640904,True,10
7951,validator_25,134189008679,True,911557998,50761500,962319498,True,4
7952,validator_5,309726005134,True,707700002,1081800,708781802,True,9
7953,validator_4,304909816248,True,679160004,31331500,710491504,True,9
7954,validator_78,48499315020,True,796400000,1017730,797417730,False,1
7955,validator_49,60079073525,True,565365995,30474380,595840375,True,1
7956,validator_15,189374294375,True,810720002,21715820,832435822,True,5
7957,validator_42,111520690440,True,688600000,3244470,691844470,False,3
7958,validator_17,181659291702,True,764839996,4706990,769546986,True,5
7959,validator_15,189969590015,True,563440000,31855640,595295640,True,5
7960,validator_22,177303471200,True,681200000,2019700,683219700,False,5
7961,validator_1,601113426833,True,865899994,3540930,869440924,True,18
7962,validator_10,283753823400,True,423100000,9423440,432523440,False,8
7963,validator_42,112119511880,True,595300000,3521440,598821440,False,3
7964,validator_2,466165250920,True,588270000,3050470,591320470,False,14
7965,validator_87,54624637930,True,612500000,27030220,639530220,False,1
7966,validator_4,305524507602,True,572219994,42471360,614691354,True,9
7967,validator_31,126988165982,True,809619995,21469240,831089235,True,3
7968,validator_5,310209981019,True,469319995,14655890,483975885,True,9
7969,validator_2,466768508280,True,596100000,7157360,603257360,False,14
7970,validator_6,309761666909,True,604500002,4109600,608609602,True,9
7971,validator_18,168283590600,True,655700000,5797540,661497540,False,5
7972,validator_32,117593550741,True,611839999,12423840,624263839,True,3
7973,validator_5,310813041946,True,581539997,21520930,603060927,True,9
7974,validator_1,602006005455,True,884900002,7678620,892578622,True,18
7975,validator_0,502106718981,True,1084000000,8395730,1092395730,True,15
7976,validator_10,284251345010,True,453500000,44021610,497521610,False,8
7977,validator_1,602609632936,True,590000001,13627480,603627481,True,18
7978,validator_11,291531331980,True,557700000,20858410,578558410,False,9
7979,validator_73,54272134060,True,641000000,4335080,645335080,False,1
7980,validator_27,112645560958,True,454839996,26074410,480914406,True,3
7981,validator_11,292131183300,True,596000000,3851320,599851320,False,9
7982,validator_7,327513092471,True,706020006,29703640,735723646,True,10
7983,validator_19,149902669070,True,808000000,18870680,826870680,False,4
7984,validator_10,284923093350,True,667300000,4448340,671748340,False,8
7985,validator_0,502747102447,True,638999996,1383470,640383466,True,15
7986,validator_13,179152953249,True,659840004,20747630,680587634,True,5
7987,validator_25,134754612880,True,545600001,20004200,565604201,True,4
7988,validator_88,51015009830,True,506000000,1352910,507352910,False,1
7989,validator_6,310486603932,True,692139993,32797030,724937023,True,9
7990,validator_9,314561192430,True,559200000,8400110,567600110,False,9
7991,validator_27,113224936098,True,578300000,1075140,579375140,True,3
7992,validator_10,285458063200,True,480900000,54069850,534969850,False,8
7993,validator_53,53727573849,True,836300000,23843060,860143060,True,1
7994,validator_1,603232911017,True,595596001,27682080,623278081,True,18
7995,validator_52,56223995115,True,550408001,27795500,578203501,True,1
7996,validator_22,177905110980,True,592300000,9339780,601639780,False,5
7997,validator_78,48964987590,True,455300000,10372570,465672570,False,1
7998,validator_78,49522045170,True,550000000,7057580,557057580,False,1
7999,validator_3,483156005750,True,608900000,1655800,610555800,False,15
8000,validator_34,121336299570,True,714300000,2949710,717249710,False,3
8001,validator_1,603885140056,True,611939999,40289040,652229039,True,18
8002,validator_10,286068739020,True,608600000,2075820,610675820,False,8
8003,validator_79,51428257650,True,482000000,2500540,484500540,False,1
8004,validator_3,483779632880,True,610600000,13027130,623627130,False,15
8005,validator_11,292818611200,True,678300000,9127900,687427900,False,9
8006,validator_76,53261662430,True,536900000,3915830,540815830,False,1
8007,validator_50,49728128793,True,723899995,2050460,725950455,True,1
8008,validator_87,55461047830,True,832800000,3609900,836409900,False,1
8009,validator_68,55729938858,True,668270005,13674700,681944705,True,1
8010,validator_8,292206492570,True,643800000,2833600,646633600,False,9
8011,validator_7,328095360559,True,573163998,9104090,582268088,True,10
8012,validator_13,179679655934,True,495640005,31062680,526702685,True,5
8013,validator_21,170130617010,True,615500000,2611080,618111080,False,5
8014,validator_5,311408157731,True,573800005,21315780,595115785,True,9
8015,validator_71,61161211514,True,635119997,9769600,644889597,True,1
8016,validator_18,168907025050,True,603400000,20034450,623434450,False,5
8017,validator_9,315277081380,True,713900000,1988950,715888950,False,9
8018,validator_19,150669035270,True,765400000,966200,766366200,False,4
8019,validator_80,46488413290,True,661900000,3051540,664951540,False,1
8020,validator_11,293507575720,True,682400000,6564520,688964520,False,9
8021,validator_9,316037987020,True,740600000,20305640,760905640,False,9
8022,validator_16,166054515931,True,548120008,5803400,553923408,True,5
8023,validator_18,169452236270,True,536800000,8411220,545211220,False,5
8024,validator_9,316641842320,True,601400000,2455300,603855300,False,9
8025,validator_0,503785389751,True,964378004,73909300,1038287304,True,15
8026,validator_5,312373062644,True,940899993,24004920,964904913,True,9
8027,validator_7,328810830031,True,645568002,69901470,715469472,True,10
8028,validator_3,484398959300,True,616600000,2726420,619326420,False,15
8029,validator_89,53110211570,True,689400000,2526260,691926260,False,1
8030,validator_35,105047748130,True,735600000,2001080,737601080,False,3
8031,validator_84,48780347540,True,634300000,6155810,640455810,False,1
8032,validator_79,52094055280,True,663500000,2297630,665797630,False,1
8033,validator_39,115314143220,True,600840000,10012500,610852500,False,3
8034,validator_1,604430592329,True,517200003,28252270,545452273,True,18
8035,validator_56,61543230585,True,1182745999,20585080,1203331079,True,1
8036,validator_3,485081773600,True,680400000,2414300,682814300,False,15
8037,validator_0,504486620590,True,682019999,19210840,701230839,True,15
8038,validator_16,166646538629,True,554139998,37882700,592022698,True,5
8039,validator_33,124348718743,True,670040000,19553740,689593740,True,3
8040,validator_72,54778450960,True,854000000,2156920,856156920,False,1
8041,validator_16,167368180266,True,709139997,12501640,721641637,True,5
8042,validator_0,505351881007,True,830057997,35202420,865260417,True,15
8043,validator_1,605211478453,True,777960004,2926120,780886124,True,18
8044,validator_1,605894149170,True,663219997,19450720,682670717,True,18
8045,validator_17,182406969746,True,739180004,8498040,747678044,True,5
8046,validator_17,183164265087,True,738254001,19041340,757295341,True,5
8047,validator_98,47468053720,True,631600000,15763640,647363640,False,1
8048,validator_10,286672258960,True,600700000,2819940,603519940,False,8
8049,validator_57,56321708904,True,582700006,38063480,620763486,True,1
8050,validator_42,112876004210,True,753600000,2892330,756492330,False,3
8051,validator_1,606677930106,True,759299996,24480940,783780936,True,18
8052,validator_4,306360247136,True,816820004,18919530,835739534,True,9
8053,validator_15,190759568538,True,786399993,3578530,789978523,True,5
8054,validator_14,193739043534,True,921140006,17449230,938589236,True,6
8055,validator_28,121634873498,True,493240003,23105400,516345403,True,3
8056,validator_12,174296012746,True,736219996,29072800,765292796,True,5
8057,validator_27,114022721533,True,777286005,20499430,797785435,True,3
8058,validator_20,167638595900,True,762300000,6328540,768628540,False,5
8059,validator_3,485637556990,True,553200000,2583390,555783390,False,15
8060,validator_1,607678635427,True,984340001,16365320,1000705321,True,18
8061,validator_81,51487870090,True,582700000,3396340,586096340,False,1
8062,validator_11,294047948620,True,538600000,1772900,540372900,False,9
8063,validator_14,194448488173,True,660171999,49272640,709444639,True,6
8064,validator_93,48684775250,True,606200000,19290900,625490900,False,1
8065,validator_11,294665247170,True,614400000,2898550,617298550,False,9
8066,validator_2,467402609910,True,627200000,6901630,634101630,False,14
8067,validator_28,122508994724,True,855370006,18751220,874121226,True,3
8068,validator_57,56879480329,True,544040005,13731420,557771425,True,1
8069,validator_79,52607570800,True,511800000,1715520,513515520,False,1
8070,validator_34,121961147460,True,602300000,22547890,624847890,False,3
8071,validator_30,115524037096,True,568557998,19332040,587890038,True,3
8072,validator_3,486134327590,True,494000000,2770600,496770600,False,15
8073,validator_15,191418312275,True,644173997,14569740,658743737,True,5
8074,validator_68,56555513973,True,771205995,54369120,825575115,True,1
8075,validator_39,116099119110,True,778800000,6175890,784975890,False,3
8076,validator_4,307031612232,True,634479996,36885100,671365096,True,9
8077,validator_32,117999334041,True,395800000,9983300,405783300,True,3
8078,validator_0,506194698332,True,829319995,13497330,842817325,True,15
8079,validator_5,312957018375,True,556820001,27135730,583955731,True,9
8080,validator_18,169931239170,True,477100000,1902900,479002900,False,5
8081,validator_28,123159314852,True,636193998,14126130,650320128,True,3
8082,validator_36,106089177650,True,599600000,3151350,602751350,False,3
8083,validator_34,122701522200,True,719200000,21174740,740374740,False,3
8084,validator_24,104924047495,True,854340008,12611640,866951648,True,3
8085,validator_19,151277801380,True,584600000,24166110,608766110,False,4
8086,validator_2,468130809090,True,723000000,5199180,728199180,False,14
8087,validator_33,125146093317,True,762519994,34854580,797374574,True,3
8088,validator_14,195373637784,True,880839991,44309620,925149611,True,6
8089,validator_7,329607727827,True,787157996,9739800,796897796,True,10
8090,validator_28,123881362733,True,699899991,22147890,722047881,True,3
8091,validator_34,123475145660,True,772500000,1123460,773623460,False,3
8092,validator_21,170825730110,True,691000000,4113100,695113100,False,5
8093,validator_9,317273616450,True,628600000,3174130,631774130,False,9
8094,validator_7,330307121130,True,692540003,6853300,699393303,True,10
8095,validator_70,52719216149,True,661339999,13747580,675087579,True,1
8096,validator_22,178496855210,True,581500000,10244230,591744230,False,5
8097,validator_2,468599973230,True,459500000,9664140,469164140,False,14
8098,validator_7,330901496466,True,582240006,12135330,594375336,True,10
8099,validator_16,168144665964,True,731085998,45399700,776485698,True,5
8100,validator_14,195817696722,True,437919998,6138940,444058938,True,6
8101,validator_31,127700783305,True,705900003,6717320,712617323,True,3
8102,validator_27,114489913894,True,465800001,1392360,467192361,True,3
8103,validator_36,106650952920,True,556300000,5475270,561775270,False,3
8104,validator_55,52599053496,True,555400001,1825730,557225731,True,1
8105,validator_59,48339356199,True,608685998,75467300,684153298,True,1
8106,validator_12,175086251951,True,765700005,24539200,790239205,True,5
8107,validator_9,317736364680,True,454100000,8648230,462748230,False,9
8108,validator_12,175833558387,True,733420006,13886430,747306436,True,5
8109,validator_1,608453400733,True,750940006,23825300,774765306,True,19
8110,validator_6,311305830129,True,791399997,27826200,819226197,True,9
8111,validator_18,170440374050,True,489300000,19834880,509134880,False,5
8112,validator_33,125857931546,True,688559999,23278230,711838229,True,3
8113,validator_6,312043487444,True,732419995,5237320,737657315,True,9
8114,validator_35,105723074690,True,655900000,19426560,675326560,False,3
8115,validator_97,57186056350,True,605300000,5770000,611070000,False,1
8116,validator_94,52866255330,True,768300000,1409420,769709420,False,1
8117,validator_34,123932285180,True,431100000,26039520,457139520,False,3
8118,validator_76,53833210960,True,569400000,2148530,571548530,False,1
8119,validator_86,55407000020,True,613500000,8938300,622438300,False,1
8120,validator_73,55096837260,True,821200000,3503200,824703200,False,1
8121,validator_22,178959060110,True,460800000,1404900,462204900,False,5
8122,validator_33,126509719241,True,609979995,41807700,651787695,True,3
8123,validator_42,113687226880,True,790000000,21222670,811222670,False,3
8124,validator_32,118808843427,True,757799996,51709390,809509386,True,3
8125,validator_41,114429723580,True,583700000,701000,584401000,False,3
8126,validator_41,115048280260,True,615900000,2656680,618556680,False,3
8127,validator_5,313487640708,True,495499993,35122340,530622333,True,9
8128,validator_89,53778934950,True,666800000,1923380,668723380,False,1
8129,validator_23,163187445540,True,697000000,2781240,699781240,False,5
8130,validator_5,314000576313,True,504920005,8015600,512935605,True,9
8131,validator_0,506953743030,True,715819998,43224700,759044698,True,15
8132,validator_34,124538754990,True,598200000,8269810,606469810,False,3
8133,validator_18,171017501590,True,574900000,2227540,577127540,False,5
8134,validator_17,183764828406,True,574919999,25643320,600563319,True,5
8135,validator_47,56741751047,True,571699992,24264010,595964002,True,1
8136,validator_4,307885971932,True,846160000,8199700,854359700,True,9
8137,validator_2,469102831960,True,500000000,2858730,502858730,False,14
8138,validator_22,179716716890,True,754500000,3156780,757656780,False,5
8139,validator_12,176635784623,True,782000006,20226230,802226236,True,5
8140,validator_37,95352039010,True,564500000,5590130,570090130,False,2
8141,validator_70,53452194943,True,683543994,49434800,732978794,True,1
8142,validator_51,53320210781,True,501940001,39014900,540954901,True,1
8143,validator_9,318335839050,True,594600000,4874370,599474370,False,9
8144,validator_8,292930457390,True,717000000,6964820,723964820,False,9
8145,validator_62,60967779087,True,618567998,26480530,645048528,True,1
8146,validator_6,312977826931,True,910199997,24139490,934339487,True,9
8147,validator_1,609075145710,True,582699997,39044980,621744977,True,19
8148,validator_14,196684524379,True,849684007,17143650,866827657,True,6
8149,validator_6,313787101229,True,803499998,5774300,809274298,True,9
8150,validator_9,318889764120,True,551300000,2625070,553925070,False,9
8151,validator_17,184330360702,True,563399996,2132300,565532296,True,5
8152,validator_2,469608580480,True,503700000,2048520,505748520,False,14
8153,validator_3,486745644320,True,597500000,13816730,611316730,False,15
8154,validator_9,319421511440,True,508500000,23247320,531747320,False,9
8155,validator_92,45671614640,True,685700000,7695180,693395180,False,1
8156,validator_1,609925018603,True,839900003,9972890,849872893,True,19
8157,validator_97,57925957760,True,738800000,1101410,739901410,False,1
8158,validator_3,487310664200,True,542300000,22719880,565019880,False,15
8159,validator_33,127036834894,True,524200003,2915650,527115653,True,3
8160,validator_12,177281629944,True,621520001,24325320,645845321,True,5
8161,validator_61,56090027081,True,779720009,21881880,801601889,True,1
8162,validator_4,308523354616,True,614700004,22682680,637382684,True,9
8163,validator_0,507946545691,True,964180001,28622660,992802661,True,15
8164,validator_12,177870529603,True,574819999,14079660,588899659,True,5
8165,validator_25,135708972178,True,917135998,37223300,954359298,True,4
8166,validator_5,314938803092,True,877207999,61018780,938226779,True,9
8167,validator_34,125183091790,True,616610000,27726800,644336800,False,3
8168,validator_1,610574137506,True,605760003,43358900,649118903,True,19
8169,validator_75,49445384930,True,572800000,1412600,574212600,False,1
8170,validator_20,168199280300,True,558000000,2684400,560684400,False,5
8171,validator_25,136341414814,True,622899996,9542640,632442636,True,4
8172,validator_50,50521336196,True,761880003,31327400,793207403,True,1
8173,validator_31,128546455231,True,817365996,28305930,845671926,True,4
8174,validator_11,295314093710,True,611700000,37146540,648846540,False,9
8175,validator_5,315572009292,True,622194000,11012200,633206200,True,9
8176,validator_6,314705367761,True,894460002,23806530,918266532,True,9
8177,validator_12,178885130911,True,1012499998,2101310,1014601308,True,5
8178,validator_21,171557084710,True,718100000,13254600,731354600,False,5
8179,validator_20,168604708450,True,397800000,7628150,405428150,False,5
8180,validator_5,316214143583,True,633680001,8454290,642134291,True,9
8181,validator_27,115038828079,True,516880005,32034180,548914185,True,3
8182,validator_0,508498545960,True,521439999,30560270,552000269,True,15
8183,validator_11,295974819540,True,659630000,1095830,660725830,False,9
8184,validator_4,309203226653,True,658399997,21472040,679872037,True,9
8185,validator_5,316990905622,True,773519999,3242040,776762039,True,9
8186,validator_13,180385502497,True,669420003,36426560,705846563,True,5
8187,validator_28,124584373768,True,695780005,7231030,703011035,True,3
8188,validator_3,487876206800,True,563700000,1842600,565542600,False,15
8189,validator_1,611368388739,True,778119993,16131240,794251233,True,19
8190,validator_3,488341046700,True,461800000,3039900,464839900,False,15
8191,validator_48,50578159137,True,593539999,5021980,598561979,True,1
8192,validator_41,115891228380,True,840500000,2448120,842948120,False,3
8193,validator_1,611968840667,True,562279998,38171930,600451928,True,19
8194,validator_93,49288013250,True,578500000,24738000,603238000,False,1
8195,validator_5,317755000425,True,761100003,2994800,764094803,True,9
8196,validator_0,509135298892,True,627120002,9632930,636752932,True,15
8197,validator_23,163861443980,True,664200000,9798440,673998440,False,5
8198,validator_7,331681741875,True,725115999,55129410,780245409,True,10
8199,validator_12,179509824203,True,592339992,32353300,624693292,True,5
8200,validator_90,53486721720,True,539200000,3784460,542984460,False,1
8201,validator_90,54110052320,True,603800000,19530600,623330600,False,1
8202,validator_35,106427570280,True,700500000,3995590,704495590,False,3
8203,validator_11,296622965970,True,624400000,23746430,648146430,False,9
8204,validator_86,55993514190,True,584800000,1714170,586514170,False,1
8205,validator_28,125460381999,True,873900001,2108230,876008231,True,3
8206,validator_18,171492559640,True,454000000,21058050,475058050,False,5
8207,validator_61,56888507455,True,773059994,25420380,798480374,True,1
8208,validator_1,612567534074,True,577780007,20913400,598693407,True,19
8209,validator_37,95894215470,True,538400000,3776460,542176460,False,2
8210,validator_52,56848795621,True,621000006,3800500,624800506,True,1
8211,validator_7,332293572076,True,610400001,1430200,611830201,True,10
8212,validator_39,116492644190,True,384050000,9475080,393525080,False,3
8213,validator_0,509944024455,True,799860003,8865560,808725563,True,15
8214,validator_39,116966801090,True,465500000,8656900,474156900,False,3
8215,validator_18,172053210080,True,540600000,20050440,560650440,False,5
8216,validator_24,105755344669,True,829300004,1997170,831297174,True,3
8217,validator_36,107341431360,True,688900000,1578440,690478440,False,3
8218,validator_5,318238324252,True,463979997,19343830,483323827,True,9
8219,validator_23,164759170750,True,860000000,37726770,897726770,False,5
8220,validator_22,180274213790,True,548600000,8896900,557496900,False,5
8221,validator_13,181045889424,True,650400007,9986920,660386927,True,5
8222,validator_4,309998730375,True,733300002,62203720,795503722,True,9
8223,validator_42,114316043930,True,626500000,2317050,628817050,False,3
8224,validator_61,57612302555,True,694780000,29015100,723795100,True,1
8225,validator_11,297163701900,True,537700000,3035930,540735930,False,9
8226,validator_32,119696071328,True,862000001,25227900,887227901,True,3
8227,validator_61,58145853626,True,501800001,31751070,533551071,True,1
8228,validator_3,489028259910,True,685300000,1913210,687213210,False,15
8229,validator_8,293580504890,True,646200000,3847500,650047500,False,9
8230,validator_6,315279495666,True,518204005,55923900,574127905,True,9
8231,validator_7,333062018604,True,730139998,38306530,768446528,True,10
8232,validator_25,136818661012,True,465699998,11546200,477246198,True,4
8233,validator_30,116110197048,True,550163992,35995960,586159952,True,3
8234,validator_8,294242946880,True,643710000,18731990,662441990,False,9
8235,validator_32,120424776785,True,678739997,49965460,728705457,True,3
8236,validator_36,108146298260,True,797400000,7466900,804866900,False,3
8237,validator_36,108878938020,True,709400000,23239760,732639760,False,3
8238,validator_0,510401536076,True,425640001,31871620,457511621,True,15
8239,validator_14,197517340086,True,790700007,42115700,832815707,True,6
8240,validator_1,613173096177,True,535804003,69758100,605562103,True,19
8241,validator_13,181719582521,True,661139997,12553100,673693097,True,5
8242,validator_41,116601634280,True,708700000,1705900,710405900,False,3
8243,validator_17,185119245830,True,778439998,10445130,788885128,True,5
8244,validator_58,52083775317,True,477400003,20059540,497459543,True,1
8245,validator_30,116759451033,True,608039995,41213990,649253985,True,3
8246,validator_8,294828086740,True,583200000,1939860,585139860,False,9
8247,validator_94,53392758970,True,519300000,7203640,526503640,False,1
8248,validator_97,58598629280,True,666900000,5771520,672671520,False,1
8249,validator_18,172593878050,True,518900000,21767970,540667970,False,5
8250,validator_7,333829501015,True,763320001,4162410,767482411,True,10
8251,validator_5,318936627858,True,657180006,41123600,698303606,True,9
8252,validator_5,319645157860,True,707800002,730000,708530002,True,9
8253,validator_21,172157083580,True,595700000,4298870,599998870,False,5
8254,validator_3,489703821650,True,635200000,40361740,675561740,False,15
8255,validator_2,470340990380,True,710700000,21709900,732409900,False,14
8256,validator_49,60591758374,True,506339999,6344850,512684849,True,1
8257,validator_0,510913039716,True,497180000,14323640,511503640,True,15
8258,validator_26,107545841811,True,677359998,7731540,685091538,True,3
8259,validator_47,57323163285,True,558505998,22906240,581412238,True,1
8260,validator_5,320475469458,True,784499998,45811600,830311598,True,10
8261,validator_17,185790034590,True,668400000,2388760,670788760,True,5
8262,validator_79,53296402190,True,660800000,28031390,688831390,False,1
8263,validator_13,182795375551,True,1047640000,28153030,1075793030,True,5
8264,validator_76,54420478540,True,568500000,18767580,587267580,False,1
8265,validator_14,198333856747,True,778732011,37784650,816516661,True,6
8266,validator_1,613921882586,True,745619989,3166420,748786409,True,19
8267,validator_19,151804799280,True,525300000,1697900,526997900,False,4
8268,validator_62,61831288419,True,781460002,82049330,863509332,True,1
8269,validator_2,470949938020,True,598300000,10647640,608947640,False,14
8270,validator_35,107057432060,True,623000000,6861780,629861780,False,3
8271,validator_48,51339798036,True,724759999,36878900,761638899,True,1
8272,validator_21,172850128080,True,674300000,18744500,693044500,False,5
8273,validator_82,53737296690,True,577600000,1623980,579223980,False,1
8274,validator_3,490237932010,True,531100000,3010360,534110360,False,15
8275,validator_43,112041935690,True,697000000,2154560,699154560,False,3
8276,validator_25,137525462964,True,703920002,2881950,706801952,True,4
8277,validator_53,54371084520,True,616180001,27330670,643510671,True,1
8278,validator_35,107823910720,True,765800000,678660,766478660,False,3
8279,validator_95,49481528930,True,474900000,13782060,488682060,False,1
8280,validator_2,471617693760,True,665500000,2255740,667755740,False,14
8281,validator_12,180310005933,True,778100000,22081730,800181730,True,5
8282,validator_16,168810235253,True,660500009,5069280,665569289,True,5
8283,validator_48,52174736490,True,828000004,6938450,834938454,True,1
8284,validator_32,121099061192,True,638504007,35780400,674284407,True,3
8285,validator_25,138177716259,True,649499995,2753300,652253295,True,4
8286,validator_31,129286912926,True,735399995,5057700,740457695,True,4
8287,validator_27,115972679291,True,928167992,5683220,933851212,True,3
8288,validator_46,52923262405,True,505859993,26289130,532149123,True,1
8289,validator_7,334438627741,True,600099996,9026730,609126726,True,10
8290,validator_25,139062759857,True,850799998,34243600,885043598,True,4
8291,validator_76,55058575680,True,632000000,6097140,638097140,False,1
8292,validator_24,106670671467,True,903399998,11926800,915326798,True,3
8293,validator_43,112700501030,True,632300000,26265340,658565340,False,3
8294,validator_80,47120239220,True,612000000,19825930,631825930,False,1
8295,validator_9,320097530670,True,674800000,1219230,676019230,False,10
8296,validator_43,113518453250,True,814800000,3152220,817952220,False,3
8297,validator_22,180983051870,True,704300000,4538080,708838080,False,5
8298,validator_0,511387274489,True,461640003,12594770,474234773,True,15
8299,validator_64,60951281882,True,828499999,9624730,838124729,True,1
8300,validator_26,108090020499,True,531557998,12620690,544178688,True,3
8301,validator_15,192132404976,True,693686001,20406700,714092701,True,6
8302,validator_39,117658056390,True,688500000,2755300,691255300,False,3
8303,validator_39,118148907730,True,480200000,10651340,490851340,False,3
8304,validator_61,58995875753,True,844799997,5222130,850022127,True,1
8305,validator_11,297992305870,True,822400000,6203970,828603970,False,9
8306,validator_3,490805290510,True,558600000,8758500,567358500,False,15
8307,validator_33,127745036223,True,688039999,20161330,708201329,True,3
8308,validator_21,173459211380,True,605700000,3383300,609083300,False,5
8309,validator_8,295368540970,True,533500000,6954230,540454230,False,9
8310,validator_12,181148676506,True,822093993,16576580,838670573,True,5
8311,validator_8,296013484890,True,641510000,3433920,644943920,False,9
8312,validator_3,491429841680,True,622500000,2051170,624551170,False,15
8313,validator_22,181651396160,True,665100000,3244290,668344290,False,5
8314,validator_45,54900256077,True,515699995,7184740,522884735,True,1
8315,validator_22,182150296550,True,497300000,1600390,498900390,False,5
8316,validator_1,614736927994,True,801240008,13805400,815045408,True,19
8317,validator_3,492040262900,True,608300000,2121220,610421220,False,15
8318,validator_12,181857846884,True,628930008,80240370,709170378,True,5
8319,validator_1,615354009721,True,585939997,31141730,617081727,True,19
8320,validator_1,616122569559,True,767599998,959840,768559838,True,19
8321,validator_3,492567881840,True,520700000,6918940,527618940,False,15
8322,validator_22,182741882070,True,580000000,11585520,591585520,False,5
8323,validator_33,128396799165,True,645000002,6762940,651762942,True,4
8324,validator_0,512164142559,True,774300000,2568070,776868070,True,16
8325,validator_3,493235273870,True,658600000,8792030,667392030,False,15
8326,validator_36,109405487020,True,516400000,10149000,526549000,False,3
8327,validator_32,121880026215,True,759940003,21025020,780965023,True,3
8328,validator_29,127827064266,True,664919994,1869620,666789614,True,3
8329,validator_41,117381271590,True,776700000,2937310,779637310,False,3
8330,validator_38,110160418000,True,692100000,25786900,717886900,False,3
8331,validator_66,62544339161,True,659500001,488220,659988221,True,1
8332,validator_17,186432332472,True,616999992,25297890,642297882,True,5
8333,validator_90,54826573120,True,715100000,1420800,716520800,False,1
8334,validator_25,139758457199,True,681440002,14257340,695697342,True,4
8335,validator_6,315831628017,True,550499991,1632360,552132351,True,9
8336,validator_72,55288870060,True,500400000,10019100,510419100,False,1
8337,validator_79,54120092100,True,821800000,1889910,823689910,False,1
8338,validator_0,512809924180,True,634500001,11281620,645781621,True,16
8339,validator_0,513432518613,True,591520003,31074430,622594433,True,16
8340,validator_79,54983734550,True,862600000,1042450,863642450,False,1
8341,validator_5,321195856826,True,701254008,19133360,720387368,True,10
8342,validator_4,310731037403,True,716185998,16121030,732307028,True,9
8343,validator_8,296522286530,True,502600000,6201640,508801640,False,9
8344,validator_34,125746524710,True,554900000,8532920,563432920,False,3
8345,validator_11,298461528590,True,466900000,2322720,469222720,False,9
8346,validator_30,117343566065,True,572220002,11895030,584115032,True,3
8347,validator_95,50063652970,True,578900000,3224040,582124040,False,1
8348,validator_84,49308719610,True,527600000,772070,528372070,False,1
8349,validator_3,493795111150,True,558400000,1437280,559837280,False,15
8350,validator_3,494593862280,True,778100000,20651130,798751130,False,15
8351,validator_33,128973198268,True,551820003,24579100,576399103,True,4
8352,validator_3,495088629450,True,489400000,5367170,494767170,False,15
8353,validator_46,53789503649,True,835360004,30881240,866241244,True,1
8354,validator_11,299223625510,True,758600000,3496920,762096920,False,9
8355,validator_9,320657107060,True,534600000,24976390,559576390,False,10
8356,validator_1,616844829362,True,712460003,9799800,722259803,True,19
8357,validator_59,48837379165,True,471720006,26302960,498022966,True,1
8358,validator_15,192891934678,True,737920002,21609700,759529702,True,6
8359,validator_55,53401737913,True,793339997,9344420,802684417,True,1
8360,validator_35,108389280710,True,554900000,10469990,565369990,False,3
8361,validator_55,54160181121,True,738159998,20283210,758443208,True,1
8362,validator_1,617705759912,True,831860000,29070550,860930550,True,19
8363,validator_10,287272498260,True,597300000,2939300,600239300,False,8
8364,validator_0,514345164884,True,907700001,4946270,912646271,True,16
8365,validator_11,299819285630,True,591600000,4060120,595660120,False,9
8366,validator_76,55642326900,True,539500000,44251220,583751220,False,1
8367,validator_32,122605461523,True,705499998,19935310,725435308,True,3
8368,validator_0,515032813075,True,681739991,5908200,687648191,True,16
8369,validator_16,169397313035,True,582540002,4537780,587077782,True,5
8370,validator_23,165338523930,True,560900000,18453180,579353180,False,5
8371,validator_8,297195929830,True,672200000,1443300,673643300,False,9
8372,validator_21,174023394410,True,557000000,7183030,564183030,False,5
8373,validator_6,316512006516,True,652799999,27578500,680378499,True,9
8374,validator_0,515643942578,True,596460003,14669500,611129503,True,16
8375,validator_25,140487939329,True,682240000,47242130,729482130,True,4
8376,validator_27,117174169086,True,1195500005,5989790,1201489795,True,3
8377,validator_9,321238200460,True,578900000,2193400,581093400,False,10
8378,validator_49,61160473195,True,540820001,27894820,568714821,True,1
8379,validator_49,61918076490,True,729619995,27983300,757603295,True,1
8380,validator_2,472251908290,True,632200000,2014530,634214530,False,14
8381,validator_14,198924934865,True,588799998,2278120,591078118,True,6
8382,validator_1,618304639949,True,587319997,11560040,598880037,True,19
8383,validator_29,128483738390,True,655800004,874120,656674124,True,4
8384,validator_65,56016767489,True,616099998,14175000,630274998,True,1
8385,validator_16,170209084165,True,793200000,18571130,811771130,True,5
8386,validator_39,118633302450,True,454100000,30294720,484394720,False,3
8387,validator_2,472789917240,True,535500000,2508950,538008950,False,14
8388,validator_8,297925714470,True,721000000,8784640,729784640,False,9
8389,validator_95,50873119340,True,806800000,2666370,809466370,False,1
8390,validator_11,300314924220,True,476870000,18768590,495638590,False,9
8391,validator_30,118157353450,True,771599995,42187390,813787385,True,3
8392,validator_3,495692477780,True,596700000,7148330,603848330,False,15
8393,validator_16,170978070563,True,713139998,55846400,768986398,True,5
8394,validator_23,165855113040,True,509470000,7119110,516589110,False,5
8395,validator_4,311469493362,True,719039999,19415960,738455959,True,9
8396,validator_9,321870187510,True,631000000,987050,631987050,False,10
8397,validator_4,312226163018,True,753739996,2929660,756669656,True,9
8398,validator_14,199534684770,True,592019995,17729910,609749905,True,6
8399,validator_2,473372757540,True,579270000,3570300,582840300,False,14
8400,validator_34,126366217250,True,616470000,3222540,619692540,False,3
8401,validator_7,335302277577,True,804240006,59409830,863649836,True,10
8402,validator_7,336191633827,True,869520000,19836250,889356250,True,10
8403,validator_71,61676831215,True,481880001,33739700,515619701,True,1
8404,validator_1,618952671948,True,599371999,48660000,648031999,True,19
8405,validator_82,54303998950,True,565800000,902260,566702260,False,1
8406,validator_8,298536594970,True,601700000,9180500,610880500,False,9
8407,validator_0,516324875932,True,660599994,20333360,680933354,True,16
8408,validator_2,474047478640,True,619000000,55721100,674721100,False,14
8409,validator_6,317055845816,True,524900000,18939300,543839300,True,9
8410,validator_7,336722531428,True,483808001,47089600,530897601,True,10
8411,validator_85,47250849880,True,633000000,8966470,641966470,False,1
8412,validator_4,312696810065,True,452440007,18207040,470647047,True,9
8413,validator_33,129677477594,True,679479996,24799330,704279326,True,4
8414,validator_25,141134490889,True,640400000,6151560,646551560,True,4
8415,validator_36,110125988910,True,701800000,18701890,720501890,False,3
8416,validator_8,299248614660,True,705600000,6419690,712019690,False,9
8417,validator_0,516817257730,True,470080008,22301790,492381798,True,16
8418,validator_36,110676576160,True,524800000,25787250,550587250,False,3
8419,validator_1,619578250126,True,584559998,41018180,625578178,True,19
8420,validator_23,166433809650,True,562900000,15796610,578696610,False,5
8421,validator_21,174713202310,True,679800000,10007900,689807900,False,5
8422,validator_36,111234889860,True,556900000,1413700,558313700,False,3
8423,validator_31,129860417179,True,566600003,6904250,573504253,True,4
8424,validator_13,183499296127,True,695119996,8800580,703920576,True,5
8425,validator_43,114188914850,True,669400000,1061600,670461600,False,3
8426,validator_5,321790822003,True,574299997,20665180,594965177,True,10
8427,validator_0,517503201866,True,626111996,59832140,685944136,True,16
8428,validator_26,108576159176,True,470799997,15338680,486138677,True,3
8429,validator_10,287740967980,True,457300000,11169720,468469720,False,8
8430,validator_65,56395878792,True,360000003,19111300,379111303,True,1
8431,validator_34,126902421010,True,523600000,12603760,536203760,False,3
8432,validator_43,114767062700,True,564500000,13647850,578147850,False,3
8433,validator_3,496431335160,True,727100000,11757380,738857380,False,15
8434,validator_36,111935268900,True,681880000,18499040,700379040,False,3
8435,validator_16,171334763199,True,336263996,20428640,356692636,True,5
8436,validator_97,59140512080,True,540600000,1282800,541882800,False,1
8437,validator_10,288433273400,True,661000000,31305420,692305420,False,9
8438,validator_1,620300935185,True,706059999,16625060,722685059,True,19
8439,validator_49,62805584030,True,881264000,6243540,887507540,True,1
8440,validator_36,112672681320,True,733700000,3712420,737412420,False,3
8441,validator_4,313417711607,True,692720002,28181540,720901542,True,9
8442,validator_1,620976507988,True,625620003,49952800,675572803,True,19
8443,validator_63,55866800686,True,635826001,34677100,670503101,True,1
8444,validator_1,621866645428,True,845480000,44657440,890137440,True,19
8445,validator_6,317567038312,True,492440006,18752490,511192496,True,9
8446,validator_43,115405838790,True,632900000,5876090,638776090,False,3
8447,validator_52,57458777045,True,557180004,52801420,609981424,True,1
8448,validator_8,299885669800,True,636100000,955140,637055140,False,9
8449,validator_11,300954257920,True,636800000,2533700,639333700,False,9
8450,validator_26,109247297604,True,655639998,15498430,671138428,True,3
8451,validator_69,51896773157,True,487720003,17121790,504841793,True,1
8452,validator_2,474485765940,True,429000000,9287300,438287300,False,14
8453,validator_18,173386965890,True,785100000,7987840,793087840,False,5
8454,validator_88,51777112250,True,742500000,19602420,762102420,False,1
8455,validator_1,622523535625,True,636163997,20726200,656890197,True,19
8456,validator_30,118948709542,True,787300002,4056090,791356092,True,3
8457,validator_6,318269781518,True,696600006,6143200,702743206,True,9
8458,validator_8,300525732710,True,635500000,4562910,640062910,False,9
8459,validator_71,62218093110,True,538899995,2361900,541261895,True,1
8460,validator_32,123398690554,True,754100001,39129030,793229031,True,3
8461,validator_5,322592892057,True,800299994,1770060,802070054,True,10
8462,validator_64,61636544075,True,683799993,1462200,685262193,True,1
8463,validator_42,114903462520,True,580700000,6718590,587418590,False,3
8464,validator_41,118174672980,True,792400000,1001390,793401390,False,3
8465,validator_25,141719211505,True,583600006,1120610,584720616,True,4
8466,validator_4,314244001104,True,811499997,14789500,826289497,True,9
8467,validator_65,57094000070,True,689099998,9021280,698121278,True,1
8468,validator_51,54118559383,True,785000002,13348600,798348602,True,1
8469,validator_89,54616035950,True,827000000,10101000,837101000,False,1
8470,validator_94,54052277070,True,655800000,3718100,659518100,False,1
8471,validator_11,301500195160,True,543100000,2837240,545937240,False,9
8472,validator_1,623201504887,True,662699992,15269270,677969262,True,19
8473,validator_41,118855609110,True,658300000,22636130,680936130,False,3
8474,validator_11,302031729990,True,530100000,1434830,531534830,False,9
8475,validator_13,184127360861,True,598600004,29464730,628064734,True,5
8476,validator_0,518041048070,True,534600004,3246200,537846204,True,16
8477,validator_5,323139016448,True,521960001,24164390,546124391,True,10
8478,validator_73,55793558740,True,694500000,2221480,696721480,False,1
8479,validator_26,109985924007,True,730300003,8326400,738626403,True,3
8480,validator_3,497257963160,True,815700000,10928000,826628000,False,15
8481,validator_81,52238765990,True,744800000,6095900,750895900,False,1
8482,validator_16,171993922000,True,643100001,16058800,659158801,True,5
8483,validator_7,337725444825,True,988739997,14173400,1002913397,True,10
8484,validator_9,322484420110,True,613200000,1032600,614232600,False,10
8485,validator_9,323000593240,True,494200000,21973130,516173130,False,10
8486,validator_3,497852877820,True,593900000,1014660,594914660,False,15
8487,validator_7,338302863899,True,533780004,43639070,577419074,True,10
8488,validator_38,110754878400,True,590300000,4160400,594460400,False,3
8489,validator_23,167120107440,True,663200000,23097790,686297790,False,5
8490,validator_38,111702072230,True,945400000,1793830,947193830,False,3
8491,validator_13,184683612705,True,550140004,6111840,556251844,True,5
8492,validator_38,112343146720,True,637600000,3474490,641074490,False,3
8493,validator_65,57705837405,True,597200005,14637330,611837335,True,1
8494,validator_0,518718435974,True,664580004,12807900,677387904,True,16
8495,validator_20,169310860760,True,666500000,39652310,706152310,False,5
8496,validator_4,314829924232,True,576199998,9723130,585923128,True,9
8497,validator_1,624023528582,True,783499995,38523700,822023695,True,19
8498,validator_17,187207175971,True,746419999,28423500,774843499,True,5
8499,validator_1,624685363481,True,642740009,19094890,661834899,True,19
8500,validator_17,187713607671,True,503200000,3231700,506431700,True,5
8501,validator_55,54969752623,True,800280002,9291500,809571502,True,1
8502,validator_19,152437856670,True,622700000,10357390,633057390,False,4
8503,validator_89,55278847850,True,660800000,2011900,662811900,False,1
8504,validator_31,130507468679,True,644400000,2651500,647051500,True,4
8505,validator_10,288956604600,True,519400000,3931200,523331200,False,9
8506,validator_0,519291543019,True,553140005,19967040,573107045,True,16
8507,validator_22,183447349170,True,684300000,21167100,705467100,False,5
8508,validator_89,55882721130,True,601300000,2573280,603873280,False,1
8509,validator_1,625271389365,True,563759994,22265890,586025884,True,19
8510,validator_9,323659834040,True,632000000,27240800,659240800,False,10
8511,validator_20,170228439060,True,896900000,20678300,917578300,False,5
8512,validator_45,55421616522,True,493767995,27592450,521360445,True,1
8513,validator_10,289708148680,True,742500000,9044080,751544080,False,9
8514,validator_93,49680938280,True,391100000,1825030,392925030,False,1
8515,validator_1,625815651857,True,530499992,13762500,544262492,True,19
8516,validator_42,115410330680,True,478700000,28168160,506868160,False,3
8517,validator_3,498360977770,True,506800000,1299950,508099950,False,15
8518,validator_0,520032104327,True,728639998,11921310,740561308,True,16
8519,validator_6,318844692419,True,572500001,2410900,574910901,True,9
8520,validator_25,142293966616,True,568740001,6015110,574755111,True,4
8521,validator_7,338972109410,True,643540001,25705510,669245511,True,10
8522,validator_41,119338767860,True,480200000,2958750,483158750,False,3
8523,validator_61,59937559837,True,888120004,53564080,941684084,True,1
8524,validator_19,153060720090,True,620510000,2353420,622863420,False,4
8525,validator_37,96757893570,True,853800000,9878100,863678100,False,3
8526,validator_58,52864296125,True,776800008,3720800,780520808,True,1
8527,validator_5,323696733677,True,548757999,8959230,557717229,True,10
8528,validator_0,520715162860,True,680199993,2858540,683058533,True,16
8529,validator_1,626616947055,True,774335998,26959200,801295198,True,19
8530,validator_1,627364907015,True,727100000,20859960,747959960,True,19
8531,validator_41,119936617400,True,595200000,2649540,597849540,False,3
8532,validator_73,56506456940,True,709100000,3798200,712898200,False,1
8533,validator_1,628254851073,True,866303998,23640060,889944058,True,19
8534,validator_0,521335804655,True,561255995,59385800,620641795,True,16
8535,validator_23,167716631340,True,593700000,2823900,596523900,False,5
8536,validator_6,319463212821,True,590240002,28280400,618520402,True,9
8537,validator_11,302603754670,True,562900000,9124680,572024680,False,9
8538,validator_16,172653762404,True,645120004,14720400,659840404,True,5
8539,validator_3,498965568370,True,602540000,2050600,604590600,False,15
8540,validator_5,324461865809,True,751664002,13468130,765132132,True,10
8541,validator_16,173333648385,True,621920001,57965980,679885981,True,5
8542,validator_36,113318035320,True,639400000,5954000,645354000,False,3
8543,validator_1,629085427376,True,812816003,17760300,830576303,True,19
8544,validator_4,315408216700,True,575539998,2752470,578292468,True,9
8545,validator_87,56150957730,True,676200000,13709900,689909900,False,1
8546,validator_14,200110433773,True,547039993,28709010,575749003,True,6
8547,validator_81,52874369660,True,629500000,6103670,635603670,False,1
8548,validator_33,130601005239,True,877694005,45833640,923527645,True,4
8549,validator_9,324219610210,True,557200000,2576170,559776170,False,10
8550,validator_8,301137485620,True,602600000,9152910,611752910,False,9
8551,validator_16,174047928210,True,711800005,2479820,714279825,True,5
8552,validator_13,185384908509,True,673220004,28075800,701295804,True,5
8553,validator_26,110725414346,True,712199999,27290340,739490339,True,3
8554,validator_36,113840879530,True,520600000,2244210,522844210,False,3
8555,validator_36,114421991810,True,574800000,6312280,581112280,False,3
8556,validator_39,119289298880,True,650200000,5796430,655996430,False,3
8557,validator_2,474934503290,True,426500000,22237350,448737350,False,14
8558,validator_22,184149011430,True,698200000,3462260,701662260,False,5
8559,validator_19,153554465430,True,492870000,875340,493745340,False,4
8560,validator_9,324800729090,True,573500000,7618880,581118880,False,10
8561,validator_1,630001558073,True,897453997,18676700,916130697,True,19
8562,validator_17,188639230968,True,899539997,26083300,925623297,True,5
8563,validator_1,630726421794,True,714368001,10495720,724863721,True,19
8564,validator_2,475546245260,True,592200000,19541970,611741970,False,14
8565,validator_9,325403776020,True,601400000,1646930,603046930,False,10
8566,validator_26,111484174637,True,738540001,20220290,758760291,True,3
8567,validator_11,303319801770,True,714200000,1847100,716047100,False,9
8568,validator_13,186152437013,True,743479994,24048510,767528504,True,5
8569,validator_42,116122243380,True,672800000,39112700,711912700,False,3
8570,validator_84,49997667210,True,676900000,12047600,688947600,False,1
8571,validator_67,54185529200,True,849799998,27492990,877292988,True,1
8572,validator_6,320114630005,True,627680004,23737180,651417184,True,10
8573,validator_4,316072387412,True,652680002,11490710,664170712,True,9
8574,validator_18,174175190230,True,785500000,2724340,788224340,False,5
8575,validator_17,189305781286,True,657199998,9350320,666550318,True,5
8576,validator_56,62276282385,True,710840000,22211800,733051800,True,1
8577,validator_76,56489563980,True,826900000,20337080,847237080,False,1
8578,validator_7,339875069511,True,875920001,27040100,902960101,True,10
8579,validator_1,631325648472,True,559663998,39562680,599226678,True,19
8580,validator_17,190073993067,True,758320001,9891780,768211781,True,5
8581,validator_33,131389870636,True,778999997,9865400,788865397,True,4
8582,validator_5,324922281600,True,436140011,24275780,460415791,True,10
8583,validator_70,54281769997,True,779000004,50575050,829575054,True,1
8584,validator_2,476238261760,True,689700000,2316500,692016500,False,14
8585,validator_36,115009495080,True,582900000,4603270,587503270,False,3
8586,validator_27,117730203058,True,509319992,46713980,556033972,True,3
8587,validator_15,193609243721,True,709780003,7529040,717309043,True,6
8588,validator_22,184848264250,True,673200000,26052820,699252820,False,5
8589,validator_0,522061210002,True,716100007,9305340,725405347,True,16
8590,validator_23,168430879300,True,711500000,2747960,714247960,False,5
8591,validator_19,154294218070,True,738400000,1352640,739752640,False,4
8592,validator_40,103708080830,True,517300000,2984890,520284890,False,3
8593,validator_36,115612219560,True,574800000,27924480,602724480,False,3
8594,validator_0,522612337905,True,518920003,32207900,551127903,True,16
8595,validator_12,182637742785,True,772874001,7021900,779895901,True,5
8596,validator_8,301766595240,True,627700000,1409620,629109620,False,9
8597,validator_5,325758758325,True,808739985,27736740,836476725,True,10
8598,validator_61,60670736029,True,722379992,10796200,733176192,True,1
8599,validator_18,174695088170,True,500700000,19197940,519897940,False,5
8600,validator_5,326478377629,True,692626004,26993300,719619304,True,10
8601,validator_1,631999926477,True,658679995,15598010,674278005,True,19
8602,validator_22,185484649960,True,612000000,24385710,636385710,False,5
8603,validator_17,190639990087,True,534044000,31953020,565997020,True,5
8604,validator_21,175246175950,True,530800000,2173640,532973640,False,5
8605,validator_0,523288001071,True,647599996,28063170,675663166,True,16
8606,validator_5,327176315461,True,679340002,18597830,697937832,True,10
8607,validator_11,304001512670,True,679600000,2110900,681710900,False,9
8608,validator_0,523944507786,True,596319995,60186720,656506715,True,16
8609,validator_20,170770223780,True,536140000,5644720,541784720,False,5
8610,validator_20,171234601020,True,459100000,5277240,464377240,False,5
8611,validator_46,54579661599,True,782970000,7187950,790157950,True,1
8612,validator_21,175764847960,True,515800000,2872010,518672010,False,5
8613,validator_56,62956011983,True,678299998,1429600,679729598,True,1
8614,validator_6,320759469333,True,644299998,539330,644839328,True,10
8615,validator_3,499688704670,True,703600000,19536300,723136300,False,15
8616,validator_37,97484713510,True,699200000,27619940,726819940,False,3
8617,validator_2,476888389650,True,644000000,6127890,650127890,False,14
8618,validator_94,54620441610,True,566100000,2064540,568164540,False,1
8619,validator_3,500454474270,True,757200000,8569600,765769600,False,15
8620,validator_28,126203336814,True,712899995,30054820,742954815,True,3
8621,validator_3,500880998050,True,425200000,1323780,426523780,False,15
8622,validator_43,116053763390,True,647600000,324600,647924600,False,3
8623,validator_19,154791960370,True,494700000,3042300,497742300,False,4
8624,validator_87,56740577030,True,588000000,1619300,589619300,False,1
8625,validator_87,57385336160,True,643200000,1559130,644759130,False,1
8626,validator_2,477685043770,True,793600000,3054120,796654120,False,14
8627,validator_10,290253081450,True,543900000,1032770,544932770,False,9
8628,validator_18,175252912810,True,555700000,2124640,557824640,False,5
8629,validator_17,191579078023,True,909979996,29107940,939087936,True,5
8630,validator_80,47843484420,True,710900000,12345200,723245200,False,1
8631,validator_1,632506583520,True,493500003,13157040,506657043,True,19
8632,validator_9,325927483240,True,521400000,2307220,523707220,False,10
8633,validator_28,127006313857,True,784760003,18217040,802977043,True,3
8634,validator_38,113049974320,True,698000000,8827600,706827600,False,3
8635,validator_73,57123626370,True,596600000,20569430,617169430,False,1
8636,validator_1,633363190414,True,848139994,8466900,856606894,True,19
8637,validator_33,132305391085,True,879199999,36320450,915520449,True,4
8638,validator_28,127956432717,True,929840000,20278860,950118860,True,3
8639,validator_35,109188407300,True,795200000,3926590,799126590,False,3
8640,validator_15,194235272646,True,622500005,3528920,626028925,True,6
8641,validator_1,634010078446,True,637800002,9088030,646888032,True,19
8642,validator_3,501462245640,True,577300000,3947590,581247590,False,15
8643,validator_21,176286080590,True,504400000,16832630,521232630,False,5
8644,validator_20,171747330250,True,507600000,5129230,512729230,False,5
8645,validator_41,120620872400,True,682600000,1655000,684255000,False,3
8646,validator_14,200760617593,True,640400000,9783820,650183820,True,6
8647,validator_29,129407757591,True,896800001,27219200,924019201,True,4
8648,validator_7,340762226003,True,864359992,22796500,887156492,True,10
8649,validator_10,290757698990,True,501700000,2917540,504617540,False,9
8650,validator_8,302347570740,True,559900000,21075500,580975500,False,9
8651,validator_90,55373767210,True,544800000,2394090,547194090,False,1
8652,validator_19,155364510790,True,570200000,2350420,572550420,False,4
8653,validator_1,634642304029,True,611720003,20505580,632225583,True,19
8654,validator_11,304555704960,True,543100000,11092290,554192290,False,9
8655,validator_15,194875424346,True,632720000,7431700,640151700,True,6
8656,validator_22,186024874690,True,538500000,1724730,540224730,False,5
8657,validator_3,502234942080,True,769800000,2896440,772696440,False,15
8658,validator_2,478124272500,True,432600000,6628730,439228730,False,14
8659,validator_40,104126430080,True,409000000,9349250,418349250,False,3
8660,validator_21,176782803550,True,475800000,20922960,496722960,False,5
8661,validator_41,121232270440,True,603900000,7498040,611398040,False,3
8662,validator_21,177330366450,True,541200000,6362900,547562900,False,5
8663,validator_9,326571726640,True,635200000,9043400,644243400,False,10
8664,validator_20,172316222280,True,541900000,26992030,568892030,False,5
8665,validator_33,133172678125,True,846000000,21287040,867287040,True,4
8666,validator_42,116742422660,True,619200000,979280,620179280,False,3
8667,validator_0,524586092580,True,600099994,41484800,641584794,True,16
8668,validator_10,291322099030,True,520800000,43600040,564400040,False,9
8669,validator_9,327167165380,True,594100000,1338740,595438740,False,10
8670,validator_63,56622883003,True,733699997,22382320,756082317,True,1
8671,validator_6,321354803473,True,577600000,17734140,595334140,True,10
8672,validator_3,502877593010,True,633200000,9450930,642650930,False,15
8673,validator_11,305040274090,True,477600000,6969130,484569130,False,9
8674,validator_4,316747218569,True,672899997,1931160,674831157,True,9
8675,validator_3,503467968740,True,571700000,18675730,590375730,False,15
8676,validator_5,328047379421,True,851940000,19123960,871063960,True,10
8677,validator_91,46611814230,True,720570000,2460340,723030340,False,1
8678,validator_26,112053899901,True,567900004,1825260,569725264,True,3
8679,validator_1,635510375129,True,846600000,21471100,868071100,True,19
8680,validator_1,636268772926,True,729019997,29377800,758397797,True,19
8681,validator_8,303039991950,True,687900000,4521210,692421210,False,9
8682,validator_24,107416447675,True,740300008,5476200,745776208,True,3
8683,validator_5,328676004526,True,587164005,41461100,628625105,True,10
8684,validator_81,53448602360,True,572400000,1832700,574232700,False,1
8685,validator_0,525221027742,True,594558002,40377160,634935162,True,16
8686,validator_7,341500848393,True,715640000,22982390,738622390,True,10
8687,validator_4,317374871754,True,589860005,37793180,627653185,True,9
8688,validator_49,63400331970,True,574100000,20647940,594747940,True,1
8689,validator_3,504294058500,True,806500000,19589760,826089760,False,15
8690,validator_19,156072657320,True,696200000,11946530,708146530,False,4
8691,validator_5,329255772324,True,571199998,8567800,579767798,True,10
8692,validator_1,636996279625,True,687479999,40026700,727506699,True,19
8693,validator_3,504841531580,True,545800000,1673080,547473080,False,15
8694,validator_6,321957830098,True,565899995,37126630,603026625,True,10
8695,validator_42,117191343830,True,437800000,11121170,448921170,False,3
8696,validator_2,478687577660,True,556870000,6435160,563305160,False,14
8697,validator_33,133905784960,True,687094005,46012830,733106835,True,4
8698,validator_1,637782722823,True,781799998,4643200,786443198,True,19
8699,validator_28,128791728215,True,823439998,11855500,835295498,True,4
8700,validator_72,56035272980,True,739400000,7002920,746402920,False,1
8701,validator_17,192186677995,True,601700002,5899970,607599972,True,6
8702,validator_58,53594389302,True,724219997,5873180,730093177,True,1
8703,validator_2,479549208600,True,859100000,2530940,861630940,False,14
8704,validator_2,480082382520,True,531200000,1973920,533173920,False,15
8705,validator_24,108271452595,True,836340000,18664920,855004920,True,3
8706,validator_9,327786981590,True,616200000,3616210,619816210,False,10
8707,validator_23,169090487600,True,650500000,9108300,659608300,False,5
8708,validator_23,169590368580,True,495900000,3980980,499880980,False,5
8709,validator_2,480770006960,True,685700000,1924440,687624440,False,15
8710,validator_26,112878550505,True,820100004,4550600,824650604,True,3
8711,validator_86,56634505870,True,634800000,6191680,640991680,False,1
8712,validator_66,63329799338,True,776939997,8520180,785460177,True,1
8713,validator_34,127718213310,True,807300000,8492300,815792300,False,3
8714,validator_0,525797627182,True,573700000,2899440,576599440,True,16
8715,validator_20,172971076230,True,599300000,55553950,654853950,False,5
8716,validator_11,305836875550,True,794100000,2501460,796601460,False,9
8717,validator_10,292027554830,True,701000000,4455800,705455800,False,9
8718,validator_89,56476976320,True,571100000,23155190,594255190,False,1
8719,validator_1,638591089820,True,807199997,1167000,808366997,True,19
8720,validator_5,329805131420,True,501279996,48079100,549359096,True,10
8721,validator_23,170284561880,True,691900000,2293300,694193300,False,5
8722,validator_47,58051340490,True,717100005,11077200,728177205,True,1
8723,validator_31,131107653784,True,598200005,1985100,600185105,True,4
8724,validator_34,128332680270,True,598900000,15566960,614466960,False,4
8725,validator_7,342039639871,True,531859998,6931480,538791478,True,10
8726,validator_3,505670899500,True,809700000,19667920,829367920,False,15
8727,validator_1,639031105914,True,423959994,16056100,440016094,True,19
8728,validator_21,177906045540,True,548000000,27679090,575679090,False,5
8729,validator_11,306527510810,True,688800000,1835260,690635260,False,9
8730,validator_3,506295891440,True,618800000,6191940,624991940,False,15
8731,validator_26,113392363081,True,476459996,37352580,513812576,True,3
8732,validator_6,322771170236,True,802799998,10540140,813340138,True,10
8733,validator_13,186692480745,True,537500002,2543730,540043732,True,5
8734,validator_14,201547400391,True,773239998,13542800,786782798,True,6
8735,validator_71,63078107249,True,832933999,27080140,860014139,True,1
8736,validator_7,342830966076,True,789200005,2126200,791326205,True,10
8737,validator_3,507301664240,True,997500000,8272800,1005772800,False,15
8738,validator_0,526519970519,True,716399997,5943340,722343337,True,16
8739,validator_29,130146367147,True,698700006,39909550,738609556,True,4
8740,validator_13,187354501168,True,630140003,31880420,662020423,True,5
8741,validator_4,317889160697,True,509570003,4718940,514288943,True,9
8742,validator_3,507739625430,True,430400000,7561190,437961190,False,15
8743,validator_82,55011395580,True,705000000,2396630,707396630,False,1
8744,validator_7,343428066137,True,570020001,27080060,597100061,True,10
8745,validator_7,344245171011,True,790669994,26434880,817104874,True,10
8746,validator_36,116124828650,True,508200000,4409090,512609090,False,3
8747,validator_40,104758711680,True,630700000,1581600,632281600,False,3
8748,validator_6,323530318640,True,748854004,10294400,759148404,True,10
8749,validator_4,318610725634,True,710779997,10784940,721564937,True,9
8750,validator_39,119900130160,True,609370000,1461280,610831280,False,3
8751,validator_19,156672024590,True,586200000,13167270,599367270,False,4
8752,validator_7,344967797092,True,689160001,33466080,722626081,True,10
8753,validator_16,174750062712,True,692100002,10034500,702134502,True,5
8754,validator_8,303564474780,True,518380000,6102830,524482830,False,9
8755,validator_37,97866915490,True,374300000,7901980,382201980,False,3
8756,validator_4,319260255656,True,633299992,16230030,649530022,True,9
8757,validator_21,178474803590,True,565700000,3058050,568758050,False,5
8758,validator_4,319906197457,True,602040001,43901800,645941801,True,9
8759,validator_21,179030853440,True,553300000,2749850,556049850,False,5
8760,validator_21,179535299840,True,502140000,2306400,504446400,False,5
8761,validator_0,527387572549,True,824640000,42962030,867602030,True,16
8762,validator_9,328401504720,True,608600000,5923130,614523130,False,10
8763,validator_21,180065389070,True,528900000,1189230,530089230,False,5
8764,validator_10,292734589650,True,704700000,2334820,707034820,False,9
8765,validator_1,639704270870,True,631119996,42044960,673164956,True,19
8766,validator_3,508387595300,True,616300000,31669870,647969870,False,15
8767,validator_1,640450485595,True,720500005,25714720,746214725,True,20
8768,validator_15,195597281877,True,710358011,11499520,721857531,True,6
8769,validator_30,119836172177,True,884799995,2662640,887462635,True,3
8770,validator_4,320781122292,True,861139995,13784840,874924835,True,10
8771,validator_37,98470459790,True,602000000,1544300,603544300,False,3
8772,validator_21,180658726280,True,573500000,19837210,593337210,False,5
8773,validator_18,175935308820,True,663200000,19196010,682396010,False,5
8774,validator_65,58228071906,True,503000001,19234500,522234501,True,1
8775,validator_8,304241972010,True,674000000,3497230,677497230,False,9
8776,validator_10,293286352680,True,522900000,28863030,551763030,False,9
8777,validator_6,324306068237,True,758239997,17509600,775749597,True,10
8778,validator_29,130971426766,True,793865999,31193620,825059619,True,4
8779,validator_17,193003252694,True,791659999,24914700,816574699,True,6
8780,validator_6,325063749065,True,749099998,8580830,757680828,True,10
8781,validator_5,330426016236,True,599799996,21084820,620884816,True,10
8782,validator_21,181475941640,True,808100000,9115360,817215360,False,5
8783,validator_17,193685120529,True,656480005,25387830,681867835,True,6
8784,validator_20,173592437030,True,616900000,4460800,621360800,False,5
8785,validator_43,116440273660,True,381800000,4710270,386510270,False,3
8786,validator_33,134505715692,True,597900002,2030730,599930732,True,4
8787,validator_1,641116279560,True,655299995,10493970,665793965,True,20
8788,validator_32,124006412842,True,599399998,8322290,607722288,True,3
8789,validator_7,345773796887,True,787639995,18359800,805999795,True,10
8790,validator_8,304718852570,True,474600000,2280560,476880560,False,9
8791,validator_1,641922431232,True,799120012,7031660,806151672,True,20
8792,validator_14,202341297389,True,785359998,8537000,793896998,True,6
8793,validator_17,194318095965,True,605505996,27469440,632975436,True,6
8794,validator_23,170909058720,True,611400000,13096840,624496840,False,5
8795,validator_37,99288722250,True,799300000,18962460,818262460,False,3
8796,validator_5,331326798154,True,853459998,47321920,900781918,True,10
8797,validator_0,528247258912,True,852119993,7566370,859686363,True,16
8798,validator_0,529338722439,True,1074173997,17289530,1091463527,True,16
8799,validator_31,131814894762,True,696699998,10540980,707240978,True,4
8800,validator_1,642560702232,True,613566000,24705000,638271000,True,20
8801,validator_0,529960188840,True,602540001,18926400,621466401,True,16
8802,validator_4,321468361212,True,649100000,38138920,687238920,True,10
8803,validator_70,54905862421,True,604339994,19752430,624092424,True,1
8804,validator_7,346399102896,True,588179999,37126010,625306009,True,10
8805,validator_7,347174180136,True,750960000,24117240,775077240,True,10
8806,validator_32,124666006331,True,639299989,20293500,659593489,True,3
8807,validator_6,325675761534,True,592999999,19012470,612012469,True,10
8808,validator_39,120414916800,True,507800000,6986640,514786640,False,3
8809,validator_70,55714733405,True,799099994,9770990,808870984,True,1
8810,validator_1,643346283564,True,783600002,1981330,785581332,True,20
8811,validator_3,508996270290,True,584600000,24074990,608674990,False,15
8812,validator_13,187856842691,True,495599993,6741530,502341523,True,5
8813,validator_3,509440856490,True,443100000,1486200,444586200,False,15
8814,validator_5,331911313650,True,577099996,7415500,584515496,True,10
8815,validator_2,481259212390,True,479900000,9305430,489205430,False,15
8816,validator_11,307194654640,True,664600000,2543830,667143830,False,9
8817,validator_16,175391172389,True,590219997,50889680,641109677,True,5
8818,validator_6,326197586422,True,508857998,12966890,521824888,True,10
8819,validator_80,48513015630,True,667200000,2331210,669531210,False,1
8820,validator_28,129449923721,True,623599996,34595510,658195506,True,4
8821,validator_96,53275424190,True,442600000,1521920,444121920,False,1
8822,validator_0,530574685385,True,595119995,19376550,614496545,True,16
8823,validator_7,347651766141,True,472330005,5256000,477586005,True,10
8824,validator_48,52838031411,True,653800001,9494920,663294921,True,1
8825,validator_43,116975516850,True,532190000,3053190,535243190,False,3
8826,validator_36,116904585060,True,773000000,6756410,779756410,False,3
8827,validator_5,332605326581,True,674240001,19772930,694012931,True,10
8828,validator_64,62270338776,True,576826001,56968700,633794701,True,1
8829,validator_32,125203133386,True,523359995,13767060,537127055,True,3
8830,validator_25,142953107711,True,658400005,741090,659141095,True,4
8831,validator_0,531270092268,True,688100003,7306880,695406883,True,16
8832,validator_81,54009845240,True,559200000,2042880,561242880,False,1
8833,validator_3,509970562620,True,525900000,3806130,529706130,False,15
8834,validator_19,157327701740,True,651100000,4577150,655677150,False,4
8835,validator_71,63715739493,True,636300004,1332240,637632244,True,1
8836,validator_14,203083015948,True,698858009,42860550,741718559,True,6
8837,validator_3,510536078850,True,561300000,4216230,565516230,False,15
8838,validator_76,56811744700,True,320440000,1740720,322180720,False,1
8839,validator_64,62875737094,True,563247998,42150320,605398318,True,1
8840,validator_1,643901834066,True,523760002,31790500,555550502,True,20
8841,validator_96,53958332980,True,680000000,2908790,682908790,False,1
8842,validator_84,50696874830,True,696600000,2607620,699207620,False,1
8843,validator_10,294003509590,True,697200000,19956910,717156910,False,9
8844,validator_1,644755091497,True,844363991,8893440,853257431,True,20
8845,validator_2,481964080520,True,701900000,2968130,704868130,False,15
8846,validator_41,121982857170,True,735400000,15186730,750586730,False,3
8847,validator_1,645197951197,True,438200000,4659700,442859700,True,20
8848,validator_67,54891829211,True,696599991,9700020,706300011,True,1
8849,validator_41,122519941570,True,534100000,2984400,537084400,False,3
8850,validator_2,482751056280,True,766600000,20375760,786975760,False,15
8851,validator_10,294603322090,True,597500000,2312500,599812500,False,9
8852,validator_2,483383054160,True,629800000,2197880,631997880,False,15
8853,validator_0,532078319863,True,776615995,31611600,808227595,True,16
8854,validator_15,196420696394,True,808899997,14514520,823414517,True,6
8855,validator_57,57732754932,True,810254003,43020600,853274603,True,1
8856,validator_65,58970397551,True,726940005,15385640,742325645,True,1
8857,validator_23,171306397720,True,394500000,2839000,397339000,False,5
8858,validator_36,117332413150,True,423300000,4528090,427828090,False,3
8859,validator_17,194782912140,True,455039995,9776180,464816175,True,6
8860,validator_3,511219311070,True,679400000,3832220,683232220,False,15
8861,validator_2,484159987540,True,775700000,1233380,776933380,False,15
8862,validator_5,333147951407,True,536900006,5724820,542624826,True,10
8863,validator_6,326941358753,True,742700001,1072330,743772331,True,10
8864,validator_2,484639300460,True,477000000,2312920,479312920,False,15
8865,validator_13,188496117533,True,626300002,12974840,639274842,True,5
8866,validator_97,59651219110,True,500100000,10607030,510707030,False,1
8867,validator_18,176573488490,True,636700000,1479670,638179670,False,5
8868,validator_42,117790651030,True,576500000,22807200,599307200,False,3
8869,validator_1,646086622684,True,869665997,19005490,888671487,True,20
8870,validator_29,131562303304,True,564439998,26436540,590876538,True,4
8871,validator_25,143735509432,True,758296001,24105720,782401721,True,4
8872,validator_31,132524163849,True,680826007,28443080,709269087,True,4
8873,validator_29,132453938962,True,889299998,2335660,891635658,True,4
8874,validator_26,114114550679,True,716499998,5687600,722187598,True,3
8875,validator_95,51464479090,True,588100000,3259750,591359750,False,1
8876,validator_8,305246066310,True,516500000,10713740,527213740,False,9
8877,validator_43,117520804750,True,542200000,3087900,545287900,False,3
8878,validator_47,59072940385,True,1017799995,3799900,1021599895,True,1
8879,validator_11,307745757590,True,547800000,3302950,551102950,False,9
8880,validator_1,646828284270,True,694320006,47341580,741661586,True,20
8881,validator_20,174185597100,True,587200000,5960070,593160070,False,5
8882,validator_79,55589896000,True,602900000,3261450,606161450,False,1
8883,validator_11,308168712170,True,420300000,2654580,422954580,False,9
8884,validator_20,174972034360,True,784800000,1637260,786437260,False,5
8885,validator_54,55558531574,True,547374000,26279980,573653980,True,1
8886,validator_7,348268303041,True,613220000,3316900,616536900,True,10
8887,validator_5,333800428034,True,649499997,2976630,652476627,True,10
8888,validator_39,121069756870,True,648700000,6140070,654840070,False,3
8889,validator_30,120520030920,True,660340003,23518740,683858743,True,3
8890,validator_11,308747739280,True,577200000,1827110,579027110,False,9
8891,validator_9,329183773220,True,779000000,3268500,782268500,False,10
8892,validator_9,329952505820,True,757700000,11032600,768732600,False,10
8893,validator_85,47946011980,True,693700000,1462100,695162100,False,1
8894,validator_20,175673693400,True,699800000,1859040,701659040,False,5
8895,validator_25,144267559730,True,524579998,7470300,532050298,True,4
8896,validator_80,49238763530,True,718600000,7147900,725747900,False,1
8897,validator_76,57359806940,True,542300000,5762240,548062240,False,1
8898,validator_54,56055903845,True,496200001,1172270,497372271,True,1
8899,validator_4,322013538310,True,513839998,31337100,545177098,True,10
8900,validator_3,511828857040,True,573700000,35845970,609545970,False,15
8901,validator_21,182255355120,True,775700000,3713480,779413480,False,5
8902,validator_85,48522915280,True,575200000,1703300,576903300,False,1
8903,validator_0,532895498162,True,781819999,35358300,817178299,True,16
8904,validator_7,349096439583,True,800060002,28076540,828136542,True,10
8905,validator_7,349907998883,True,750740000,60819300,811559300,True,10
8906,validator_76,57917932460,True,537100000,21025520,558125520,False,1
8907,validator_36,117920835240,True,575300000,13122090,588422090,False,3
8908,validator_74,49719319280,True,533700000,2177860,535877860,False,1
8909,validator_7,350498985418,True,568199995,22786540,590986535,True,10
8910,validator_21,182884091420,True,626190000,2546300,628736300,False,5
8911,validator_1,647581416223,True,719939993,33191960,753131953,True,20
8912,validator_19,157974501660,True,622700000,24099920,646799920,False,4
8913,validator_36,118597270060,True,670700000,5734820,676434820,False,3
8914,validator_38,113755446590,True,686400000,19072270,705472270,False,3
8915,validator_8,305815813080,True,550100000,19646770,569746770,False,9
8916,validator_0,533422501515,True,521620003,5383350,527003353,True,16
8917,validator_52,58050115933,True,542999998,48338890,591338888,True,1
8918,validator_26,114684807274,True,535975995,34280600,570256595,True,3
8919,validator_11,309268297700,True,511100000,9458420,520558420,False,9
8920,validator_8,306474619610,True,655700000,3106530,658806530,False,9
8921,validator_26,115465946402,True,771139998,9999130,781139128,True,3
8922,validator_1,648153185521,True,570399998,1369300,571769298,True,20
8923,validator_38,114457696310,True,700300000,1949720,702249720,False,3
8924,validator_3,512437339270,True,606400000,2082230,608482230,False,16
8925,validator_57,58531915832,True,789800010,9360890,799160900,True,1
8926,validator_13,189148199639,True,638500006,13582100,652082106,True,5
8927,validator_13,189905849130,True,739266001,18383490,757649491,True,5
8928,validator_1,648715489043,True,537849992,24453530,562303522,True,20
8929,validator_13,190361188329,True,436779999,18559200,455339199,True,5
8930,validator_19,158487115150,True,502800000,9813490,512613490,False,4
8931,validator_75,50078321270,True,623000000,9936340,632936340,False,1
8932,validator_0,533971447659,True,547500004,1446140,548946144,True,16
8933,validator_14,203706810148,True,567800000,55994200,623794200,True,6
8934,validator_10,295272926210,True,667200000,2404120,669604120,False,9
8935,validator_23,171956105530,True,645600000,4107810,649707810,False,5
8936,validator_41,123247621970,True,721800000,5880400,727680400,False,3
8937,validator_22,186400148080,True,372400000,2873390,375273390,False,5
8938,validator_8,307053547640,True,559300000,19628030,578928030,False,9
8939,validator_1,649355577912,True,638099999,1988870,640088869,True,20
8940,validator_6,327854861131,True,899619998,13882380,913502378,True,10
8941,validator_6,328425544732,True,558736001,11947600,570683601,True,10
8942,validator_9,330517850320,True,547300000,18044500,565344500,False,10
8943,validator_34,129215299790,True,880100000,2519520,882619520,False,4
8944,validator_13,191020306631,True,632060002,27058300,659118302,True,5
8945,validator_73,57789261640,True,645200000,20435270,665635270,False,1
8946,validator_21,183340536120,True,454900000,1544700,456444700,False,5
8947,validator_79,56172536840,True,580700000,1940840,582640840,False,1
8948,validator_7,351112707405,True,593800007,19921980,613721987,True,10
8949,validator_1,650195366111,True,827893999,11894200,839788199,True,20
8950,validator_35,109857212040,True,667300000,1504740,668804740,False,3
8951,validator_22,187168295020,True,731700000,36446940,768146940,False,5
8952,validator_42,118448372130,True,656800000,921100,657721100,False,3
8953,validator_31,133238949884,True,682100005,32686030,714786035,True,4
8954,validator_12,183250210124,True,596029999,16437340,612467339,True,5
8955,validator_78,50043777870,True,519300000,2432700,521732700,False,1
8956,validator_2,485317272350,True,666300000,11671890,677971890,False,15
8957,validator_38,115114669500,True,655400000,1573190,656973190,False,3
8958,validator_7,351752184743,True,546951998,92525340,639477338,True,10
8959,validator_3,513256746590,True,815400000,4007320,819407320,False,16
8960,validator_23,172702696830,True,742100000,4491300,746591300,False,5
8961,validator_17,195287371282,True,502500002,1959140,504459142,True,6
8962,validator_4,322675470503,True,628439993,33492200,661932193,True,10
8963,validator_11,309860825700,True,586300000,6228000,592528000,False,9
8964,validator_11,310348073300,True,474540000,12707600,487247600,False,9
8965,validator_4,323330329099,True,633899996,20958600,654858596,True,10
8966,validator_11,310924925000,True,569900000,6951700,576851700,False,9
8967,validator_17,196230501776,True,941600004,1530490,943130494,True,6
8968,validator_63,57255651087,True,613580004,19188080,632768084,True,1
8969,validator_22,187900621000,True,730800000,1525980,732325980,False,5
8970,validator_29,133160332284,True,682600002,23793320,706393322,True,4
8971,validator_10,295846723750,True,571300000,2497540,573797540,False,9
8972,validator_19,159137180950,True,646660000,3405800,650065800,False,4
8973,validator_24,109117602186,True,818757991,27391600,846149591,True,3
8974,validator_9,331180107950,True,649150000,13107630,662257630,False,10
8975,validator_0,534745212412,True,767320003,6444750,773764753,True,16
8976,validator_23,173333387230,True,628700000,1990400,630690400,False,5
8977,validator_18,177089346720,True,507000000,8858230,515858230,False,5
8978,validator_20,176478484410,True,796800000,7991010,804791010,False,5
8979,validator_10,296514475990,True,664200000,3552240,667752240,False,9
8980,validator_7,352439353843,True,677900000,9269100,687169100,True,11
8981,validator_9,331579583870,True,389800000,9675920,399475920,False,10
8982,validator_13,191371021828,True,335419997,15295200,350715197,True,5
8983,validator_17,197030491513,True,774933997,25055740,799989737,True,6
8984,validator_18,177707016320,True,603500000,14169600,617669600,False,5
8985,validator_0,535372901067,True,596179995,31508660,627688655,True,16
8986,validator_80,49788132460,True,545900000,3468930,549368930,False,1
8987,validator_4,323881052990,True,539340001,11383890,550723891,True,10
8988,validator_35,110731538180,True,872100000,2226140,874326140,False,3
8989,validator_2,485909072730,True,583200000,8600380,591800380,False,15
8990,validator_0,535996178701,True,592299994,30977640,623277634,True,16
8991,validator_17,197606834612,True,548319999,28023100,576343099,True,6
8992,validator_17,198179597719,True,541360007,31403100,572763107,True,6
8993,validator_7,353139810147,True,672846004,27610300,700456304,True,11
8994,validator_40,105230723280,True,452800000,19211600,472011600,False,3
8995,validator_82,55672116680,True,658700000,2021100,660721100,False,1
8996,validator_1,650929292312,True,730260001,3666200,733926201,True,20
8997,validator_26,116051586041,True,556959999,28679640,585639639,True,3
8998,validator_1,651466886414,True,511000002,26594100,537594102,True,20
8999,validator_9,332218749600,True,620200000,18965730,639165730,False,10
9000,validator_41,124027529510,True,779000000,907540,779907540,False,3
9001,validator_0,536854831018,True,854899997,3752320,858652317,True,16
9002,validator_46,55143509101,True,561200002,2647500,563847502,True,1
9003,validator_2,486587517380,True,677500000,944650,678444650,False,15
9004,validator_87,57941865900,True,555400000,1129740,556529740,False,1
9005,validator_15,196948804596,True,525600002,2508200,528108202,True,6
9006,validator_8,307668460480,True,611700000,3212840,614912840,False,9
9007,validator_3,513709277970,True,447000000,5531380,452531380,False,16
9008,validator_5,334555601197,True,716620003,38553160,755173163,True,10
9009,validator_0,537774747046,True,912199998,7716030,919916028,True,16
9010,validator_5,335382376398,True,796840001,29935200,826775201,True,10
9011,validator_1,652452477054,True,958820000,26770640,985590640,True,20
9012,validator_54,56761208948,True,703600003,1705100,705305103,True,1
9013,validator_5,335855992668,True,468400000,5216270,473616270,True,10
9014,validator_37,100023367650,True,733900000,745400,734645400,False,3
9015,validator_52,58802529151,True,725399998,27013220,752413218,True,1
9016,validator_1,653049925257,True,588640003,8808200,597448203,True,20
9017,validator_8,308388842800,True,717400000,2982320,720382320,False,9
9018,validator_6,328892170588,True,464199996,2425860,466625856,True,10
9019,validator_33,135241634959,True,716339997,19579270,735919267,True,4
9020,validator_21,183962362830,True,619100000,2726710,621826710,False,5
9021,validator_96,54517077080,True,554900000,3844100,558744100,False,1
9022,validator_89,57133165700,True,636200000,19989380,656189380,False,1
9023,validator_28,130246502225,True,741400004,55178500,796578504,True,4
9024,validator_73,58309648140,True,517500000,2886500,520386500,False,1
9025,validator_42,118894309360,True,444200000,1737230,445937230,False,3
9026,validator_4,324540094294,True,657700004,1341300,659041304,True,10
9027,validator_9,332920125100,True,699700000,1675500,701375500,False,10
9028,validator_13,192032193994,True,651839996,9332170,661172166,True,6
9029,validator_9,333478759210,True,528500000,30134110,558634110,False,10
9030,validator_10,297397297350,True,880900000,1921360,882821360,False,9
9031,validator_86,57245922270,True,608100000,3316400,611416400,False,1
9032,validator_4,325222987712,True,676599998,6293420,682893418,True,10
9033,validator_69,52492848279,True,571100002,24975120,596075122,True,1
9034,validator_16,176010487192,True,583450003,35864800,619314803,True,5
9035,validator_13,192707762694,True,659480000,16088700,675568700,True,6
9036,validator_36,119193502650,True,586600000,9632590,596232590,False,3
9037,validator_0,538453271555,True,666200009,12324500,678524509,True,16
9038,validator_27,118442909704,True,710100006,2606640,712706646,True,3
9039,validator_40,105807571470,True,571500000,5348190,576848190,False,3
9040,validator_92,46057448040,True,384700000,1133400,385833400,False,1
9041,validator_34,129642404630,True,421800000,5304840,427104840,False,4
9042,validator_11,311591087440,True,635300000,30862440,666162440,False,9
9043,validator_2,487202412240,True,608600000,6294860,614894860,False,15
9044,validator_3,514412797250,True,697300000,6219280,703519280,False,16
9045,validator_7,354018449590,True,803960003,74679440,878639443,True,11
9046,validator_38,115628210330,True,493500000,20040830,513540830,False,3
9047,validator_28,131050009849,True,794539994,8967630,803507624,True,4
9048,validator_4,325950613859,True,699353997,28272150,727626147,True,10
9049,validator_7,354540324889,True,519539999,2335300,521875299,True,11
9050,validator_24,110095127891,True,948099995,29425710,977525705,True,3
9051,validator_2,487717606840,True,494400000,20794600,515194600,False,15
9052,validator_5,336457205603,True,561138005,40074930,601212935,True,10
9053,validator_86,57736512700,True,479800000,10790430,490590430,False,1
9054,validator_35,111285081620,True,540800000,12743440,553543440,False,3
9055,validator_64,63513992020,True,636499996,1754930,638254926,True,1
9056,validator_14,204575768839,True,806516001,62442690,868958691,True,6
9057,validator_7,355169146015,True,587139996,41681130,628821126,True,11
9058,validator_9,334018238430,True,536200000,3279220,539479220,False,10
9059,validator_1,653753033704,True,678719997,24388450,703108447,True,20
9060,validator_39,121759142070,True,684400000,4985200,689385200,False,3
9061,validator_25,145127499231,True,842900001,17039500,859939501,True,4
9062,validator_5,337349838803,True,861040000,31593200,892633200,True,10
9063,validator_8,308942650500,True,551200000,2607700,553807700,False,9
9064,validator_13,193166072676,True,437160002,21149980,458309982,True,6
9065,validator_40,106654569120,True,845200000,1797650,846997650,False,3
9066,validator_97,60045349770,True,392500000,1630660,394130660,False,1
9067,validator_18,178255559420,True,537800000,10743100,548543100,False,5
9068,validator_2,488358991290,True,630900000,10484450,641384450,False,15
9069,validator_25,145775381225,True,638560004,9321990,647881994,True,4
9070,validator_24,110655489531,True,533860000,26501640,560361640,True,3
9071,validator_4,326406562554,True,445919995,10028700,455948695,True,10
9072,validator_20,177078352680,True,598700000,1168270,599868270,False,5
9073,validator_6,329516503406,True,597839998,26492820,624332818,True,10
9074,validator_20,177760742780,True,643900000,38490100,682390100,False,5
9075,validator_1,654541596927,True,767700003,20863220,788563223,True,20
9076,validator_82,56346546880,True,663200000,11230200,674430200,False,1
9077,validator_6,330095597691,True,572280005,6814280,579094285,True,10
9078,validator_2,489018664390,True,656700000,2973100,659673100,False,15
9079,validator_2,489619994960,True,593400000,7930570,601330570,False,15
9080,validator_9,334729892160,True,695900000,15753730,711653730,False,10
9081,validator_0,539154143326,True,699699991,1171780,700871771,True,16
9082,validator_1,655195744274,True,646295997,7851350,654147347,True,20
9083,validator_19,159596887850,True,453100000,6606900,459706900,False,4
9084,validator_14,205376455465,True,786457996,14228630,800686626,True,6
9085,validator_16,176968012125,True,916823993,40700940,957524933,True,5
9086,validator_6,330831116852,True,720486001,15033160,735519161,True,10
9087,validator_22,188531514320,True,599200000,31693320,630893320,False,5
9088,validator_15,197612708697,True,645170001,18734100,663904101,True,6
9089,validator_21,184573211560,True,590400000,20448730,610848730,False,5
9090,validator_10,297999165260,True,601100000,767910,601867910,False,9
9091,validator_3,514918095050,True,504000000,1297800,505297800,False,16
9092,validator_2,490221181660,True,580100000,21086700,601186700,False,15
9093,validator_3,515447656330,True,502000000,27561280,529561280,False,16
9094,validator_60,64144420678,True,677600002,29124340,706724342,True,2
9095,validator_16,177698076327,True,713714002,16350200,730064202,True,5
9096,validator_1,655890429980,True,655526006,39159700,694685706,True,20
9097,validator_73,58837226220,True,525600000,1978080,527578080,False,1
9098,validator_23,173876891360,True,539800000,3704130,543504130,False,5
9099,validator_13,193796347599,True,628500003,1774920,630274923,True,6
9100,validator_10,298578314460,True,550400000,28749200,579149200,False,9
9101,validator_16,178393253727,True,673520000,21657400,695177400,True,5
9102,validator_39,122408141970,True,624100000,24899900,648999900,False,3
9103,validator_23,174461890660,True,583300000,1699300,584999300,False,5
9104,validator_96,55078307900,True,558970000,2260820,561230820,False,1
9105,validator_11,312277945250,True,683000000,3857810,686857810,False,9
9106,validator_56,63550714101,True,533439998,61262120,594702118,True,1
9107,validator_28,131905323776,True,849799997,5513930,855313927,True,4
9108,validator_9,335429789640,True,698600000,1297480,699897480,False,10
9109,validator_0,539869878150,True,697845994,17888830,715734824,True,16
9110,validator_84,51319017910,True,619400000,2743080,622143080,False,1
9111,validator_1,656460505045,True,564120005,5955060,570075065,True,20
9112,validator_88,52359938880,True,562000000,20826630,582826630,False,1
9113,validator_3,515933853570,True,481300000,4897240,486197240,False,16
9114,validator_61,61465275326,True,773599997,20939300,794539297,True,1
9115,validator_1,657169764774,True,671819999,37439730,709259729,True,20
9116,validator_22,189028191320,True,494500000,2177000,496677000,False,5
9117,validator_37,100688235570,True,661400000,3467920,664867920,False,3
9118,validator_0,540709355121,True,822539991,16936980,839476971,True,16
9119,validator_3,516354214690,True,414350000,6011120,420361120,False,16
9120,validator_7,355854262296,True,658260001,26856280,685116281,True,11
9121,validator_8,309463735410,True,516600000,4484910,521084910,False,9
9122,validator_10,299206320960,True,608900000,19106500,628006500,False,9
9123,validator_1,657678189968,True,475880004,32545190,508425194,True,20
9124,validator_1,658418654952,True,726180004,14284980,740464984,True,20
9125,validator_4,327059742781,True,632019997,21160230,653180227,True,10
9126,validator_10,299770148060,True,556600000,7227100,563827100,False,9
9127,validator_43,118006255160,True,482200000,3250410,485450410,False,3
9128,validator_0,541632769198,True,912565997,10848080,923414077,True,16
9129,validator_75,50668567870,True,587600000,2646600,590246600,False,1
9130,validator_96,55704463380,True,604200000,21955480,626155480,False,1
9131,validator_60,64881449297,True,730099999,6928620,737028619,True,2
9132,validator_87,58486469860,True,543300000,1303960,544603960,False,1
9133,validator_16,179174499830,True,731880003,49366100,781246103,True,5
9134,validator_41,124543019310,True,494800000,20689800,515489800,False,3
9135,validator_4,327602594428,True,510499997,32351650,542851647,True,10
9136,validator_17,198988336376,True,780899997,27838660,808738657,True,6
9137,validator_9,336119539670,True,685800000,3950030,689750030,False,10
9138,validator_1,659242836482,True,821900000,2281530,824181530,True,20
9139,validator_6,331634510557,True,796140005,7253700,803393705,True,10
9140,validator_8,310165641300,True,677400000,24505890,701905890,False,9
9141,validator_3,516910393290,True,545900000,10278600,556178600,False,16
9142,validator_53,54977811317,True,575299997,31426800,606726797,True,1
9143,validator_4,328163290584,True,539139996,21556160,560696156,True,10
9144,validator_31,133920120147,True,642653993,38516270,681170263,True,4
9145,validator_10,300528886060,True,752300000,6438000,758738000,False,9
9146,validator_1,659833831361,True,553495999,37498880,590994879,True,20
9147,validator_17,199655496774,True,649699998,17460400,667160398,True,6
9148,validator_3,517560556520,True,638700000,11463230,650163230,False,16
9149,validator_10,301233062240,True,684100000,20076180,704176180,False,9
9150,validator_2,490733486690,True,509000000,3305030,512305030,False,15
9151,validator_50,51037483635,True,508549999,7597440,516147439,True,1
9152,validator_96,56339479780,True,630600000,4416400,635016400,False,1
9153,validator_21,185121307370,True,510400000,37695810,548095810,False,5
9154,validator_61,62114638139,True,627559993,21802820,649362813,True,1
9155,validator_32,125901821964,True,671799998,26888580,698688578,True,3
9156,validator_93,50188032710,True,503500000,3594430,507094430,False,1
9157,validator_1,660924123290,True,1060939999,29351930,1090291929,True,20
9158,validator_39,123034531470,True,623700000,2689500,626389500,False,3
9159,validator_16,179981807527,True,794039997,13267700,807307697,True,5
9160,validator_35,111923256380,True,634800000,3374760,638174760,False,3
9161,validator_3,518290854000,True,708900000,21397480,730297480,False,16
9162,validator_6,332321236104,True,652300007,34425540,686725547,True,10
9163,validator_1,661637417573,True,662320003,50974280,713294283,True,20
9164,validator_87,59174257840,True,685000000,2787980,687787980,False,1
9165,validator_6,333153330475,True,818680001,13414370,832094371,True,10
9166,validator_95,51983963980,True,500100000,19384890,519484890,False,1
9167,validator_42,119287406070,True,390600000,2496710,393096710,False,3
9168,validator_77,50353890470,True,634200000,1731740,635931740,False,1
9169,validator_6,333943732073,True,745819998,44581600,790401598,True,10
9170,validator_1,662238715187,True,547679994,53617620,601297614,True,20
9171,validator_0,542213841261,True,540800003,40272060,581072063,True,16
9172,validator_91,47295482260,True,656400000,27268030,683668030,False,1
9173,validator_81,54426973640,True,405940000,11188400,417128400,False,1
9174,validator_1,662942496514,True,697219997,6561330,703781327,True,20
9175,validator_0,542922427362,True,676540001,32046100,708586101,True,16
9176,validator_14,206086397740,True,688159995,21782280,709942275,True,6
9177,validator_40,107283548520,True,620800000,8179400,628979400,False,3
9178,validator_20,178483409300,True,717600000,5066520,722666520,False,5
9179,validator_7,356577327092,True,721799996,1264800,723064796,True,11
9180,validator_37,101201039240,True,509900000,2903670,512803670,False,3
9181,validator_34,130448175330,True,803400000,2370700,805770700,False,4
9182,validator_7,357151153230,True,547899998,25926140,573826138,True,11
9183,validator_15,198156072677,True,532800000,10563980,543363980,True,6
9184,validator_28,132520994329,True,591354003,24316550,615670553,True,4
9185,validator_11,312899174330,True,602100000,19129080,621229080,False,9
9186,validator_37,101969042120,True,765400000,2602880,768002880,False,3
9187,validator_12,183891232526,True,634200002,6822400,641022402,True,5
9188,validator_33,135774611807,True,528859998,4116850,532976848,True,4
9189,validator_6,334631542000,True,683899997,3909930,687809927,True,10
9190,validator_1,663532718248,True,564590004,25631730,590221734,True,20
9191,validator_8,310774879240,True,607600000,1637940,609237940,False,9
9192,validator_29,133800063598,True,592485994,47245320,639731314,True,4
9193,validator_3,518920507970,True,607600000,22053970,629653970,False,16
9194,validator_3,519453408850,True,527500000,5400880,532900880,False,16
9195,validator_10,301835380170,True,600200000,2117930,602317930,False,9
9196,validator_5,337865287134,True,480740001,34708330,515448331,True,10
9197,validator_15,198779641137,True,567859990,55708470,623568460,True,6
9198,validator_2,491184248990,True,441800000,8962300,450762300,False,15
9199,validator_28,133323419153,True,761500004,40924820,802424824,True,4
9200,validator_35,112432635640,True,494600000,14779260,509379260,False,3
9201,validator_18,178805370520,True,546600000,3211100,549811100,False,5
9202,validator_7,357942047425,True,772979995,17914200,790894195,True,11
9203,validator_75,51366931420,True,673300000,25063550,698363550,False,1
9204,validator_24,111410498436,True,743620005,11388900,755008905,True,3
9205,validator_10,302374123300,True,537200000,1543130,538743130,False,9
9206,validator_50,51653957374,True,564219999,52253740,616473739,True,1
9207,validator_7,358585407057,True,618340002,25019630,643359632,True,11
9208,validator_30,121257128226,True,722000006,15097300,737097306,True,3
9209,validator_30,121863137586,True,577770000,28239360,606009360,True,3
9210,validator_8,311252922620,True,469600000,8443380,478043380,False,9
9211,validator_0,543670304400,True,721939998,25937040,747877038,True,16
9212,validator_12,184483533459,True,581679993,10620940,592300933,True,5
9213,validator_62,62396502657,True,557940008,7274230,565214238,True,1
9214,validator_9,336764493070,True,640100000,4853400,644953400,False,10
9215,validator_8,311984340450,True,730300000,1117830,731417830,False,9
9216,validator_6,335306130638,True,653819998,20768640,674588638,True,10
9217,validator_9,337517407130,True,741600000,11314060,752914060,False,10
9218,validator_50,52126724914,True,470800000,1967540,472767540,True,1
9219,validator_2,491741079350,True,555300000,1530360,556830360,False,15
9220,validator_69,53145232735,True,624860006,27524450,652384456,True,1
9221,validator_17,200224745458,True,562019994,7228690,569248684,True,6
9222,validator_0,544416235755,True,732639995,13291360,745931355,True,17
9223,validator_14,206937822574,True,833660004,17764830,851424834,True,6
9224,validator_3,519930721470,True,458100000,19212620,477312620,False,16
9225,validator_39,123777933370,True,734100000,9301900,743401900,False,3
9226,validator_6,335809918554,True,489218006,14569910,503787916,True,10
9227,validator_0,545350174473,True,913399998,20538720,933938718,True,17
9228,validator_1,664365013709,True,775168001,57127460,832295461,True,20
9229,validator_39,124277217970,True,471900000,27384600,499284600,False,3
9230,validator_63,57942042375,True,652155998,34235290,686391288,True,1
9231,validator_8,312636190290,True,650200000,1649840,651849840,False,9
9232,validator_20,179102355650,True,598800000,20146350,618946350,False,5
9233,validator_41,125172974030,True,628900000,1054720,629954720,False,3
9234,validator_25,146370699726,True,567760001,27558500,595318501,True,4
9235,validator_13,194438376092,True,613819993,28208500,642028493,True,6
9236,validator_16,180728379528,True,709540001,37032000,746572001,True,5
9237,validator_78,50611167880,True,557900000,9490010,567390010,False,1
9238,validator_13,195368171426,True,898160004,31635330,929795334,True,6
9239,validator_43,118753249280,True,742600000,4394120,746994120,False,3
9240,validator_1,665063163637,True,690799998,7349930,698149928,True,20
9241,validator_1,665934296589,True,833239992,37892960,871132952,True,20
9242,validator_13,196259610423,True,881319997,10119000,891438997,True,6
9243,validator_11,313544824530,True,639700000,5950200,645650200,False,9
9244,validator_3,520557811110,True,625000000,2089640,627089640,False,16
9245,validator_36,119666332710,True,466400000,6430060,472830060,False,3
9246,validator_3,521082223970,True,503000000,21412860,524412860,False,16
9247,validator_93,50927170120,True,720800000,18337410,739137410,False,1
9248,validator_77,51044780180,True,687100000,3789710,690889710,False,1
9249,validator_1,666796026329,True,858400000,3329740,861729740,True,20
9250,validator_0,546198030831,True,837679998,10176360,847856358,True,17
9251,validator_60,65668415093,True,757719996,29245800,786965796,True,2
9252,validator_7,359216451164,True,618520007,12524100,631044107,True,11
9253,validator_10,303012616570,True,633400000,5093270,638493270,False,9
9254,validator_4,329074648822,True,869815998,41542240,911358238,True,10
9255,validator_15,199413632181,True,630300004,3691040,633991044,True,6
9256,validator_85,49105843280,True,573200000,9728000,582928000,False,1
9257,validator_0,546857308670,True,623527999,35749840,659277839,True,17
9258,validator_7,359847784397,True,588440003,42893230,631333233,True,11
9259,validator_18,179289553600,True,482900000,1283080,484183080,False,5
9260,validator_45,56144601087,True,674099995,48884570,722984565,True,1
9261,validator_4,329779462252,True,697600000,7213430,704813430,True,10
9262,validator_68,57167439265,True,605020002,6905290,611925292,True,1
9263,validator_24,112207568994,True,761041998,36028560,797070558,True,3
9264,validator_5,338510562417,True,624199993,21075290,645275283,True,10
9265,validator_72,56642667800,True,603700000,3694820,607394820,False,1
9266,validator_54,57620619255,True,838900007,20510300,859410307,True,1
9267,validator_17,200974685956,True,724255998,25684500,749940498,True,6
9268,validator_11,314119586150,True,570400000,4361620,574761620,False,9
9269,validator_2,492392936980,True,648500000,3357630,651857630,False,15
9270,validator_78,51363768690,True,750600000,2000810,752600810,False,1
9271,validator_23,175087027230,True,615800000,9336570,625136570,False,5
9272,validator_4,330451022714,True,654740002,16820460,671560462,True,10
9273,validator_1,667486561627,True,669199998,21335300,690535298,True,20
9274,validator_32,126564915975,True,619464001,43630010,663094011,True,3
9275,validator_15,200171820477,True,733760006,24428290,758188296,True,6
9276,validator_93,51300769820,True,372200000,1399700,373599700,False,1
9277,validator_6,336595498997,True,779340003,6240440,785580443,True,10
9278,validator_21,185640819570,True,513400000,6112200,519512200,False,5
9279,validator_85,49845223580,True,736700000,2680300,739380300,False,1
9280,validator_7,360496481421,True,630100004,18597020,648697024,True,11
9281,validator_7,361188834622,True,625188001,67165200,692353201,True,11
9282,validator_13,197169134966,True,853548003,55976540,909524543,True,6
9283,validator_25,147003694981,True,625720005,7275250,632995255,True,4
9284,validator_0,547517545104,True,652000004,8236430,660236434,True,17
9285,validator_6,337341004425,True,693399998,52105430,745505428,True,10
9286,validator_0,548250584313,True,722999999,10039210,733039209,True,17
9287,validator_39,124800949110,True,522500000,1231140,523731140,False,3
9288,validator_7,361756702042,True,553020000,14847420,567867420,True,11
9289,validator_23,175670110130,True,581100000,1982900,583082900,False,5
9290,validator_10,303723118140,True,707200000,3301570,710501570,False,9
9291,validator_8,313247168610,True,605000000,5978320,610978320,False,9
9292,validator_2,493187927520,True,786300000,8690540,794990540,False,15
9293,validator_42,119961088110,True,666200000,7482040,673682040,False,3
9294,validator_26,116652704799,True,582639998,18478760,601118758,True,3
9295,validator_54,58526999458,True,885340003,21040200,906380203,True,1
9296,validator_38,116398137370,True,768300000,1627040,769927040,False,3
9297,validator_14,207588826521,True,621714007,29289940,651003947,True,6
9298,validator_31,134548648974,True,610699997,17828830,628528827,True,4
9299,validator_3,521652991870,True,561400000,9367900,570767900,False,16
9300,validator_3,522215812710,True,561100000,1720840,562820840,False,16
9301,validator_2,493740528630,True,538400000,14201110,552601110,False,15
9302,validator_36,120109872860,True,424170000,19370150,443540150,False,3
9303,validator_84,52303654280,True,965700000,18936370,984636370,False,1
9304,validator_0,548885823011,True,625769998,9468700,635238698,True,17
9305,validator_4,330961441220,True,454636006,55782500,510418506,True,10
9306,validator_10,304228579440,True,504200000,1261300,505461300,False,9
9307,validator_30,122483238089,True,595140003,24960500,620100503,True,3
9308,validator_0,549388819754,True,496840003,6156740,502996743,True,17
9309,validator_23,176570760590,True,894500000,6150460,900650460,False,5
9310,validator_16,181337787725,True,600899997,8508200,609408197,True,5
9311,validator_13,197875957068,True,694900002,11922100,706822102,True,6
9312,validator_0,549748027759,True,356600005,2608000,359208005,True,17
9313,validator_32,127330532959,True,762200004,3416980,765616984,True,3
9314,validator_5,339225078919,True,697180002,17336500,714516502,True,10
9315,validator_0,550600829594,True,825399995,27401840,852801835,True,17
9316,validator_15,201121322746,True,940800009,8702260,949502269,True,6
9317,validator_87,59651015140,True,475400000,1357300,476757300,False,1
9318,validator_36,120610201450,True,493600000,6728590,500328590,False,3
9319,validator_7,362543330910,True,743140008,43488860,786628868,True,11
9320,validator_71,64443874130,True,690299997,37834640,728134637,True,2
9321,validator_42,120734066610,True,700000000,72978500,772978500,False,3
9322,validator_23,177257156990,True,684400000,1996400,686396400,False,5
9323,validator_23,177683986490,True,424700000,2129500,426829500,False,5
9324,validator_16,182184139957,True,824000002,22352230,846352232,True,5
9325,validator_1,668353027077,True,835020000,31445450,866465450,True,20
9326,validator_11,314764425290,True,635000000,9839140,644839140,False,9
9327,validator_3,522808712210,True,591000000,1899500,592899500,False,16
9328,validator_51,54895814721,True,740999998,36255340,777255338,True,1
9329,validator_10,304766875220,True,535800000,2495780,538295780,False,9
9330,validator_7,363224423307,True,661179997,19912400,681092397,True,11
9331,validator_10,305275309290,True,505900000,2534070,508434070,False,9
9332,validator_58,54304857609,True,700620007,9848300,710468307,True,1
9333,validator_77,51550732910,True,504900000,1052730,505952730,False,1
9334,validator_67,55744725555,True,810420004,42476340,852896344,True,1
9335,validator_78,51923845450,True,557900000,2176760,560076760,False,1
9336,validator_5,340083065907,True,830060008,27926980,857986988,True,10
9337,validator_22,189659835280,True,629000000,2643960,631643960,False,5
9338,validator_7,363918917650,True,667570003,26924340,694494343,True,11
9339,validator_53,55780048618,True,787660001,14577300,802237301,True,1
9340,validator_1,668904260000,True,547599993,3632930,551232923,True,20
9341,validator_2,494374234170,True,627300000,6405540,633705540,False,15
9342,validator_36,121352168590,True,739600000,2367140,741967140,False,3
9343,validator_41,125709539220,True,535800000,765190,536565190,False,3
9344,validator_1,669684076408,True,710754008,69062400,779816408,True,20
9345,validator_14,208479396061,True,861354000,29215540,890569540,True,6
9346,validator_71,64976946957,True,512385997,20686830,533072827,True,2
9347,validator_39,125412564240,True,610700000,915130,611615130,False,3
9348,validator_97,60530143120,True,460800000,23993350,484793350,False,1
9349,validator_59,49635354837,True,779840002,18135670,797975672,True,1
9350,validator_33,136636735995,True,808219998,53904190,862124188,True,4
9351,validator_28,133952257336,True,576260003,52578180,628838183,True,4
9352,validator_1,670398102181,True,678265993,35759780,714025773,True,20
9353,validator_0,551170206495,True,567600001,1776900,569376901,True,17
9354,validator_47,59894978557,True,771834012,50204160,822038172,True,1
9355,validator_28,134678522040,True,687588004,38676700,726264704,True,4
9356,validator_46,55800440399,True,649399998,7531300,656931298,True,1
9357,validator_92,46650166670,True,590100000,2618630,592718630,False,1
9358,validator_9,338227401830,True,706400000,3594700,709994700,False,10
9359,validator_9,338781887060,True,552900000,1585230,554485230,False,10
9360,validator_40,107976140520,True,689600000,2992000,692592000,False,3
9361,validator_0,551684574167,True,512900002,1467670,514367672,True,17
9362,validator_61,63015435960,True,894579991,6217830,900797821,True,1
9363,validator_0,552500203670,True,791700003,23929500,815629503,True,17
9364,validator_11,315348949780,True,578000000,6524490,584524490,False,9
9365,validator_59,50545231039,True,894420002,15456200,909876202,True,1
9366,validator_4,331686312209,True,722599999,2270990,724870989,True,10
9367,validator_5,340735398847,True,646200000,6132940,652332940,True,10
9368,validator_23,178555494930,True,853000000,18508440,871508440,False,5
9369,validator_5,341302599224,True,540060007,27140370,567200377,True,10
9370,validator_1,671157599524,True,745178003,14319340,759497343,True,20
9371,validator_20,179670259400,True,564700000,3203750,567903750,False,5
9372,validator_73,59332639210,True,474400000,21012990,495412990,False,1
9373,validator_6,337950465421,True,600219996,9241000,609460996,True,10
9374,validator_3,523528105210,True,682400000,36993000,719393000,False,16
9375,validator_30,123458600284,True,973540005,1822190,975362195,True,3
9376,validator_6,338501547765,True,537719994,13362350,551082344,True,10
9377,validator_26,117315518513,True,654599994,8213720,662813714,True,3
9378,validator_14,209209012040,True,701915989,27699990,729615979,True,6
9379,validator_25,147661429368,True,621339997,36394390,657734387,True,4
9380,validator_6,339165851032,True,661599997,2703270,664303267,True,10
9381,validator_10,305892072320,True,614000000,2763030,616763030,False,9
9382,validator_19,160268831850,True,664200000,7744000,671944000,False,5
9383,validator_1,671558705226,True,363060002,38045700,401105702,True,20
9384,validator_11,316027306780,True,675300000,3057000,678357000,False,9
9385,validator_86,58291051920,True,552700000,1839220,554539220,False,1
9386,validator_34,130983887070,True,534900000,811740,535711740,False,4
9387,validator_53,56523615016,True,668659998,74906400,743566398,True,1
9388,validator_96,56910970960,True,568800000,2691180,571491180,False,1
9389,validator_3,524074599350,True,544900000,1594140,546494140,False,16
9390,validator_2,495112348730,True,736100000,2014560,738114560,False,15
9391,validator_16,183112990470,True,888920003,39930510,928850513,True,5
9392,validator_16,183876410070,True,753300000,10119600,763419600,True,5
9393,validator_21,186113845930,True,469780000,3246360,473026360,False,5
9394,validator_9,339363973490,True,572900000,9186430,582086430,False,10
9395,validator_28,135276668235,True,578339995,19806200,598146195,True,4
9396,validator_14,209655022265,True,426099995,19910230,446010225,True,6
9397,validator_11,316625502010,True,576500000,21695230,598195230,False,9
9398,validator_4,332400186927,True,706839998,7034720,713874718,True,10
9399,validator_56,64414485798,True,824669997,39101700,863771697,True,2
9400,validator_14,210433851695,True,704772000,74057430,778829430,True,6
9401,validator_79,56724354820,True,545800000,6017980,551817980,False,1
9402,validator_12,185163896448,True,641979999,38382990,680362989,True,5
9403,validator_9,339960224590,True,593700000,2551100,596251100,False,10
9404,validator_3,524736819280,True,660900000,1319930,662219930,False,16
9405,validator_72,57276544330,True,614600000,19276530,633876530,False,1
9406,validator_6,339641882761,True,447445999,28585730,476031729,True,10
9407,validator_38,116967571270,True,568200000,1233900,569433900,False,3
9408,validator_12,185916890321,True,751600003,1393870,752993873,True,5
9409,validator_73,59892630150,True,557000000,2990940,559990940,False,1
9410,validator_61,63803028723,True,751560003,36032760,787592763,True,1
9411,validator_87,60280397410,True,614800000,14582270,629382270,False,1
9412,validator_1,672394718863,True,800779997,35233640,836013637,True,21
9413,validator_46,56581431592,True,760700003,20291190,780991193,True,1
9414,validator_6,340224047267,True,543800006,38364500,582164506,True,10
9415,validator_61,64332620225,True,509820002,19771500,529591502,True,2
9416,validator_50,52740348693,True,591879999,21743780,613623779,True,1
9417,validator_53,57254882961,True,681460005,49807940,731267945,True,1
9418,validator_4,333060834751,True,627780004,32867820,660647824,True,10
9419,validator_15,201781705543,True,638269997,22112800,660382797,True,6
9420,validator_2,495741240610,True,628000000,891880,628891880,False,15
9421,validator_15,202449915039,True,662759996,5449500,668209496,True,6
9422,validator_7,364638067952,True,678000002,41150300,719150302,True,11
9423,validator_17,201535155754,True,535839998,24629800,560469798,True,6
9424,validator_13,198666347467,True,775699999,14690400,790390399,True,6
9425,validator_94,55225149640,True,591100000,13608030,604708030,False,1
9426,validator_45,56776285341,True,623099994,8584260,631684254,True,1
9427,validator_25,148485917970,True,767486002,57002600,824488602,True,4
9428,validator_11,317171238420,True,543600000,2136410,545736410,False,9
9429,validator_80,50418252120,True,625700000,4419660,630119660,False,1
9430,validator_43,119383562780,True,628000000,2313500,630313500,False,3
9431,validator_2,496192836070,True,443900000,7695460,451595460,False,15
9432,validator_71,65771490216,True,792599999,1943260,794543259,True,2
9433,validator_44,54124786137,True,764419997,24254380,788674377,True,1
9434,validator_1,673150412796,True,735800003,19893930,755693933,True,21
9435,validator_43,120163317650,True,777900000,1854870,779754870,False,3
9436,validator_44,54947054139,True,812200002,10068000,822268002,True,1
9437,validator_41,126387131020,True,673100000,4491800,677591800,False,3
9438,validator_4,333827955471,True,756500000,10620720,767120720,True,10
9439,validator_0,553190621999,True,654879999,35538330,690418329,True,17
9440,validator_16,184524900472,True,637940002,10550400,648490402,True,5
9441,validator_2,496893786600,True,697300000,3650530,700950530,False,15
9442,validator_1,673836293097,True,683820001,2060300,685880301,True,21
9443,validator_7,365130139050,True,489499998,2571100,492071098,True,11
9444,validator_13,199287023515,True,594659998,26016050,620676048,True,6
9445,validator_0,553989993631,True,772800002,26571630,799371632,True,17
9446,validator_7,365758388166,True,576040006,52209110,628249116,True,11
9447,validator_14,211102764541,True,644020006,24892840,668912846,True,6
9448,validator_11,317768258750,True,593400000,3620330,597020330,False,9
9449,validator_3,525585099790,True,826300000,21980510,848280510,False,16
9450,validator_3,526073137720,True,485200000,2837930,488037930,False,16
9451,validator_6,341086001272,True,859000005,2954000,861954005,True,10
9452,validator_0,554769347365,True,754196004,25157730,779353734,True,17
9453,validator_58,55062355985,True,719999996,37498380,757498376,True,1
9454,validator_1,674397383801,True,549500004,11590700,561090704,True,21
9455,validator_8,313784415350,True,535500000,1746740,537246740,False,9
9456,validator_7,366288150384,True,504119998,25642220,529762218,True,11
9457,validator_1,675230675299,True,822399998,10891500,833291498,True,21
9458,validator_48,53632421012,True,740820001,53569600,794389601,True,1
9459,validator_39,125860838930,True,444900000,3374690,448274690,False,3
9460,validator_32,127994128595,True,660899996,2695640,663595636,True,3
9461,validator_3,526657464260,True,582400000,1926540,584326540,False,16
9462,validator_36,122085922880,True,687000000,46754290,733754290,False,3
9463,validator_20,180205763930,True,527680000,7824530,535504530,False,5
9464,validator_0,555382124460,True,573948005,38829090,612777095,True,17
9465,validator_49,64095148910,True,684160000,10656940,694816940,True,2
9466,validator_1,676065307174,True,827939995,6691880,834631875,True,21
9467,validator_40,108589531450,True,603200000,10190930,613390930,False,3
9468,validator_43,120811648410,True,644100000,4230760,648330760,False,3
9469,validator_42,121391196680,True,654500000,2630070,657130070,False,3
9470,validator_4,334500927367,True,666599996,6371900,672971896,True,10
9471,validator_9,340645227010,True,678600000,6402420,685002420,False,10
9472,validator_4,335031283694,True,528699997,1656330,530356327,True,10
9473,validator_19,160759702790,True,488700000,2170940,490870940,False,5
9474,validator_1,676851712503,True,765839999,20565330,786405329,True,21
9475,validator_1,677525747201,True,639099998,34934700,674034698,True,21
9476,validator_70,56425227699,True,685494004,25000290,710494294,True,1
9477,validator_9,341295811110,True,647900000,2684100,650584100,False,10
9478,validator_2,497507072860,True,610900000,2386260,613286260,False,15
9479,validator_4,335792151883,True,752679999,8188190,760868189,True,10
9480,validator_2,498112896960,True,595300000,10524100,605824100,False,15
9481,validator_5,342135918499,True,814419995,18899280,833319275,True,10
9482,validator_8,314402509580,True,607600000,10494230,618094230,False,9
9483,validator_20,180886634430,True,664300000,16570500,680870500,False,5
9484,validator_8,314893519810,True,472600000,18410230,491010230,False,9
9485,validator_35,113009542970,True,567400000,9507330,576907330,False,3
9486,validator_97,61085524460,True,553400000,1981340,555381340,False,1
9487,validator_60,66254998644,True,575839991,10743560,586583551,True,2
9488,validator_23,179051369300,True,492600000,3274370,495874370,False,5
9489,validator_74,50531213880,True,792300000,19594600,811894600,False,1
9490,validator_56,65101792924,True,665060006,22247120,687307126,True,2
9491,validator_9,341848130090,True,549200000,3118980,552318980,False,10
9492,validator_9,342502682340,True,650800000,3752250,654552250,False,10
9493,validator_6,341899972112,True,779280000,34690840,813970840,True,10
9494,validator_73,60504403530,True,584400000,27373380,611773380,False,1
9495,validator_3,527451469810,True,774800000,19205550,794005550,False,16
9496,validator_9,343079715380,True,575300000,1733040,577033040,False,10
9497,validator_6,342753440286,True,783500004,69968170,853468174,True,10
9498,validator_0,555877066405,True,487280005,7661940,494941945,True,17
9499,validator_6,343389439789,True,609286003,26713500,635999503,True,10
9500,validator_71,66546827356,True,767240000,8097140,775337140,True,2
9501,validator_12,186780137465,True,848260004,14987140,863247144,True,5
9502,validator_20,181668885450,True,778210000,4041020,782251020,False,5
9503,validator_35,113607331370,True,588200000,9588400,597788400,False,3
9504,validator_10,306388441320,True,494100000,2269000,496369000,False,9
9505,validator_1,677976686893,True,443700002,7239690,450939692,True,21
9506,validator_5,342748395427,True,594999998,17476930,612476928,True,10
9507,validator_16,185393743372,True,837208000,31634900,868842900,True,5
9508,validator_19,161373044710,True,610700000,2641920,613341920,False,5
9509,validator_30,124094434791,True,622899997,12934510,635834507,True,3
9510,validator_1,678747195181,True,728859988,41648300,770508288,True,21
9511,validator_11,318357112550,True,587200000,1653800,588853800,False,9
9512,validator_2,498758009290,True,642300000,2812330,645112330,False,15
9513,validator_1,679296968229,True,548699998,1073050,549773048,True,21
9514,validator_1,679930485636,True,606540007,26977400,633517407,True,21
9515,validator_7,367002830677,True,697546003,17134290,714680293,True,11
9516,validator_11,318948358090,True,589600000,1645540,591245540,False,9
9517,validator_37,102580581390,True,601400000,10139270,611539270,False,3
9518,validator_1,680620384586,True,680000000,9898950,689898950,True,21
9519,validator_3,528140498890,True,687100000,1929080,689029080,False,16
9520,validator_19,161860058210,True,481400000,5613500,487013500,False,5
9521,validator_34,131603269390,True,617900000,1482320,619382320,False,4
9522,validator_23,179541372200,True,485800000,4202900,490002900,False,5
9523,validator_29,134421610536,True,616265998,5280940,621546938,True,4
9524,validator_0,556787702776,True,885640001,24996370,910636371,True,17
9525,validator_10,307169861570,True,771200000,10220250,781420250,False,9
9526,validator_22,190255811120,True,574900000,21075840,595975840,False,5
9527,validator_43,121486749180,True,664500000,10600770,675100770,False,3
9528,validator_60,67000158352,True,717119998,28039710,745159708,True,2
9529,validator_1,681327666902,True,661439996,45842320,707282316,True,21
9530,validator_55,55740932922,True,744759999,26420300,771180299,True,1
9531,validator_40,109269944090,True,660800000,19612640,680412640,False,3
9532,validator_1,682265291197,True,934799995,2824300,937624295,True,21
9533,validator_17,202384304795,True,826460001,22689040,849149041,True,6
9534,validator_48,54375349856,True,726600004,16328840,742928844,True,1
9535,validator_24,112972616416,True,742846002,22201420,765047422,True,3
9536,validator_33,137173028697,True,519620002,16672700,536292702,True,4
9537,validator_82,56884349080,True,515800000,22002200,537802200,False,1
9538,validator_8,315437084210,True,536800000,6764400,543564400,False,9
9539,validator_60,67913086851,True,888499999,24428500,912928499,True,2
9540,validator_31,135304053294,True,751600000,3804320,755404320,True,4
9541,validator_14,211836013760,True,726099999,7149220,733249219,True,6
9542,validator_10,307795274950,True,623600000,1813380,625413380,False,9
9543,validator_15,202969328541,True,502400002,17013500,519413502,True,6
9544,validator_10,308449497360,True,652900000,1322410,654222410,False,9
9545,validator_1,682906807997,True,628420000,13096800,641516800,True,21
9546,validator_11,319544110920,True,593500000,2252830,595752830,False,9
9547,validator_30,124825216620,True,728299999,2481830,730781829,True,3
9548,validator_18,179910191040,True,617100000,3537440,620637440,False,5
9549,validator_76,58636199170,True,716500000,1766710,718266710,False,1
9550,validator_9,343633466430,True,551800000,1951050,553751050,False,10
9551,validator_11,320270808330,True,716800000,9897410,726697410,False,10
9552,validator_1,683558207297,True,601880000,49519300,651399300,True,21
9553,validator_7,367712071879,True,668540002,40701200,709241202,True,11
9554,validator_8,316075917210,True,636700000,2133000,638833000,False,9
9555,validator_3,528716699030,True,572500000,3700140,576200140,False,16
9556,validator_89,57734937280,True,600700000,1071580,601771580,False,1
9557,validator_44,55557565444,True,582240005,28271300,610511305,True,1
9558,validator_11,320868607330,True,595600000,2199000,597799000,False,10
9559,validator_7,368331771055,True,585206006,34493170,619699176,True,11
9560,validator_12,187640378370,True,840440005,19800900,860240905,True,5
9561,validator_2,499342839900,True,583100000,1730610,584830610,False,15
9562,validator_26,118264973841,True,940599998,8855330,949455328,True,3
9563,validator_40,109897356310,True,624000000,3412220,627412220,False,3
9564,validator_9,344229428230,True,594600000,1361800,595961800,False,10
9565,validator_41,127153651160,True,745500000,21020140,766520140,False,3
9566,validator_11,321572548330,True,667100000,36841000,703941000,False,10
9567,validator_7,368939844763,True,587920008,20153700,608073708,True,11
9568,validator_52,59541872434,True,734000003,5343280,739343283,True,1
9569,validator_43,122133370310,True,640400000,6221130,646621130,False,3
9570,validator_15,203987194260,True,1006863999,11001720,1017865719,True,6
9571,validator_1,684378387126,True,792919999,27259830,820179829,True,21
9572,validator_31,136171562404,True,827870010,39639100,867509110,True,4
9573,validator_37,103207368660,True,616500000,10287270,626787270,False,3
9574,validator_10,308963599670,True,512300000,1802310,514102310,False,9
9575,validator_2,499823385480,True,478200000,2345580,480545580,False,15
9576,validator_16,186197309451,True,781599999,21966080,803566079,True,5
9577,validator_24,113702804526,True,729300000,888110,730188110,True,3
9578,validator_83,53844491190,True,532600000,8701510,541301510,False,1
9579,validator_8,316654177210,True,565600000,12660000,578260000,False,9
9580,validator_31,137088080631,True,891339997,25178230,916518227,True,4
9581,validator_39,126503324160,True,635400000,7085230,642485230,False,3
9582,validator_34,132098066350,True,484000000,10796960,494796960,False,4
9583,validator_11,322208689950,True,632700000,3441620,636141620,False,10
9584,validator_69,53763463604,True,598699999,19530870,618230869,True,1
9585,validator_36,122639687290,True,553100000,664410,553764410,False,3
9586,validator_8,317300569880,True,624400000,21992670,646392670,False,9
9587,validator_1,685148347061,True,766299995,3659940,769959935,True,21
9588,validator_1,685736925288,True,572539997,16038230,588578227,True,21
9589,validator_8,317903676510,True,593400000,9706630,603106630,False,9
9590,validator_11,322873150980,True,660800000,3661030,664461030,False,10
9591,validator_7,369614920360,True,640079997,34995600,675075597,True,11
9592,validator_8,318552963270,True,648100000,1186760,649286760,False,9
9593,validator_6,344162024607,True,766159998,6424820,772584818,True,10
9594,validator_72,57933445730,True,647700000,9201400,656901400,False,1
9595,validator_39,127235375480,True,723200000,8851320,732051320,False,3
9596,validator_12,188349444732,True,702840002,6226360,709066362,True,5
9597,validator_4,336247749406,True,439367993,16229530,455597523,True,10
9598,validator_23,180224422520,True,671800000,11250320,683050320,False,5
9599,validator_9,344837093170,True,587500000,20164940,607664940,False,10
9600,validator_8,319168807870,True,612200000,3644600,615844600,False,9
9601,validator_12,189177553673,True,783940001,44168940,828108941,True,5
9602,validator_5,343453482808,True,700600001,4487380,705087381,True,10
9603,validator_33,137857529192,True,659599995,24900500,684500495,True,4
9604,validator_17,202952705129,True,554684004,13716330,568400334,True,6
9605,validator_25,149004576145,True,487546005,31112170,518658175,True,4
9606,validator_2,500361476040,True,536300000,1790560,538090560,False,15
9607,validator_23,180924175400,True,697200000,2552880,699752880,False,5
9608,validator_10,309617319240,True,651900000,1819570,653719570,False,9
9609,validator_0,557510273152,True,690486006,32084370,722570376,True,17
9610,validator_2,500872656880,True,509300000,1880840,511180840,False,15
9611,validator_3,529204158220,True,484770000,2689190,487459190,False,16
9612,validator_34,132530641930,True,429100000,3475580,432575580,False,4
9613,validator_32,128512465436,True,461350001,56986840,518336841,True,4
9614,validator_7,370416652081,True,774660001,27071720,801731721,True,11
9615,validator_54,59175566593,True,617760005,30807130,648567135,True,1
9616,validator_3,529950074850,True,737600000,8316630,745916630,False,16
9617,validator_6,344703992286,True,533239999,8727680,541967679,True,10
9618,validator_5,344250270480,True,770454002,26333670,796787672,True,10
9619,validator_56,65850858390,True,740900006,8165460,749065466,True,2
9620,validator_73,61203676730,True,694200000,5073200,699273200,False,1
9621,validator_23,181413676130,True,482600000,6900730,489500730,False,5
9622,validator_1,686247631639,True,507800001,2906350,510706351,True,21
9623,validator_4,336630204373,True,373219997,9234970,382454967,True,10
9624,validator_15,204543464092,True,533140002,23129830,556269832,True,6
9625,validator_7,371441071018,True,1021899997,2518940,1024418937,True,11
9626,validator_9,345452256270,True,614500000,663100,615163100,False,10
9627,validator_37,104040169860,True,830900000,1901200,832801200,False,3
9628,validator_18,180431969780,True,518600000,3178740,521778740,False,5
9629,validator_9,346044634260,True,589700000,2677990,592377990,False,10
9630,validator_14,212521539978,True,664539998,20986220,685526218,True,6
9631,validator_4,337335552859,True,700373996,4974490,705348486,True,10
9632,validator_5,345110108498,True,818159998,41678020,859838018,True,10
9633,validator_7,372063445266,True,592420008,29954240,622374248,True,11
9634,validator_26,118959055732,True,660399991,33681900,694081891,True,3
9635,validator_1,686964359562,True,689360003,27367920,716727923,True,21
9636,validator_13,199940036035,True,633120000,19892520,653012520,True,6
9637,validator_0,558283563692,True,724200000,49090540,773290540,True,17
9638,validator_72,58543452840,True,604900000,5107110,610007110,False,1
9639,validator_4,338123909055,True,778539996,9816200,788356196,True,10
9640,validator_97,61616177430,True,526370000,4282970,530652970,False,1
9641,validator_22,190802114860,True,536000000,10303740,546303740,False,5
9642,validator_74,51201740030,True,667400000,3126150,670526150,False,1
9643,validator_11,323429794630,True,554400000,2243650,556643650,False,10
9644,validator_17,203614635660,True,654239991,7690540,661930531,True,6
9645,validator_29,134954627685,True,503359989,29657160,533017149,True,4
9646,validator_20,182272170850,True,601200000,2085400,603285400,False,5
9647,validator_29,135879524883,True,921619998,3277200,924897198,True,4
9648,validator_10,310264491410,True,644800000,2372170,647172170,False,9
9649,validator_14,213657670814,True,1128600006,7530830,1136130836,True,6
9650,validator_47,60787524971,True,831453994,61092420,892546414,True,1
9651,validator_76,59579458190,True,896800000,46459020,943259020,False,1
9652,validator_4,338861000746,True,718040001,19051690,737091691,True,10
9653,validator_12,189945221559,True,729579996,38087890,767667886,True,5
9654,validator_7,372592777364,True,501263998,28068100,529332098,True,11
9655,validator_17,204256137765,True,610860005,30642100,641502105,True,6
9656,validator_13,200598899352,True,641999997,16863320,658863317,True,6
9657,validator_39,127756142800,True,519000000,1767320,520767320,False,3
9658,validator_28,135874635092,True,594299997,3666860,597966857,True,4
9659,validator_31,137791907770,True,686039999,17787140,703827139,True,4
9660,validator_62,63001687040,True,580040003,25144380,605184383,True,1
9661,validator_6,345464092922,True,727929996,32170640,760100636,True,10
9662,validator_17,205000786416,True,717080001,27568650,744648651,True,6
9663,validator_10,310761533320,True,495500000,1541910,497041910,False,9
9664,validator_25,149788322344,True,763899999,19846200,783746199,True,4
9665,validator_36,123183293850,True,540770000,2836560,543606560,False,3
9666,validator_6,346046520463,True,502620001,79807540,582427541,True,10
9667,validator_1,687759722057,True,744739995,50622500,795362495,True,21
9668,validator_2,501588422380,True,713500000,2265500,715765500,False,15
9669,validator_86,58850803910,True,552000000,7751990,559751990,False,1
9670,validator_4,339449041904,True,566699998,21341160,588041158,True,10
9671,validator_31,138426403762,True,626600002,7895990,634495992,True,4
9672,validator_3,530723587930,True,753800000,19713080,773513080,False,16
9673,validator_11,324244458300,True,793700000,20963670,814663670,False,10
9674,validator_0,559007126741,True,715959989,7603060,723563049,True,17
9675,validator_3,531551077610,True,824700000,2789680,827489680,False,16
9676,validator_4,340057696690,True,549780006,58874780,608654786,True,10
9677,validator_20,182847754030,True,573400000,2183180,575583180,False,5
9678,validator_2,502051692580,True,460400000,2870200,463270200,False,15
9679,validator_1,688413009009,True,646319992,6966960,653286952,True,21
9680,validator_2,502707299300,True,651400000,4206720,655606720,False,15
9681,validator_27,119096244697,True,643860003,9474990,653334993,True,3
9682,validator_29,136416153823,True,529300000,7328940,536628940,True,4
9683,validator_0,559586090037,True,575639996,3323300,578963296,True,17
9684,validator_38,117629790640,True,659100000,3119370,662219370,False,3
9685,validator_0,560290432734,True,675919997,28422700,704342697,True,17
9686,validator_33,138567415581,True,707699989,2186400,709886389,True,4
9687,validator_4,340855363821,True,783580011,14087120,797667131,True,10
9688,validator_5,345745921601,True,607396003,28417100,635813103,True,10
9689,validator_4,341668847918,True,774100007,39384090,813484097,True,10
9690,validator_11,324915875400,True,668900000,2517100,671417100,False,10
9691,validator_8,319823072970,True,650600000,3665100,654265100,False,9
9692,validator_1,688937831789,True,512700000,12122780,524822780,True,21
9693,validator_35,114225613190,True,591900000,26381820,618281820,False,3
9694,validator_23,182016130050,True,600500000,1953920,602453920,False,5
9695,validator_39,128376049730,True,614900000,5006930,619906930,False,4
9696,validator_65,59712803342,True,740400001,2005790,742405791,True,1
9697,validator_12,190635005497,True,666019998,23763940,689783938,True,5
9698,validator_22,191338563900,True,534200000,2249040,536449040,False,5
9699,validator_22,192106402040,True,765000000,2838140,767838140,False,6
9700,validator_3,532059165940,True,505800000,2288330,508088330,False,16
9701,validator_3,532626067840,True,564400000,2501900,566901900,False,16
9702,validator_12,191154699914,True,509820007,9874410,519694417,True,5
9703,validator_18,181092884900,True,652300000,8615120,660915120,False,5
9704,validator_7,373349179872,True,746019998,10382510,756402508,True,11
9705,validator_45,57427536240,True,640999999,10250900,651250899,True,1
9706,validator_7,373959900175,True,601540003,9180300,610720303,True,11
9707,validator_67,56662003871,True,911000006,6278310,917278316,True,1
9708,validator_24,114296759422,True,567520006,26434890,593954896,True,3
9709,validator_18,181738077000,True,641600000,3592100,645192100,False,5
9710,validator_3,533278272170,True,643400000,8804330,652204330,False,16
9711,validator_27,119916701294,True,780179997,40276600,820456597,True,3
9712,validator_2,503227776040,True,492400000,28076740,520476740,False,15
9713,validator_1,689911283864,True,970300005,3152070,973452075,True,21
9714,validator_9,346667901740,True,620400000,2867480,623267480,False,10
9715,validator_9,347599302540,True,910000000,21400800,931400800,False,10
9716,validator_1,690639551797,True,702139993,26127940,728267933,True,21
9717,validator_32,129165665273,True,647320007,5879830,653199837,True,4
9718,validator_24,115116560923,True,809900001,9901500,819801501,True,3
9719,validator_28,136803310293,True,906180001,22495200,928675201,True,4
9720,validator_1,691118309902,True,475260005,3498100,478758105,True,21
9721,validator_12,191774380911,True,540759997,78921000,619680997,True,5
9722,validator_3,534050833210,True,769300000,3261040,772561040,False,16
9723,validator_1,691777079245,True,633980003,24789340,658769343,True,21
9724,validator_27,120828063775,True,848883991,62478490,911362481,True,3
9725,validator_3,534560541610,True,507800000,1908400,509708400,False,16
9726,validator_16,186936185000,True,724340009,14535540,738875549,True,5
9727,validator_20,183501775730,True,646300000,7721700,654021700,False,5
9728,validator_42,122017780180,True,621200000,5383500,626583500,False,3
9729,validator_59,51336488320,True,770004001,21253280,791257281,True,1
9730,validator_27,121662721863,True,826367998,8290090,834658088,True,3
9731,validator_19,162476111420,True,577700000,38353210,616053210,False,5
9732,validator_9,348333234180,True,715100000,18831640,733931640,False,10
9733,validator_3,535214743740,True,646500000,7702130,654202130,False,16
9734,validator_2,503777757040,True,546800000,3181000,549981000,False,15
9735,validator_2,504182380740,True,400900000,3723700,404623700,False,15
9736,validator_83,54354665230,True,506300000,3874040,510174040,False,1
9737,validator_29,136962429939,True,533369996,12906120,546276116,True,4
9738,validator_47,61312308975,True,519799994,4984010,524784004,True,1
9739,validator_23,182730558850,True,694900000,19528800,714428800,False,5
9740,validator_41,127756284560,True,599400000,3233400,602633400,False,3
9741,validator_9,348905019660,True,566100000,5685480,571785480,False,10
9742,validator_53,58228239362,True,965660001,7696400,973356401,True,1
9743,validator_36,123831177920,True,645500000,2384070,647884070,False,3
9744,validator_0,561032171879,True,740500005,1239140,741739145,True,17
9745,validator_39,128896729630,True,518000000,2679900,520679900,False,4
9746,validator_7,374653408179,True,682800004,10708000,693508004,True,11
9747,validator_4,342268129905,True,581620007,17661980,599281987,True,10
9748,validator_51,55541820321,True,618420000,27585600,646005600,True,1
9749,validator_70,57067995500,True,637200001,5567800,642767801,True,1
9750,validator_6,346533219854,True,483600001,3099390,486699391,True,10
9751,validator_2,504898834730,True,707500000,8953990,716453990,False,15
9752,validator_5,346589982901,True,833800000,10261300,844061300,True,10
9753,validator_1,692246049945,True,435000000,33970700,468970700,True,21
9754,validator_43,122837738780,True,693900000,10468470,704368470,False,3
9755,validator_39,129605009470,True,707100000,1179840,708279840,False,4
9756,validator_95,52467719780,True,463300000,20455800,483755800,False,1
9757,validator_1,692890718947,True,624399992,20269010,644669002,True,21
9758,validator_34,133038758140,True,504800000,3316210,508116210,False,4
9759,validator_1,693795929551,True,894020004,11190600,905210604,True,21
9760,validator_1,694784022655,True,939300004,48793100,988093104,True,21
9761,validator_0,561930900112,True,865460003,33268230,898728233,True,17
9762,validator_0,562631751629,True,665479997,35371520,700851517,True,17
9763,validator_66,63832132661,True,469083993,33249330,502333323,True,1
9764,validator_1,695248114256,True,460560001,3531600,464091601,True,21
9765,validator_23,183249284090,True,516900000,1825240,518725240,False,5
9766,validator_3,535970756280,True,753900000,2112540,756012540,False,16
9767,validator_4,343054879975,True,784900000,1850070,786750070,True,10
9768,validator_27,122517665564,True,847380001,7563700,854943701,True,3
9769,validator_31,139229963466,True,796400004,7159700,803559704,True,4
9770,validator_3,536645024100,True,673400000,867820,674267820,False,16
9771,validator_5,347269146605,True,668800004,10363700,679163704,True,10
9772,validator_7,375582220111,True,926160002,2651930,928811932,True,11
9773,validator_40,110644392210,True,744200000,2835900,747035900,False,3
9774,validator_0,563444147645,True,806399996,5996020,812396016,True,17
9775,validator_7,376235903048,True,632519997,21162940,653682937,True,11
9776,validator_35,115168114040,True,920200000,22300850,942500850,False,3
9777,validator_17,205640335247,True,619700001,19848830,639548831,True,6
9778,validator_37,104638098090,True,580800000,17128230,597928230,False,3
9779,validator_25,150525619237,True,712839993,24456900,737296893,True,4
9780,validator_11,325418311990,True,500800000,1636590,502436590,False,10
9781,validator_36,124434959150,True,584100000,19681230,603781230,False,3
9782,validator_11,325862768100,True,442000000,2456110,444456110,False,10
9783,validator_24,115887749627,True,766810004,4378700,771188704,True,3
9784,validator_9,349630211770,True,723600000,1592110,725192110,False,10
9785,validator_10,311410211910,True,647500000,1178590,648678590,False,9
9786,validator_16,187728130294,True,769599994,22345300,791945294,True,5
9787,validator_80,51081950050,True,642600000,21097930,663697930,False,1
9788,validator_16,188367204292,True,628339998,10734000,639073998,True,5
9789,validator_3,537212440100,True,558500000,8916000,567416000,False,16
9790,validator_19,163055791730,True,577300000,2380310,579680310,False,5
9791,validator_80,51892927580,True,808000000,2977530,810977530,False,1
9792,validator_1,695898888192,True,640340006,10433930,650773936,True,21
9793,validator_25,151150809837,True,599240000,25950600,625190600,True,4
9794,validator_91,47924977960,True,613800000,15695700,629495700,False,1
9795,validator_36,125129458050,True,692500000,1998900,694498900,False,3
9796,validator_8,320332633640,True,499700000,9860670,509560670,False,10
9797,validator_16,188999133090,True,606279998,25648800,631928798,True,5
9798,validator_22,192838859180,True,712000000,20457140,732457140,False,6
9799,validator_16,189616627586,True,603299996,14194500,617494496,True,5
9800,validator_9,350195362500,True,549900000,15250730,565150730,False,10
9801,validator_0,564139218276,True,631540001,63530630,695070631,True,17
9802,validator_2,505618675150,True,718200000,1640420,719840420,False,15
9803,validator_24,116636120407,True,724940000,23430780,748370780,True,3
9804,validator_27,123265952864,True,724560000,23727300,748287300,True,3
9805,validator_1,696731622510,True,787320008,45414310,832734318,True,21
9806,validator_1,697249797812,True,502340002,15835300,518175302,True,21
9807,validator_99,46221311290,True,697000000,16383080,713383080,False,1
9808,validator_1,697870427385,True,600380003,20249570,620629573,True,21
9809,validator_40,111380151950,True,734400000,1359740,735759740,False,3
9810,validator_5,348064237003,True,784139998,10950400,795090398,True,10
9811,validator_19,163532509370,True,473400000,3317640,476717640,False,5
9812,validator_14,214589342518,True,903706004,27965700,931671704,True,6
9813,validator_11,326502598530,True,635900000,3930430,639830430,False,10
9814,validator_1,698478672137,True,580339992,27904760,608244752,True,21
9815,validator_25,151991882691,True,794139994,46932860,841072854,True,4
9816,validator_25,152556367820,True,544259999,20225130,564485129,True,4
9817,validator_28,137595083441,True,786039998,5733150,791773148,True,4
9818,validator_2,506418515890,True,798600000,1240740,799840740,False,15
9819,validator_36,125642825090,True,510880000,2487040,513367040,False,3
9820,validator_18,182436141980,True,696200000,1864980,698064980,False,5
9821,validator_4,343807723605,True,741600000,11243630,752843630,True,10
9822,validator_5,348709579385,True,625140002,20202380,645342382,True,10
9823,validator_28,138076547548,True,438910007,42554100,481464107,True,4
9824,validator_5,349394052686,True,675340001,9133300,684473301,True,10
9825,validator_90,56036540300,True,659700000,3073090,662773090,False,1
9826,validator_29,137597979838,True,609659999,25889900,635549899,True,4
9827,validator_12,192498962655,True,679300004,45281740,724581744,True,6
9828,validator_10,311943300150,True,526300000,6788240,533088240,False,9
9829,validator_23,183888644310,True,636900000,2460220,639360220,False,5
9830,validator_15,205124033691,True,570499999,10069600,580569599,True,6
9831,validator_14,215357213027,True,761120009,6750500,767870509,True,6
9832,validator_97,62249899970,True,629700000,4022540,633722540,False,1
9833,validator_12,193620820012,True,1101899997,19957360,1121857357,True,6
9834,validator_10,312490008230,True,544700000,2008080,546708080,False,9
9835,validator_98,47930911110,True,460500000,2357390,462857390,False,1
9836,validator_92,47116563570,True,463800000,2596900,466396900,False,1
9837,validator_41,128303087710,True,525900000,20903150,546803150,False,4
9838,validator_36,126193754470,True,549200000,1729380,550929380,False,3
9839,validator_12,194139850290,True,492039998,26990280,519030278,True,6
9840,validator_40,111900509050,True,518300000,2057100,520357100,False,3
9841,validator_38,118247792200,True,612600000,5401560,618001560,False,3
9842,validator_15,205759203803,True,620980002,14190110,635170112,True,6
9843,validator_13,201418649546,True,800900004,18850190,819750194,True,6
9844,validator_17,206393488991,True,745160004,7993740,753153744,True,6
9845,validator_6,347279507933,True,705959999,40328080,746288079,True,10
9846,validator_32,129821994429,True,636480006,19849150,656329156,True,4
9847,validator_11,327102881630,True,598200000,2083100,600283100,False,10
9848,validator_37,105255664800,True,609900000,7666710,617566710,False,3
9849,validator_21,186695932390,True,579100000,2986460,582086460,False,5
9850,validator_21,187234027420,True,536200000,1895030,538095030,False,5
9851,validator_55,56379107731,True,595800009,42374800,638174809,True,1
9852,validator_22,193437291820,True,585200000,13232640,598432640,False,6
9853,validator_1,699346700399,True,840410002,27618260,868028262,True,21
9854,validator_4,344506919037,True,688380002,10815430,699195432,True,10
9855,validator_13,201885810138,True,458100002,9060590,467160592,True,6
9856,validator_92,47701118950,True,581900000,2655380,584555380,False,1
9857,validator_54,59787445580,True,610700007,1178980,611878987,True,1
9858,validator_3,537729965140,True,512100000,5425040,517525040,False,16
9859,validator_29,138179425325,True,563543997,17901490,581445487,True,4
9860,validator_33,139331802678,True,758995997,5391100,764387097,True,4
9861,validator_21,187803609580,True,567200000,2382160,569582160,False,5
9862,validator_1,699937724099,True,552760000,38263700,591023700,True,21
9863,validator_11,327628318560,True,521700000,3736930,525436930,False,10
9864,validator_13,202717806539,True,825900001,6096400,831996401,True,6
9865,validator_3,538054510060,True,315400000,9144920,324544920,False,16
9866,validator_60,68668096553,True,728900002,26109700,755009702,True,2
9867,validator_86,59375076310,True,522560000,1712400,524272400,False,1
9868,validator_37,105824884330,True,562700000,6519530,569219530,False,3
9869,validator_4,345337874741,True,828400004,2555700,830955704,True,10
9870,validator_5,350324986330,True,908549994,22383650,930933644,True,10
9871,validator_2,507128170930,True,706400000,3255040,709655040,False,15
9872,validator_14,216201858636,True,824420009,20225600,844645609,True,6
9873,validator_9,350773834440,True,574800000,3671940,578471940,False,10
9874,validator_6,347935820135,True,617738002,38574200,656312202,True,10
9875,validator_17,207082229771,True,645160000,43580780,688740780,True,6
9876,validator_26,119650095438,True,676740006,14299700,691039706,True,3
9877,validator_29,138903438319,True,682200004,41812990,724012994,True,4
9878,validator_0,564813233913,True,636219997,37795640,674015637,True,17
9879,validator_1,700641312483,True,666499994,37088390,703588384,True,21
9880,validator_2,507813183540,True,664400000,20612610,685012610,False,15
9881,validator_23,184382177460,True,488000000,5533150,493533150,False,5
9882,validator_93,52208378860,True,905800000,1809040,907609040,False,1
9883,validator_1,701157335179,True,513199996,2822700,516022696,True,21
9884,validator_7,376877381209,True,635920001,5558160,641478161,True,11
9885,validator_27,123964718874,True,689140000,9626010,698766010,True,3
9886,validator_24,117355290036,True,702539999,16629630,719169629,True,3
9887,validator_7,377571235906,True,679619997,14234700,693854697,True,11
9888,validator_37,106400949410,True,572700000,3365080,576065080,False,3
9889,validator_45,58066509754,True,630620004,8353510,638973514,True,1
9890,validator_53,58789606942,True,539640000,21727580,561367580,True,1
9891,validator_26,120261543033,True,595139995,16307600,611447595,True,3
9892,validator_3,538580440760,True,519400000,6530700,525930700,False,16
9893,validator_65,60376732764,True,661399992,2529430,663929422,True,1
9894,validator_77,52103695290,True,526700000,26262380,552962380,False,1
9895,validator_33,140276148790,True,922800002,21546110,944346112,True,4
9896,validator_11,328221459500,True,589200000,3940940,593140940,False,10
9897,validator_13,203478131238,True,757519999,2804700,760324699,True,6
9898,validator_98,48552556320,True,607100000,14545210,621645210,False,1
9899,validator_9,351526390640,True,728700000,23856200,752556200,False,10
9900,validator_0,565500013053,True,685800000,979140,686779140,True,17
9901,validator_70,57664767142,True,590397992,6373650,596771642,True,1
9902,validator_29,139652400553,True,692039994,56922240,748962234,True,4
9903,validator_0,566521540216,True,989539993,31987170,1021527163,True,17
9904,validator_60,69240021773,True,552440000,19485220,571925220,True,2
9905,validator_31,140064015861,True,775580005,58472390,834052395,True,4
9906,validator_4,345911072495,True,541179994,32017760,573197754,True,10
9907,validator_3,539214637850,True,630800000,3397090,634197090,False,16
9908,validator_42,122807090400,True,787000000,2310220,789310220,False,3
9909,validator_1,702003591480,True,826320001,19936300,846256301,True,21
9910,validator_33,140964097538,True,658930008,29018740,687948748,True,4
9911,validator_6,348777165908,True,820900003,20445770,841345773,True,10
9912,validator_14,216890006431,True,678639995,9507800,688147795,True,6
9913,validator_16,190113829754,True,495599998,1602170,497202168,True,5
9914,validator_67,57417965000,True,717019999,38941130,755961129,True,1
9915,validator_0,566997697009,True,458219993,17936800,476156793,True,17
9916,validator_39,130278722130,True,662300000,11412660,673712660,False,4
9917,validator_31,140658858664,True,565740003,29102800,594842803,True,4
9918,validator_51,56328584994,True,769960003,16804670,786764673,True,1
9919,validator_27,124641753108,True,656719994,20314240,677034234,True,3
9920,validator_0,567805555385,True,787519996,20338380,807858376,True,17
9921,validator_1,702732530540,True,704300000,24639060,728939060,True,21
9922,validator_2,508455691470,True,634000000,8507930,642507930,False,15
9923,validator_60,69846634541,True,592864008,13748760,606612768,True,2
9924,validator_7,378161555235,True,580639999,9679330,590319329,True,11
9925,validator_0,568472500579,True,637880004,29065190,666945194,True,17
9926,validator_4,346683838533,True,733199998,39566040,772766038,True,10
9927,validator_70,58273048979,True,590180007,18101830,608281837,True,1
9928,validator_7,378892885609,True,724700004,6630370,731330374,True,11
9929,validator_10,313093330170,True,602400000,921940,603321940,False,9
9930,validator_0,569297664880,True,800900001,24264300,825164301,True,17
9931,validator_3,539868862150,True,609400000,44824300,654224300,False,16
9932,validator_22,194206489530,True,729900000,39297710,769197710,False,6
9933,validator_2,509109651160,True,645600000,8359690,653959690,False,15
9934,validator_20,183961482420,True,440100000,19606690,459706690,False,5
9935,validator_1,703522892936,True,747119996,43242400,790362396,True,21
9936,validator_21,188345111080,True,539800000,1701500,541501500,False,5
9937,validator_2,509752477040,True,640200000,2625880,642825880,False,15
9938,validator_18,182984982780,True,547600000,1240800,548840800,False,5
9939,validator_1,704352325268,True,791620002,37812330,829432332,True,22
9940,validator_53,59407054586,True,600074004,17373640,617447644,True,1
9941,validator_86,60243040830,True,865100000,2864520,867964520,False,1
9942,validator_18,183571795740,True,572000000,14812960,586812960,False,5
9943,validator_1,705433372001,True,1078400003,2646730,1081046733,True,22
9944,validator_14,217474384548,True,564359997,20018120,584378117,True,6
9945,validator_11,328611394320,True,387000000,2934820,389934820,False,10
9946,validator_34,133876532270,True,818000000,19774130,837774130,False,4
9947,validator_37,107090993790,True,681200000,8844380,690044380,False,3
9948,validator_26,120823904509,True,540969996,21391480,562361476,True,3
9949,validator_39,130736120140,True,455300000,2098010,457398010,False,4
9950,validator_0,570094292371,True,772032001,24595490,796627491,True,17
9951,validator_37,107645720510,True,552800000,1926720,554726720,False,3
9952,validator_1,705959356812,True,496600001,29384810,525984811,True,22
9953,validator_1,706852827339,True,885819997,7650530,893470527,True,22
9954,validator_20,184585082190,True,617700000,5899770,623599770,False,5
9955,validator_22,194746710710,True,538200000,2021180,540221180,False,6
9956,validator_70,58760696484,True,469794005,17853500,487647505,True,1
9957,validator_66,64303055364,True,447288003,23634700,470922703,True,2
9958,validator_15,206358118108,True,565158005,33756300,598914305,True,6
9959,validator_29,140419381349,True,758699996,8280800,766980796,True,4
9960,validator_43,123695931000,True,835900000,22292220,858192220,False,3
9961,validator_71,67143831658,True,585940002,11064300,597004302,True,2
9962,validator_4,347406183972,True,712799999,9545440,722345439,True,10
9963,validator_25,153314422524,True,745860004,12194700,758054704,True,4
9964,validator_21,188844656080,True,496400000,3145000,499545000,False,5
9965,validator_95,53173323880,True,704000000,1604100,705604100,False,1
9966,validator_17,207894238475,True,785740004,26268700,812008704,True,6
9967,validator_23,185024762860,True,639400000,3185400,642585400,False,5
9968,validator_30,125456257731,True,618200001,12841110,631041111,True,3
9969,validator_33,141549312069,True,547020001,38194530,585214531,True,4
9970,validator_10,313936309200,True,841700000,1279030,842979030,False,9
9971,validator_72,59149446560,True,589500000,16493720,605993720,False,1
9972,validator_80,52636573580,True,722600000,21046000,743646000,False,1
9973,validator_32,130552260454,True,703100005,27166020,730266025,True,4
9974,validator_11,329212987730,True,564300000,37293410,601593410,False,10
9975,validator_3,540508340250,True,636600000,2878100,639478100,False,16
9976,validator_1,707565679739,True,689900000,22952400,712852400,True,22
9977,validator_98,49103399450,True,543900000,6943130,550843130,False,1
9978,validator_78,52553595850,True,599200000,30550400,629750400,False,1
9979,validator_66,64965857068,True,626840004,35961700,662801704,True,2
9980,validator_3,541279157990,True,752000000,18817740,770817740,False,16
9981,validator_61,64968314384,True,621399999,14294160,635694159,True,2
9982,validator_10,314575683900,True,636000000,3374700,639374700,False,9
9983,validator_4,348319965051,True,902739999,11041080,913781079,True,10
9984,validator_21,189390635000,True,544100000,1878920,545978920,False,5
9985,validator_9,352181349800,True,652000000,2959160,654959160,False,11
9986,validator_3,541995802380,True,711600000,5044390,716644390,False,16
9987,validator_10,315294544590,True,698600000,20260690,718860690,False,9
9988,validator_4,348942641650,True,599079999,23596600,622676599,True,10
9989,validator_4,349704221026,True,710800006,50779370,761579376,True,10
9990,validator_10,315967834120,True,663400000,9889530,673289530,False,9
9991,validator_2,510368688360,True,605600000,10611320,616211320,False,15
9992,validator_1,708426606031,True,812259992,48666300,860926292,True,22
9993,validator_43,124265610260,True,567600000,2079260,569679260,False,3
9994,validator_39,131463545150,True,725000000,2425010,727425010,False,4
9995,validator_63,58790309454,True,813323999,34943080,848267079,True,1
9996,validator_76,60185255390,True,603300000,2497200,605797200,False,1
9997,validator_16,190751448458,True,631440004,6178700,637618704,True,5
9998,validator_41,128905727850,True,599500000,3140140,602640140,False,4
9999,validator_54,60369868170,True,559180010,23242580,582422590,True,1
