block_num,validator_id,validator_capital,validator_restaking_factor,total_gas_fee,total_mev_available,block_reward,is_attacker,num_validator_nodes
0,validator_37,64631280880,True,610900000,20380880,631280880,False,2
1,validator_6,32677257596,True,623805996,53451600,677257596,True,1
2,validator_22,64690711201,True,675600001,15111200,690711201,True,2
3,validator_18,96611340368,True,601887998,9452370,611340368,True,3
4,validator_17,160683199436,True,667439996,15759440,683199436,True,5
5,validator_15,256837156330,True,819100010,18056320,837156330,True,8
6,validator_18,97266064002,True,608120004,46603630,654723634,True,3
7,validator_12,96721139793,True,701399993,19739800,721139793,True,3
8,validator_43,64684057630,True,673400000,10657630,684057630,False,2
9,validator_31,160668210430,True,667000000,1210430,668210430,False,5
10,validator_47,64605005890,True,603100000,1905890,605005890,False,2
11,validator_40,32870399010,True,861440000,8959010,870399010,False,1
12,validator_15,257804670590,True,943239990,24274270,967514260,True,8
13,validator_33,32477134450,True,466800000,10334450,477134450,False,1
14,validator_21,64684431399,True,655759999,28671400,684431399,True,2
15,validator_4,32691523100,True,688300000,3223100,691523100,True,1
16,validator_40,33627699270,True,753100000,4200260,757300260,False,1
17,validator_43,65431288270,True,742900000,4330640,747230640,False,2
18,validator_48,160461708600,True,460300000,1408600,461708600,False,5
19,validator_44,96611713230,True,591500000,20213230,611713230,False,3
20,validator_35,96708883750,True,707300000,1583750,708883750,False,3
21,validator_34,256621518000,True,600800000,20718000,621518000,False,8
22,validator_16,33199319626,True,1175800006,23519620,1199319626,True,1
23,validator_18,98155914641,True,883639999,6210640,889850639,True,3
24,validator_17,161390454481,True,700640005,6615040,707255045,True,5
25,validator_29,32415030420,True,411000000,4030420,415030420,False,1
26,validator_21,65325629944,True,621620005,19578540,641198545,True,2
27,validator_46,96478311960,True,474100000,4211960,478311960,False,3
28,validator_34,257306179200,True,681900000,2761200,684661200,False,8
29,validator_15,258412185573,True,600420003,7094980,607514983,True,8
30,validator_17,162023657911,True,599580000,33623430,633203430,True,5
31,validator_1,64679357136,True,658158006,21199130,679357136,True,2
32,validator_36,96771663040,True,751300000,20363040,771663040,False,3
33,validator_17,162613618517,True,567700006,22260600,589960606,True,5
34,validator_29,32894804060,True,470800000,8973640,479773640,False,1
35,validator_10,32944798713,True,926540003,18258710,944798713,True,1
36,validator_0,32497179680,True,473740000,23439680,497179680,True,1
37,validator_42,32773918850,True,771600000,2318850,773918850,False,1
38,validator_38,32490139800,True,487500000,2639800,490139800,False,1
39,validator_48,161119616580,True,637100000,20807980,657907980,False,5
40,validator_31,161119972100,True,449400000,2361670,451761670,False,5
41,validator_14,96648541321,True,610659991,37881330,648541321,True,3
42,validator_8,32695089031,True,659900001,35189030,695089031,True,1
43,validator_15,259101007183,True,660320010,28501600,688821610,True,8
44,validator_34,257947360300,True,638600000,2581100,641181100,False,8
45,validator_14,97481631821,True,805600010,27490490,833090500,True,3
46,validator_46,97119413380,True,620300000,20801420,641101420,False,3
47,validator_43,65870481560,True,433100000,6093290,439193290,False,2
48,validator_11,32655678308,True,611560008,44118300,655678308,True,1
49,validator_37,65115372770,True,482200000,1891890,484091890,False,2
50,validator_36,97450829760,True,668800000,10366720,679166720,False,3
51,validator_29,33458722860,True,560500000,3418800,563918800,False,1
52,validator_27,96519437370,True,511300000,8137370,519437370,False,3
53,validator_38,33067308290,True,573700000,3468490,577168490,False,1
54,validator_27,97285918340,True,765500000,980970,766480970,False,3
55,validator_32,32660186940,True,658800000,1386940,660186940,False,1
56,validator_17,163283653679,True,642073992,27961170,670035162,True,5
57,validator_18,98952031546,True,762520005,33596900,796116905,True,3
58,validator_33,33178980850,True,699000000,2846400,701846400,False,1
59,validator_0,33039339316,True,497220006,44939630,542159636,True,1
60,validator_34,258461767590,True,476000000,38407290,514407290,False,8
61,validator_25,32589542080,True,583100000,6442080,589542080,False,1
62,validator_31,161554493530,True,422900000,11621430,434521430,False,5
63,validator_47,65142277920,True,536800000,472030,537272030,False,2
64,validator_1,65412360543,True,727199997,5803410,733003407,True,2
65,validator_29,34047073300,True,577500000,10850440,588350440,False,1
66,validator_34,259275224350,True,812200000,1256760,813456760,False,8
67,validator_30,64720902000,True,717700000,3202000,720902000,False,2
68,validator_25,33154174320,True,564000000,632240,564632240,False,1
69,validator_47,65746921240,True,596900000,7743320,604643320,False,2
70,validator_46,97513750410,True,390000000,4337030,394337030,False,3
71,validator_13,32649050043,True,609560003,39490040,649050043,True,1
72,validator_8,33294996165,True,580179994,19727140,599907134,True,1
73,validator_37,65674906410,True,531300000,28233640,559533640,False,2
74,validator_39,32695995320,True,694500000,1495320,695995320,False,1
75,validator_36,98023516800,True,569200000,3487040,572687040,False,3
76,validator_14,97932242527,True,448900006,1710700,450610706,True,3
77,validator_15,259671399581,True,567600008,2792390,570392398,True,8
78,validator_14,98586868726,True,631099999,23526200,654626199,True,3
79,validator_30,65261267600,True,539200000,1165600,540365600,False,2
80,validator_44,97149085660,True,535300000,2072430,537372430,False,3
81,validator_13,33528664932,True,827679999,51934890,879614889,True,1
82,validator_15,260605099977,True,920839996,12860400,933700396,True,8
83,validator_15,261354522269,True,735440002,13982290,749422292,True,8
84,validator_43,66302183000,True,428500000,3201440,431701440,False,2
85,validator_32,33204950130,True,543100000,1663190,544763190,False,1
86,validator_14,99439060235,True,839659999,12531510,852191509,True,3
87,validator_14,100250294309,True,755349994,55884080,811234074,True,3
88,validator_17,163930548885,True,645400006,1495200,646895206,True,5
89,validator_33,33813331400,True,631100000,3250550,634350550,False,1
90,validator_48,161585222380,True,456000000,9605800,465605800,False,5
91,validator_7,64763269917,True,752399997,10869920,763269917,True,2
92,validator_4,33284848033,True,552746003,40578930,593324933,True,1
93,validator_27,97859694570,True,569530000,4246230,573776230,False,3
94,validator_41,64752551380,True,726600000,25951380,752551380,False,2
95,validator_25,33688637490,True,531900000,2563170,534463170,False,1
96,validator_46,98108948050,True,569000000,26197640,595197640,False,3
97,validator_36,98683567860,True,657300000,2751060,660051060,False,3
98,validator_41,65232722000,True,477100000,3070620,480170620,False,2
99,validator_15,262010491293,True,628939994,27029030,655969024,True,8
100,validator_27,98404578470,True,542300000,2583900,544883900,False,3
101,validator_48,162198599580,True,607700000,5677200,613377200,False,5
102,validator_46,98829550810,True,716900000,3702760,720602760,False,3
103,validator_37,66267405200,True,570000000,22498790,592498790,False,2
104,validator_34,259856694750,True,580200000,1270400,581470400,False,8
105,validator_39,33508324650,True,809900000,2429330,812329330,False,1
106,validator_17,164697961083,True,764599998,2812200,767412198,True,5
107,validator_41,65673746010,True,437400000,3624010,441024010,False,2
108,validator_34,260426865110,True,563900000,6270360,570170360,False,8
109,validator_29,34710792900,True,660700000,3019600,663719600,False,1
110,validator_43,66938389600,True,616500000,19706600,636206600,False,2
111,validator_26,32776807300,True,768700000,8107300,776807300,False,1
112,validator_31,162181077350,True,624100000,2483820,626583820,False,5
113,validator_48,162808356640,True,602700000,7057060,609757060,False,5
114,validator_4,33823811413,True,463194000,75769380,538963380,True,1
115,validator_16,33796567507,True,559640001,37607880,597247881,True,1
116,validator_34,260976709870,True,528600000,21244760,549844760,False,8
117,validator_31,162559415800,True,376000000,2338450,378338450,False,5
118,validator_18,99923061396,True,957306000,13723850,971029850,True,3
119,validator_12,97632674466,True,881660003,29874670,911534673,True,3
120,validator_36,99445150660,True,742700000,18882800,761582800,False,3
121,validator_27,99100176660,True,669100000,26498190,695598190,False,3
122,validator_33,34436563210,True,622100000,1131810,623231810,False,1
123,validator_34,261507531250,True,527600000,3221380,530821380,False,8
124,validator_17,165568273519,True,845539996,24772440,870312436,True,5
125,validator_29,35304449600,True,591400000,2256700,593656700,False,1
126,validator_15,262696130288,True,664940005,20698990,685638995,True,8
127,validator_7,65508057856,True,719893999,24893940,744787939,True,2
128,validator_21,65956699629,True,621240005,9829680,631069685,True,2
129,validator_48,163442471510,True,633500000,614870,634114870,False,5
130,validator_17,166252251816,True,659439997,24538300,683978297,True,5
131,validator_34,262234751850,True,707800000,19420600,727220600,False,8
132,validator_15,263197650796,True,466794008,34726500,501520508,True,8
133,validator_35,97290684830,True,547300000,34501080,581801080,False,3
134,validator_15,263830328977,True,630540001,2138180,632678181,True,8
135,validator_49,64565767320,True,563800000,1967320,565767320,False,2
136,validator_15,264694074363,True,860099996,3645390,863745386,True,8
137,validator_22,65234329394,True,538699993,4918200,543618193,True,2
138,validator_47,66365497880,True,617600000,976640,618576640,False,2
139,validator_46,99528185410,True,689600000,9034600,698634600,False,3
140,validator_30,65877459900,True,614600000,1592300,616192300,False,2
141,validator_7,66318429248,True,781384002,28987390,810371392,True,2
142,validator_39,34165193650,True,639600000,17269000,656869000,False,1
143,validator_11,33419775160,True,744300002,19796850,764096852,True,1
144,validator_17,166873854512,True,594899996,26702700,621602696,True,5
145,validator_1,66382549152,True,944459999,25728610,970188609,True,2
146,validator_35,97794242950,True,500800000,2758120,503558120,False,3
147,validator_30,66403163180,True,523400000,2303280,525703280,False,2
148,validator_27,99828479470,True,726100000,2202810,728302810,False,3
149,validator_15,265472218703,True,755840000,22304340,778144340,True,8
150,validator_48,163961434350,True,517700000,1262840,518962840,False,5
151,validator_46,100252713610,True,716600000,7928200,724528200,False,3
152,validator_19,64650443935,True,620680005,29763930,650443935,True,2
153,validator_49,65308059920,True,733400000,8892600,742292600,False,2
154,validator_4,34652873461,True,744428008,84634040,829062048,True,1
155,validator_46,100832190450,True,563200000,16276840,579476840,False,3
156,validator_26,33407158400,True,627900000,2451100,630351100,False,1
157,validator_13,34229386952,True,651877990,48844030,700722020,True,1
158,validator_48,164550205180,True,580200000,8570830,588770830,False,5
159,validator_14,100976436439,True,719000000,7142130,726142130,True,3
160,validator_36,100069141570,True,595700000,28290910,623990910,False,3
161,validator_48,165066234010,True,514200000,1828830,516028830,False,5
162,validator_47,67024949120,True,639600000,19851240,659451240,False,2
163,validator_35,98269431220,True,472700000,2488270,475188270,False,3
164,validator_12,98276485474,True,641800008,2011000,643811008,True,3
165,validator_44,97653178220,True,500200000,3892560,504092560,False,3
166,validator_37,66860941330,True,583400000,10136130,593536130,False,2
167,validator_21,66528230523,True,531253994,40276900,571530894,True,2
168,validator_13,35008101323,True,760720001,17994370,778714371,True,1
169,validator_48,165583852210,True,514500000,3118200,517618200,False,5
170,validator_48,166084240010,True,474600000,25787800,500387800,False,5
171,validator_29,35747095880,True,439900000,2746280,442646280,False,1
172,validator_41,66199803480,True,513400000,12657470,526057470,False,2
173,validator_34,262682651360,True,444700000,3199510,447899510,False,8
174,validator_34,263129112030,True,439200000,7260670,446460670,False,8
175,validator_18,100451595101,True,521600005,6933700,528533705,True,3
176,validator_44,98490971450,True,830200000,7593230,837793230,False,3
177,validator_14,101712132774,True,728939995,6756340,735696335,True,3
178,validator_15,266151974979,True,652280006,27476270,679756276,True,8
179,validator_34,263888730230,True,757600000,2018200,759618200,False,8
180,validator_14,102502205203,True,783859999,6212430,790072429,True,3
181,validator_36,100688829560,True,613100000,6587990,619687990,False,3
182,validator_43,67673383790,True,733600000,1394190,734994190,False,2
183,validator_39,34700962850,True,534900000,869200,535769200,False,1
184,validator_18,100850956932,True,378700001,20661830,399361831,True,3
185,validator_30,66927064400,True,522500000,1401220,523901220,False,2
186,validator_27,100381753590,True,549900000,3374120,553274120,False,3
187,validator_15,266582124319,True,418240000,11909340,430149340,True,8
188,validator_46,101638206460,True,792700000,13316010,806016010,False,3
189,validator_30,67470695400,True,523400000,20231000,543631000,False,2
190,validator_23,32596670328,True,578700008,17970320,596670328,True,1
191,validator_21,67135484724,True,570168001,37086200,607254201,True,2
192,validator_49,65851826430,True,539700000,4066510,543766510,False,2
193,validator_28,32531814150,True,530800000,1014150,531814150,False,1
194,validator_18,101677005551,True,815219999,10828620,826048619,True,3
195,validator_38,33636892190,True,567200000,2383900,569583900,False,1
196,validator_6,33544758602,True,852900006,14601000,867501006,True,1
197,validator_27,100936086220,True,543300000,11032630,554332630,False,3
198,validator_36,101249710560,True,539850000,21031000,560881000,False,3
199,validator_19,65228136968,True,553480003,24213030,577693033,True,2
200,validator_34,264447583300,True,531000000,27853070,558853070,False,8
201,validator_26,33966599840,True,550300000,9141440,559441440,False,1
202,validator_0,33714021538,True,670759992,3922230,674682222,True,1
203,validator_48,166525835610,True,438100000,3495600,441595600,False,5
204,validator_0,34211104923,True,486119995,10963390,497083385,True,1
205,validator_38,34274041390,True,635100000,2049200,637149200,False,1
206,validator_34,265168037480,True,713900000,6554180,720454180,False,8
207,validator_17,167723119140,True,830899998,18364630,849264628,True,5
208,validator_5,64801219723,True,797899993,3319730,801219723,True,2
209,validator_17,168599099532,True,847600002,28380390,875980392,True,5
210,validator_4,35500590709,True,828439998,19277250,847717248,True,1
211,validator_21,67886849951,True,720424007,30941220,751365227,True,2
212,validator_15,267204652047,True,603285998,19241730,622527728,True,8
213,validator_37,67330836880,True,463800000,6095550,469895550,False,2
214,validator_42,33205392250,True,412700000,18773400,431473400,False,1
215,validator_5,65509736239,True,692560006,15956510,708516516,True,2
216,validator_17,169329060538,True,728900006,1061000,729961006,True,5
217,validator_6,34253429405,True,705600003,3070800,708670803,True,1
218,validator_17,169957945045,True,609400007,19484500,628884507,True,5
219,validator_48,167204448210,True,671000000,7612600,678612600,False,5
220,validator_34,265882750470,True,713100000,1612990,714712990,False,8
221,validator_41,66817243010,True,613900000,3539530,617439530,False,2
222,validator_34,266549896150,True,664700000,2445680,667145680,False,8
223,validator_19,66015110669,True,774720001,12253700,786973701,True,2
224,validator_2,32622359907,True,593346007,29013900,622359907,True,1
225,validator_9,32800466666,True,774320006,26146660,800466666,True,1
226,validator_31,163008668500,True,437300000,11952700,449252700,False,5
227,validator_27,101426495920,True,488200000,2209700,490409700,False,3
228,validator_33,34988378320,True,549100000,2715110,551815110,False,1
229,validator_17,170902559085,True,920460000,24154040,944614040,True,5
230,validator_15,268091320853,True,882200006,4468800,886668806,True,8
231,validator_22,65866752725,True,630500001,1923330,632423331,True,2
232,validator_15,268772026346,True,643105993,37599500,680705493,True,8
233,validator_35,98831604590,True,558500000,3673370,562173370,False,3
234,validator_15,269704278760,True,911999994,20252420,932252414,True,8
235,validator_34,267158422820,True,602000000,6526670,608526670,False,8
236,validator_31,163755452400,True,744900000,1883900,746783900,False,5
237,validator_3,32632065501,True,610400001,21665500,632065501,True,1
238,validator_22,66491403733,True,621800008,2851000,624651008,True,2
239,validator_15,270394927395,True,682300005,8348630,690648635,True,8
240,validator_13,35813285519,True,762819996,42364200,805184196,True,1
241,validator_15,270922117229,True,516966004,10223830,527189834,True,8
242,validator_34,267818537990,True,658400000,1715170,660115170,False,8
243,validator_15,271527061121,True,597200002,7743890,604943892,True,8
244,validator_15,272140685219,True,604359998,9264100,613624098,True,8
245,validator_24,32532066430,True,510420000,21646430,532066430,True,1
246,validator_17,171597163781,True,686819996,7784700,694604696,True,5
247,validator_34,268355776280,True,528600000,8638290,537238290,False,8
248,validator_31,164420280790,True,662300000,2528390,664828390,False,5
249,validator_31,165032819090,True,591900000,20638300,612538300,False,5
250,validator_12,99095097208,True,800039994,18571740,818611734,True,3
251,validator_28,33159360790,True,608300000,19246640,627546640,False,1
252,validator_34,268783734870,True,419150000,8808590,427958590,False,8
253,validator_10,33636581117,True,655900004,35882400,691782404,True,1
254,validator_10,34396042010,True,735640003,23820890,759460893,True,1
255,validator_46,102113468680,True,472700000,2562220,475262220,False,3
256,validator_11,33951243057,True,528599997,2867900,531467897,True,1
257,validator_44,99012013890,True,514900000,6142440,521042440,False,3
258,validator_7,67022339789,True,692860001,11050540,703910541,True,2
259,validator_18,102658493997,True,961657996,19830450,981488446,True,3
260,validator_14,103103508905,True,599000002,2303700,601303702,True,3
261,validator_48,167669103610,True,457600000,7055400,464655400,False,5
262,validator_26,34552849210,True,584100000,2149370,586249370,False,1
263,validator_14,103773578018,True,644159993,25909120,670069113,True,3
264,validator_4,36215345509,True,699560000,15194800,714754800,True,1
265,validator_47,67745750940,True,719270000,1531820,720801820,False,2
266,validator_15,272656546182,True,492359993,23500970,515860963,True,8
267,validator_17,172249931618,True,646139997,6627840,652767837,True,5
268,validator_10,35067012329,True,655540009,15430310,670970319,True,1
269,validator_42,33706564940,True,491600000,9572690,501172690,False,1
270,validator_15,273390010482,True,705400000,28064300,733464300,True,8
271,validator_15,274203590784,True,777440002,36140300,813580302,True,8
272,validator_17,173005352762,True,743140004,12281140,755421144,True,5
273,validator_12,100007953518,True,897840010,15016300,912856310,True,3
274,validator_45,32642536900,True,639800000,2736900,642536900,False,1
275,validator_1,67270866075,True,878000003,10316920,888316923,True,2
276,validator_34,269205339800,True,400100000,21504930,421604930,False,8
277,validator_27,102060548280,True,573000000,61052360,634052360,False,3
278,validator_5,66278092664,True,747379995,20976430,768356425,True,2
279,validator_18,103168961339,True,480752002,29715340,510467342,True,3
280,validator_18,104047178964,True,875299995,2917630,878217625,True,3
281,validator_35,99430535330,True,591400000,7530740,598930740,False,3
282,validator_5,66850408967,True,570500003,1816300,572316303,True,2
283,validator_34,269921888040,True,696300000,20248240,716548240,False,8
284,validator_37,67864692020,True,507300000,26555140,533855140,False,2
285,validator_34,270448127660,True,506200000,20039620,526239620,False,8
286,validator_31,165620948040,True,586600000,1528950,588128950,False,5
287,validator_15,275072557864,True,827740000,41227080,868967080,True,8
288,validator_49,66471458630,True,613000000,6632200,619632200,False,2
289,validator_3,33285545048,True,626800007,26679540,653479547,True,1
290,validator_44,99642153960,True,628700000,1440070,630140070,False,3
291,validator_27,102665744720,True,596100000,9096440,605196440,False,3
292,validator_15,275870398105,True,788500001,9340240,797840241,True,8
293,validator_34,271121393060,True,670540000,2725400,673265400,False,8
294,validator_15,276452682401,True,581200006,1084290,582284296,True,8
295,validator_48,168376829400,True,705900000,1825790,707725790,False,5
296,validator_44,100213912590,True,557200000,14558630,571758630,False,3
297,validator_36,101720913590,True,449600000,21603030,471203030,False,3
298,validator_44,100738504330,True,521800000,2791740,524591740,False,3
299,validator_15,276989645378,True,512349997,24612980,536962977,True,8
300,validator_20,32561819100,True,522240000,39579100,561819100,True,1
301,validator_28,33867001490,True,695500000,12140700,707640700,False,1
302,validator_15,277626042227,True,633799999,2596850,636396849,True,8
303,validator_17,173779473652,True,729540000,44580890,774120890,True,5
304,validator_15,278436032352,True,796299995,13690130,809990125,True,8
305,validator_11,34501427612,True,536840005,13344550,550184555,True,1
306,validator_19,66949433375,True,913500006,20822700,934322706,True,2
307,validator_48,168949195710,True,569900000,2466310,572366310,False,5
308,validator_20,33424045033,True,847400003,14825930,862225933,True,1
309,validator_18,104649026649,True,587820005,14027680,601847685,True,3
310,validator_28,34533570020,True,664400000,2168530,666568530,False,1
311,validator_36,102316419990,True,564400000,31106400,595506400,False,3
312,validator_34,271766212350,True,642900000,1919290,644819290,False,8
313,validator_5,67515500597,True,661400000,3691630,665091630,True,2
314,validator_18,105218169347,True,528779998,40362700,569142698,True,3
315,validator_48,169623738710,True,671200000,3343000,674543000,False,5
316,validator_14,104421016587,True,645299999,2138570,647438569,True,3
317,validator_38,34975662910,True,691200000,10421520,701621520,False,1
318,validator_48,170261854910,True,631700000,6416200,638116200,False,5
319,validator_34,272238493410,True,470400000,1881060,472281060,False,8
320,validator_34,272913455550,True,671600000,3362140,674962140,False,8
321,validator_9,33475018098,True,666300002,8251430,674551432,True,1
322,validator_49,67082557220,True,605600000,5498590,611098590,False,2
323,validator_26,35142117810,True,585500000,3768600,589268600,False,1
324,validator_30,68079218680,True,587700000,20823280,608523280,False,2
325,validator_19,67568745672,True,583019997,36292300,619312297,True,2
326,validator_45,33442628460,True,780100000,19991560,800091560,False,1
327,validator_45,33922357010,True,473000000,6728550,479728550,False,1
328,validator_28,35256220130,True,714700000,7950110,722650110,False,1
329,validator_31,166160503640,True,528200000,11355600,539555600,False,5
330,validator_9,34143325426,True,634279998,34027330,668307328,True,1
331,validator_6,34737834523,True,450099998,34305120,484405118,True,1
332,validator_17,174539635793,True,711160001,49002140,760162141,True,5
333,validator_17,175463164553,True,902620000,20908760,923528760,True,5
334,validator_32,33742500480,True,534900000,2650350,537550350,False,1
335,validator_21,68574102979,True,685899998,1353030,687253028,True,2
336,validator_6,35607994630,True,862900007,7260100,870160107,True,1
337,validator_7,67673731942,True,600340003,51052150,651392153,True,2
338,validator_41,67325811030,True,500300000,8268020,508568020,False,2
339,validator_34,273514222310,True,581400000,19366760,600766760,False,8
340,validator_17,176098768150,True,617219997,18383600,635603597,True,5
341,validator_31,166652674700,True,491100000,1071060,492171060,False,5
342,validator_37,68477041550,True,606200000,6149530,612349530,False,2
343,validator_0,34790532223,True,575800000,3627300,579427300,True,1
344,validator_1,67796364204,True,496559999,28938130,525498129,True,2
345,validator_36,102851451050,True,524700000,10331060,535031060,False,3
346,validator_37,69252723030,True,770900000,4781480,775681480,False,2
347,validator_47,68395393460,True,646900000,2742520,649642520,False,2
348,validator_15,279272878748,True,826639996,10206400,836846396,True,8
349,validator_43,68538747690,True,845800000,19563900,865363900,False,2
350,validator_34,274175847230,True,655200000,6424920,661624920,False,8
351,validator_14,105134397754,True,676090007,37291160,713381167,True,3
352,validator_31,167302656840,True,647900000,2082140,649982140,False,5
353,validator_17,176811714541,True,676463991,36482400,712946391,True,5
354,validator_15,280112878334,True,821639996,18359590,839999586,True,8
355,validator_34,274691035530,True,514300000,888300,515188300,False,8
356,validator_8,33946856368,True,648560003,3300200,651860203,True,1
357,validator_28,35785584460,True,522400000,6964330,529364330,False,1
358,validator_19,68232360103,True,630000001,33614430,663614431,True,2
359,validator_30,68734978800,True,649400000,6360120,655760120,False,2
360,validator_38,35512404620,True,528200000,8541710,536741710,False,1
361,validator_3,33863139580,True,573800002,3794530,577594532,True,1
362,validator_34,275282159270,True,583000000,8123740,591123740,False,8
363,validator_17,177709457910,True,835987999,61755370,897743369,True,5
364,validator_33,35538177840,True,544900000,4899520,549799520,False,1
365,validator_27,103191540830,True,512100000,13696110,525796110,False,3
366,validator_15,280686130554,True,544554000,28698220,573252220,True,8
367,validator_2,33317713696,True,687799999,7553790,695353789,True,1
368,validator_27,103885826280,True,668500000,25785450,694285450,False,3
369,validator_44,101358596660,True,618800000,1292330,620092330,False,3
370,validator_37,70079150430,True,822400000,4027400,826427400,False,2
371,validator_43,69261806680,True,686800000,36258990,723058990,False,2
372,validator_46,102989397590,True,867600000,8328910,875928910,False,3
373,validator_12,100559793440,True,534180002,17659920,551839922,True,3
374,validator_48,170704218880,True,439900000,2463970,442363970,False,5
375,validator_34,276098188020,True,815100000,928750,816028750,False,8
376,validator_11,35308978581,True,746279999,61270970,807550969,True,1
377,validator_31,167928608700,True,623000000,2951860,625951860,False,5
378,validator_17,178517169543,True,804560003,3151630,807711633,True,5
379,validator_32,34441777220,True,695500000,3776740,699276740,False,1
380,validator_17,179033036343,True,485518000,30348800,515866800,True,5
381,validator_34,276907777540,True,803800000,5789520,809589520,False,8
382,validator_27,104452411520,True,560100000,6485240,566585240,False,3
383,validator_42,34471881740,True,761900000,3416800,765316800,False,1
384,validator_48,171375678010,True,667600000,3859130,671459130,False,5
385,validator_31,168414713990,True,485030000,1075290,486105290,False,5
386,validator_48,171940383000,True,561800000,2904990,564704990,False,5
387,validator_17,179677926147,True,628980004,15909800,644889804,True,5
388,validator_15,281201332263,True,500340009,14861700,515201709,True,8
389,validator_15,281672014805,True,449740002,20942540,470682542,True,8
390,validator_16,34461248772,True,636540005,28141260,664681265,True,1
391,validator_14,105876110354,True,726960000,14752600,741712600,True,3
392,validator_46,103533063890,True,531510000,12156300,543666300,False,3
393,validator_36,103369930530,True,515900000,2579480,518479480,False,3
394,validator_5,68324479659,True,784740002,24239060,808979062,True,2
395,validator_45,34400761630,True,472300000,6104620,478404620,False,1
396,validator_36,103977534790,True,605900000,1704260,607604260,False,3
397,validator_13,36619466389,True,796600000,9580870,806180870,True,1
398,validator_18,105557661547,True,329840000,9652200,339492200,True,3
399,validator_31,168871231320,True,453000000,3517330,456517330,False,5
400,validator_17,180159370643,True,427699996,53744500,481444496,True,5
401,validator_47,69030018760,True,631900000,2725300,634625300,False,2
402,validator_34,277541373000,True,607400000,26195460,633595460,False,8
403,validator_3,34489583097,True,597399997,29043520,626443517,True,1
404,validator_30,69489221100,True,741000000,13242300,754242300,False,2
405,validator_30,70123339410,True,609700000,24418310,634118310,False,2
406,validator_17,181024030465,True,839620002,25039820,864659822,True,5
407,validator_30,70795485190,True,669300000,2845780,672145780,False,2
408,validator_21,69247459252,True,644020003,29336270,673356273,True,2
409,validator_39,35414818020,True,710800000,3055170,713855170,False,1
410,validator_46,104178514780,True,636100000,9350890,645450890,False,3
411,validator_31,169341145920,True,467840000,2074600,469914600,False,5
412,validator_48,172444040200,True,494900000,8757200,503657200,False,5
413,validator_5,68813895660,True,482140001,7276000,489416001,True,2
414,validator_12,101353916240,True,781340000,12782800,794122800,True,3
415,validator_41,67948300710,True,622100000,389680,622489680,False,2
416,validator_44,102241976160,True,880300000,3079500,883379500,False,3
417,validator_20,34132274832,True,680999999,27229800,708229799,True,1
418,validator_5,69543190392,True,704020002,25274730,729294732,True,2
419,validator_17,181751271645,True,686920000,40321180,727241180,True,5
420,validator_25,34384919530,True,671400000,24882040,696282040,False,1
421,validator_1,68470317531,True,658559997,15393330,673953327,True,2
422,validator_15,282438201841,True,764099996,2087040,766187036,True,8
423,validator_31,169999233200,True,655400000,2687280,658087280,False,5
424,validator_45,35034658420,True,625100000,8796790,633896790,False,1
425,validator_31,170657642040,True,655400000,3008840,658408840,False,5
426,validator_12,102320753209,True,947579999,19256970,966836969,True,3
427,validator_47,69582195690,True,549100000,3076930,552176930,False,2
428,validator_14,106564559164,True,686700010,1748800,688448810,True,3
429,validator_7,68435232196,True,735300004,26200250,761500254,True,2
430,validator_32,35199276890,True,751800000,5699670,757499670,False,1
431,validator_31,171401712950,True,740500000,3570910,744070910,False,5
432,validator_18,106203055605,True,621819998,23574060,645394058,True,3
433,validator_44,102885545700,True,638000000,5569540,643569540,False,3
434,validator_1,69210249804,True,733099993,6832280,739932273,True,2
435,validator_32,35814984710,True,614600000,1107820,615707820,False,1
436,validator_34,278374685970,True,801700000,31612970,833312970,False,8
437,validator_31,172097337950,True,673800000,21825000,695625000,False,5
438,validator_12,103222334536,True,869639997,31941330,901581327,True,3
439,validator_12,103967477028,True,719779992,25362500,745142492,True,3
440,validator_18,106895061384,True,685899999,6105780,692005779,True,3
441,validator_5,70210572293,True,664500001,2881900,667381901,True,2
442,validator_25,35151457030,True,759100000,7437500,766537500,False,1
443,validator_12,104474029623,True,496820005,9732590,506552595,True,3
444,validator_14,107394703238,True,789161994,40982080,830144074,True,3
445,validator_4,36756513112,True,513120003,28047600,541167603,True,1
446,validator_12,104969138478,True,458540005,36568850,495108855,True,3
447,validator_46,104735626240,True,552920000,4191460,557111460,False,3
448,validator_27,105122673610,True,659400000,10862090,670262090,False,3
449,validator_18,107640675184,True,707220000,38393800,745613800,True,3
450,validator_6,36436054571,True,799898001,28161940,828059941,True,1
451,validator_15,283287302824,True,810600003,38500980,849100983,True,8
452,validator_29,36486206040,True,737600000,1510160,739110160,False,1
453,validator_27,105850920550,True,726300000,1946940,728246940,False,3
454,validator_34,278990528320,True,611600000,4242350,615842350,False,8
455,validator_37,70641613730,True,534800000,27663300,562463300,False,2
456,validator_18,108542951546,True,869700002,32576360,902276362,True,3
457,validator_30,71645049720,True,828800000,20764530,849564530,False,2
458,validator_17,182657342544,True,856999999,49070900,906070899,True,5
459,validator_5,71081685329,True,850699996,20413040,871113036,True,2
460,validator_36,104577185870,True,562000000,37651080,599651080,False,3
461,validator_49,67710954120,True,625800000,2596900,628396900,False,2
462,validator_9,34767899731,True,587000005,37574300,624574305,True,1
463,validator_17,183392660742,True,725959998,9358200,735318198,True,5
464,validator_37,71412341050,True,769000000,1727320,770727320,False,2
465,validator_12,105546545074,True,574700006,2706590,577406596,True,3
466,validator_5,71631380531,True,519280002,30415200,549695202,True,2
467,validator_42,35149608540,True,668500000,9226800,677726800,False,1
468,validator_30,72266428470,True,620000000,1378750,621378750,False,2
469,validator_46,105354241200,True,610700000,7914960,618614960,False,3
470,validator_34,279517102430,True,516900000,9674110,526574110,False,8
471,validator_48,172958839990,True,499600000,15199790,514799790,False,5
472,validator_18,109405488836,True,845864000,16673290,862537290,True,3
473,validator_36,105236312310,True,640600000,18526440,659126440,False,3
474,validator_22,67172975931,True,662899998,18672200,681572198,True,2
475,validator_31,172720991650,True,621500000,2153700,623653700,False,5
476,validator_21,69755581383,True,470840001,37282130,508122131,True,2
477,validator_34,279990034060,True,468700000,4231630,472931630,False,8
478,validator_31,173241937280,True,493670000,27275630,520945630,False,5
479,validator_1,69852796137,True,617640003,24906330,642546333,True,2
480,validator_24,33524109863,True,952414003,39629430,992043433,True,1
481,validator_42,35568396670,True,416300000,2488130,418788130,False,1
482,validator_46,105954575450,True,597100000,3234250,600334250,False,3
483,validator_34,280663558130,True,659000000,14524070,673524070,False,8
484,validator_30,72985934560,True,712300000,7206090,719506090,False,2
485,validator_26,35618652610,True,463300000,13234800,476534800,False,1
486,validator_5,72243633445,True,595379994,16872920,612252914,True,2
487,validator_36,105861827710,True,624000000,1515400,625515400,False,3
488,validator_15,283837416426,True,515900002,34213600,550113602,True,8
489,validator_7,69190338429,True,728640003,26466230,755106233,True,2
490,validator_38,36108596360,True,590000000,6191740,596191740,False,1
491,validator_34,281186608940,True,521400000,1650810,523050810,False,8
492,validator_15,284317195045,True,466319999,13458620,479778619,True,8
493,validator_5,73038281647,True,757059992,37588210,794648202,True,2
494,validator_15,285043482663,True,706499998,19787620,726287618,True,8
495,validator_48,173635634290,True,674900000,1894300,676794300,False,5
496,validator_36,106315351830,True,451600000,1924120,453524120,False,3
497,validator_19,68910806238,True,653740005,24706130,678446135,True,2
498,validator_35,100062940810,True,608700000,23705480,632405480,False,3
499,validator_8,34600789952,True,617574004,36359580,653933584,True,1
500,validator_34,281659400570,True,453500000,19291630,472791630,False,8
501,validator_2,34190624999,True,849340003,23571300,872911303,True,1
502,validator_48,174404491680,True,741600000,27257390,768857390,False,5
503,validator_34,282346706580,True,676100000,11206010,687306010,False,8
504,validator_34,282868667440,True,484200000,37760860,521960860,False,8
505,validator_14,108099921534,True,671219996,33998300,705218296,True,3
506,validator_42,36172463270,True,601400000,2666600,604066600,False,1
507,validator_18,109937138779,True,507386003,24263940,531649943,True,3
508,validator_22,67735230856,True,531879995,30374930,562254925,True,2
509,validator_36,106848724930,True,513400000,19973100,533373100,False,3
510,validator_23,33385319797,True,778469999,10179470,788649469,True,1
511,validator_46,106530381150,True,569100000,6705700,575805700,False,3
512,validator_34,283634843490,True,760900000,5276050,766176050,False,8
513,validator_17,184363634380,True,949479998,21493640,970973638,True,5
514,validator_14,108786381335,True,640778001,45681800,686459801,True,3
515,validator_43,69919549090,True,648300000,9442410,657742410,False,2
516,validator_14,109492659058,True,689106003,17171720,706277723,True,3
517,validator_7,69693369084,True,485639995,17390660,503030655,True,2
518,validator_12,106344827969,True,789739995,8542900,798282895,True,3
519,validator_37,71958572360,True,536600000,9631310,546231310,False,2
520,validator_40,34234751710,True,599900000,7152440,607052440,False,1
521,validator_33,36172909410,True,629300000,5431570,634731570,False,1
522,validator_31,173752705280,True,505800000,4968000,510768000,False,5
523,validator_15,285680643058,True,621900005,15260390,637160395,True,8
524,validator_14,110246907160,True,750140002,4108100,754248102,True,3
525,validator_15,286277637751,True,579699993,17294700,596994693,True,8
526,validator_36,107420842960,True,569900000,2218030,572118030,False,3
527,validator_3,35194592199,True,661359992,43649110,705009102,True,1
528,validator_35,100708395250,True,635500000,9954440,645454440,False,3
529,validator_44,103401839790,True,497700000,18594090,516294090,False,3
530,validator_21,70790140106,True,996079993,38478730,1034558723,True,2
531,validator_9,35530875515,True,711600004,51375780,762975784,True,1
532,validator_34,284130997840,True,490700000,5454350,496154350,False,8
533,validator_48,175154952420,True,708800000,41660740,750460740,False,5
534,validator_34,284719823540,True,568700000,20125700,588825700,False,8
535,validator_48,175832492410,True,675100000,2439990,677539990,False,5
536,validator_46,107315174250,True,783400000,1393100,784793100,False,3
537,validator_36,107880692560,True,458200000,1649600,459849600,False,3
538,validator_13,37422177613,True,765499994,37211230,802711224,True,1
539,validator_17,185080144174,True,668000004,48509790,716509794,True,5
540,validator_15,287064360849,True,766439998,20283100,786723098,True,8
541,validator_15,287827400968,True,736200009,26840110,763040119,True,8
542,validator_44,103881932290,True,473800000,6292500,480092500,False,3
543,validator_40,34777829430,True,537800000,5277720,543077720,False,1
544,validator_15,288488114262,True,643319994,17393300,660713294,True,9
545,validator_41,68631202490,True,673400000,9501780,682901780,False,2
546,validator_19,69845250733,True,899339995,35104500,934444495,True,2
547,validator_34,285257025040,True,534900000,2301500,537201500,False,8
548,validator_31,174361331460,True,606600000,2026180,608626180,False,5
549,validator_27,106632026590,True,778600000,2506040,781106040,False,3
550,validator_43,70458625800,True,537600000,1476710,539076710,False,2
551,validator_15,289067052963,True,575300001,3638700,578938701,True,9
552,validator_15,289666265794,True,562940001,36272830,599212831,True,9
553,validator_14,110793524450,True,532767990,13849300,546617290,True,3
554,validator_22,68639153256,True,895664000,8258400,903922400,True,2
555,validator_15,290465275395,True,764694001,34315600,799009601,True,9
556,validator_14,111371592348,True,542639998,35427900,578067898,True,3
557,validator_39,35961704920,True,545300000,1586900,546886900,False,1
558,validator_33,36787600270,True,600600000,14090860,614690860,False,1
559,validator_36,108508902000,True,606500000,21709440,628209440,False,3
560,validator_17,185472984573,True,388919999,3920400,392840399,True,5
561,validator_13,38166308505,True,733319992,10810900,744130892,True,1
562,validator_48,176447519410,True,600400000,14627000,615027000,False,5
563,validator_31,175016198330,True,653100000,1766870,654866870,False,5
564,validator_21,71433716436,True,629500000,14076330,643576330,True,2
565,validator_38,36689373140,True,556500000,24276780,580776780,False,1
566,validator_34,285991946170,True,706500000,28421130,734921130,False,8
567,validator_12,107025187171,True,649080002,31279200,680359202,True,3
568,validator_37,72667657180,True,707000000,2084820,709084820,False,2
569,validator_31,175492334330,True,467500000,8636000,476136000,False,5
570,validator_27,107356666490,True,718200000,6439900,724639900,False,3
571,validator_15,290912448284,True,403759999,43412890,447172889,True,9
572,validator_36,109188615840,True,675500000,4213840,679713840,False,3
573,validator_27,108041128170,True,672600000,11861680,684461680,False,3
574,validator_26,36215057190,True,593400000,3004580,596404580,False,1
575,validator_47,70208543610,True,624400000,1947920,626347920,False,2
576,validator_18,110645299517,True,704699998,3460740,708160738,True,3
577,validator_6,37135747873,True,672414002,27279300,699693302,True,1
578,validator_9,36165634094,True,614463999,20294580,634758579,True,1
579,validator_36,109973708490,True,782700000,2392650,785092650,False,3
580,validator_14,112064903883,True,651279995,42031540,693311535,True,3
581,validator_2,34960788607,True,762140008,8023600,770163608,True,1
582,validator_27,108763348070,True,684700000,37519900,722219900,False,3
583,validator_14,112958877155,True,873414002,20559270,893973272,True,3
584,validator_22,69533218127,True,891900001,2164870,894064871,True,2
585,validator_45,35648807060,True,611000000,3148640,614148640,False,1
586,validator_46,107791959620,True,459670000,17115370,476785370,False,3
587,validator_17,186142228371,True,632759998,36483800,669243798,True,5
588,validator_31,176004184230,True,510100000,1749900,511849900,False,5
589,validator_34,286529587510,True,519000000,18641340,537641340,False,8
590,validator_15,291751026936,True,825980002,12598650,838578652,True,9
591,validator_43,70926910810,True,465800000,2485010,468285010,False,2
592,validator_15,292322270011,True,563453995,7789080,571243075,True,9
593,validator_38,37415627040,True,716500000,9753900,726253900,False,1
594,validator_3,35815931012,True,617780003,3558810,621338813,True,1
595,validator_31,176576055260,True,561700000,10171030,571871030,False,5
596,validator_6,37971872376,True,828000003,8124500,836124503,True,1
597,validator_20,34902601618,True,768200006,2126780,770326786,True,1
598,validator_15,293015365950,True,679299999,13795940,693095939,True,9
599,validator_46,108476105620,True,681500000,2646000,684146000,False,3
600,validator_35,101294747780,True,565900000,20452530,586352530,False,3
601,validator_39,36587863270,True,614900000,11258350,626158350,False,1
602,validator_1,70666534319,True,786700002,27038180,813738182,True,2
603,validator_7,70475620812,True,778600008,3651720,782251728,True,2
604,validator_36,110539340440,True,563400000,2231950,565631950,False,3
605,validator_28,36581966130,True,793400000,2981670,796381670,False,1
606,validator_15,293834510877,True,792939997,26204930,819144927,True,9
607,validator_17,186739659280,True,557159999,40270910,597430909,True,5
608,validator_37,73232689120,True,562300000,2731940,565031940,False,2
609,validator_9,36840776110,True,658259996,16882020,675142016,True,1
610,validator_15,294488918673,True,650199996,4207800,654407796,True,9
611,validator_43,71874433800,True,945600000,1922990,947522990,False,2
612,validator_0,35695467430,True,889100007,15835200,904935207,True,1
613,validator_12,107836925975,True,790900004,20838800,811738804,True,3
614,validator_41,69320513520,True,679400000,9911030,689311030,False,2
615,validator_8,35270661650,True,645615998,24255700,669871698,True,1
616,validator_15,295243809972,True,741357999,13533300,754891299,True,9
617,validator_34,287192853630,True,636600000,26666120,663266120,False,8
618,validator_34,287964213500,True,769700000,1659870,771359870,False,8
619,validator_10,35751435626,True,675299997,9123300,684423297,True,1
620,validator_9,37449801182,True,603299992,5725080,609025072,True,1
621,validator_35,101986374780,True,689600000,2027000,691627000,False,3
622,validator_18,111677995829,True,1022100002,10596310,1032696312,True,3
623,validator_31,177177325370,True,590500000,10770110,601270110,False,5
624,validator_48,177196287390,True,740200000,8567980,748767980,False,5
625,validator_37,73703630030,True,450000000,20940910,470940910,False,2
626,validator_0,36269409684,True,572600004,1342250,573942254,True,1
627,validator_40,35382846410,True,599200000,5816980,605016980,False,1
628,validator_15,295861312271,True,609873999,7628300,617502299,True,9
629,validator_15,296495320512,True,624300001,9708240,634008241,True,9
630,validator_16,35021908108,True,521740006,38919330,560659336,True,1
631,validator_34,288424712200,True,453500000,6998700,460498700,False,9
632,validator_34,289066760670,True,636800000,5248470,642048470,False,9
633,validator_22,70409272087,True,867600000,8453960,876053960,True,2
634,validator_13,38752704014,True,567839999,18555510,586395509,True,1
635,validator_21,72023159735,True,573799999,15643300,589443299,True,2
636,validator_43,72389154530,True,495200000,19520730,514720730,False,2
637,validator_20,35730593151,True,782340003,45651530,827991533,True,1
638,validator_46,109007917960,True,521200000,10612340,531812340,False,3
639,validator_31,177898339170,True,692000000,29013800,721013800,False,5
640,validator_5,73602745596,True,529100009,35363940,564463949,True,2
641,validator_18,112342805557,True,627459998,37349730,664809728,True,3
642,validator_12,108504092976,True,652740001,14427000,667167001,True,3
643,validator_18,113184748265,True,833819998,8122710,841942708,True,3
644,validator_42,36704915450,True,529800000,2652180,532452180,False,1
645,validator_15,297265936598,True,753579996,17036090,770616086,True,9
646,validator_47,70989622810,True,774600000,6479200,781079200,False,2
647,validator_34,289683860940,True,603500000,13600270,617100270,False,9
648,validator_14,113620045061,True,657000006,4167900,661167906,True,3
649,validator_26,36837459060,True,620200000,2201870,622401870,False,1
650,validator_10,36338381406,True,583500000,3445780,586945780,True,1
651,validator_6,38704976657,True,708200001,24904280,733104281,True,1
652,validator_49,68389112050,True,675400000,2757930,678157930,False,2
653,validator_34,290276225820,True,575800000,16564880,592364880,False,9
654,validator_43,72921886570,True,509300000,23432040,532732040,False,2
655,validator_33,37473930350,True,682300000,4030080,686330080,False,1
656,validator_9,37994590882,True,538020000,6769700,544789700,True,1
657,validator_40,36131512540,True,746900000,1766130,748666130,False,1
658,validator_34,290892296360,True,610720000,5350540,616070540,False,9
659,validator_42,37084229790,True,377800000,1514340,379314340,False,1
660,validator_34,291580498560,True,681300000,6902200,688202200,False,9
661,validator_19,70386571186,True,514720003,26600450,541320453,True,2
662,validator_44,104530427310,True,644900000,3595020,648495020,False,3
663,validator_34,292179226810,True,595500000,3228250,598728250,False,9
664,validator_48,177823772270,True,600200000,27284880,627484880,False,5
665,validator_43,73505227870,True,580100000,3241300,583341300,False,2
666,validator_15,298033958116,True,760199998,7821520,768021518,True,9
667,validator_34,292748302050,True,566100000,2975240,569075240,False,9
668,validator_34,293367105030,True,614900000,3902980,618802980,False,9
669,validator_41,69998419260,True,671600000,6305740,677905740,False,2
670,validator_46,109544967030,True,527100000,9949070,537049070,False,3
671,validator_14,114339729960,True,664379999,55304900,719684899,True,3
672,validator_42,37756245490,True,653000000,19015700,672015700,False,1
673,validator_3,36496549897,True,637619995,42998890,680618885,True,1
674,validator_1,71449222297,True,778299998,4387980,782687978,True,2
675,validator_31,178443087070,True,518400000,26347900,544747900,False,5
676,validator_6,39578786693,True,854373996,19436040,873810036,True,1
677,validator_15,298894789157,True,814924001,45907040,860831041,True,9
678,validator_44,105036241780,True,503300000,2514470,505814470,False,3
679,validator_36,111204269090,True,662900000,2028650,664928650,False,3
680,validator_46,110074545460,True,528200000,1378430,529578430,False,3
681,validator_24,34085449293,True,551900000,9439430,561339430,True,1
682,validator_17,187396296114,True,654440004,2196830,656636834,True,5
683,validator_25,35831233830,True,677500000,2276800,679776800,False,1
684,validator_24,34637313672,True,549199999,2664380,551864379,True,1
685,validator_1,72136836388,True,628720001,58894090,687614091,True,2
686,validator_49,68990452970,True,591700000,9640920,601340920,False,2
687,validator_46,110739029790,True,657100000,7384330,664484330,False,3
688,validator_41,70611618060,True,610500000,2698800,613198800,False,2
689,validator_13,39614178587,True,852568003,8906570,861474573,True,1
690,validator_21,72762980767,True,737300002,2521030,739821032,True,2
691,validator_9,38817961426,True,806620004,16750540,823370544,True,1
692,validator_48,178172259720,True,346500000,1987450,348487450,False,5
693,validator_48,178658545940,True,484900000,1386220,486286220,False,5
694,validator_0,36859871587,True,588300003,2161900,590461903,True,1
695,validator_31,179119501300,True,675200000,1214230,676414230,False,5
696,validator_15,299528141055,True,624439998,8911900,633351898,True,9
697,validator_15,300338810021,True,784440006,26228960,810668966,True,9
698,validator_17,188033678143,True,634499999,2882030,637382029,True,5
699,validator_15,300931848753,True,589300002,3738730,593038732,True,9
700,validator_21,73590129963,True,815393996,11755200,827149196,True,2
701,validator_15,301668696465,True,706140002,30707710,736847712,True,9
702,validator_19,71073127438,True,666680002,19876250,686556252,True,2
703,validator_17,189064145874,True,1020640001,9827730,1030467731,True,5
704,validator_12,109476391602,True,943700006,28598620,972298626,True,3
705,validator_48,179325254140,True,657800000,8908200,666708200,False,5
706,validator_48,179879715030,True,539700000,14760890,554460890,False,5
707,validator_39,37144056070,True,552400000,3792800,556192800,False,1
708,validator_10,37173733577,True,767668001,67684170,835352171,True,1
709,validator_26,37382789920,True,542800000,2530860,545330860,False,1
710,validator_21,74358970190,True,758799997,10040230,768840227,True,2
711,validator_18,114071851463,True,879499998,7603200,887103198,True,3
712,validator_15,302206755668,True,517828003,20231200,538059203,True,9
713,validator_34,294018271170,True,648000000,3166140,651166140,False,9
714,validator_34,294703162770,True,682800000,2091600,684891600,False,9
715,validator_10,37809237931,True,595260004,40244350,635504354,True,1
716,validator_17,189572060477,True,500900003,7014600,507914603,True,5
717,validator_28,37308209420,True,724400000,1843290,726243290,False,1
718,validator_26,37850832560,True,466000000,2042640,468042640,False,1
719,validator_22,70991095627,True,554700000,27123540,581823540,True,2
720,validator_48,180285242830,True,402500000,3027800,405527800,False,5
721,validator_22,71718668495,True,708219998,19352870,727572868,True,2
722,validator_36,111723084490,True,501300000,17515400,518815400,False,3
723,validator_25,36492575030,True,657900000,3441200,661341200,False,1
724,validator_47,71537022190,True,543500000,3899380,547399380,False,2
725,validator_19,71783440841,True,674540003,35773400,710313403,True,2
726,validator_15,302908661457,True,691839999,10065790,701905789,True,9
727,validator_23,34162460512,True,765093995,12046720,777140715,True,1
728,validator_46,111380172490,True,635600000,5542700,641142700,False,3
729,validator_3,37434395991,True,917079994,20766100,937846094,True,1
730,validator_48,180913912430,True,608100000,20569600,628669600,False,5
731,validator_20,36322687645,True,557779994,34314500,592094494,True,1
732,validator_23,34964934348,True,795340006,7133830,802473836,True,1
733,validator_15,303600143263,True,618080006,73401800,691481806,True,9
734,validator_26,38421442800,True,568400000,2210240,570610240,False,1
735,validator_14,114862750275,True,475119995,47900320,523020315,True,3
736,validator_5,74324883431,True,710019995,12117840,722137835,True,2
737,validator_12,110291028780,True,790839998,23797180,814637178,True,3
738,validator_27,109307860440,True,541100000,3412370,544512370,False,3
739,validator_35,102599436480,True,610500000,2561700,613061700,False,3
740,validator_34,295507363970,True,801800000,2401200,804201200,False,9
741,validator_48,181464270830,True,543100000,7258400,550358400,False,5
742,validator_15,304270023726,True,649540003,20340460,669880463,True,9
743,validator_10,38579912088,True,740559997,30114160,770674157,True,1
744,validator_34,296072654690,True,562900000,2390720,565290720,False,9
745,validator_34,296650657130,True,575200000,2802440,578002440,False,9
746,validator_17,190330496189,True,743460002,14975710,758435712,True,5
747,validator_14,115719738210,True,813539995,43447940,856987935,True,3
748,validator_18,114745813086,True,672200003,1761620,673961623,True,3
749,validator_27,109939023070,True,629000000,2162630,631162630,False,3
750,validator_44,105615659260,True,575600000,3817480,579417480,False,3
751,validator_31,179721057820,True,595200000,6356520,601556520,False,5
752,validator_14,116392791607,True,629079997,43973400,673053397,True,3
753,validator_49,69605819570,True,605400000,9966600,615366600,False,2
754,validator_31,180281844000,True,542800000,17986180,560786180,False,5
755,validator_15,304936510926,True,656620000,9867200,666487200,True,9
756,validator_48,182091599120,True,621400000,5928290,627328290,False,5
757,validator_17,191181058485,True,809415996,41146300,850562296,True,5
758,validator_27,110460076740,True,518100000,2953670,521053670,False,3
759,validator_14,117210827619,True,808800002,9236010,818036012,True,3
760,validator_32,36306649450,True,489100000,2564740,491664740,False,1
761,validator_30,73742756140,True,754600000,2221580,756821580,False,2
762,validator_30,74384634060,True,634100000,7777920,641877920,False,2
763,validator_16,35806514208,True,775480000,9126100,784606100,True,1
764,validator_34,297278059160,True,616700000,10702030,627402030,False,9
765,validator_48,182758704530,True,663900000,3205410,667105410,False,5
766,validator_46,112001510390,True,600800000,20537900,621337900,False,3
767,validator_41,71377885540,True,755300000,10967480,766267480,False,2
768,validator_18,115434733194,True,669000008,19920100,688920108,True,3
769,validator_14,117869076490,True,639520001,18728870,658248871,True,3
770,validator_26,39058620200,True,634900000,2277400,637177400,False,1
771,validator_17,191842574884,True,606893999,54622400,661516399,True,5
772,validator_35,103257962060,True,636200000,22325580,658525580,False,3
773,validator_34,298043132580,True,763400000,1673420,765073420,False,9
774,validator_5,75133803260,True,781313989,27605840,808919829,True,2
775,validator_13,40300459284,True,658559997,27720700,686280697,True,1
776,validator_27,111011548340,True,530500000,20971600,551471600,False,3
777,validator_34,298550181280,True,505600000,1448700,507048700,False,9
778,validator_8,36046409089,True,723719999,52027440,775747439,True,1
779,validator_4,37549158599,True,766060007,26585480,792645487,True,1
780,validator_32,37073388370,True,765100000,1638920,766738920,False,1
781,validator_32,37688681170,True,604800000,10492800,615292800,False,1
782,validator_15,305571132040,True,613399994,21221120,634621114,True,9
783,validator_38,37952301370,True,527200000,9474330,536674330,False,1
784,validator_31,180837098490,True,545500000,9754490,555254490,False,5
785,validator_48,183432105120,True,652900000,20500590,673400590,False,5
786,validator_27,111673458020,True,640500000,21409680,661909680,False,3
787,validator_37,74456365760,True,749000000,3735730,752735730,False,2
788,validator_39,37788010470,True,641800000,2154400,643954400,False,1
789,validator_40,36588196240,True,453400000,3283700,456683700,False,1
790,validator_26,39770667350,True,702500000,9547150,712047150,False,1
791,validator_37,75114363300,True,651200000,6797540,657997540,False,2
792,validator_48,183885465130,True,452300000,1060010,453360010,False,5
793,validator_47,72232562790,True,692900000,2640600,695540600,False,2
794,validator_25,37162087930,True,660300000,9212900,669512900,False,1
795,validator_28,37976604020,True,666800000,1594600,668394600,False,1
796,validator_36,112186091700,True,454300000,8707210,463007210,False,3
797,validator_27,112132035380,True,455500000,3077360,458577360,False,3
798,validator_14,118494580962,True,615940002,9564470,625504472,True,3
799,validator_37,75743427010,True,627500000,1563710,629063710,False,2
800,validator_48,184507101830,True,618800000,2836700,621636700,False,5
801,validator_47,72924112370,True,681700000,9849580,691549580,False,2
802,validator_5,75851646351,True,694740001,23103090,717843091,True,2
803,validator_34,299022295680,True,468800000,3314400,472114400,False,9
804,validator_31,181433153290,True,573800000,22254800,596054800,False,5
805,validator_7,70947711693,True,441659991,30430890,472090881,True,2
806,validator_46,112542856190,True,523070000,18275800,541345800,False,3
807,validator_41,71959630730,True,571420000,10325190,581745190,False,2
808,validator_18,116079429295,True,626340001,18356100,644696101,True,3
809,validator_38,38426776370,True,470500000,3975000,474475000,False,1
810,validator_7,71882350619,True,923639996,10998930,934638926,True,2
811,validator_35,103885285460,True,623900000,3423400,627323400,False,3
812,validator_15,306270291143,True,682120003,17039100,699159103,True,9
813,validator_31,182232223830,True,797300000,1770540,799070540,False,5
814,validator_37,76291380840,True,546700000,1253830,547953830,False,2
815,validator_14,119299263864,True,794320012,10362890,804682902,True,3
816,validator_40,37398056520,True,802600000,7260280,809860280,False,1
817,validator_17,192736631396,True,860360002,33696510,894056512,True,6
818,validator_47,73508597110,True,582390000,2094740,584484740,False,2
819,validator_45,36216326780,True,562900000,4619720,567519720,False,1
820,validator_45,37203863610,True,982000000,5536830,987536830,False,1
821,validator_5,76588723751,True,691084000,45993400,737077400,True,2
822,validator_35,104498015680,True,584700000,28030220,612730220,False,3
823,validator_35,105008938200,True,509000000,1922520,510922520,False,3
824,validator_14,119951564376,True,650300002,2000510,652300512,True,3
825,validator_45,37829382690,True,622300000,3219080,625519080,False,1
826,validator_17,193521718831,True,748220005,36867430,785087435,True,6
827,validator_25,37637981330,True,473400000,2493400,475893400,False,1
828,validator_0,37601029085,True,709019998,32137500,741157498,True,1
829,validator_17,194174432726,True,633000005,19713890,652713895,True,6
830,validator_48,185151431030,True,643400000,929200,644329200,False,5
831,validator_49,70240621000,True,598900000,35901430,634801430,False,2
832,validator_12,111048586872,True,756000002,1558090,757558092,True,3
833,validator_30,75076442560,True,683100000,8708500,691808500,False,2
834,validator_19,72423314881,True,619860000,20014040,639874040,True,2
835,validator_23,35582440830,True,606420002,11086480,617506482,True,1
836,validator_15,307015280521,True,735239998,9749380,744989378,True,9
837,validator_7,72449333543,True,548700004,18282920,566982924,True,2
838,validator_27,112652615360,True,518300000,2279980,520579980,False,3
839,validator_27,113227393850,True,572400000,2378490,574778490,False,3
840,validator_13,40856191505,True,542100001,13632220,555732221,True,1
841,validator_47,74286455320,True,767200000,10658210,777858210,False,2
842,validator_4,38302037271,True,728658002,24220670,752878672,True,1
843,validator_37,76895982390,True,602200000,2401550,604601550,False,2
844,validator_5,77397389819,True,799679988,8986080,808666068,True,2
845,validator_34,299586929140,True,561800000,2833460,564633460,False,9
846,validator_19,72955064283,True,518980002,12769400,531749402,True,2
847,validator_36,112978947970,True,790400000,2456270,792856270,False,3
848,validator_48,185643840350,True,471700000,20709320,492409320,False,5
849,validator_10,39220591891,True,598620003,42059800,640679803,True,1
850,validator_31,182669529980,True,433800000,3506150,437306150,False,5
851,validator_37,77538581770,True,640350000,2249380,642599380,False,2
852,validator_23,36274144561,True,634800001,56903730,691703731,True,1
853,validator_41,72443710830,True,480100000,3980100,484080100,False,2
854,validator_37,78004767290,True,464300000,1885520,466185520,False,2
855,validator_48,186088004130,True,425620000,18543780,444163780,False,5
856,validator_36,113631823830,True,650800000,2075860,652875860,False,3
857,validator_14,120696895375,True,738899999,6431000,745330999,True,3
858,validator_36,114120392150,True,478670000,9898320,488568320,False,3
859,validator_18,117069872070,True,981919995,8522780,990442775,True,3
860,validator_8,36645429575,True,562875996,36144490,599020486,True,1
861,validator_20,37101818817,True,776500002,2631170,779131172,True,1
862,validator_31,183357546580,True,685400000,2616600,688016600,False,5
863,validator_23,36965051875,True,646284004,44623310,690907314,True,1
864,validator_39,38304110210,True,514700000,1399740,516099740,False,1
865,validator_30,75796081860,True,717300000,2339300,719639300,False,2
866,validator_43,74217037610,True,692300000,19509740,711809740,False,2
867,validator_34,300263582430,True,675000000,1653290,676653290,False,9
868,validator_22,72266758793,True,502795998,45294300,548090298,True,2
869,validator_44,106281518880,True,656300000,9559620,665859620,False,3
870,validator_28,38721881250,True,738100000,7177230,745277230,False,1
871,validator_34,300858365120,True,592900000,1882690,594782690,False,9
872,validator_34,301430345320,True,548400000,23580200,571980200,False,9
873,validator_44,106986800720,True,701600000,3681840,705281840,False,3
874,validator_15,307680886340,True,653699999,11905820,665605819,True,9
875,validator_36,114844816350,True,722100000,2324200,724424200,False,3
876,validator_48,186767997250,True,674200000,5793120,679993120,False,5
877,validator_41,73116118030,True,660800000,11607200,672407200,False,2
878,validator_47,74831766320,True,530970000,14341000,545311000,False,2
879,validator_37,78655956790,True,641600000,9589500,651189500,False,2
880,validator_34,302038493860,True,604800000,3348540,608148540,False,9
881,validator_10,39802411197,True,575200006,6619300,581819306,True,1
882,validator_48,187387277330,True,618000000,1280080,619280080,False,5
883,validator_43,74845440970,True,593600000,34803360,628403360,False,2
884,validator_20,37928751709,True,753493992,73438900,826932892,True,1
885,validator_22,73021383108,True,734699995,19924320,754624315,True,2
886,validator_49,70771958220,True,529100000,2237220,531337220,False,2
887,validator_17,194870649010,True,686439994,9776290,696216284,True,6
888,validator_20,38702576059,True,751900000,21924350,773824350,True,1
889,validator_34,302638486210,True,598100000,1892350,599992350,False,9
890,validator_36,115456010890,True,600700000,10494540,611194540,False,3
891,validator_35,105632937200,True,621600000,2399000,623999000,False,3
892,validator_21,74894441529,True,510379999,25091340,535471339,True,2
893,validator_23,37746462302,True,755799997,25610430,781410427,True,1
894,validator_46,113183456520,True,637800000,2800330,640600330,False,3
895,validator_8,37425160678,True,765459993,14271110,779731103,True,1
896,validator_49,71370945420,True,596100000,2887200,598987200,False,2
897,validator_20,39466963854,True,763199995,1187800,764387795,True,1
898,validator_34,303208565570,True,560900000,9179360,570079360,False,9
899,validator_8,37929855808,True,484780000,19915130,504695130,True,1
900,validator_23,38335161744,True,577280002,11419440,588699442,True,1
901,validator_18,117903607977,True,797531997,36203910,833735907,True,3
902,validator_31,184065255600,True,680400000,27309020,707709020,False,5
903,validator_37,79383017390,True,723400000,3660600,727060600,False,2
904,validator_13,41673942003,True,807199998,10550500,817750498,True,1
905,validator_1,73023497827,True,823339999,63321440,886661439,True,2
906,validator_34,303814410560,True,599000000,6844990,605844990,False,9
907,validator_34,304201848900,True,385000000,2438340,387438340,False,9
908,validator_3,38011918836,True,572500005,5022840,577522845,True,1
909,validator_21,75708692735,True,788213996,26037210,814251206,True,2
910,validator_6,40166570947,True,566057994,21726260,587784254,True,1
911,validator_34,304889695030,True,678500000,9346130,687846130,False,9
912,validator_22,73712830879,True,646240001,45207770,691447771,True,2
913,validator_15,308293838674,True,554344004,58608330,612952334,True,9
914,validator_17,195500880105,True,589739995,40491100,630231095,True,6
915,validator_43,75458232650,True,609100000,3691680,612791680,False,2
916,validator_3,38924075853,True,872099997,40057020,912157017,True,1
917,validator_30,76376141320,True,560460000,19599460,580059460,False,2
918,validator_29,37115419580,True,625300000,3913540,629213540,False,1
919,validator_21,76242982129,True,528779994,5509400,534289394,True,2
920,validator_17,196382856594,True,877799999,4176490,881976489,True,6
921,validator_32,38368195610,True,676400000,3114440,679514440,False,1
922,validator_16,36527571412,True,691900004,29157200,721057204,True,1
923,validator_49,71942908720,True,569700000,2263300,571963300,False,2
924,validator_22,74566943805,True,818299996,35812930,854112926,True,2
925,validator_36,116113534890,True,655200000,2324000,657524000,False,3
926,validator_12,111919621629,True,841259997,29774760,871034757,True,3
927,validator_35,106187836910,True,535500000,19399710,554899710,False,3
928,validator_17,197039725955,True,598300001,58569360,656869361,True,6
929,validator_15,309021529376,True,718140002,9550700,727690702,True,9
930,validator_14,121449595473,True,701979998,50720100,752700098,True,3
931,validator_47,75566830120,True,734500000,563800,735063800,False,2
932,validator_15,309699379412,True,643059996,34790040,677850036,True,9
933,validator_48,188051208950,True,657300000,6631620,663931620,False,5
934,validator_30,77064152940,True,677100000,10911620,688011620,False,2
935,validator_48,188750395410,True,678600000,20586460,699186460,False,5
936,validator_44,107780729520,True,788000000,5928800,793928800,False,3
937,validator_45,38379056720,True,547500000,2174030,549674030,False,1
938,validator_14,122400839618,True,921440005,29804140,951244145,True,3
939,validator_31,184725753320,True,657400000,3097720,660497720,False,5
940,validator_34,305610798730,True,718900000,2203700,721103700,False,9
941,validator_45,39050605520,True,665300000,6248800,671548800,False,1
942,validator_38,38980324920,True,552700000,848550,553548550,False,1
943,validator_15,310449225842,True,716600000,33246430,749846430,True,9
944,validator_7,73126041938,True,666265995,10442400,676708395,True,2
945,validator_45,39769417220,True,716000000,2811700,718811700,False,1
946,validator_46,113855733540,True,667300000,4977020,672277020,False,3
947,validator_44,108317608960,True,534170000,2709440,536879440,False,3
948,validator_19,73515307287,True,525240004,35003000,560243004,True,2
949,validator_1,73607662210,True,549760003,34404380,584164383,True,2
950,validator_2,35709343387,True,743500000,5054780,748554780,True,1
951,validator_48,189334153740,True,562500000,21258330,583758330,False,5
952,validator_49,72604379290,True,657500000,3970570,661470570,False,2
953,validator_14,123008150419,True,597600001,9710800,607310801,True,3
954,validator_17,197662643897,True,598120002,24797940,622917942,True,6
955,validator_12,112614667760,True,683100011,11946120,695046131,True,3
956,validator_34,306364895220,True,746700000,7396490,754096490,False,9
957,validator_20,40273493985,True,800920001,5610130,806530131,True,1
958,validator_1,74197359025,True,564265995,25430820,589696815,True,2
959,validator_8,38689936458,True,731320010,28760640,760080650,True,1
960,validator_24,35342976953,True,690960001,14703280,705663281,True,1
961,validator_31,185332332560,True,575700000,30879240,606579240,False,5
962,validator_7,73810776071,True,658240003,26494130,684734133,True,2
963,validator_26,40337140650,True,547000000,19473300,566473300,False,1
964,validator_17,198112225921,True,442999994,6582030,449582024,True,6
965,validator_12,113116839004,True,492160004,10011240,502171244,True,3
966,validator_2,36270146986,True,535199999,25603600,560803599,True,1
967,validator_35,106839147390,True,639700000,11610480,651310480,False,3
968,validator_40,37969689560,True,564300000,7333040,571633040,False,1
969,validator_34,307016381620,True,647600000,3886400,651486400,False,9
970,validator_31,185972396980,True,601200000,38864420,640064420,False,5
971,validator_25,38131894220,True,489900000,4012890,493912890,False,1
972,validator_44,108664071340,True,345100000,1362380,346462380,False,3
973,validator_1,74750538466,True,538120001,15059440,553179441,True,2
974,validator_25,38974136450,True,839200000,3042230,842242230,False,1
975,validator_39,38861310640,True,546600000,10600430,557200430,False,1
976,validator_46,114378866720,True,521700000,1433180,523133180,False,3
977,validator_15,311134462624,True,680500002,4736780,685236782,True,9
978,validator_35,107550780390,True,691700000,19933000,711633000,False,3
979,validator_36,116649954690,True,509900000,26519800,536419800,False,3
980,validator_12,113761443409,True,616760005,27844400,644604405,True,3
981,validator_13,42443679132,True,762919999,6817130,769737129,True,1
982,validator_1,75679852361,True,920299995,9013900,929313895,True,2
983,validator_34,307661979230,True,642500000,3097610,645597610,False,9
984,validator_14,123867647563,True,847240004,12257140,859497144,True,3
985,validator_26,40828198970,True,488170000,2888320,491058320,False,1
986,validator_32,38897674010,True,521100000,8378400,529478400,False,1
987,validator_37,79875870630,True,474700000,18153240,492853240,False,2
988,validator_17,198784720310,True,666439999,6054390,672494389,True,6
989,validator_31,186571846400,True,595900000,3549420,599449420,False,5
990,validator_49,73179448160,True,566200000,8868870,575068870,False,2
991,validator_48,189990873090,True,655300000,1419350,656719350,False,5
992,validator_21,76929278704,True,663019995,23276580,686296575,True,2
993,validator_17,199479258486,True,684999996,9538180,694538176,True,6
994,validator_17,200051899386,True,568820000,3820900,572640900,True,6
995,validator_22,75437481258,True,814320003,56217450,870537453,True,2
996,validator_47,76168606120,True,598600000,3176000,601776000,False,2
997,validator_49,73667433300,True,479400000,8585140,487985140,False,2
998,validator_37,80323838160,True,445500000,2467530,447967530,False,2
999,validator_47,76661427690,True,490190000,2631570,492821570,False,2
1000,validator_6,40822193892,True,648720005,6902940,655622945,True,1
1001,validator_31,187246110700,True,672400000,1864300,674264300,False,5
1002,validator_25,39564164140,True,580400000,9627690,590027690,False,1
1003,validator_10,40419543893,True,615439996,1692700,617132696,True,1
1004,validator_48,190558257710,True,564800000,2584620,567384620,False,5
1005,validator_23,39223724120,True,868853996,19708380,888562376,True,1
1006,validator_36,117059645390,True,388400000,21290700,409690700,False,3
1007,validator_18,118577092881,True,645720004,27764900,673484904,True,3
1008,validator_48,191091665920,True,526600000,6808210,533408210,False,5
1009,validator_6,41416206390,True,565520008,28492490,594012498,True,1
1010,validator_14,124610051661,True,732599998,9804100,742404098,True,3
1011,validator_13,43104474630,True,633319998,27475500,660795498,True,1
1012,validator_33,38196944250,True,702100000,20913900,723013900,False,1
1013,validator_22,76251310488,True,761360000,52469230,813829230,True,2
1014,validator_22,76972113640,True,702400002,18403150,720803152,True,2
1015,validator_9,39447005128,True,593720002,35323700,629043702,True,1
1016,validator_1,76397412127,True,706179996,11379770,717559766,True,2
1017,validator_27,113803486490,True,572800000,3292640,576092640,False,3
1018,validator_36,117388885550,True,327200000,2040160,329240160,False,3
1019,validator_31,187815098000,True,567400000,1587300,568987300,False,5
1020,validator_27,114373485120,True,551700000,18298630,569998630,False,3
1021,validator_22,77751375408,True,758440008,20821760,779261768,True,2
1022,validator_22,78552721198,True,766600000,34745790,801345790,True,2
1023,validator_8,39449897583,True,749239995,10721130,759961125,True,1
1024,validator_45,40274875520,True,502500000,2958300,505458300,False,1
1025,validator_6,41998624795,True,569600005,12818400,582418405,True,1
1026,validator_32,39567743150,True,663800000,6269140,670069140,False,1
1027,validator_13,43646083862,True,510480002,31129230,541609232,True,1
1028,validator_41,73777681810,True,652700000,8863780,661563780,False,2
1029,validator_1,77102120595,True,678460008,26248460,704708468,True,2
1030,validator_38,39610147240,True,627100000,2722320,629822320,False,1
1031,validator_18,119417824429,True,819579998,21151550,840731548,True,3
1032,validator_34,308299027600,True,616500000,20548370,637048370,False,9
1033,validator_3,39688175065,True,760700002,3399210,764099212,True,1
1034,validator_2,37037758788,True,741400002,26211800,767611802,True,1
1035,validator_49,74281087010,True,610700000,2953710,613653710,False,2
1036,validator_43,76084710890,True,605400000,21078240,626478240,False,2
1037,validator_17,200746831475,True,670299999,24632090,694932089,True,6
1038,validator_41,74398094430,True,594000000,26412620,620412620,False,2
1039,validator_34,308953807300,True,652000000,2779700,654779700,False,9
1040,validator_1,77644471525,True,500680000,41670930,542350930,True,2
1041,validator_48,191669846010,True,558900000,19280090,578180090,False,5
1042,validator_16,37225939241,True,689399999,8967830,698367829,True,1
1043,validator_17,201407822566,True,644899991,16091100,660991091,True,6
1044,validator_34,309573767140,True,617200000,2759840,619959840,False,9
1045,validator_1,78446147853,True,799999998,1676330,801676328,True,2
1046,validator_48,192297126810,True,606200000,21080800,627280800,False,6
1047,validator_47,77276346090,True,613700000,1218400,614918400,False,2
1048,validator_15,311710207196,True,556000002,19744570,575744572,True,9
1049,validator_36,117985108440,True,583700000,12522890,596222890,False,3
1050,validator_17,201948628925,True,537399999,3406360,540806359,True,6
1051,validator_40,38419962830,True,447600000,2673270,450273270,False,1
1052,validator_28,39236028000,True,511000000,3146750,514146750,False,1
1053,validator_16,37917050973,True,662639992,28471740,691111732,True,1
1054,validator_34,310117985440,True,540100000,4118300,544218300,False,9
1055,validator_17,202646377414,True,665419989,32328500,697748489,True,6
1056,validator_31,188427150900,True,610800000,1252900,612052900,False,5
1057,validator_34,310806605280,True,662600000,26019840,688619840,False,9
1058,validator_40,38984520230,True,561800000,2757400,564557400,False,1
1059,validator_6,42707567397,True,699940002,9002600,708942602,True,1
1060,validator_44,109380983980,True,695200000,21712640,716912640,False,3
1061,validator_28,39751699600,True,513600000,2071600,515671600,False,1
1062,validator_44,110056499560,True,672100000,3415580,675515580,False,3
1063,validator_5,78053856161,True,638670002,17796340,656466342,True,2
1064,validator_24,35963093285,True,612940002,7176330,620116332,True,1
1065,validator_48,192853142590,True,544000000,12015780,556015780,False,6
1066,validator_34,311397553680,True,589000000,1948400,590948400,False,9
1067,validator_10,41219022890,True,771499997,27979000,799478997,True,1
1068,validator_47,77694327710,True,399000000,18981620,417981620,False,2
1069,validator_32,40264653780,True,674800000,22110630,696910630,False,1
1070,validator_4,38938641734,True,625060003,11544460,636604463,True,1
1071,validator_4,39837373456,True,849315992,49415730,898731722,True,1
1072,validator_38,40090966690,True,460100000,20719450,480819450,False,1
1073,validator_10,41946035773,True,682380003,44632880,727012883,True,1
1074,validator_31,189030781740,True,592300000,11330840,603630840,False,5
1075,validator_1,78989535327,True,515300004,28087470,543387474,True,2
1076,validator_14,125336517961,True,691440000,35026300,726466300,True,3
1077,validator_27,114884232740,True,509010000,1737620,510747620,False,3
1078,validator_30,77590835240,True,505900000,20782300,526682300,False,2
1079,validator_34,311999327450,True,598700000,3073770,601773770,False,9
1080,validator_18,120077263045,True,648599996,10838620,659438616,True,3
1081,validator_27,115565410750,True,679100000,2078010,681178010,False,3
1082,validator_31,189670579680,True,636800000,2997940,639797940,False,5
1083,validator_15,312489346597,True,757400001,21739400,779139401,True,9
1084,validator_46,115039778690,True,640700000,20211970,660911970,False,3
1085,validator_15,313161939902,True,652280005,20313300,672593305,True,9
1086,validator_9,40213167438,True,757540000,8622310,766162310,True,1
1087,validator_12,114589678728,True,810067999,18167320,828235319,True,3
1088,validator_41,75014869550,True,613400000,3375120,616775120,False,2
1089,validator_14,126103305962,True,742460001,24328000,766788001,True,3
1090,validator_18,120682142475,True,588940000,15939430,604879430,True,3
1091,validator_14,126727405163,True,582046001,42053200,624099201,True,3
1092,validator_48,193630690670,True,774400000,3148080,777548080,False,6
1093,validator_36,118641690990,True,653600000,2982550,656582550,False,3
1094,validator_17,203219014608,True,569099994,3537200,572637194,True,6
1095,validator_35,108271383530,True,708700000,11903140,720603140,False,3
1096,validator_28,40324771400,True,563700000,9371800,573071800,False,1
1097,validator_41,75707262040,True,691500000,892490,692392490,False,2
1098,validator_48,194085085700,True,453000000,1395030,454395030,False,6
1099,validator_42,38376967230,True,618100000,2621740,620721740,False,1
1100,validator_0,38199093584,True,576419999,21644500,598064499,True,1
1101,validator_12,115164738797,True,568019999,7040070,575060069,True,3
1102,validator_25,40243387260,True,659500000,19723120,679223120,False,1
1103,validator_34,312484847580,True,478900000,6620130,485520130,False,9
1104,validator_19,74180137539,True,644959992,19870260,664830252,True,2
1105,validator_22,79321633100,True,747660002,21251900,768911902,True,2
1106,validator_15,313606111002,True,441400000,2771100,444171100,True,9
1107,validator_28,41077293290,True,750900000,1621890,752521890,False,1
1108,validator_35,108874744350,True,599300000,4060820,603360820,False,3
1109,validator_12,115984737896,True,805519999,14479100,819999099,True,3
1110,validator_15,314478251346,True,823460004,48680340,872140344,True,9
1111,validator_31,190397428630,True,723800000,3048950,726848950,False,5
1112,validator_16,38595080525,True,666740002,11289550,678029552,True,1
1113,validator_17,204058309809,True,815020001,24275200,839295201,True,6
1114,validator_36,119348146010,True,702800000,3655020,706455020,False,3
1115,validator_13,44316224364,True,659114002,11026500,670140502,True,1
1116,validator_19,75020006643,True,829220004,10649100,839869104,True,2
1117,validator_5,78956703062,True,894300001,8546900,902846901,True,2
1118,validator_48,194725848170,True,636500000,4262470,640762470,False,6
1119,validator_5,79742275263,True,767220001,18352200,785572201,True,2
1120,validator_48,195294074670,True,565700000,2526500,568226500,False,6
1121,validator_34,313116455730,True,612000000,19608150,631608150,False,9
1122,validator_24,36743381020,True,755870005,24417730,780287735,True,1
1123,validator_25,40842381860,True,596300000,2694600,598994600,False,1
1124,validator_43,76792365840,True,688400000,19254950,707654950,False,2
1125,validator_18,121466674900,True,742646005,41886420,784532425,True,3
1126,validator_34,313786195420,True,642900000,26839690,669739690,False,9
1127,validator_31,191103209050,True,703400000,2380420,705780420,False,5
1128,validator_22,79840801236,True,470660006,48508130,519168136,True,2
1129,validator_35,109370073960,True,474400000,20929610,495329610,False,3
1130,validator_34,314445599240,True,655900000,3503820,659403820,False,9
1131,validator_15,315160758310,True,673440004,9066960,682506964,True,9
1132,validator_6,43376947737,True,619346000,50034340,669380340,True,1
1133,validator_0,38670077306,True,466900002,4083720,470983722,True,1
1134,validator_41,76446118840,True,735300000,3556800,738856800,False,2
1135,validator_14,127312156703,True,555180000,29571540,584751540,True,3
1136,validator_41,76965441280,True,517100000,2222440,519322440,False,2
1137,validator_2,37822711818,True,774820000,10133030,784953030,True,1
1138,validator_30,78204558900,True,610900000,2823660,613723660,False,2
1139,validator_48,195895240560,True,593800000,7365890,601165890,False,6
1140,validator_48,196476436400,True,575800000,5395840,581195840,False,6
1141,validator_43,77354102240,True,551100000,10636400,561736400,False,2
1142,validator_22,80453070734,True,598239998,14029500,612269498,True,2
1143,validator_47,78434035710,True,731400000,8308000,739708000,False,2
1144,validator_17,205192573113,True,1109440004,24823300,1134263304,True,6
1145,validator_34,315200337280,True,753600000,1138040,754738040,False,9
1146,validator_14,128038186905,True,721800002,4230200,726030202,True,4
1147,validator_11,36004955398,True,688905997,7070820,695976817,True,1
1148,validator_15,315963800827,True,754799997,48242520,803042517,True,9
1149,validator_36,120023147350,True,674300000,701340,675001340,False,3
1150,validator_34,315801203560,True,594300000,6566280,600866280,False,9
1151,validator_7,74553170398,True,731099997,11294330,742394327,True,2
1152,validator_31,191686142970,True,582400000,533920,582933920,False,5
1153,validator_48,197019914660,True,523600000,19878260,543478260,False,6
1154,validator_31,192201148150,True,513700000,1305180,515005180,False,6
1155,validator_48,197640003990,True,602300000,17789330,620089330,False,6
1156,validator_14,128818401935,True,753459990,26755040,780215030,True,4
1157,validator_19,75689261078,True,639619995,29634440,669254435,True,2
1158,validator_17,205807160479,True,593940006,20647360,614587366,True,6
1159,validator_18,122159597698,True,671379998,21542800,692922798,True,3
1160,validator_35,109862031350,True,489900000,2057390,491957390,False,3
1161,validator_31,192947351850,True,722000000,24203700,746203700,False,6
1162,validator_41,77461885080,True,476000000,20443800,496443800,False,2
1163,validator_34,316343824150,True,528200000,14420590,542620590,False,9
1164,validator_33,38722809150,True,523800000,2064900,525864900,False,1
1165,validator_19,76277445513,True,545299995,42884440,588184435,True,2
1166,validator_6,44039662167,True,645840000,16874430,662714430,True,1
1167,validator_3,40324361846,True,621840001,14346780,636186781,True,1
1168,validator_33,39362776390,True,636200000,3767240,639967240,False,1
1169,validator_47,79099091590,True,661300000,3755880,665055880,False,2
1170,validator_12,116680411455,True,691059999,4613560,695673559,True,3
1171,validator_35,110491682550,True,603400000,26251200,629651200,False,3
1172,validator_15,316649404589,True,679440002,6163760,685603762,True,9
1173,validator_25,41396582260,True,552300000,1900400,554200400,False,1
1174,validator_34,317011835780,True,664800000,3211630,668011630,False,9
1175,validator_18,123011802200,True,817480002,34724500,852204502,True,3
1176,validator_34,317359022980,True,339200000,7987200,347187200,False,9
1177,validator_37,81070592800,True,736300000,10454640,746754640,False,2
1178,validator_21,77318897900,True,374399996,15219200,389619196,True,2
1179,validator_18,123676541743,True,653640003,11099540,664739543,True,3
1180,validator_15,317298091788,True,630493999,18193200,648687199,True,9
1181,validator_31,193413735920,True,463300000,3084070,466384070,False,6
1182,validator_34,317893710970,True,532900000,1787990,534687990,False,9
1183,validator_19,77041329638,True,739559995,24324130,763884125,True,2
1184,validator_48,198236860850,True,594600000,2256860,596856860,False,6
1185,validator_27,116130336860,True,552700000,12226110,564926110,False,3
1186,validator_33,39933066650,True,549670000,20620260,570290260,False,1
1187,validator_34,318404155600,True,487440000,23004630,510444630,False,9
1188,validator_15,318015156260,True,671340002,45724470,717064472,True,9
1189,validator_49,74772197610,True,482900000,8210600,491110600,False,2
1190,validator_34,319062251900,True,654900000,3196300,658096300,False,9
1191,validator_18,124184455384,True,505200001,2713640,507913641,True,3
1192,validator_41,78244981410,True,762000000,21096330,783096330,False,2
1193,validator_15,318816367539,True,761500009,39711270,801211279,True,9
1194,validator_34,319735329840,True,653100000,19977940,673077940,False,9
1195,validator_18,125109137309,True,898659995,26021930,924681925,True,3
1196,validator_14,129612903126,True,768099991,26401200,794501191,True,4
1197,validator_14,130267481356,True,643240000,11338230,654578230,True,4
1198,validator_7,75334737600,True,735756002,45811200,781567202,True,2
1199,validator_22,81219980824,True,755319990,11590100,766910090,True,2
1200,validator_30,78785273840,True,578110000,2604940,580714940,False,2
1201,validator_14,131064983861,True,788120005,9382500,797502505,True,4
1202,validator_10,42377553249,True,429299996,2217480,431517476,True,1
1203,validator_43,78029997740,True,669000000,6895500,675895500,False,2
1204,validator_35,110933105850,True,436700000,4723300,441423300,False,3
1205,validator_10,43189705447,True,794193998,17958200,812152198,True,1
1206,validator_41,78876039210,True,621600000,9457800,631057800,False,2
1207,validator_1,79715886426,True,723099999,3251100,726351099,True,2
1208,validator_12,117440843797,True,730654002,29778340,760432342,True,3
1209,validator_2,38474794916,True,609759998,42323100,652083098,True,1
1210,validator_18,125934925958,True,805039999,20748650,825788649,True,3
1211,validator_6,44673023837,True,594606010,38755660,633361670,True,1
1212,validator_35,111585416240,True,650200000,2110390,652310390,False,3
1213,validator_42,39089133890,True,692900000,19266660,712166660,False,1
1214,validator_47,79721057650,True,607000000,14966060,621966060,False,2
1215,validator_0,39279426852,True,581400006,27949540,609349546,True,1
1216,validator_43,78615699070,True,584100000,1601330,585701330,False,2
1217,validator_35,112266251140,True,677980000,2854900,680834900,False,3
1218,validator_15,319486152712,True,645903993,23881180,669785173,True,9
1219,validator_31,193990122730,True,574400000,1986810,576386810,False,6
1220,validator_12,117980282192,True,498014005,41424390,539438395,True,3
1221,validator_4,40507710364,True,650819998,19516910,670336908,True,1
1222,validator_31,194491813030,True,497900000,3790300,501690300,False,6
1223,validator_4,40971530063,True,452365999,11453700,463819699,True,1
1224,validator_44,110564513940,True,498800000,9214380,508014380,False,3
1225,validator_7,75907832073,True,566300003,6794470,573094473,True,2
1226,validator_17,206524452963,True,691520004,25772480,717292484,True,6
1227,validator_31,195074153900,True,580700000,1640870,582340870,False,6
1228,validator_30,79531351540,True,738400000,7677700,746077700,False,2
1229,validator_1,80289851305,True,567673999,6290880,573964879,True,2
1230,validator_48,198741183270,True,493500000,10822420,504322420,False,6
1231,validator_45,40828591300,True,545900000,7815780,553715780,False,1
1232,validator_31,195715020480,True,631700000,9166580,640866580,False,6
1233,validator_34,320538589540,True,798600000,4659700,803259700,False,10
1234,validator_15,320268270008,True,744419996,37697300,782117296,True,10
1235,validator_39,39573153890,True,710700000,1143250,711843250,False,1
1236,validator_43,79346793970,True,717200000,13894900,731094900,False,2
1237,validator_39,40246525620,True,671800000,1571730,673371730,False,1
1238,validator_36,120677206810,True,648700000,5359460,654059460,False,3
1239,validator_15,320671692064,True,382399996,21022060,403422056,True,10
1240,validator_17,207288258264,True,760600001,3205300,763805301,True,6
1241,validator_3,41182019746,True,835340000,22317900,857657900,True,1
1242,validator_1,81049700141,True,735399996,24448840,759848836,True,2
1243,validator_44,111331436570,True,761400000,5522630,766922630,False,3
1244,validator_44,111923886540,True,589600000,2849970,592449970,False,3
1245,validator_46,115583828060,True,523600000,20449370,544049370,False,3
1246,validator_44,112550117160,True,601900000,24330620,626230620,False,3
1247,validator_33,40584893920,True,650000000,1827270,651827270,False,1
1248,validator_31,196332538730,True,616600000,918250,617518250,False,6
1249,validator_15,321316814656,True,594960002,50162590,645122592,True,10
1250,validator_30,80122028660,True,584800000,5877120,590677120,False,2
1251,validator_37,81551350680,True,478300000,2457880,480757880,False,2
1252,validator_14,131744623369,True,675900008,3739500,679639508,True,4
1253,validator_15,321945678201,True,590769995,38093550,628863545,True,10
1254,validator_9,41020837328,True,783640000,24029890,807669890,True,1
1255,validator_34,321311841170,True,745000000,28251630,773251630,False,10
1256,validator_3,41883713349,True,672240003,29453600,701693603,True,1
1257,validator_14,132246480351,True,483240002,18616980,501856982,True,4
1258,validator_31,196973310310,True,620100000,20671580,640771580,False,6
1259,validator_15,322593354798,True,643199997,4476600,647676597,True,10
1260,validator_16,39153912224,True,541645989,17185710,558831699,True,1
1261,validator_18,126694719459,True,704200001,55593500,759793501,True,3
1262,validator_14,133007390269,True,742573998,18335920,760909918,True,4
1263,validator_21,78063049128,True,735999998,8151230,744151228,True,2
1264,validator_12,118547454715,True,565700003,1472520,567172523,True,3
1265,validator_5,80473622459,True,726799996,4547200,731347196,True,2
1266,validator_44,113038927290,True,468400000,20410130,488810130,False,3
1267,validator_12,118996472373,True,443179998,5837660,449017658,True,3
1268,validator_46,116095331580,True,507500000,4003520,511503520,False,3
1269,validator_41,79352628410,True,467400000,9189200,476589200,False,2
1270,validator_29,37644540360,True,527300000,1820780,529120780,False,1
1271,validator_25,41953217510,True,536500000,20135250,556635250,False,1
1272,validator_21,78624490965,True,530779997,30661840,561441837,True,2
1273,validator_43,79910389570,True,558000000,5595600,563595600,False,2
1274,validator_41,80082569090,True,728400000,1540680,729940680,False,2
1275,validator_34,321918054110,True,606000000,212940,606212940,False,10
1276,validator_18,127486635781,True,761040002,30876320,791916322,True,3
1277,validator_35,112746878100,True,451700000,28926960,480626960,False,3
1278,validator_29,38404425260,True,756800000,3084900,759884900,False,1
1279,validator_30,80777169480,True,651100000,4040820,655140820,False,2
1280,validator_2,39257111842,True,755020006,27296920,782316926,True,1
1281,validator_36,121374681080,True,693300000,4174270,697474270,False,3
1282,validator_15,323308259423,True,713300005,1604620,714904625,True,10
1283,validator_41,80814971890,True,712100000,20302800,732402800,False,2
1284,validator_36,121869570720,True,476400000,18489640,494889640,False,3
1285,validator_22,81863056598,True,612840004,30235770,643075774,True,2
1286,validator_28,41536826390,True,451300000,8233100,459533100,False,1
1287,validator_44,113486351460,True,444500000,2924170,447424170,False,3
1288,validator_47,80420282570,True,696700000,2524920,699224920,False,2
1289,validator_11,36628370033,True,622000005,1414630,623414635,True,1
1290,validator_1,82076083588,True,1005640007,20743440,1026383447,True,2
1291,validator_14,133976823288,True,959499999,9933020,969433019,True,4
1292,validator_15,324194481815,True,879900002,6322390,886222392,True,10
1293,validator_7,76730531775,True,809320002,13379700,822699702,True,2
1294,validator_34,322502173140,True,580510000,3609030,584119030,False,10
1295,validator_27,116806075830,True,671700000,4038970,675738970,False,3
1296,validator_19,77923600530,True,872600002,9670890,882270892,True,2
1297,validator_34,323222175330,True,713500000,6502190,720002190,False,10
1298,validator_15,324852296615,True,644200000,13614800,657814800,True,10
1299,validator_9,41548415632,True,486508004,41070300,527578304,True,1
1300,validator_15,325368103008,True,485593993,30212400,515806393,True,10
1301,validator_46,116511801190,True,408740000,7729610,416469610,False,3
1302,validator_41,81677583420,True,842300000,20311530,862611530,False,2
1303,validator_12,119624411203,True,603560000,24378830,627938830,True,3
1304,validator_34,323765272930,True,540900000,2197600,543097600,False,10
1305,validator_12,120323151296,True,668739993,30000100,698740093,True,3
1306,validator_32,40763938500,True,497200000,2084720,499284720,False,1
1307,validator_26,41594869940,True,761400000,5270970,766670970,False,1
1308,validator_42,39788147510,True,690600000,8413620,699013620,False,1
1309,validator_36,122589018720,True,716600000,2848000,719448000,False,3
1310,validator_48,199414743800,True,659800000,13760530,673560530,False,6
1311,validator_18,128160593672,True,656899991,17057900,673957891,True,4
1312,validator_14,134666689892,True,682540004,7326600,689866604,True,4
1313,validator_15,325988911032,True,614899994,5908030,620808024,True,10
1314,validator_30,81287401500,True,508500000,1732020,510232020,False,2
1315,validator_29,39010076160,True,601000000,4650900,605650900,False,1
1316,validator_35,113437950950,True,658100000,32972850,691072850,False,3
1317,validator_47,81125703350,True,696600000,8820780,705420780,False,2
1318,validator_21,79396840944,True,730139999,42209980,772349979,True,2
1319,validator_21,79994430857,True,576465993,21123920,597589913,True,2
1320,validator_45,41451239960,True,608300000,14348660,622648660,False,1
1321,validator_17,207925383872,True,591819998,45305610,637125608,True,6
1322,validator_14,135314258141,True,644499999,3068250,647568249,True,4
1323,validator_34,324175210330,True,405700000,4237400,409937400,False,10
1324,validator_17,208753971268,True,800299996,28287400,828587396,True,6
1325,validator_27,117486229920,True,660300000,19854090,680154090,False,3
1326,validator_15,326705700228,True,671321996,45467200,716789196,True,10
1327,validator_48,200109233850,True,690900000,3590050,694490050,False,6
1328,validator_0,40061280547,True,753599995,28253700,781853695,True,1
1329,validator_36,123143333720,True,544700000,9615000,554315000,False,3
1330,validator_18,128965239898,True,785020006,19626220,804646226,True,4
1331,validator_34,324981000830,True,802500000,3290500,805790500,False,10
1332,validator_44,114115133940,True,625000000,3782480,628782480,False,3
1333,validator_13,44876778361,True,548539997,12014000,560553997,True,1
1334,validator_30,81839974440,True,533600000,18972940,552572940,False,2
1335,validator_12,120934066501,True,587740005,23175200,610915205,True,3
1336,validator_35,113927195650,True,487700000,1544700,489244700,False,3
1337,validator_15,327387953813,True,670040005,12213580,682253585,True,10
1338,validator_34,325520462130,True,537700000,1761300,539461300,False,10
1339,validator_14,136140249242,True,793520011,32471090,825991101,True,4
1340,validator_15,328304487023,True,887460010,29073200,916533210,True,10
1341,validator_12,121782584305,True,815754004,32763800,848517804,True,3
1342,validator_15,328832624760,True,495399997,32737740,528137737,True,10
1343,validator_43,80498052500,True,583700000,3962930,587662930,False,2
1344,validator_12,122563378881,True,753200006,27594570,780794576,True,3
1345,validator_34,326290594220,True,758400000,11732090,770132090,False,10
1346,validator_1,82709792591,True,597194003,36515000,633709003,True,2
1347,validator_34,326895666180,True,586000000,19071960,605071960,False,10
1348,validator_43,81118693860,True,618600000,2041360,620641360,False,2
1349,validator_27,118095279090,True,602600000,6449170,609049170,False,3
1350,validator_27,118723546570,True,626600000,1667480,628267480,False,3
1351,validator_48,200517999130,True,384700000,24065280,408765280,False,6
1352,validator_17,209424649639,True,652340001,18338370,670678371,True,6
1353,validator_14,136961939363,True,808600001,13090120,821690121,True,4
1354,validator_18,129568924697,True,593319999,10364800,603684799,True,4
1355,validator_49,75190764010,True,418000000,566400,418566400,False,2
1356,validator_9,42285718430,True,735099998,2202800,737302798,True,1
1357,validator_46,117062180210,True,542400000,7979020,550379020,False,3
1358,validator_46,117821604260,True,746200000,13224050,759424050,False,3
1359,validator_34,327570121240,True,667500000,6955060,674455060,False,10
1360,validator_46,118525009940,True,691900000,11505680,703405680,False,3
1361,validator_19,78710883716,True,764183996,23099190,787283186,True,2
1362,validator_15,329741228616,True,860269996,48333860,908603856,True,10
1363,validator_44,114645848540,True,520300000,10414600,530714600,False,3
1364,validator_34,328023392030,True,450200000,3070790,453270790,False,10
1365,validator_23,39792119959,True,559799999,8595840,568395839,True,1
1366,validator_31,197387295130,True,412000000,1984820,413984820,False,6
1367,validator_18,130184725712,True,567999995,47801020,615801015,True,4
1368,validator_12,123402230613,True,811574002,27277730,838851732,True,3
1369,validator_31,198092086320,True,685300000,19491190,704791190,False,6
1370,validator_31,198604307380,True,495500000,16721060,512221060,False,6
1371,validator_48,201215349680,True,696100000,1250550,697350550,False,6
1372,validator_31,199375566140,True,766800000,4458760,771258760,False,6
1373,validator_17,210496478481,True,1047700002,24128840,1071828842,True,6
1374,validator_37,81979626580,True,423200000,5075900,428275900,False,2
1375,validator_25,42378748000,True,423800000,1730490,425530490,False,1
1376,validator_16,39986550182,True,813139998,19497960,832637958,True,1
1377,validator_37,82647708590,True,654600000,13482010,668082010,False,2
1378,validator_13,45718993363,True,805460002,36755000,842215002,True,1
1379,validator_48,201901021950,True,680900000,4772270,685672270,False,6
1380,validator_35,114338809490,True,407900000,3713840,411613840,False,3
1381,validator_4,41585905804,True,603240001,11135740,614375741,True,1
1382,validator_31,199961798130,True,584500000,1731990,586231990,False,6
1383,validator_16,40768505587,True,765380005,16575400,781955405,True,1
1384,validator_37,83022110430,True,371300000,3101840,374401840,False,2
1385,validator_46,119097605970,True,563800000,8796030,572596030,False,3
1386,validator_17,211306339823,True,798500012,11361330,809861342,True,6
1387,validator_24,37470878620,True,701000000,26497600,727497600,True,1
1388,validator_37,83705925770,True,681800000,2015340,683815340,False,2
1389,validator_35,115139972910,True,780700000,20463420,801163420,False,3
1390,validator_33,41212254550,True,625900000,1460630,627360630,False,1
1391,validator_31,200536136230,True,553500000,20838100,574338100,False,6
1392,validator_18,130715774515,True,489120003,41928800,531048803,True,4
1393,validator_12,124276951379,True,859639996,15080770,874720766,True,3
1394,validator_37,84288310790,True,530400000,51985020,582385020,False,2
1395,validator_31,201174072350,True,634600000,3336120,637936120,False,6
1396,validator_21,80664532958,True,598460001,71642100,670102101,True,2
1397,validator_31,201774538000,True,598900000,1565650,600465650,False,6
1398,validator_20,40787141751,True,477399996,36247770,513647766,True,1
1399,validator_15,330395855813,True,652400007,2227190,654627197,True,10
1400,validator_15,331049443446,True,638180003,15407630,653587633,True,10
1401,validator_34,328600334480,True,571400000,5542450,576942450,False,10
1402,validator_15,331806990488,True,751400002,6147040,757547042,True,10
1403,validator_44,115335641240,True,686100000,3692700,689792700,False,3
1404,validator_15,332325729566,True,491659998,27079080,518739078,True,10
1405,validator_43,81582844590,True,462900000,1250730,464150730,False,2
1406,validator_18,131869035749,True,1142719994,10541240,1153261234,True,4
1407,validator_44,116019285910,True,670500000,13144670,683644670,False,3
1408,validator_46,119724765530,True,623800000,3359560,627159560,False,3
1409,validator_14,137933473414,True,949640001,21894050,971534051,True,4
1410,validator_19,79587378019,True,874740003,1754300,876494303,True,2
1411,validator_0,40933946173,True,854199996,18465630,872665626,True,1
1412,validator_3,42615917711,True,722900002,9304360,732204362,True,1
1413,validator_31,202420433300,True,637200000,8695300,645895300,False,6
1414,validator_15,333075153927,True,743119991,6304370,749424361,True,10
1415,validator_17,211948300583,True,610670000,31290760,641960760,True,6
1416,validator_35,115697586930,True,547800000,9814020,557614020,False,3
1417,validator_48,202611240340,True,690300000,19918390,710218390,False,6
1418,validator_8,40268970769,True,799720006,19353180,819073186,True,1
1419,validator_42,40239763670,True,449900000,1716160,451616160,False,1
1420,validator_9,42924185670,True,630466000,8001240,638467240,True,1
1421,validator_2,39947315644,True,666980002,23223800,690203802,True,1
1422,validator_17,212592200430,True,611340007,32559840,643899847,True,6
1423,validator_2,40674689402,True,716019998,11353760,727373758,True,1
1424,validator_16,41493853170,True,700460003,24887580,725347583,True,1
1425,validator_48,203300171250,True,685100000,3830910,688930910,False,6
1426,validator_49,75894925240,True,700100000,4061230,704161230,False,2
1427,validator_48,204007954630,True,705100000,2683380,707783380,False,6
1428,validator_35,116235119550,True,527900000,9632620,537532620,False,3
1429,validator_31,203068059390,True,619300000,28326090,647626090,False,6
1430,validator_34,329214651710,True,612200000,2117230,614317230,False,10
1431,validator_17,213560517411,True,966900001,1416980,968316981,True,6
1432,validator_38,40605037790,True,512700000,1371100,514071100,False,1
1433,validator_18,132794578742,True,905240003,20302990,925542993,True,4
1434,validator_48,204784202560,True,772100000,4147930,776247930,False,6
1435,validator_14,138711595244,True,742440000,35681830,778121830,True,4
1436,validator_45,42078987890,True,624400000,3347930,627747930,False,1
1437,validator_34,329729914130,True,496300000,18962420,515262420,False,10
1438,validator_15,334022077307,True,905654000,41269380,946923380,True,10
1439,validator_17,214380179293,True,813540002,6121880,819661882,True,6
1440,validator_39,40733597130,True,483900000,3171510,487071510,False,1
1441,validator_27,119380323100,True,651900000,4876530,656776530,False,3
1442,validator_5,81173334666,True,696500007,3212200,699712207,True,2
1443,validator_23,40536371846,True,709895997,34355890,744251887,True,1
1444,validator_11,37524782839,True,872560006,23852800,896412806,True,1
1445,validator_24,38160525319,True,661899999,27746700,689646699,True,1
1446,validator_13,46594992864,True,838700001,37299500,875999501,True,1
1447,validator_45,42637731610,True,539900000,18843720,558743720,False,1
1448,validator_49,76436525840,True,532700000,8900600,541600600,False,2
1449,validator_11,38241283137,True,697719998,18780300,716500298,True,1
1450,validator_17,215097305103,True,714400000,2725810,717125810,True,6
1451,validator_31,203634975450,True,547400000,19516060,566916060,False,6
1452,validator_5,81807803525,True,618759999,15708860,634468859,True,2
1453,validator_47,81631739940,True,485200000,20836590,506036590,False,2
1454,validator_18,133398337946,True,600900004,2859200,603759204,True,4
1455,validator_46,120366559330,True,617100000,24693800,641793800,False,3
1456,validator_15,334572618913,True,504080006,46461600,550541606,True,10
1457,validator_47,82304530880,True,668100000,4690940,672790940,False,2
1458,validator_48,205424386730,True,633400000,6784170,640184170,False,6
1459,validator_31,204267118840,True,613400000,18743390,632143390,False,6
1460,validator_19,80411158168,True,796367999,27412150,823780149,True,2
1461,validator_6,45490104801,True,790659994,26420970,817080964,True,1
1462,validator_31,204848726430,True,580100000,1507590,581607590,False,6
1463,validator_15,335252274702,True,658579999,21075790,679655789,True,10
1464,validator_27,119994908700,True,613000000,1585600,614585600,False,3
1465,validator_7,77367744553,True,630199998,7012780,637212778,True,2
1466,validator_44,116669023590,True,634600000,15137680,649737680,False,3
1467,validator_48,206140233590,True,712900000,2946860,715846860,False,6
1468,validator_42,40911597370,True,669800000,2033700,671833700,False,1
1469,validator_15,335847399141,True,575057999,20066440,595124439,True,10
1470,validator_15,336672937370,True,801017999,24520230,825538229,True,10
1471,validator_14,139624066540,True,887700006,24771290,912471296,True,4
1472,validator_14,140308455963,True,677163993,7225430,684389423,True,4
1473,validator_21,81178640145,True,510953997,3153190,514107187,True,2
1474,validator_31,205419632230,True,560800000,10105800,570905800,False,6
1475,validator_27,120555819810,True,556000000,4911110,560911110,False,3
1476,validator_38,41061622620,True,453900000,2684830,456584830,False,1
1477,validator_39,41380297630,True,643100000,3600500,646700500,False,1
1478,validator_31,205965229210,True,537200000,8396980,545596980,False,6
1479,validator_18,133974531492,True,569400006,6793540,576193546,True,4
1480,validator_22,82762939630,True,879773992,20109040,899883032,True,2
1481,validator_21,81969002848,True,770540003,19822700,790362703,True,2
1482,validator_31,206639817740,True,673000000,1588530,674588530,False,6
1483,validator_18,134736415982,True,741894000,19990490,761884490,True,4
1484,validator_43,82118009850,True,531970000,3195260,535165260,False,2
1485,validator_0,41563824768,True,604199995,25678600,629878595,True,1
1486,validator_31,207392369140,True,731700000,20851400,752551400,False,6
1487,validator_1,83584802409,True,856833998,18175820,875009818,True,2
1488,validator_49,77166438930,True,709000000,20913090,729913090,False,2
1489,validator_25,42982231080,True,600600000,2883080,603483080,False,1
1490,validator_15,337082489210,True,370000000,39551840,409551840,True,10
1491,validator_48,206772196210,True,607900000,24062620,631962620,False,6
1492,validator_34,330142723830,True,411200000,1609700,412809700,False,10
1493,validator_6,46032661687,True,515659996,26896890,542556886,True,1
1494,validator_17,215561948816,True,449739993,14903720,464643713,True,6
1495,validator_1,84395505506,True,746399997,64303100,810703097,True,2
1496,validator_34,330746260330,True,585600000,17936500,603536500,False,10
1497,validator_15,337786334133,True,694660003,9184920,703844923,True,10
1498,validator_49,77932654900,True,762200000,4015970,766215970,False,2
1499,validator_31,208184613560,True,788500000,3744420,792244420,False,6
1500,validator_15,338550209218,True,710179995,53695090,763875085,True,10
1501,validator_37,84888768160,True,598000000,2457370,600457370,False,2
1502,validator_38,41822991470,True,750800000,10568850,761368850,False,1
1503,validator_1,85066879650,True,626280004,45094140,671374144,True,2
1504,validator_46,121071337910,True,696100000,8678580,704778580,False,3
1505,validator_37,85438393090,True,528700000,20924930,549624930,False,2
1506,validator_48,207344478980,True,571100000,1182770,572282770,False,6
1507,validator_14,141073098857,True,737719994,26922900,764642894,True,4
1508,validator_36,123654972720,True,509000000,2639000,511639000,False,3
1509,validator_24,38785969167,True,619200008,6243840,625443848,True,1
1510,validator_34,331435204170,True,685100000,3843840,688943840,False,10
1511,validator_31,208802353790,True,596300000,21440230,617740230,False,6
1512,validator_15,339316419362,True,736859994,29350150,766210144,True,10
1513,validator_34,331913486360,True,474100000,4182190,478282190,False,10
1514,validator_17,216163568053,True,556880007,44739230,601619237,True,6
1515,validator_9,43503312810,True,524380000,54747140,579127140,True,1
1516,validator_15,340187908726,True,830685994,40803370,871489364,True,10
1517,validator_41,82218276310,True,533780000,6912890,540692890,False,2
1518,validator_14,141648948557,True,558600000,17249700,575849700,True,4
1519,validator_47,82919549410,True,589200000,25818530,615018530,False,2
1520,validator_44,117333527080,True,663100000,1403490,664503490,False,3
1521,validator_15,340777840949,True,569959993,19972230,589932223,True,10
1522,validator_31,209363609470,True,554000000,7255680,561255680,False,6
1523,validator_27,121156124340,True,590500000,9804530,600304530,False,3
1524,validator_47,83538306910,True,615830000,2927500,618757500,False,2
1525,validator_34,332646985220,True,730400000,3098860,733498860,False,10
1526,validator_18,135275775275,True,526559993,12799300,539359293,True,4
1527,validator_35,116910969990,True,668900000,6950440,675850440,False,3
1528,validator_14,142422032256,True,734939999,38143700,773083699,True,4
1529,validator_25,43529237500,True,544900000,2106420,547006420,False,1
1530,validator_46,121766377200,True,674300000,20739290,695039290,False,3
1531,validator_16,42187136301,True,653140001,40143130,693283131,True,1
1532,validator_31,209929318270,True,549800000,15908800,565708800,False,6
1533,validator_23,41124221038,True,567974002,19875190,587849192,True,1
1534,validator_15,341420936886,True,626557997,16537940,643095937,True,10
1535,validator_1,85824941044,True,730618004,27443390,758061394,True,2
1536,validator_48,207976977480,True,625500000,6998500,632498500,False,6
1537,validator_34,333255960120,True,605100000,3874900,608974900,False,10
1538,validator_5,82562183933,True,726500008,27880400,754380408,True,2
1539,validator_17,216836253120,True,642760007,29925060,672685067,True,6
1540,validator_36,124271184250,True,614200000,2011530,616211530,False,3
1541,validator_28,42308771890,True,770000000,1945500,771945500,False,1
1542,validator_15,342355928224,True,908959998,26031340,934991338,True,10
1543,validator_30,82389679050,True,541500000,8204610,549704610,False,2
1544,validator_41,82892814810,True,667100000,7438500,674538500,False,2
1545,validator_48,208785766410,True,781900000,26888930,808788930,False,6
1546,validator_48,209513814070,True,723300000,4747660,728047660,False,6
1547,validator_10,43862292162,True,664420005,8166710,672586715,True,1
1548,validator_32,41280210340,True,513100000,3171840,516271840,False,1
1549,validator_48,210106213070,True,581800000,10599000,592399000,False,6
1550,validator_6,46742443890,True,692480003,17302200,709782203,True,1
1551,validator_41,83602729540,True,705000000,4914730,709914730,False,2
1552,validator_27,121731220370,True,573800000,1296030,575096030,False,3
1553,validator_19,81080674137,True,663899999,5615970,669515969,True,2
1554,validator_15,343055805449,True,697899995,1977230,699877225,True,10
1555,validator_28,42695398090,True,379700000,6926200,386626200,False,1
1556,validator_44,117923300020,True,542000000,47772940,589772940,False,3
1557,validator_31,210445888800,True,515600000,970530,516570530,False,6
1558,validator_44,118709458040,True,779100000,7058020,786158020,False,3
1559,validator_6,47556656018,True,786124008,28088120,814212128,True,1
1560,validator_47,83988108500,True,441300000,8501590,449801590,False,2
1561,validator_12,124937931156,True,660069997,909780,660979777,True,3
1562,validator_18,136063500632,True,750680007,37045350,787725357,True,4
1563,validator_43,82657121710,True,532700000,6411860,539111860,False,2
1564,validator_36,124835723250,True,559600000,4939000,564539000,False,3
1565,validator_37,86109616270,True,670500000,723180,671223180,False,2
1566,validator_22,83276167601,True,508980001,4247970,513227971,True,2
1567,validator_24,39533345414,True,740840007,6536240,747376247,True,1
1568,validator_46,122517173730,True,740500000,10296530,750796530,False,3
1569,validator_12,125585421183,True,627639997,19850030,647490027,True,3
1570,validator_35,117599053330,True,679900000,8183340,688083340,False,3
1571,validator_46,123267155830,True,704100000,45882100,749982100,False,3
1572,validator_34,333805271740,True,546200000,3111620,549311620,False,10
1573,validator_18,136825013576,True,737340004,24172940,761512944,True,4
1574,validator_48,210820719810,True,694800000,19706740,714506740,False,6
1575,validator_44,119464282810,True,745500000,9324770,754824770,False,3
1576,validator_46,123775562600,True,498800000,9606770,508406770,False,3
1577,validator_3,43225153637,True,585199996,24035930,609235926,True,1
1578,validator_11,38903500338,True,637440001,24777200,662217201,True,1
1579,validator_15,343791749834,True,685279995,50664390,735944385,True,10
1580,validator_11,39480833629,True,573760001,3573290,577333291,True,1
1581,validator_24,40091637091,True,554739997,3551680,558291677,True,1
1582,validator_34,334416651370,True,605400000,5979630,611379630,False,10
1583,validator_18,137555754062,True,713200006,17540480,730740486,True,4
1584,validator_12,126155498514,True,566840001,3237330,570077331,True,3
1585,validator_36,125551775340,True,697500000,18552090,716052090,False,3
1586,validator_5,83293727532,True,721139999,10403600,731543599,True,2
1587,validator_4,42280131804,True,683440000,10786000,694226000,True,1
1588,validator_36,126161840560,True,607100000,2965220,610065220,False,3
1589,validator_34,335053081060,True,633800000,2629690,636429690,False,10
1590,validator_34,335546542760,True,482900000,10561700,493461700,False,10
1591,validator_34,336148886920,True,600600000,1744160,602344160,False,10
1592,validator_6,48446266554,True,883599996,6010540,889610536,True,1
1593,validator_19,81793546335,True,687559998,25312200,712872198,True,2
1594,validator_9,44137444029,True,627599999,6531220,634131219,True,1
1595,validator_48,211524740970,True,701200000,2821160,704021160,False,6
1596,validator_25,44365476500,True,828000000,8239000,836239000,False,1
1597,validator_48,212220792670,True,688000000,8051700,696051700,False,6
1598,validator_15,344724766830,True,898419996,34597000,933016996,True,10
1599,validator_22,84088139364,True,803420003,8551760,811971763,True,2
1600,validator_28,43243278080,True,538800000,9079990,547879990,False,1
1601,validator_5,84214866878,True,883359996,37779350,921139346,True,2
1602,validator_32,41792722660,True,508900000,3612320,512512320,False,1
1603,validator_14,143352356870,True,906519994,23804620,930324614,True,4
1604,validator_15,345307514371,True,573260001,9487540,582747541,True,10
1605,validator_3,43876060538,True,613834001,37072900,650906901,True,1
1606,validator_48,212840051330,True,609100000,10158660,619258660,False,6
1607,validator_18,138223022763,True,586790001,80478700,667268701,True,4
1608,validator_10,44778811481,True,860199999,56319320,916519319,True,1
1609,validator_19,82564944475,True,747800000,23598140,771398140,True,2
1610,validator_6,49027192154,True,577700000,3225600,580925600,True,1
1611,validator_15,346316016151,True,982360000,26141780,1008501780,True,10
1612,validator_2,41326949816,True,600063994,52196420,652260414,True,1
1613,validator_11,39961962844,True,425499995,55629220,481129215,True,1
1614,validator_30,82936633280,True,538700000,8254230,546954230,False,2
1615,validator_41,84387324440,True,783100000,1494900,784594900,False,2
1616,validator_18,138842580140,True,608499997,11057380,619557377,True,4
1617,validator_11,40525359301,True,536299997,27096460,563396457,True,1
1618,validator_35,118191876040,True,582600000,10222710,592822710,False,3
1619,validator_15,347218968076,True,883939995,19011930,902951925,True,10
1620,validator_36,126758064280,True,586500000,9723720,596223720,False,3
1621,validator_48,213281290360,True,423000000,18239030,441239030,False,6
1622,validator_15,348025337045,True,802699999,3668970,806368969,True,10
1623,validator_26,42170756580,True,573000000,2886640,575886640,False,1
1624,validator_14,144145841273,True,762460003,31024400,793484403,True,4
1625,validator_12,126982394170,True,806699996,20195660,826895656,True,3
1626,validator_5,85025335279,True,782540001,27928400,810468401,True,2
1627,validator_16,43053450084,True,856170003,10143780,866313783,True,1
1628,validator_46,124317019570,True,540000000,1456970,541456970,False,3
1629,validator_47,84591887290,True,584600000,19178790,603778790,False,2
1630,validator_19,83132213820,True,559460005,7809340,567269345,True,2
1631,validator_41,85062591960,True,674000000,1267520,675267520,False,2
1632,validator_47,85215007260,True,614700000,8419970,623119970,False,2
1633,validator_46,124964494640,True,644800000,2675070,647475070,False,3
1634,validator_1,86429540990,True,584400006,20199940,604599946,True,2
1635,validator_39,42023277280,True,636500000,6479650,642979650,False,1
1636,validator_19,83685960380,True,531360000,22386560,553746560,True,2
1637,validator_44,120022519740,True,555900000,2336930,558236930,False,3
1638,validator_18,139692457816,True,832465996,17411680,849877676,True,4
1639,validator_48,213982169050,True,695200000,5678690,700878690,False,6
1640,validator_46,125506724160,True,540700000,1529520,542229520,False,3
1641,validator_10,45290773058,True,504920007,7041570,511961577,True,1
1642,validator_5,85776959754,True,732400005,19224470,751624475,True,2
1643,validator_38,42521671330,True,696200000,2479860,698679860,False,1
1644,validator_16,43758451766,True,695620002,9381680,705001682,True,1
1645,validator_34,336981974980,True,830300000,2788060,833088060,False,10
1646,validator_2,41981703516,True,621440000,33313700,654753700,True,1
1647,validator_49,78450800550,True,515900000,2245650,518145650,False,2
1648,validator_17,217588137052,True,724240002,27643930,751883932,True,6
1649,validator_7,78307792751,True,936799998,3248200,940048198,True,2
1650,validator_18,140439526760,True,701840004,45228940,747068944,True,4
1651,validator_41,85822551460,True,738700000,21259500,759959500,False,2
1652,validator_49,79124912370,True,672700000,1411820,674111820,False,2
1653,validator_46,126141411700,True,632100000,2587540,634687540,False,3
1654,validator_48,214669623700,True,684900000,2554650,687454650,False,6
1655,validator_49,79778340590,True,652300000,1128220,653428220,False,2
1656,validator_15,348749977445,True,716400000,8240400,724640400,True,10
1657,validator_17,218306476179,True,695620007,22719120,718339127,True,6
1658,validator_12,127727368791,True,694816001,50158620,744974621,True,3
1659,validator_22,84935114483,True,845100009,1875110,846975119,True,2
1660,validator_15,349241580480,True,476140005,15463030,491603035,True,10
1661,validator_15,349990629404,True,742160004,6888920,749048924,True,10
1662,validator_48,215060036110,True,387000000,3412410,390412410,False,6
1663,validator_44,120672767920,True,647600000,2648180,650248180,False,3
1664,validator_36,127340829880,True,579900000,2865600,582765600,False,3
1665,validator_30,83714528180,True,771400000,6494900,777894900,False,2
1666,validator_48,215645607870,True,582000000,3571760,585571760,False,6
1667,validator_37,86670584040,True,541900000,19067770,560967770,False,2
1668,validator_46,126830045900,True,668200000,20434200,688634200,False,3
1669,validator_34,337537591820,True,549100000,6516840,555616840,False,10
1670,validator_46,127360122490,True,528400000,1676590,530076590,False,3
1671,validator_7,79032229351,True,721820000,2616600,724436600,True,2
1672,validator_31,211139197430,True,683100000,10208630,693308630,False,6
1673,validator_15,350741592908,True,696400004,54563500,750963504,True,10
1674,validator_25,44969928410,True,602300000,2151910,604451910,False,1
1675,validator_6,49578909857,True,547400003,4317700,551717703,True,1
1676,validator_49,80413782790,True,629200000,6242200,635442200,False,2
1677,validator_48,216155210800,True,506600000,3002930,509602930,False,6
1678,validator_31,211838888330,True,698500000,1190900,699690900,False,6
1679,validator_24,40887086983,True,778806002,16643890,795449892,True,1
1680,validator_24,41506281586,True,576914003,42280600,619194603,True,1
1681,validator_47,85843974680,True,617900000,11067420,628967420,False,2
1682,validator_48,216893446320,True,735000000,3235520,738235520,False,6
1683,validator_14,144782489675,True,617896002,18752400,636648402,True,4
1684,validator_48,217643267240,True,738300000,11520920,749820920,False,6
1685,validator_34,338176707460,True,630700000,8415640,639115640,False,10
1686,validator_17,218974423569,True,665000000,2947390,667947390,True,6
1687,validator_37,87113416100,True,440300000,2532060,442832060,False,2
1688,validator_22,85571887806,True,603714003,33059320,636773323,True,2
1689,validator_8,40797954971,True,519120002,9864200,528984202,True,1
1690,validator_43,83226685260,True,532700000,36863550,569563550,False,2
1691,validator_34,338738834460,True,560300000,1827000,562127000,False,10
1692,validator_31,212366059820,True,523700000,3471490,527171490,False,6
1693,validator_14,145619545610,True,815367995,21687940,837055935,True,4
1694,validator_17,219770720269,True,767240000,29056700,796296700,True,6
1695,validator_35,118818374740,True,588600000,37898700,626498700,False,3
1696,validator_17,220336482352,True,535650003,30112080,565762083,True,6
1697,validator_5,86399500341,True,579875997,42664590,622540587,True,2
1698,validator_17,221031374418,True,682619996,12272070,694892066,True,6
1699,validator_41,86390391560,True,564400000,3440100,567840100,False,2
1700,validator_34,339254783060,True,513400000,2548600,515948600,False,10
1701,validator_48,218110938640,True,440400000,27271400,467671400,False,6
1702,validator_34,339793466590,True,537400000,1283530,538683530,False,10
1703,validator_1,87117318190,True,666740000,21037200,687777200,True,2
1704,validator_40,39507100330,True,521940000,640100,522580100,False,1
1705,validator_1,87930687489,True,811599999,1769300,813369299,True,2
1706,validator_33,41647506950,True,434000000,1252400,435252400,False,1
1707,validator_47,86519438160,True,673000000,2463480,675463480,False,2
1708,validator_48,218586311540,True,461400000,13972900,475372900,False,6
1709,validator_36,127824338560,True,481300000,2208680,483508680,False,3
1710,validator_15,351389672680,True,636580002,11499770,648079772,True,10
1711,validator_35,119365689770,True,545500000,1815030,547315030,False,3
1712,validator_7,79986631158,True,903959997,50441810,954401807,True,2
1713,validator_48,219183483840,True,595100000,2072300,597172300,False,6
1714,validator_31,213213388750,True,844300000,3028930,847328930,False,6
1715,validator_42,41503382630,True,575200000,16585260,591785260,False,1
1716,validator_27,122450112170,True,714000000,4891800,718891800,False,3
1717,validator_22,86273378901,True,685999995,15491100,701491095,True,2
1718,validator_12,128581364332,True,812540001,41455540,853995541,True,4
1719,validator_15,351817056519,True,382339999,45043840,427383839,True,10
1720,validator_14,146445782052,True,805440002,20796440,826236442,True,4
1721,validator_17,221771561368,True,715000000,25186950,740186950,True,6
1722,validator_8,41588111700,True,740249999,49906730,790156729,True,1
1723,validator_15,352726324042,True,899500003,9767520,909267523,True,11
1724,validator_12,129216336614,True,619540002,15432280,634972282,True,4
1725,validator_19,84788070425,True,1084299995,17810050,1102110045,True,2
1726,validator_33,42320543240,True,663400000,9636290,673036290,False,1
1727,validator_1,88829591994,True,897000005,1904500,898904505,True,2
1728,validator_31,213950301540,True,717600000,19312790,736912790,False,6
1729,validator_15,353449862279,True,710619997,12918240,723538237,True,11
1730,validator_34,340418628050,True,604800000,20361460,625161460,False,10
1731,validator_48,219947453760,True,744200000,19769920,763969920,False,6
1732,validator_34,340928197780,True,507500000,2069730,509569730,False,10
1733,validator_15,354314013880,True,861500001,2651600,864151601,True,11
1734,validator_32,42325440330,True,530710000,2007670,532717670,False,1
1735,validator_28,43806047930,True,559800000,2969850,562769850,False,1
1736,validator_27,123017028720,True,565800000,1116550,566916550,False,3
1737,validator_5,86930631642,True,496360001,34771300,531131301,True,2
1738,validator_34,341473342620,True,538200000,6944840,545144840,False,10
1739,validator_12,129890268059,True,649920005,24011440,673931445,True,4
1740,validator_34,342164262860,True,681500000,9420240,690920240,False,10
1741,validator_45,43358818450,True,700400000,20686840,721086840,False,1
1742,validator_34,342670522380,True,504200000,2059520,506259520,False,10
1743,validator_17,222696046035,True,890879997,33604670,924484667,True,6
1744,validator_48,220308183030,True,359300000,1429270,360729270,False,6
1745,validator_3,44562009535,True,653839997,32109000,685948997,True,1
1746,validator_36,128532226560,True,702100000,5788000,707888000,False,4
1747,validator_34,343277020060,True,603300000,3197680,606497680,False,10
1748,validator_25,45631869630,True,642100000,19841220,661941220,False,1
1749,validator_46,127927225620,True,563300000,3803130,567103130,False,3
1750,validator_48,220993588560,True,676100000,9305530,685405530,False,6
1751,validator_37,87731229690,True,612100000,5713590,617813590,False,2
1752,validator_24,42083719882,True,548999996,28438300,577438296,True,1
1753,validator_48,221593628660,True,592700000,7340100,600040100,False,6
1754,validator_27,123592873350,True,574300000,1544630,575844630,False,3
1755,validator_20,41530044549,True,711619998,31282800,742902798,True,1
1756,validator_44,121366190790,True,672900000,20522870,693422870,False,3
1757,validator_17,223449817359,True,744740004,9031320,753771324,True,6
1758,validator_31,214513319180,True,536800000,26217640,563017640,False,6
1759,validator_45,43949986250,True,586000000,5167800,591167800,False,1
1760,validator_12,130616099059,True,710240000,15591000,725831000,True,4
1761,validator_30,84215996510,True,499200000,2268330,501468330,False,2
1762,validator_22,86971910397,True,674139996,24391500,698531496,True,2
1763,validator_15,354960628274,True,622580004,24034390,646614394,True,11
1764,validator_20,42062887010,True,514040001,18802460,532842461,True,1
1765,validator_34,343930174690,True,651900000,1254630,653154630,False,10
1766,validator_16,44454586189,True,683120003,13014420,696134423,True,1
1767,validator_5,87571083039,True,630059997,10391400,640451397,True,2
1768,validator_5,88169203750,True,584600001,13520710,598120711,True,2
1769,validator_35,120020840070,True,644800000,10350300,655150300,False,3
1770,validator_31,215171519880,True,636400000,21800700,658200700,False,6
1771,validator_17,224012298761,True,553020002,9461400,562481402,True,7
1772,validator_2,42576467955,True,584799999,9964440,594764439,True,1
1773,validator_13,47109258345,True,497380001,16885480,514265481,True,1
1774,validator_24,42830723348,True,742000006,5003460,747003466,True,1
1775,validator_20,42934598336,True,846580006,25131320,871711326,True,1
1776,validator_45,44624464150,True,673100000,1377900,674477900,False,1
1777,validator_11,41212345994,True,683799993,3186700,686986693,True,1
1778,validator_28,44426448700,True,607500000,12900770,620400770,False,1
1779,validator_49,81174522010,True,755700000,5039220,760739220,False,2
1780,validator_46,128535206220,True,598200000,9780600,607980600,False,4
1781,validator_46,128903243040,True,358500000,9536820,368036820,False,4
1782,validator_7,80470961607,True,476899999,7430450,484330449,True,2
1783,validator_46,129372856030,True,459700000,9912990,469612990,False,4
1784,validator_15,355680404375,True,682746001,37030100,719776101,True,11
1785,validator_16,44954349888,True,487599999,12163700,499763699,True,1
1786,validator_8,42201807939,True,611199999,2496240,613696239,True,1
1787,validator_37,88212293830,True,471600000,9464140,481064140,False,2
1788,validator_27,124127851810,True,533800000,1178460,534978460,False,3
1789,validator_17,224591936562,True,536200001,43437800,579637801,True,7
1790,validator_44,121907421700,True,537700000,3530910,541230910,False,3
1791,validator_39,42717354730,True,689600000,4477450,694077450,False,1
1792,validator_23,41736989739,True,586360001,26408700,612768701,True,1
1793,validator_21,82518331856,True,528300008,21029000,549329008,True,2
1794,validator_48,222215468500,True,611400000,10439840,621839840,False,6
1795,validator_43,83878908400,True,643700000,8523140,652223140,False,2
1796,validator_26,42855054560,True,681300000,2997980,684297980,False,1
1797,validator_7,81265752284,True,771199997,23590680,794790677,True,2
1798,validator_34,344555627770,True,622000000,3453080,625453080,False,10
1799,validator_34,345327171330,True,750800000,20743560,771543560,False,10
1800,validator_26,43490629500,True,626200000,9374940,635574940,False,1
1801,validator_34,345990532300,True,656900000,6460970,663360970,False,10
1802,validator_43,84586972690,True,687800000,20264290,708064290,False,2
1803,validator_43,85012209910,True,420000000,5237220,425237220,False,2
1804,validator_38,43461253230,True,936700000,2881900,939581900,False,1
1805,validator_46,129875404340,True,500600000,1948310,502548310,False,4
1806,validator_31,215674412580,True,492560000,10332700,502892700,False,6
1807,validator_15,356178640252,True,489339997,8895880,498235877,True,11
1808,validator_17,225137200261,True,524179999,21083700,545263699,True,7
1809,validator_18,140950373895,True,501139995,9707140,510847135,True,4
1810,validator_34,346635391160,True,622000000,22858860,644858860,False,10
1811,validator_22,88047433331,True,1073000004,2522930,1075522934,True,2
1812,validator_48,222832002900,True,614800000,1734400,616534400,False,6
1813,validator_12,131542102961,True,922400002,3603900,926003902,True,4
1814,validator_31,216247693220,True,571470000,1810640,573280640,False,6
1815,validator_49,81691556400,True,510620000,6414390,517034390,False,2
1816,validator_34,347254642280,True,611100000,8151120,619251120,False,10
1817,validator_12,132267475667,True,687859996,37512710,725372706,True,4
1818,validator_34,347916582350,True,635700000,26240070,661940070,False,10
1819,validator_39,43173908620,True,454310000,2243890,456553890,False,1
1820,validator_18,141633350793,True,654059998,28916900,682976898,True,4
1821,validator_14,147069772797,True,604300005,19690740,623990745,True,4
1822,validator_34,348515823460,True,556800000,42441110,599241110,False,10
1823,validator_31,216872386880,True,617800000,6893660,624693660,False,6
1824,validator_17,225859754962,True,715840001,6714700,722554701,True,7
1825,validator_22,88858823037,True,794740006,16649700,811389706,True,2
1826,validator_15,356759207766,True,578600004,1967510,580567514,True,11
1827,validator_47,87093805830,True,554300000,20067670,574367670,False,2
1828,validator_15,357596119364,True,830199998,6711600,836911598,True,11
1829,validator_31,217446481620,True,554500000,19594740,574094740,False,6
1830,validator_17,226735487881,True,826733999,48998920,875732919,True,7
1831,validator_14,147683714216,True,603959999,9981420,613941419,True,4
1832,validator_34,349178476460,True,660500000,2153000,662653000,False,10
1833,validator_48,223459184600,True,625900000,1281700,627181700,False,6
1834,validator_1,89350061521,True,511979997,8489530,520469527,True,2
1835,validator_34,349830556690,True,648700000,3380230,652080230,False,10
1836,validator_49,82284275730,True,590500000,2219330,592719330,False,2
1837,validator_21,83061595374,True,490340008,52923510,543263518,True,2
1838,validator_5,88942337269,True,752139999,20993520,773133519,True,2
1839,validator_19,85378521924,True,553395999,37055500,590451499,True,2
1840,validator_17,227529136277,True,766839996,26808400,793648396,True,7
1841,validator_27,124862176740,True,732500000,1824930,734324930,False,3
1842,validator_34,350377068510,True,538700000,7811820,546511820,False,10
1843,validator_15,358290521077,True,686259993,8141720,694401713,True,11
1844,validator_19,86198036227,True,813620003,5894300,819514303,True,2
1845,validator_36,129128699500,True,586600000,9872940,596472940,False,4
1846,validator_48,224078554270,True,617000000,2369670,619369670,False,7
1847,validator_12,132844451153,True,572040006,4935480,576975486,True,4
1848,validator_39,43657806950,True,464400000,19498330,483898330,False,1
1849,validator_12,133577250933,True,719814000,12985780,732799780,True,4
1850,validator_34,351049499310,True,671600000,830800,672430800,False,10
1851,validator_6,50218722188,True,602290001,37522330,639812331,True,1
1852,validator_35,120553498550,True,522800000,9858480,532658480,False,3
1853,validator_36,129712275030,True,576900000,6675530,583575530,False,4
1854,validator_41,86891427760,True,488400000,12636200,501036200,False,2
1855,validator_2,43339844311,True,762299996,1076360,763376356,True,1
1856,validator_34,351534294920,True,482200000,2595610,484795610,False,10
1857,validator_11,41908229619,True,689499995,6383630,695883625,True,1
1858,validator_44,122532617660,True,611100000,14095960,625195960,False,3
1859,validator_10,45882046031,True,587939993,3332980,591272973,True,1
1860,validator_22,89498655930,True,631020003,8812890,639832893,True,2
1861,validator_34,352129093870,True,589100000,5698950,594798950,False,11
1862,validator_42,42024484220,True,520000000,1101590,521101590,False,1
1863,validator_37,88782568950,True,567400000,2875120,570275120,False,2
1864,validator_20,43523092532,True,570119996,18374200,588494196,True,1
1865,validator_15,359054503580,True,731278003,32704500,763982503,True,11
1866,validator_32,43049188880,True,719600000,4148550,723748550,False,1
1867,validator_11,42464210316,True,545999997,9980700,555980697,True,1
1868,validator_48,224550161510,True,469100000,2507240,471607240,False,7
1869,validator_15,359881660423,True,806600003,20556840,827156843,True,11
1870,validator_15,360290974549,True,401079996,8234130,409314126,True,11
1871,validator_27,125523566770,True,658500000,2890030,661390030,False,3
1872,validator_30,84926392010,True,708000000,2395500,710395500,False,2
1873,validator_15,361027070744,True,710879995,25216200,736096195,True,11
1874,validator_34,352632294950,True,489200000,14001080,503201080,False,11
1875,validator_36,130173936860,True,459900000,1761830,461661830,False,4
1876,validator_15,361657190887,True,620880003,9240140,630120143,True,11
1877,validator_37,89504820770,True,720400000,1851820,722251820,False,2
1878,validator_24,43491382977,True,647399999,13259630,660659629,True,1
1879,validator_24,44160751674,True,624319997,45048700,669368697,True,1
1880,validator_39,44226372440,True,559400000,9165490,568565490,False,1
1881,validator_41,87457367590,True,565100000,839830,565939830,False,2
1882,validator_15,362471537756,True,781359999,32986870,814346869,True,11
1883,validator_27,126266496640,True,739300000,3629870,742929870,False,3
1884,validator_17,228330006567,True,784500000,16370290,800870290,True,7
1885,validator_15,363042300869,True,566839993,3923120,570763113,True,11
1886,validator_18,142255508016,True,567260003,54897220,622157223,True,4
1887,validator_16,45517228780,True,553800002,9078890,562878892,True,1
1888,validator_49,83054102550,True,764400000,5426820,769826820,False,2
1889,validator_6,50876458888,True,652900000,4836700,657736700,True,1
1890,validator_34,353085442950,True,431500000,21648000,453148000,False,11
1891,validator_42,42627143360,True,600900000,1759140,602659140,False,1
1892,validator_14,148512507757,True,808960001,19833540,828793541,True,4
1893,validator_12,134379364260,True,754873997,47239330,802113327,True,4
1894,validator_34,353618936640,True,531400000,2093690,533493690,False,11
1895,validator_21,83829035191,True,765899997,1539820,767439817,True,2
1896,validator_31,218015751270,True,566300000,2969650,569269650,False,6
1897,validator_31,218659232720,True,640100000,3381450,643481450,False,6
1898,validator_47,87631464740,True,535200000,2458910,537658910,False,2
1899,validator_15,363740069713,True,670300004,27468840,697768844,True,11
1900,validator_28,44954524530,True,522300000,5775830,528075830,False,1
1901,validator_42,43237864360,True,607900000,2821000,610721000,False,1
1902,validator_24,44753230393,True,538219999,54258720,592478719,True,1
1903,validator_1,90100881824,True,734420003,16400300,750820303,True,2
1904,validator_33,42942779750,True,615800000,6436510,622236510,False,1
1905,validator_2,44226911979,True,849279998,37787670,887067668,True,1
1906,validator_30,85520476640,True,584340000,9744630,594084630,False,2
1907,validator_14,149519641981,True,1000600004,6534220,1007134224,True,4
1908,validator_34,354317393330,True,696900000,1556690,698456690,False,11
1909,validator_9,44627497592,True,488800003,1253560,490053563,True,1
1910,validator_17,228953616436,True,569539999,54069870,623609869,True,7
1911,validator_15,364524372006,True,752420003,31882290,784302293,True,11
1912,validator_20,44208464765,True,660960003,24412230,685372233,True,1
1913,validator_47,88309287080,True,675400000,2422340,677822340,False,2
1914,validator_17,229461262193,True,491959997,15685760,507645757,True,7
1915,validator_34,354911388190,True,583000000,10994860,593994860,False,11
1916,validator_34,355316159400,True,402700000,2071210,404771210,False,11
1917,validator_13,47771750546,True,660100001,2392200,662492201,True,1
1918,validator_27,126734939340,True,466000000,2442700,468442700,False,3
1919,validator_39,44778022620,True,549100000,2550180,551650180,False,1
1920,validator_46,130476811950,True,582300000,19107610,601407610,False,4
1921,validator_1,90796810966,True,689100002,6829140,695929142,True,2
1922,validator_15,365133076410,True,583820004,24884400,608704404,True,11
1923,validator_23,42731410638,True,990399999,4020900,994420899,True,1
1924,validator_31,219251018320,True,572000000,19785600,591785600,False,6
1925,validator_49,83668871700,True,604900000,9869150,614769150,False,2
1926,validator_23,43581076049,True,840600001,9065410,849665411,True,1
1927,validator_15,365769016165,True,632200005,3739750,635939755,True,11
1928,validator_22,90127609620,True,626600000,2353690,628953690,True,2
1929,validator_45,45276175690,True,649100000,2611540,651711540,False,1
1930,validator_5,89677475810,True,708560001,26578540,735138541,True,2
1931,validator_44,123028445660,True,493500000,2328000,495828000,False,3
1932,validator_26,44148688410,True,654200000,3858910,658058910,False,1
1933,validator_1,91658763728,True,855200002,6752760,861952762,True,2
1934,validator_30,86129382380,True,606100000,2805740,608905740,False,2
1935,validator_31,219910514320,True,635300000,24196000,659496000,False,6
1936,validator_22,90807871334,True,655903994,24357720,680261714,True,2
1937,validator_35,121210130380,True,648700000,7931830,656631830,False,3
1938,validator_40,40236659130,True,703200000,26358800,729558800,False,1
1939,validator_34,355850395740,True,531200000,3036340,534236340,False,11
1940,validator_18,143107900279,True,842459993,9932270,852392263,True,4
1941,validator_31,220527275320,True,610100000,6661000,616761000,False,6
1942,validator_29,39494429210,True,478400000,5953050,484353050,False,1
1943,validator_38,44028535200,True,565100000,2181970,567281970,False,1
1944,validator_17,230223787690,True,737800007,24725490,762525497,True,7
1945,validator_5,90025706450,True,334540000,13690640,348230640,True,2
1946,validator_1,92273162313,True,588960005,25438580,614398585,True,2
1947,validator_0,42379507367,True,767239989,48442610,815682599,True,1
1948,validator_46,130888620750,True,409100000,2708800,411808800,False,4
1949,validator_36,130892445360,True,717300000,1208500,718508500,False,4
1950,validator_14,150286024405,True,757020004,9362420,766382424,True,4
1951,validator_15,366461678025,True,690200000,2461860,692661860,True,11
1952,validator_36,131435799390,True,541200000,2154030,543354030,False,4
1953,validator_24,45675822060,True,887099997,35491670,922591667,True,1
1954,validator_27,127252965840,True,513300000,4726500,518026500,False,3
1955,validator_15,367199869453,True,710935998,27255430,738191428,True,11
1956,validator_10,46693593633,True,778400002,33147600,811547602,True,1
1957,validator_34,356619556530,True,766200000,2960790,769160790,False,11
1958,validator_1,92978847993,True,682380000,23305680,705685680,True,2
1959,validator_46,131456174450,True,564300000,3253700,567553700,False,4
1960,validator_24,46402753942,True,696740002,30191880,726931882,True,1
1961,validator_37,90059881270,True,552400000,2660500,555060500,False,2
1962,validator_20,44895557368,True,684160003,2932600,687092603,True,1
1963,validator_35,121991068840,True,779000000,1938460,780938460,False,3
1964,validator_18,143869184798,True,725803999,35480520,761284519,True,4
1965,validator_15,368003591648,True,781979995,21742200,803722195,True,11
1966,validator_21,84785620919,True,930500008,26085720,956585728,True,2
1967,validator_41,87858462420,True,397330000,3764830,401094830,False,2
1968,validator_31,221109639450,True,572810000,9554130,582364130,False,6
1969,validator_46,132048601530,True,566400000,26027080,592427080,False,4
1970,validator_48,225150363510,True,579900000,20302000,600202000,False,7
1971,validator_48,225763706490,True,608800000,4542980,613342980,False,7
1972,validator_31,221770110350,True,658900000,1570900,660470900,False,6
1973,validator_31,222393605260,True,621000000,2494910,623494910,False,6
1974,validator_15,368711422448,True,701900000,5930800,707830800,True,11
1975,validator_41,88392975060,True,507300000,27212640,534512640,False,2
1976,validator_43,85562304810,True,549300000,794900,550094900,False,2
1977,validator_34,357286782950,True,661600000,5626420,667226420,False,11
1978,validator_30,86641554000,True,492090000,20081620,512171620,False,2
1979,validator_49,84223237620,True,550800000,3565920,554365920,False,2
1980,validator_36,132157239420,True,719700000,1740030,721440030,False,4
1981,validator_48,226456988990,True,690800000,2482500,693282500,False,7
1982,validator_5,91005700252,True,967700002,12293800,979993802,True,2
1983,validator_15,369612382577,True,878600009,22360120,900960129,True,11
1984,validator_15,370216885568,True,581720001,22782990,604502991,True,11
1985,validator_44,123519875780,True,489200000,2230120,491430120,False,3
1986,validator_14,150878091540,True,560960005,31107130,592067135,True,4
1987,validator_14,151503101120,True,616000000,9009580,625009580,True,4
1988,validator_17,231059771788,True,817379998,18604100,835984098,True,7
1989,validator_36,132968599360,True,783600000,27759940,811359940,False,4
1990,validator_40,40662699880,True,423500000,2540750,426040750,False,1
1991,validator_7,81892868508,True,588019994,39096230,627116224,True,2
1992,validator_15,371109395958,True,875079990,17430400,892510390,True,11
1993,validator_4,43113069621,True,817499997,15437820,832937817,True,1
1994,validator_45,45920675700,True,640500000,4000010,644500010,False,1
1995,validator_44,123978262500,True,456970000,1416720,458386720,False,3
1996,validator_14,152071999784,True,565800004,3098660,568898664,True,4
1997,validator_37,90636604970,True,574200000,2523700,576723700,False,2
1998,validator_1,93708196617,True,727100004,2248620,729348624,True,2
1999,validator_12,135270540376,True,866239996,24936120,891176116,True,4
2000,validator_34,358017196950,True,728800000,1614000,730414000,False,11
2001,validator_34,358540979180,True,521200000,2582230,523782230,False,11
2002,validator_5,91607361525,True,560220003,41441270,601661273,True,2
2003,validator_34,359237092680,True,693400000,2713500,696113500,False,11
2004,validator_10,47275095229,True,579799996,1701600,581501596,True,1
2005,validator_34,359904257830,True,665400000,1765150,667165150,False,11
2006,validator_15,371695688299,True,562000011,24292330,586292341,True,11
2007,validator_39,45316232150,True,500300000,37909530,538209530,False,1
2008,validator_34,360537428260,True,613240000,19930430,633170430,False,11
2009,validator_43,86222042210,True,651000000,8737400,659737400,False,2
2010,validator_48,227090424520,True,568000000,65435530,633435530,False,7
2011,validator_18,144496210504,True,598420006,28605700,627025706,True,4
2012,validator_6,51413540960,True,516306002,20776070,537082072,True,1
2013,validator_34,361144042340,True,604700000,1914080,606614080,False,11
2014,validator_7,82418712208,True,515840010,10003690,525843700,True,2
2015,validator_13,48567665779,True,784240003,11675230,795915233,True,1
2016,validator_15,372577521370,True,872600001,9233070,881833071,True,11
2017,validator_40,41295625450,True,631900000,1025570,632925570,False,1
2018,validator_1,94390111846,True,653103999,28811230,681915229,True,2
2019,validator_31,222979694240,True,574810000,11278980,586088980,False,6
2020,validator_31,223568640680,True,579000000,9946440,588946440,False,6
2021,validator_3,45569242379,True,964380004,42852840,1007232844,True,1
2022,validator_15,373587529476,True,992400006,17608100,1010008106,True,11
2023,validator_7,83149545084,True,659959996,70872880,730832876,True,2
2024,validator_22,91483715842,True,658160008,17684500,675844508,True,2
2025,validator_27,127840692150,True,563700000,24026310,587726310,False,3
2026,validator_16,46238195321,True,705300001,15666540,720966541,True,1
2027,validator_15,374270094774,True,666199998,16365300,682565298,True,11
2028,validator_1,95046606446,True,652800000,3694600,656494600,True,2
2029,validator_1,95759339356,True,698280010,14452900,712732910,True,2
2030,validator_44,124728591570,True,705400000,44929070,750329070,False,3
2031,validator_21,85584312519,True,796700000,1991600,798691600,True,2
2032,validator_12,135863221300,True,576080004,16600920,592680924,True,4
2033,validator_11,43216309077,True,723020001,29078760,752098761,True,1
2034,validator_28,45502781070,True,538500000,9756540,548256540,False,1
2035,validator_9,45458600736,True,806470004,24633140,831103144,True,1
2036,validator_49,85158035520,True,925900000,8897900,934797900,False,2
2037,validator_43,86824929090,True,600800000,2086880,602886880,False,2
2038,validator_46,132719982870,True,651100000,20281340,671381340,False,4
2039,validator_34,361693160320,True,548000000,1117980,549117980,False,11
2040,validator_49,85715767700,True,556300000,1432180,557732180,False,2
2041,validator_31,224097761980,True,526700000,2421300,529121300,False,7
2042,validator_4,43783639343,True,658459992,12109730,670569722,True,1
2043,validator_31,224749128800,True,631300000,20066820,651366820,False,7
2044,validator_48,227845256900,True,752900000,1932380,754832380,False,7
2045,validator_15,375033218375,True,758540001,4583600,763123601,True,11
2046,validator_35,122601033820,True,608200000,1764980,609964980,False,3
2047,validator_17,231749864368,True,682240000,7852580,690092580,True,7
2048,validator_17,232338849305,True,587100007,1884930,588984937,True,7
2049,validator_19,86941743024,True,740599997,3106800,743706797,True,2
2050,validator_27,128408060410,True,552100000,15268260,567368260,False,4
2051,validator_36,133708328660,True,728700000,11029300,739729300,False,4
2052,validator_15,375662607551,True,615759996,13629180,629389176,True,11
2053,validator_18,144953940554,True,453300000,4430050,457730050,True,4
2054,validator_33,43624729630,True,676500000,5449880,681949880,False,1
2055,validator_34,362272718340,True,570800000,8758020,579558020,False,11
2056,validator_9,46265716421,True,797799995,9315690,807115685,True,1
2057,validator_12,136554941299,True,689839999,1880000,691719999,True,4
2058,validator_15,376339648455,True,657120004,19920900,677040904,True,11
2059,validator_41,89033956150,True,635400000,5581090,640981090,False,2
2060,validator_16,46915068216,True,653129995,23742900,676872895,True,1
2061,validator_5,92374948329,True,727020004,40566800,767586804,True,2
2062,validator_23,44201689890,True,603120001,17493840,620613841,True,1
2063,validator_34,362822271960,True,548440000,1113620,549553620,False,11
2064,validator_15,376893685277,True,548720002,5316820,554036822,True,11
2065,validator_34,363410755760,True,586600000,1883800,588483800,False,11
2066,validator_7,84088166383,True,918399999,20221300,938621299,True,2
2067,validator_15,377641166581,True,711720004,35761300,747481304,True,11
2068,validator_44,125289149400,True,559800000,757830,560557830,False,3
2069,validator_7,84746673677,True,651499994,7007300,658507294,True,2
2070,validator_48,228386934180,True,539400000,2277280,541677280,False,7
2071,validator_18,145994294158,True,1016608004,23745600,1040353604,True,4
2072,validator_1,96406525550,True,646100004,1086190,647186194,True,3
2073,validator_34,364082199630,True,668200000,3243870,671443870,False,11
2074,validator_44,125724408100,True,432200000,3058700,435258700,False,3
2075,validator_36,134414263340,True,685100000,20834680,705934680,False,4
2076,validator_48,228855431180,True,461400000,7097000,468497000,False,7
2077,validator_49,86426623700,True,704300000,6556000,710856000,False,2
2078,validator_27,128843073130,True,431900000,3112720,435012720,False,4
2079,validator_8,42872434619,True,660980000,9646680,670626680,True,1
2080,validator_14,152861081738,True,746620004,42461950,789081954,True,4
2081,validator_5,93062733061,True,681096002,6688730,687784732,True,2
2082,validator_16,47700930846,True,775100000,10762630,785862630,True,1
2083,validator_15,378534368483,True,860640002,32561900,893201902,True,11
2084,validator_14,153405526932,True,530099994,14345200,544445194,True,4
2085,validator_15,379460976279,True,916139996,10467800,926607796,True,11
2086,validator_40,41974589230,True,669100000,9863780,678963780,False,1
2087,validator_44,126223919240,True,479000000,20511140,499511140,False,3
2088,validator_36,135079617140,True,656800000,8553800,665353800,False,4
2089,validator_34,364595274430,True,511540000,1534800,513074800,False,11
2090,validator_15,380084404479,True,620000000,3428200,623428200,True,11
2091,validator_34,365172836580,True,558200000,19362150,577562150,False,11
2092,validator_17,233167773800,True,796639995,32284500,828924495,True,7
2093,validator_31,225209193960,True,446300000,13765160,460065160,False,7
2094,validator_22,92061140443,True,564400001,13024600,577424601,True,2
2095,validator_36,135976261740,True,894100000,2544600,896644600,False,4
2096,validator_31,225601808360,True,389400000,3214400,392614400,False,7
2097,validator_46,133415640130,True,695300000,357260,695657260,False,4
2098,validator_12,137253482195,True,695499996,3040900,698540896,True,4
2099,validator_7,85523689309,True,755400002,21615630,777015632,True,2
2100,validator_15,380828219561,True,734680002,9135080,743815082,True,11
2101,validator_44,126813924500,True,579000000,11005260,590005260,False,3
2102,validator_46,133919996930,True,501600000,2756800,504356800,False,4
2103,validator_31,226129977290,True,506200000,21968930,528168930,False,7
2104,validator_16,48584323921,True,855480005,27913070,883393075,True,1
2105,validator_30,87224120000,True,580500000,2066000,582566000,False,2
2106,validator_5,93742898963,True,678200002,1965900,680165902,True,2
2107,validator_35,123413791420,True,789200000,23557600,812757600,False,3
2108,validator_1,97180486289,True,738559999,35400740,773960739,True,3
2109,validator_37,91191628270,True,545400000,9623300,555023300,False,2
2110,validator_48,229547735610,True,689900000,2404430,692304430,False,7
2111,validator_25,46275404900,True,640200000,3335270,643535270,False,1
2112,validator_17,233878184738,True,698379998,12030940,710410938,True,7
2113,validator_26,44836910810,True,686500000,1722400,688222400,False,1
2114,validator_38,44587274900,True,556200000,2539700,558739700,False,1
2115,validator_34,365959236920,True,784000000,2400340,786400340,False,11
2116,validator_48,230083324570,True,515200000,20388960,535588960,False,7
2117,validator_1,97806201667,True,619599998,6115380,625715378,True,3
2118,validator_34,366576992450,True,598370000,19385530,617755530,False,11
2119,validator_31,226897586220,True,765100000,2508930,767608930,False,7
2120,validator_20,45617387207,True,715099999,6729840,721829839,True,1
2121,validator_48,230586957670,True,499800000,3833100,503633100,False,7
2122,validator_27,129383304160,True,503100000,37131030,540231030,False,4
2123,validator_7,86382245811,True,843920002,14636500,858556502,True,2
2124,validator_21,86185657082,True,575500003,25844560,601344563,True,2
2125,validator_16,49128523550,True,533359999,10839630,544199629,True,1
2126,validator_14,154107021333,True,677366001,24128400,701494401,True,4
2127,validator_18,146969207687,True,956899999,18013530,974913529,True,4
2128,validator_17,234744673443,True,858540005,7948700,866488705,True,7
2129,validator_22,92736331867,True,636439994,38751430,675191424,True,2
2130,validator_2,45113636875,True,864299996,22424900,886724896,True,1
2131,validator_16,49972471849,True,828199999,15748300,843948299,True,1
2132,validator_12,137855681377,True,594000002,8199180,602199182,True,4
2133,validator_31,227472584570,True,565400000,9598350,574998350,False,7
2134,validator_7,87036756507,True,629889996,24620700,654510696,True,2
2135,validator_31,228322508840,True,845700000,4224270,849924270,False,7
2136,validator_6,52078607959,True,647963999,17103000,665066999,True,1
2137,validator_47,88918904360,True,606400000,3217280,609617280,False,2
2138,validator_21,86726784784,True,531000002,10127700,541127702,True,2
2139,validator_7,87604355162,True,563119995,4478660,567598655,True,2
2140,validator_34,367041340320,True,458300000,6047870,464347870,False,11
2141,validator_15,381626750396,True,744803995,53726840,798530835,True,11
2142,validator_15,382359470869,True,730500003,2220470,732720473,True,11
2143,validator_34,367665884910,True,622600000,1944590,624544590,False,11
2144,validator_34,368218760010,True,551200000,1675100,552875100,False,11
2145,validator_7,88522348467,True,897459995,20533310,917993305,True,2
2146,validator_43,87430439830,True,603000000,2510740,605510740,False,2
2147,validator_47,89695046530,True,774100000,2042170,776142170,False,2
2148,validator_15,382891957035,True,521059996,11426170,532486166,True,11
2149,validator_19,87881289320,True,908219996,31326300,939546296,True,2
2150,validator_28,45974036010,True,459700000,11554940,471254940,False,1
2151,validator_48,231283387210,True,676200000,20229540,696429540,False,7
2152,validator_0,43237996999,True,856400002,2089630,858489632,True,1
2153,validator_15,383485989974,True,530899999,63132940,594032939,True,11
2154,validator_47,90392294990,True,694700000,2548460,697248460,False,2
2155,validator_8,43570230169,True,693700000,4095550,697795550,True,1
2156,validator_31,228839706750,True,514100000,3097910,517197910,False,7
2157,validator_44,127372145430,True,551400000,6820930,558220930,False,3
2158,validator_47,91074861420,True,672900000,9666430,682566430,False,2
2159,validator_48,231787412810,True,501100000,2925600,504025600,False,7
2160,validator_7,89291670408,True,750600001,18721940,769321941,True,2
2161,validator_15,384016130077,True,506360003,23780100,530140103,True,12
2162,validator_7,89873886616,True,560646008,21570200,582216208,True,2
2163,validator_31,229527160940,True,675700000,11754190,687454190,False,7
2164,validator_19,88762004016,True,872639996,8074700,880714696,True,2
2165,validator_12,138463174906,True,595679999,11813530,607493529,True,4
2166,validator_12,139313581825,True,826269999,24136920,850406919,True,4
2167,validator_31,230132012040,True,603900000,951100,604851100,False,7
2168,validator_48,232251639680,True,461200000,3026870,464226870,False,7
2169,validator_7,90543571716,True,650700000,18985100,669685100,True,2
2170,validator_48,232689400480,True,433680000,4080800,437760800,False,7
2171,validator_48,233203770180,True,493700000,20669700,514369700,False,7
2172,validator_17,235645939658,True,874499995,26766220,901266215,True,7
2173,validator_24,46954187575,True,536940003,14493630,551433633,True,1
2174,validator_44,128000806440,True,626100000,2561010,628661010,False,4
2175,validator_27,130001126380,True,608600000,9222220,617822220,False,4
2176,validator_31,230808128450,True,633400000,42716410,676116410,False,7
2177,validator_48,233911385900,True,704700000,2915720,707615720,False,7
2178,validator_6,52847994164,True,766940005,2446200,769386205,True,1
2179,validator_35,123865418090,True,438300000,13326670,451626670,False,3
2180,validator_49,87138983930,True,691100000,21260230,712360230,False,2
2181,validator_19,89519309936,True,722206000,35099920,757305920,True,2
2182,validator_12,139994085406,True,661956001,18547580,680503581,True,4
2183,validator_15,384749253473,True,706319996,26803400,733123396,True,12
2184,validator_35,124401511250,True,522400000,13693160,536093160,False,3
2185,validator_17,236437317363,True,767720005,23657700,791377705,True,7
2186,validator_28,46446992030,True,470600000,2356020,472956020,False,1
2187,validator_15,385473687708,True,706899995,17534240,724434235,True,12
2188,validator_3,46455472979,True,874040000,12190600,886230600,True,1
2189,validator_30,87769451500,True,542300000,3031500,545331500,False,2
2190,validator_19,90104682746,True,565980010,19392800,585372810,True,2
2191,validator_39,46102652520,True,785300000,1120370,786420370,False,1
2192,validator_40,42592171630,True,615200000,2382400,617582400,False,1
2193,validator_49,87597882630,True,455000000,3898700,458898700,False,2
2194,validator_48,234415574740,True,480900000,23288840,504188840,False,7
2195,validator_27,130723066120,True,718800000,3139740,721939740,False,4
2196,validator_18,147652209753,True,679719996,3282070,683002066,True,4
2197,validator_34,368617872950,True,392800000,6312940,399112940,False,11
2198,validator_11,43860446281,True,631546004,12591200,644137204,True,1
2199,validator_46,134649461930,True,702800000,26665000,729465000,False,4
2200,validator_44,128481414150,True,460600000,20007710,480607710,False,4
2201,validator_1,98516576209,True,697158002,13216540,710374542,True,3
2202,validator_48,234869153380,True,452300000,1278640,453578640,False,7
2203,validator_4,44633177447,True,841900004,7638100,849538104,True,1
2204,validator_44,129103384150,True,620700000,1270000,621970000,False,4
2205,validator_13,49337153465,True,740700006,28787680,769487686,True,1
2206,validator_41,89604768330,True,557700000,13112180,570812180,False,2
2207,validator_31,231456481250,True,645600000,2752800,648352800,False,7
2208,validator_30,88484743980,True,693900000,21392480,715292480,False,2
2209,validator_49,88173246230,True,555400000,19963600,575363600,False,2
2210,validator_7,91284171803,True,712369997,28230090,740600087,True,2
2211,validator_33,44281221590,True,655100000,1391960,656491960,False,1
2212,validator_1,99147673045,True,602099996,28996840,631096836,True,3
2213,validator_47,91691722820,True,595200000,21661400,616861400,False,2
2214,validator_34,369097294090,True,476800000,2621140,479421140,False,11
2215,validator_34,369598244070,True,456700000,44249980,500949980,False,11
2216,validator_15,386214208812,True,674338004,66183100,740521104,True,12
2217,validator_18,148169408378,True,491459995,25738630,517198625,True,4
2218,validator_24,47916792896,True,945354001,17251320,962605321,True,1
2219,validator_46,135275239810,True,621300000,4477880,625777880,False,4
2220,validator_8,44178087817,True,587858008,19999640,607857648,True,1
2221,validator_25,46934439760,True,637400000,21634860,659034860,False,1
2222,validator_1,99677516627,True,520068002,9775580,529843582,True,3
2223,validator_44,129626784850,True,481500000,41900700,523400700,False,4
2224,validator_34,370337477200,True,738600000,633130,739233130,False,11
2225,validator_32,43696641210,True,644700000,2752330,647452330,False,1
2226,validator_43,87981103050,True,530300000,20363220,550663220,False,2
2227,validator_49,88672600930,True,478500000,20854700,499354700,False,2
2228,validator_44,130324323080,True,693600000,3938230,697538230,False,4
2229,validator_21,87318802377,True,588799993,3217600,592017593,True,2
2230,validator_31,231951761270,True,473270000,22010020,495280020,False,7
2231,validator_48,235394950580,True,523800000,1997200,525797200,False,7
2232,validator_27,131399164440,True,648300000,27798320,676098320,False,4
2233,validator_48,235960963410,True,564610000,1402830,566012830,False,7
2234,validator_16,50635103652,True,653240003,9391800,662631803,True,1
2235,validator_34,371008970740,True,655300000,16193540,671493540,False,11
2236,validator_44,131095222090,True,756500000,14399010,770899010,False,4
2237,validator_15,386949131705,True,715639993,19282900,734922893,True,12
2238,validator_15,387476924468,True,516720003,11072760,527792763,True,12
2239,validator_8,44857700434,True,624839997,54772620,679612617,True,1
2240,validator_48,236572676450,True,606500000,5213040,611713040,False,7
2241,validator_31,232416992270,True,463300000,1931000,465231000,False,7
2242,validator_36,136656608720,True,678700000,1646980,680346980,False,4
2243,validator_1,100361278904,True,645520007,38242270,683762277,True,3
2244,validator_39,46550634320,True,413700000,34281800,447981800,False,1
2245,validator_5,94553068983,True,784262000,25908020,810170020,True,2
2246,validator_31,232882689910,True,463600000,2097640,465697640,False,7
2247,validator_26,45419056740,True,561400000,20745930,582145930,False,1
2248,validator_11,44707036876,True,811059995,35530600,846590595,True,1
2249,validator_17,237092586801,True,595187998,60081440,655269438,True,7
2250,validator_46,135980928950,True,686100000,19589140,705689140,False,4
2251,validator_16,51395393590,True,735345998,24943940,760289938,True,1
2252,validator_48,237177918050,True,601100000,4141600,605241600,False,7
2253,validator_10,47984021130,True,688720001,20205900,708925901,True,1
2254,validator_9,46874313638,True,602199997,6397220,608597217,True,1
2255,validator_2,45695205383,True,568919998,12648510,581568508,True,1
2256,validator_35,125144877070,True,732600000,10765820,743365820,False,3
2257,validator_14,154733148632,True,578889999,47237300,626127299,True,4
2258,validator_46,136502823250,True,508800000,13094300,521894300,False,4
2259,validator_14,155581226099,True,846600007,1477460,848077467,True,4
2260,validator_17,237915508489,True,794350008,28571680,822921688,True,7
2261,validator_36,137251424120,True,584300000,10515400,594815400,False,4
2262,validator_31,233402742370,True,519410000,642460,520052460,False,7
2263,validator_16,52048990698,True,626239998,27357110,653597108,True,1
2264,validator_18,148871117672,True,668459994,33249300,701709294,True,4
2265,validator_7,91929993740,True,636200007,9621930,645821937,True,2
2266,validator_19,90711780071,True,578519995,28577330,607097325,True,2
2267,validator_43,88636733650,True,634800000,20830600,655630600,False,2
2268,validator_38,45359998100,True,766400000,6323200,772723200,False,1
2269,validator_27,132046182640,True,620600000,26418200,647018200,False,4
2270,validator_28,47080702370,True,629400000,4310340,633710340,False,1
2271,validator_14,156114679699,True,528400000,5053600,533453600,True,4
2272,validator_44,131567249410,True,463000000,9027320,472027320,False,4
2273,validator_41,90093922380,True,478700000,10454050,489154050,False,2
2274,validator_34,371749835270,True,723600000,17264530,740864530,False,11
2275,validator_2,46263436341,True,524779998,43450960,568230958,True,1
2276,validator_18,149705737108,True,831300006,3319430,834619436,True,4
2277,validator_17,238556195816,True,630899997,9787330,640687327,True,7
2278,validator_7,92711336034,True,771840004,9502290,781342294,True,2
2279,validator_25,47385142720,True,446550000,4152960,450702960,False,1
2280,validator_48,237776119380,True,578700000,19501330,598201330,False,7
2281,validator_30,89082081780,True,577870000,19467800,597337800,False,2
2282,validator_39,47004622500,True,448400000,5588180,453988180,False,1
2283,validator_31,233906827300,True,501200000,2884930,504084930,False,7
2284,validator_10,48664856669,True,666399999,14435540,680835539,True,1
2285,validator_48,238380757500,True,601200000,3438120,604638120,False,7
2286,validator_3,47248660012,True,783800003,9387030,793187033,True,1
2287,validator_5,95066928370,True,498719997,15139390,513859387,True,2
2288,validator_1,100975374790,True,601440006,12655880,614095886,True,3
2289,validator_1,101844961423,True,849600003,19986630,869586633,True,3
2290,validator_7,93236391830,True,467859996,57195800,525055796,True,2
2291,validator_31,234417124300,True,508140000,2157000,510297000,False,7
2292,validator_10,49429063486,True,741919997,22286820,764206817,True,1
2293,validator_45,46755366000,True,831600000,3090300,834690300,False,1
2294,validator_17,239146357218,True,580614002,9547400,590161402,True,7
2295,validator_15,388252073960,True,771900002,3249490,775149492,True,12
2296,validator_30,89714654970,True,623800000,8773190,632573190,False,2
2297,validator_14,156907452628,True,762739999,30032930,792772929,True,4
2298,validator_46,137238007210,True,726000000,9183960,735183960,False,4
2299,validator_12,140843357939,True,838380003,10892530,849272533,True,4
2300,validator_5,95964940263,True,889700003,8311890,898011893,True,2
2301,validator_4,45424131881,True,781600004,9354430,790954434,True,1
2302,validator_34,372453113400,True,701600000,1678130,703278130,False,11
2303,validator_40,43267011130,True,674000000,839500,674839500,False,1
2304,validator_27,132614775960,True,561100000,7493320,568593320,False,4
2305,validator_10,50352268588,True,903720002,19485100,923205102,True,1
2306,validator_35,125817028460,True,670500000,1651390,672151390,False,3
2307,validator_34,373032115040,True,560700000,18301640,579001640,False,11
2308,validator_17,239840671199,True,691100011,3213970,694313981,True,7
2309,validator_2,46844924937,True,571199996,10288600,581488596,True,1
2310,validator_8,45654025177,True,780200003,16124740,796324743,True,1
2311,validator_27,133126923460,True,511100000,1047500,512147500,False,4
2312,validator_18,150436989228,True,682506000,48746120,731252120,True,4
2313,validator_38,45867613680,True,506000000,1615580,507615580,False,1
2314,validator_26,46049876420,True,627700000,3119680,630819680,False,1
2315,validator_17,240379983820,True,531114001,8198620,539312621,True,7
2316,validator_40,43688782500,True,411600000,10171370,421771370,False,1
2317,validator_31,234883586630,True,464500000,1962330,466462330,False,7
2318,validator_17,240986205319,True,578259999,27961500,606221499,True,7
2319,validator_25,47992626290,True,598400000,9083570,607483570,False,1
2320,validator_38,46463016150,True,592800000,2602470,595402470,False,1
2321,validator_46,137933173670,True,691800000,3366460,695166460,False,4
2322,validator_38,47102728800,True,619600000,20112650,639712650,False,1
2323,validator_36,137935944300,True,683700000,820180,684520180,False,4
2324,validator_47,92291100240,True,595700000,3677420,599377420,False,2
2325,validator_40,44353818590,True,663300000,1736090,665036090,False,1
2326,validator_9,47655616739,True,769840001,11463100,781303101,True,1
2327,validator_43,89100113850,True,456900000,6480200,463380200,False,2
2328,validator_49,89091181260,True,415300000,3280330,418580330,False,2
2329,validator_40,45085026050,True,728600000,2607460,731207460,False,1
2330,validator_22,93564115891,True,816700004,11084020,827784024,True,2
2331,validator_45,47526507430,True,768000000,3141430,771141430,False,1
2332,validator_12,141527703957,True,653579998,30766020,684346018,True,4
2333,validator_17,241774998716,True,760539997,28253400,788793397,True,7
2334,validator_14,157547168854,True,637900006,1816220,639716226,True,4
2335,validator_48,239013542810,True,629900000,2885310,632785310,False,7
2336,validator_31,235488813850,True,603000000,2227220,605227220,False,7
2337,validator_20,46273120874,True,617939997,37793670,655733667,True,1
2338,validator_49,89750129150,True,657000000,1947890,658947890,False,2
2339,validator_18,150942129736,True,455560008,49580500,505140508,True,4
2340,validator_15,388774346502,True,493286002,28986540,522272542,True,12
2341,validator_35,126234422790,True,415700000,1694330,417394330,False,3
2342,validator_27,133551778260,True,417170000,7684800,424854800,False,4
2343,validator_48,239575000380,True,529400000,32057570,561457570,False,7
2344,validator_14,158352366039,True,803399995,1797190,805197185,True,4
2345,validator_45,48060589760,True,531300000,2782330,534082330,False,1
2346,validator_42,43788990260,True,543400000,7725900,551125900,False,1
2347,validator_46,138546616210,True,609800000,3642540,613442540,False,4
2348,validator_27,134266814340,True,712600000,2436080,715036080,False,4
2349,validator_12,142112807082,True,554083995,31019130,585103125,True,4
2350,validator_15,389404830495,True,608099993,22384000,630483993,True,12
2351,validator_14,159075968822,True,699500003,24102780,723602783,True,4
2352,validator_23,44878139025,True,659858005,16591130,676449135,True,1
2353,validator_22,94119988499,True,539069998,16802610,555872608,True,2
2354,validator_14,159885502323,True,781500001,28033500,809533501,True,4
2355,validator_11,45508551079,True,773642003,27872200,801514203,True,1
2356,validator_31,236073289830,True,575300000,9175980,584475980,False,7
2357,validator_33,44868878520,True,584900000,2756930,587656930,False,1
2358,validator_44,132391460020,True,814600000,9610610,824210610,False,4
2359,validator_44,132961230020,True,561100000,8670000,569770000,False,4
2360,validator_27,134984795740,True,708500000,9481400,717981400,False,4
2361,validator_15,390219153872,True,783239997,31083380,814323377,True,12
2362,validator_27,135657683770,True,669800000,3088030,672888030,False,4
2363,validator_24,48718239801,True,794400005,7046900,801446905,True,1
2364,validator_34,373842145410,True,795200000,14830370,810030370,False,11
2365,validator_47,92980917730,True,687400000,2417490,689817490,False,2
2366,validator_35,126951096730,True,692900000,23773940,716673940,False,3
2367,validator_6,53661116467,True,790260003,22862300,813122303,True,1
2368,validator_35,127584039120,True,622000000,10942390,632942390,False,3
2369,validator_14,161089268651,True,1160747998,43018330,1203766328,True,5
2370,validator_14,161853440950,True,757400009,6772290,764172299,True,5
2371,validator_31,236549847670,True,475200000,1357840,476557840,False,7
2372,validator_18,151687317939,True,732240003,12948200,745188203,True,4
2373,validator_10,51458710492,True,1082720004,23721900,1106441904,True,1
2374,validator_31,237073503340,True,503500000,20155670,523655670,False,7
2375,validator_16,52553175266,True,493999998,10184570,504184568,True,1
2376,validator_17,242461021455,True,645919999,40102740,686022739,True,7
2377,validator_14,162757252755,True,888758005,15053800,903811805,True,5
2378,validator_37,91900780670,True,706000000,3152400,709152400,False,2
2379,validator_8,46409005737,True,753300000,1680560,754980560,True,1
2380,validator_34,374489015790,True,627270000,19600380,646870380,False,11
2381,validator_30,90357095400,True,615600000,26840430,642440430,False,2
2382,validator_29,40067194280,True,552700000,20065070,572765070,False,1
2383,validator_34,375090373280,True,600300000,1057490,601357490,False,11
2384,validator_19,91345865177,True,626600006,7485100,634085106,True,2
2385,validator_37,92421923490,True,517500000,3642820,521142820,False,2
2386,validator_41,90634669200,True,534100000,6646820,540746820,False,2
2387,validator_34,375724388250,True,630800000,3214970,634014970,False,11
2388,validator_34,376507380350,True,781000000,1992100,782992100,False,11
2389,validator_28,47665760150,True,582500000,2557780,585057780,False,1
2390,validator_35,128171175850,True,582000000,5136730,587136730,False,4
2391,validator_18,152728347633,True,1011619994,29409700,1041029694,True,4
2392,validator_48,240042858780,True,439000000,28858400,467858400,False,7
2393,validator_7,94001444164,True,747239994,17812340,765052334,True,2
2394,validator_44,133528795850,True,558400000,9165830,567565830,False,4
2395,validator_49,90284057780,True,532400000,1528630,533928630,False,2
2396,validator_46,139274854540,True,719200000,9038330,728238330,False,4
2397,validator_34,376992025580,True,482200000,2445230,484645230,False,11
2398,validator_45,48830229480,True,765500000,4139720,769639720,False,1
2399,validator_21,87870715271,True,523879994,28032900,551912894,True,2
2400,validator_44,134069744380,True,539100000,1848530,540948530,False,4
2401,validator_14,163303941758,True,537120003,9569000,546689003,True,5
2402,validator_14,163789318161,True,470566003,14810400,485376403,True,5
2403,validator_22,94906634346,True,777999997,8645850,786645847,True,2
2404,validator_34,377553089620,True,559600000,1464040,561064040,False,11
2405,validator_36,138565886240,True,627100000,2841940,629941940,False,4
2406,validator_47,93617207430,True,625900000,10389700,636289700,False,2
2407,validator_49,90947562480,True,659800000,3704700,663504700,False,2
2408,validator_47,94248971790,True,616600000,15164360,631764360,False,2
2409,validator_7,94760098982,True,697385998,61268820,758654818,True,2
2410,validator_27,136067496900,True,402400000,7413130,409813130,False,4
2411,validator_27,136634313240,True,562900000,3916340,566816340,False,4
2412,validator_26,46740044060,True,677800000,12367640,690167640,False,1
2413,validator_49,91556686180,True,607800000,1323700,609123700,False,2
2414,validator_44,134625069440,True,546600000,8725060,555325060,False,4
2415,validator_43,89807385380,True,688600000,18671530,707271530,False,2
2416,validator_8,47210391908,True,770520011,30866160,801386171,True,1
2417,validator_15,390850044109,True,593239997,37650240,630890237,True,12
2418,validator_14,164509849480,True,709019999,11511320,720531319,True,5
2419,validator_12,142884622888,True,743780006,28035800,771815806,True,4
2420,validator_19,92115359373,True,750893996,18600200,769494196,True,2
2421,validator_30,90885659340,True,525200000,3363940,528563940,False,2
2422,validator_47,94766153930,True,506600000,10582140,517182140,False,2
2423,validator_15,391568506638,True,715799999,2662530,718462529,True,12
2424,validator_48,240614095760,True,562600000,8636980,571236980,False,7
2425,validator_22,95781329772,True,849900006,24795420,874695426,True,2
2426,validator_45,49342733610,True,509700000,2804130,512504130,False,1
2427,validator_12,143374789439,True,466106001,24060550,490166551,True,4
2428,validator_12,144122482681,True,734640002,13053240,747693242,True,4
2429,validator_34,378192454560,True,638100000,1264940,639364940,False,11
2430,validator_34,379072371580,True,870400000,9517020,879917020,False,11
2431,validator_19,92499572206,True,366640003,17572830,384212833,True,2
2432,validator_17,243021343857,True,531740002,28582400,560322402,True,7
2433,validator_12,144980750813,True,811580002,46688130,858268132,True,4
2434,validator_42,44541988160,True,750100000,2897900,752997900,False,1
2435,validator_0,43918284301,True,620760002,59527300,680287302,True,1
2436,validator_31,237681075940,True,605000000,2572600,607572600,False,7
2437,validator_31,238130745860,True,445460000,4209920,449669920,False,7
2438,validator_1,102548985618,True,699799995,4224200,704024195,True,3
2439,validator_20,47155165631,True,879599997,2444760,882044757,True,1
2440,validator_35,128779458450,True,606300000,1982600,608282600,False,4
2441,validator_0,44377716401,True,439220000,20212100,459432100,True,1
2442,validator_7,95495204009,True,715599997,19505030,735105027,True,2
2443,validator_18,153465621435,True,701120002,36153800,737273802,True,4
2444,validator_22,96354191211,True,536319999,36541440,572861439,True,3
2445,validator_15,392127729134,True,555719996,3502500,559222496,True,12
2446,validator_17,243608590381,True,567019994,20226530,587246524,True,7
2447,validator_48,241021111280,True,398500000,8515520,407015520,False,7
2448,validator_37,93076161480,True,648800000,5437990,654237990,False,2
2449,validator_31,238854764830,True,722600000,1418970,724018970,False,7
2450,validator_34,379753416710,True,657500000,23545130,681045130,False,11
2451,validator_29,40537541460,True,457400000,12947180,470347180,False,1
2452,validator_14,165370743884,True,833399994,27494410,860894404,True,5
2453,validator_44,135146119260,True,517300000,3749820,521049820,False,4
2454,validator_5,96916731956,True,914720003,37071690,951791693,True,3
2455,validator_15,392845585455,True,633779991,84076330,717856321,True,12
2456,validator_1,103248597413,True,675999995,23611800,699611795,True,3
2457,validator_15,393640597377,True,772570002,22441920,795011922,True,12
2458,validator_48,241683453300,True,660900000,1442020,662342020,False,7
2459,validator_4,45830089185,True,383270004,22687300,405957304,True,1
2460,validator_34,380409255780,True,645600000,10239070,655839070,False,11
2461,validator_3,47669516113,True,411400001,9456100,420856101,True,1
2462,validator_34,380936633480,True,508300000,19077700,527377700,False,11
2463,validator_14,165971214713,True,571789999,28680830,600470829,True,5
2464,validator_34,381688907380,True,748600000,3673900,752273900,False,11
2465,validator_7,96037755641,True,530377992,12173640,542551632,True,3
2466,validator_40,45683476770,True,594400000,4050720,598450720,False,1
2467,validator_2,47496441781,True,639000004,12516840,651516844,True,1
2468,validator_41,91121951740,True,475900000,11382540,487282540,False,2
2469,validator_34,382582868940,True,892300000,1661560,893961560,False,11
2470,validator_15,394313316528,True,655660001,17059150,672719151,True,12
2471,validator_14,166740501125,True,757319992,11966420,769286412,True,5
2472,validator_26,47475433390,True,727900000,7489330,735389330,False,1
2473,validator_34,383017995340,True,426140000,8986400,435126400,False,11
2474,validator_34,383513245930,True,485900000,9350590,495250590,False,11
2475,validator_48,242569060620,True,883500000,2107320,885607320,False,7
2476,validator_17,244216387242,True,605640001,2156860,607796861,True,7
2477,validator_7,96537324934,True,473298003,26271290,499569293,True,3
2478,validator_14,167568037241,True,821600006,5936110,827536116,True,5
2479,validator_31,239323655300,True,465000000,3890470,468890470,False,7
2480,validator_16,53151114059,True,590880003,7058790,597938793,True,1
2481,validator_5,97650264569,True,705880013,27652600,733532613,True,3
2482,validator_12,145957438418,True,956600005,20087600,976687605,True,4
2483,validator_15,395076001097,True,742569999,20114570,762684569,True,12
2484,validator_31,239901747940,True,574470000,3622640,578092640,False,7
2485,validator_15,395823917296,True,738699999,9216200,747916199,True,12
2486,validator_36,139325079910,True,756400000,2793670,759193670,False,4
2487,validator_31,240268505870,True,364100000,2657930,366757930,False,7
2488,validator_41,91683310070,True,540500000,20858330,561358330,False,2
2489,validator_10,52164027025,True,687599993,17716540,705316533,True,1
2490,validator_42,45082213160,True,532500000,7725000,540225000,False,1
2491,validator_9,48691215271,True,979488002,56110530,1035598532,True,1
2492,validator_41,92326604210,True,622700000,20594140,643294140,False,2
2493,validator_12,146675549413,True,709199995,8911000,718110995,True,4
2494,validator_35,129219852220,True,424600000,15793770,440393770,False,4
2495,validator_15,396429090301,True,584900005,20273000,605173005,True,12
2496,validator_24,49499209602,True,742826001,38143800,780969801,True,1
2497,validator_31,240862523990,True,589000000,5018120,594018120,False,7
2498,validator_18,154129022790,True,644199995,19201360,663401355,True,4
2499,validator_44,135880693390,True,728000000,6574130,734574130,False,4
2500,validator_34,384079143120,True,559500000,6397190,565897190,False,12
2501,validator_34,384637126970,True,538600000,19383850,557983850,False,12
2502,validator_12,147577084914,True,888596001,12939500,901535501,True,4
2503,validator_41,93103375640,True,774400000,2371430,776771430,False,2
2504,validator_34,385303932300,True,664910000,1895330,666805330,False,12
2505,validator_3,48200855179,True,502519996,28819070,531339066,True,1
2506,validator_29,41194710540,True,649400000,7769080,657169080,False,1
2507,validator_14,168534210942,True,956140001,10033700,966173701,True,5
2508,validator_2,48006018062,True,480220001,29356280,509576281,True,1
2509,validator_5,98301806097,True,620939998,30601530,651541528,True,3
2510,validator_44,136370700190,True,481100000,8906800,490006800,False,4
2511,validator_44,136998998630,True,608300000,19998440,628298440,False,4
2512,validator_48,243234577750,True,664500000,1017130,665517130,False,7
2513,validator_10,52814923389,True,636539994,14356370,650896364,True,1
2514,validator_2,48777607062,True,762600000,8989000,771589000,True,1
2515,validator_43,90387551600,True,571900000,8266220,580166220,False,2
2516,validator_48,243739441350,True,503200000,1663600,504863600,False,7
2517,validator_27,137407040070,True,753100000,19626830,772726830,False,4
2518,validator_41,93619729940,True,511000000,5354300,516354300,False,2
2519,validator_24,50129501990,True,608965998,21326390,630292388,True,1
2520,validator_49,92219243680,True,654400000,8157500,662557500,False,2
2521,validator_31,241342303790,True,472500000,7279800,479779800,False,7
2522,validator_28,48130236880,True,457840000,6636730,464476730,False,1
2523,validator_34,385949286320,True,637400000,7954020,645354020,False,12
2524,validator_24,50894324108,True,733239998,31582120,764822118,True,1
2525,validator_46,139809957500,True,513700000,21402960,535102960,False,4
2526,validator_37,93710430310,True,631000000,3268830,634268830,False,2
2527,validator_31,241935285470,True,583000000,9981680,592981680,False,7
2528,validator_44,137616519750,True,589200000,28321120,617521120,False,4
2529,validator_31,242697078150,True,752800000,8992680,761792680,False,7
2530,validator_17,244854239229,True,629799997,8051990,637851987,True,7
2531,validator_48,244347736350,True,605000000,3295000,608295000,False,7
2532,validator_40,46247707410,True,542400000,21830640,564230640,False,1
2533,validator_31,243383382050,True,679700000,6603900,686303900,False,7
2534,validator_26,48027475480,True,531500000,20542090,552042090,False,1
2535,validator_41,94239120210,True,616400000,2990270,619390270,False,2
2536,validator_47,95259360050,True,489300000,3906120,493206120,False,2
2537,validator_43,90932110430,True,533100000,11458830,544558830,False,2
2538,validator_15,397264479270,True,808960009,26428960,835388969,True,12
2539,validator_37,94220144410,True,502200000,7514100,509714100,False,2
2540,validator_30,91479488330,True,591500000,2328990,593828990,False,2
2541,validator_13,50012781101,True,673099996,2527640,675627636,True,1
2542,validator_21,88469693787,True,597799996,1178520,598978516,True,2
2543,validator_5,99123712892,True,777999995,43906800,821906795,True,3
2544,validator_15,397917855446,True,612400006,40976170,653376176,True,12
2545,validator_34,386669691820,True,717500000,2905500,720405500,False,12
2546,validator_49,92814233380,True,586100000,8889700,594989700,False,2
2547,validator_7,97405965730,True,867699996,940800,868640796,True,3
2548,validator_15,398518809379,True,584100003,16853930,600953933,True,12
2549,validator_11,46248407541,True,729520002,10336460,739856462,True,1
2550,validator_17,245466447009,True,587040000,25167780,612207780,True,7
2551,validator_34,387287289620,True,596000000,21597800,617597800,False,12
2552,validator_48,244862950880,True,513900000,1314530,515214530,False,7
2553,validator_45,49748763100,True,404400000,1629490,406029490,False,1
2554,validator_49,93397702660,True,580700000,2769280,583469280,False,2
2555,validator_13,50756419465,True,708190004,35448360,743638364,True,1
2556,validator_5,99923205116,True,789820004,9672220,799492224,True,3
2557,validator_14,169256960037,True,700520005,22229090,722749095,True,5
2558,validator_17,246062286806,True,578099997,17739800,595839797,True,7
2559,validator_17,246853762196,True,786000000,5475390,791475390,True,7
2560,validator_36,139995171470,True,667800000,2291560,670091560,False,4
2561,validator_47,95885314950,True,606700000,19254900,625954900,False,2
2562,validator_34,387925276930,True,636900000,1087310,637987310,False,12
2563,validator_17,247419664797,True,562600001,3302600,565902601,True,7
2564,validator_9,49556532886,True,805469995,59847620,865317615,True,1
2565,validator_44,138341649330,True,722200000,2929580,725129580,False,4
2566,validator_36,140645638510,True,648300000,2167040,650467040,False,4
2567,validator_12,148430568644,True,833740000,19743730,853483730,True,4
2568,validator_14,169890197220,True,623020003,10217180,633237183,True,5
2569,validator_49,94236919510,True,827600000,11616850,839216850,False,2
2570,validator_12,149139744828,True,681739994,27436190,709176184,True,4
2571,validator_30,92127266950,True,630700000,17078620,647778620,False,2
2572,validator_35,129903265220,True,681600000,1813000,683413000,False,4
2573,validator_48,245483732570,True,603800000,16981690,620781690,False,7
2574,validator_7,98066888142,True,659700002,1222410,660922412,True,3
2575,validator_44,139033137030,True,689000000,2487700,691487700,False,4
2576,validator_21,89163393983,True,679819996,13880200,693700196,True,2
2577,validator_15,399396723679,True,860419990,17494310,877914300,True,12
2578,validator_48,246219272950,True,733500000,2040380,735540380,False,7
2579,validator_34,388522619230,True,557100000,40242300,597342300,False,12
2580,validator_31,244156831630,True,730600000,42849580,773449580,False,7
2581,validator_48,247093543060,True,869100000,5170110,874270110,False,7
2582,validator_46,140458998080,True,644200000,4840580,649040580,False,4
2583,validator_7,98584221273,True,501640011,15693120,517333131,True,3
2584,validator_22,97033678622,True,675539991,3947420,679487411,True,3
2585,validator_7,99271267107,True,677400004,9645830,687045834,True,3
2586,validator_37,94929344630,True,706900000,2300220,709200220,False,2
2587,validator_34,389159837230,True,635900000,1318000,637218000,False,12
2588,validator_23,45692048899,True,769840004,44069870,813909874,True,1
2589,validator_34,389824854790,True,659500000,5517560,665017560,False,12
2590,validator_34,390573846280,True,721600000,27391490,748991490,False,12
2591,validator_44,139629944030,True,578300000,18507000,596807000,False,4
2592,validator_14,170596841842,True,637366002,69278620,706644622,True,5
2593,validator_9,50103305181,True,517819995,28952300,546772295,True,1
2594,validator_34,391081523020,True,503900000,3776740,507676740,False,12
2595,validator_1,104016872514,True,737754001,30521100,768275101,True,3
2596,validator_27,137994279070,True,580500000,6739000,587239000,False,4
2597,validator_14,171433635368,True,812519996,24273530,836793526,True,5
2598,validator_17,248334999250,True,885984003,29350450,915334453,True,7
2599,validator_45,50461137010,True,685900000,26473910,712373910,False,1
2600,validator_17,248971116921,True,607414011,28703660,636117671,True,7
2601,validator_9,50929640002,True,796760001,29574820,826334821,True,1
2602,validator_33,45435493720,True,546900000,19715200,566615200,False,1
2603,validator_48,247576717470,True,461200000,21974410,483174410,False,7
2604,validator_34,391732200390,True,614200000,36477370,650677370,False,12
2605,validator_37,95585208480,True,651500000,4363850,655863850,False,2
2606,validator_5,100652924964,True,721839998,7879850,729719848,True,3
2607,validator_19,93301914579,True,782200003,20142370,802342373,True,2
2608,validator_40,46884605290,True,611100000,25797880,636897880,False,1
2609,validator_34,392393102150,True,636000000,24901760,660901760,False,12
2610,validator_41,94780615310,True,531700000,9795100,541495100,False,2
2611,validator_15,400075358078,True,669619999,9014400,678634399,True,12
2612,validator_2,49508009542,True,697460000,32942480,730402480,True,1
2613,validator_15,400724093736,True,604519998,44215660,648735658,True,12
2614,validator_31,244742762460,True,560600000,25330830,585930830,False,7
2615,validator_37,96095605580,True,499900000,10497100,510397100,False,3
2616,validator_15,401385875486,True,652800000,8981750,661781750,True,12
2617,validator_15,402234347310,True,818080004,30391820,848471824,True,12
2618,validator_28,48748776880,True,604800000,13740000,618540000,False,1
2619,validator_48,248194187090,True,603400000,14069620,617469620,False,7
2620,validator_14,172239128967,True,786339999,19153600,805493599,True,5
2621,validator_40,47396707890,True,507300000,4802600,512102600,False,1
2622,validator_41,95257446290,True,466600000,10230980,476830980,False,2
2623,validator_21,89855522502,True,671619999,20508520,692128519,True,2
2624,validator_34,393026276590,True,627000000,6174440,633174440,False,12
2625,validator_31,245385353700,True,640200000,2391240,642591240,False,7
2626,validator_21,90548721046,True,660500004,32698540,693198544,True,2
2627,validator_15,402874722907,True,631740007,8635590,640375597,True,12
2628,validator_15,403617926048,True,700000001,43203140,743203141,True,12
2629,validator_35,130578592410,True,673800000,1527190,675327190,False,4
2630,validator_18,154965427821,True,828100001,8305030,836405031,True,4
2631,validator_17,249735708282,True,730880001,33711360,764591361,True,7
2632,validator_18,155576728717,True,610099996,1200900,611300896,True,4
2633,validator_27,138646060070,True,650100000,1681000,651781000,False,4
2634,validator_15,404368694541,True,735659993,15108500,750768493,True,12
2635,validator_26,48644969110,True,612900000,4593630,617493630,False,1
2636,validator_46,140964548120,True,503900000,1650040,505550040,False,4
2637,validator_14,172956145663,True,707153996,9862700,717016696,True,5
2638,validator_46,141720117200,True,751800000,3769080,755569080,False,4
2639,validator_1,104839017211,True,814299997,7844700,822144697,True,3
2640,validator_24,51429703559,True,515920001,19459450,535379451,True,1
2641,validator_44,140320676060,True,669300000,21432030,690732030,False,4
2642,validator_3,48757612825,True,520599996,36157650,556757646,True,1
2643,validator_29,41731090660,True,500100000,36280120,536380120,False,1
2644,validator_7,99886696637,True,583780000,31649530,615429530,True,3
2645,validator_15,404864632127,True,493199996,2737590,495937586,True,12
2646,validator_31,245918576080,True,513900000,19322380,533222380,False,7
2647,validator_39,47630210530,True,623300000,2288030,625588030,False,1
2648,validator_21,91327799281,True,743820005,35258230,779078235,True,2
2649,validator_38,47493881740,True,390000000,1152940,391152940,False,1
2650,validator_12,149948491706,True,794419998,14326880,808746878,True,4
2651,validator_49,94848242610,True,607800000,3523100,611323100,False,2
2652,validator_22,97773958187,True,709919995,30359570,740279565,True,3
2653,validator_27,139222815790,True,575500000,1255720,576755720,False,4
2654,validator_18,156334045120,True,724920003,32396400,757316403,True,4
2655,validator_44,140863716530,True,534900000,8140470,543040470,False,4
2656,validator_17,250752152016,True,1012719994,3723740,1016443734,True,7
2657,validator_15,405438789143,True,560999996,13157020,574157016,True,12
2658,validator_49,95354327190,True,501600000,4484580,506084580,False,2
2659,validator_31,246385948880,True,463700000,3672800,467372800,False,7
2660,validator_43,91389687320,True,456550000,1026890,457576890,False,2
2661,validator_22,98595088809,True,800874002,20256620,821130622,True,3
2662,validator_15,406107692119,True,648439996,20462980,668902976,True,12
2663,validator_17,251645684811,True,871039995,22492800,893532795,True,7
2664,validator_37,96904197410,True,807400000,1191830,808591830,False,3
2665,validator_12,150501628152,True,547000006,6136440,553136446,True,4
2666,validator_31,247079757810,True,684200000,9608930,693808930,False,7
2667,validator_19,93974184719,True,665000000,7270140,672270140,True,2
2668,validator_25,48597054360,True,602000000,2428070,604428070,False,1
2669,validator_34,393504585890,True,434700000,43609300,478309300,False,12
2670,validator_2,50434377944,True,922100012,4268390,926368402,True,1
2671,validator_18,157009222453,True,656824003,18353330,675177333,True,4
2672,validator_15,406735986065,True,607820006,20473940,628293946,True,12
2673,validator_24,52203196455,True,763379996,10112900,773492896,True,1
2674,validator_27,139707052080,True,482640000,1596290,484236290,False,4
2675,validator_15,407171149412,True,406659997,28503350,435163347,True,12
2676,validator_0,45009102122,True,622700001,8685720,631385721,True,1
2677,validator_19,94590680422,True,595080003,21415700,616495703,True,2
2678,validator_15,407867259404,True,676100002,20009990,696109992,True,12
2679,validator_44,141334773720,True,470100000,957190,471057190,False,4
2680,validator_7,100700380630,True,761620003,52063990,813683993,True,3
2681,validator_49,95804586930,True,448500000,1759740,450259740,False,2
2682,validator_34,394082898880,True,574900000,3412990,578312990,False,12
2683,validator_39,48323458950,True,692200000,1048420,693248420,False,1
2684,validator_48,248831773900,True,627800000,9786810,637586810,False,7
2685,validator_15,408600149337,True,730600003,2289930,732889933,True,12
2686,validator_29,42408634610,True,675700000,1843950,677543950,False,1
2687,validator_47,96490185930,True,594900000,9970980,604870980,False,3
2688,validator_15,409203434375,True,584219998,19065040,603285038,True,12
2689,validator_15,409997179778,True,791800003,1945400,793745403,True,12
2690,validator_17,252537681584,True,886263993,5732780,891996773,True,7
2691,validator_34,394675741880,True,581300000,11543000,592843000,False,12
2692,validator_22,99126727025,True,500539996,31098220,531638216,True,3
2693,validator_19,95219300144,True,627000002,1619720,628619722,True,2
2694,validator_34,395255188280,True,571000000,8446400,579446400,False,12
2695,validator_15,410571135120,True,568540002,5415340,573955342,True,12
2696,validator_34,395873553690,True,608300000,10065410,618365410,False,12
2697,validator_46,142385788900,True,661300000,4371700,665671700,False,4
2698,validator_44,141808798620,True,472100000,1924900,474024900,False,4
2699,validator_21,92099667282,True,759500001,12368000,771868001,True,2
2700,validator_31,247665485110,True,581300000,4427300,585727300,False,7
2701,validator_47,97179092930,True,687100000,1807000,688907000,False,3
2702,validator_49,96379979660,True,553300000,22092730,575392730,False,3
2703,validator_34,396392686110,True,516900000,2232420,519132420,False,12
2704,validator_17,253225908369,True,640480005,47746780,688226785,True,7
2705,validator_40,48040450700,True,642370000,1372810,643742810,False,1
2706,validator_48,249419032460,True,579200000,8058560,587258560,False,7
2707,validator_15,411307566771,True,720940001,15491650,736431651,True,12
2708,validator_30,92615936420,True,486100000,2569470,488669470,False,2
2709,validator_44,142426411920,True,609410000,8203300,617613300,False,4
2710,validator_22,99718134251,True,566906006,24501220,591407226,True,3
2711,validator_9,51528207062,True,582600000,15967060,598567060,True,1
2712,validator_17,253909029861,True,650066002,33055490,683121492,True,7
2713,validator_39,48852208160,True,527200000,1549210,528749210,False,1
2714,validator_28,49337054580,True,586000000,2277700,588277700,False,1
2715,validator_17,254506453995,True,572180004,25244130,597424134,True,7
2716,validator_34,396879590200,True,482700000,4204090,486904090,False,12
2717,validator_35,131174097430,True,592500000,3005020,595505020,False,4
2718,validator_34,397427991300,True,544300000,4101100,548401100,False,12
2719,validator_34,397902145470,True,472300000,1854170,474154170,False,12
2720,validator_22,100374588177,True,644599996,11853930,656453926,True,3
2721,validator_21,92722838049,True,615099997,8070770,623170767,True,2
2722,validator_37,97404650550,True,493000000,7453140,500453140,False,3
2723,validator_46,143044683570,True,639300000,19594670,658894670,False,4
2724,validator_7,101434681635,True,637746005,96555000,734301005,True,3
2725,validator_13,51678315293,True,900899998,20995830,921895828,True,1
2726,validator_15,411836565810,True,525999999,2999040,528999039,True,12
2727,validator_41,95774489720,True,514800000,2243430,517043430,False,2
2728,validator_35,131737622260,True,560100000,3424830,563524830,False,4
2729,validator_48,250087598820,True,631900000,36666360,668566360,False,7
2730,validator_15,412459821790,True,575060000,48195980,623255980,True,12
2731,validator_31,248195609060,True,527400000,2723950,530123950,False,7
2732,validator_37,97992734650,True,586400000,1684100,588084100,False,3
2733,validator_49,97043377960,True,660700000,2698300,663398300,False,3
2734,validator_15,413072392013,True,602319993,10250230,612570223,True,12
2735,validator_46,143797783850,True,751500000,1600280,753100280,False,4
2736,validator_34,398421548320,True,511000000,8402850,519402850,False,12
2737,validator_49,97772860090,True,724500000,4982130,729482130,False,3
2738,validator_33,45998550750,True,560700000,2357030,563057030,False,1
2739,validator_15,413693817199,True,547266006,74159180,621425186,True,12
2740,validator_21,93393008587,True,646639998,23530540,670170538,True,2
2741,validator_25,49265284790,True,665700000,2530430,668230430,False,1
2742,validator_34,398973392780,True,549500000,2344460,551844460,False,12
2743,validator_48,250660968760,True,570200000,3169940,573369940,False,7
2744,validator_46,144377553260,True,574800000,4969410,579769410,False,4
2745,validator_15,414446843644,True,750000005,3026440,753026445,True,12
2746,validator_15,415012413960,True,548059996,17510320,565570316,True,12
2747,validator_48,251119216460,True,455900000,2347700,458247700,False,7
2748,validator_32,44346832930,True,648600000,1591720,650191720,False,1
2749,validator_44,142921669820,True,469800000,25457900,495257900,False,4
2750,validator_15,415801382516,True,765460006,23508550,788968556,True,12
2751,validator_34,399649630160,True,674200000,2037380,676237380,False,12
2752,validator_36,141292831310,True,639000000,8192800,647192800,False,4
2753,validator_36,141806686790,True,489490000,24365480,513855480,False,4
2754,validator_39,49539098380,True,661700000,25190220,686890220,False,1
2755,validator_34,400257757250,True,604800000,3327090,608127090,False,12
2756,validator_38,48194233500,True,671800000,28551760,700351760,False,1
2757,validator_15,416219618823,True,395839997,22396310,418236307,True,13
2758,validator_36,142597995010,True,788400000,2908220,791308220,False,4
2759,validator_31,248672798040,True,456200000,20988980,477188980,False,7
2760,validator_21,94308353122,True,908900005,6444530,915344535,True,2
2761,validator_34,400860592890,True,601400000,1435640,602835640,False,12
2762,validator_31,249303974670,True,607500000,23676630,631176630,False,7
2763,validator_17,255214729896,True,698946001,9329900,708275901,True,7
2764,validator_18,157576330993,True,554168000,12940540,567108540,True,4
2765,validator_17,255798939561,True,557920005,26289660,584209665,True,7
2766,validator_46,145001350340,True,620400000,3397080,623797080,False,4
2767,validator_25,50049982430,True,780600000,4097640,784697640,False,1
2768,validator_31,249942519110,True,632000000,6544440,638544440,False,7
2769,validator_34,401382813130,True,520200000,2020240,522220240,False,12
2770,validator_49,98360477710,True,584300000,3317620,587617620,False,3
2771,validator_2,51215411159,True,747869995,33163220,781033215,True,1
2772,validator_34,401995787530,True,610300000,2674400,612974400,False,12
2773,validator_47,97866578150,True,684300000,3185220,687485220,False,3
2774,validator_34,402658249040,True,654000000,8461510,662461510,False,12
2775,validator_5,101467075265,True,757468001,56682300,814150301,True,3
2776,validator_46,145464473740,True,459800000,3323400,463123400,False,4
2777,validator_36,143109080020,True,491500000,19585010,511085010,False,4
2778,validator_12,151476802461,True,943099999,32074310,975174309,True,4
2779,validator_12,152300161791,True,820140000,3219330,823359330,True,4
2780,validator_12,153096880333,True,778580002,18138540,796718542,True,4
2781,validator_7,102320920029,True,821000004,65238390,886238394,True,3
2782,validator_49,98999326330,True,583500000,55348620,638848620,False,3
2783,validator_7,103026137130,True,683560001,21657100,705217101,True,3
2784,validator_34,403159934770,True,499800000,1885730,501685730,False,12
2785,validator_25,50606085810,True,551300000,4803380,556103380,False,1
2786,validator_12,153852976277,True,744900004,11195940,756095944,True,4
2787,validator_31,250562288510,True,617600000,2169400,619769400,False,7
2788,validator_3,49427245974,True,653639999,15993150,669633149,True,1
2789,validator_36,143571255700,True,460300000,1875680,462175680,False,4
2790,validator_15,416981179298,True,757700005,3860470,761560475,True,13
2791,validator_8,47883805629,True,623693991,49719730,673413721,True,1
2792,validator_8,48424049005,True,523299996,16943380,540243376,True,1
2793,validator_17,256668161953,True,855400002,13822390,869222392,True,8
2794,validator_3,50178225874,True,739800000,11179900,750979900,True,1
2795,validator_45,50965198170,True,499400000,4661160,504061160,False,1
2796,validator_31,251158031050,True,588700000,7042540,595742540,False,7
2797,validator_46,146164483550,True,696800000,3209810,700009810,False,4
2798,validator_17,257388995894,True,713840001,6993940,720833941,True,8
2799,validator_48,251982751260,True,861400000,2134800,863534800,False,7
2800,validator_39,50067768220,True,526800000,1869840,528669840,False,1
2801,validator_34,403827211150,True,661200000,6076380,667276380,False,12
2802,validator_18,158215801408,True,622099985,17370430,639470415,True,4
2803,validator_17,258232538589,True,816939995,26602700,843542695,True,8
2804,validator_20,47871069366,True,698279995,17623740,715903735,True,1
2805,validator_15,417712838690,True,730500002,1159390,731659392,True,13
2806,validator_34,404426297120,True,597400000,1685970,599085970,False,12
2807,validator_37,98503613090,True,501600000,9278440,510878440,False,3
2808,validator_27,140293800690,True,575800000,10948610,586748610,False,4
2809,validator_12,154697090150,True,796380003,47733870,844113873,True,4
2810,validator_14,173457199459,True,472259996,28793800,501053796,True,5
2811,validator_47,98532874650,True,655000000,11296500,666296500,False,3
2812,validator_41,96484768920,True,702300000,7979200,710279200,False,3
2813,validator_31,251828501750,True,666900000,3570700,670470700,False,7
2814,validator_17,258883770147,True,619183998,32047560,651231558,True,8
2815,validator_46,146708826440,True,542300000,2042890,544342890,False,4
2816,validator_48,252634490100,True,642500000,9238840,651738840,False,7
2817,validator_9,52238298089,True,661519997,48571030,710091027,True,1
2818,validator_21,94917834673,True,547099991,62381560,609481551,True,2
2819,validator_35,132419483950,True,662000000,19861690,681861690,False,4
2820,validator_41,97130903350,True,624600000,21534430,646134430,False,3
2821,validator_11,47030528016,True,750164005,31956470,782120475,True,1
2822,validator_31,252346443260,True,510300000,7641510,517941510,False,7
2823,validator_35,133148750780,True,709700000,19566830,729266830,False,4
2824,validator_48,253293197920,True,649100000,9607820,658707820,False,7
2825,validator_46,147487034250,True,774900000,3307810,778207810,False,4
2826,validator_31,253023106820,True,673300000,3363560,676663560,False,7
2827,validator_41,97694792990,True,559200000,4689640,563889640,False,3
2828,validator_15,418526795804,True,803673994,10283120,813957114,True,13
2829,validator_27,140931537390,True,636100000,1636700,637736700,False,4
2830,validator_34,404947855150,True,504300000,17258030,521558030,False,12
2831,validator_7,103978082280,True,879898000,72047150,951945150,True,3
2832,validator_36,144031572610,True,458000000,2316910,460316910,False,4
2833,validator_46,148009972390,True,519100000,3838140,522938140,False,4
2834,validator_1,105483002074,True,625419993,18564870,643984863,True,3
2835,validator_48,253851892480,True,551700000,6994560,558694560,False,7
2836,validator_14,174217527035,True,751399996,8927580,760327576,True,5
2837,validator_32,44946288660,True,596900000,2555730,599455730,False,1
2838,validator_15,419191869147,True,620360003,44713340,665073343,True,13
2839,validator_3,50851769807,True,670200003,3343930,673543933,True,1
2840,validator_12,155467267846,True,755050006,15127690,770177696,True,4
2841,validator_15,419896161031,True,695358004,8933880,704291884,True,13
2842,validator_27,141454633310,True,513000000,10095920,523095920,False,4
2843,validator_14,174740389931,True,508599996,14262900,522862896,True,5
2844,validator_34,405482146380,True,531000000,3291230,534291230,False,12
2845,validator_17,259303080545,True,405139998,14170400,419310398,True,8
2846,validator_48,254436324800,True,580800000,3632320,584432320,False,7
2847,validator_43,91962262280,True,561700000,10874960,572574960,False,2
2848,validator_5,102267336080,True,779999995,20260820,800260815,True,3
2849,validator_22,101109726629,True,713479992,21658460,735138452,True,3
2850,validator_48,255199349030,True,760000000,3024230,763024230,False,7
2851,validator_5,102956982399,True,669039999,20606320,689646319,True,3
2852,validator_43,92513300850,True,549100000,1938570,551038570,False,2
2853,validator_15,420510879279,True,601020008,13698240,614718248,True,13
2854,validator_15,421222771797,True,670960008,40932510,711892518,True,13
2855,validator_36,144649387100,True,597300000,20514490,617814490,False,4
2856,validator_5,103727581087,True,741120008,29478680,770598688,True,3
2857,validator_18,158980252009,True,747180001,17270600,764450601,True,4
2858,validator_22,101902489043,True,728640004,64122410,792762414,True,3
2859,validator_15,421990293792,True,745599995,21922000,767521995,True,13
2860,validator_37,99064268510,True,539600000,21055420,560655420,False,3
2861,validator_35,133912412110,True,758000000,5661330,763661330,False,4
2862,validator_37,99571496260,True,487600000,19627750,507227750,False,3
2863,validator_15,422619459356,True,602640004,26525560,629165564,True,13
2864,validator_28,49876527970,True,530700000,8773390,539473390,False,1
2865,validator_27,142085242910,True,628600000,2009600,630609600,False,4
2866,validator_31,253611925900,True,584900000,3919080,588819080,False,7
2867,validator_43,93062767150,True,545600000,3866300,549466300,False,2
2868,validator_9,53044069297,True,775800008,29971200,805771208,True,1
2869,validator_15,423325769651,True,648587995,57722300,706310295,True,13
2870,validator_15,424348788501,True,1018800000,4218850,1023018850,True,13
2871,validator_19,96068712066,True,803894002,45517920,849411922,True,3
2872,validator_31,254515702670,True,883700000,20076770,903776770,False,7
2873,validator_15,425034072495,True,682500004,2783990,685283994,True,13
2874,validator_31,255037534770,True,518700000,3132100,521832100,False,7
2875,validator_19,96833176132,True,756674006,7790060,764464066,True,3
2876,validator_40,48785400990,True,741300000,3650290,744950290,False,1
2877,validator_48,255860650300,True,659900000,1401270,661301270,False,7
2878,validator_15,425902556429,True,843378004,25105930,868483934,True,13
2879,validator_36,145286189740,True,634600000,2202640,636802640,False,4
2880,validator_43,93740485380,True,647400000,30318230,677718230,False,2
2881,validator_23,46398418510,True,704400011,1969600,706369611,True,1
2882,validator_34,405968180520,True,470200000,15834140,486034140,False,12
2883,validator_32,45643120740,True,676800000,20032080,696832080,False,1
2884,validator_34,406479354340,True,510000000,1173820,511173820,False,12
2885,validator_31,255742753250,True,702700000,2518480,705218480,False,7
2886,validator_44,143654671650,True,723800000,9201830,733001830,False,4
2887,validator_18,159797351010,True,793040001,24059000,817099001,True,4
2888,validator_46,148577709800,True,564800000,2937410,567737410,False,4
2889,validator_15,426543171362,True,619720003,20894930,640614933,True,13
2890,validator_1,106244987994,True,730584000,31401920,761985920,True,3
2891,validator_25,51301681180,True,684400000,11195370,695595370,False,1
2892,validator_15,427271015894,True,724400002,3444530,727844532,True,13
2893,validator_34,407089518750,True,589000000,21164410,610164410,False,12
2894,validator_29,43147484830,True,729500000,9350220,738850220,False,1
2895,validator_9,53856620741,True,794580004,17971440,812551444,True,1
2896,validator_16,54066359063,True,891800004,23445000,915245004,True,1
2897,validator_46,149248066590,True,667600000,2756790,670356790,False,4
2898,validator_43,94402476480,True,661100000,891100,661991100,False,2
2899,validator_6,54406000226,True,703259999,41623760,744883759,True,1
2900,validator_7,104628170201,True,620736001,29351920,650087921,True,3
2901,validator_19,97568165827,True,706189995,28799700,734989695,True,3
2902,validator_22,102402628852,True,492920009,7219800,500139809,True,3
2903,validator_48,256461815740,True,598400000,2765440,601165440,False,8
2904,validator_41,98189301410,True,492640000,1868420,494508420,False,3
2905,validator_33,46710947650,True,702800000,9596900,712396900,False,1
2906,validator_19,98395960061,True,810719994,17074240,827794234,True,3
2907,validator_20,48375920568,True,496700002,8151200,504851202,True,1
2908,validator_44,144373776590,True,707700000,11404940,719104940,False,4
2909,validator_49,99551117520,True,545800000,5991190,551791190,False,3
2910,validator_12,156432435944,True,945000008,20168090,965168098,True,4
2911,validator_0,45828733146,True,792960004,26671020,819631024,True,1
2912,validator_35,134481416090,True,558000000,11003980,569003980,False,4
2913,validator_34,407669952650,True,573400000,7033900,580433900,False,12
2914,validator_34,408243603340,True,537700000,35950690,573650690,False,12
2915,validator_15,427937146393,True,659639999,6490500,666130499,True,13
2916,validator_15,428865797637,True,925800004,2851240,928651244,True,13
2917,validator_15,429414307639,True,525040002,23470000,548510002,True,13
2918,validator_0,46572531828,True,705640002,38158680,743798682,True,1
2919,validator_15,430121591209,True,682566000,24717570,707283570,True,13
2920,validator_34,408739292810,True,492700000,2989470,495689470,False,12
2921,validator_21,95530662805,True,611100002,1728130,612828132,True,2
2922,validator_14,175312381871,True,552220000,19771940,571991940,True,5
2923,validator_22,102987550686,True,583199994,1721840,584921834,True,3
2924,validator_49,100111592130,True,535600000,24874610,560474610,False,3
2925,validator_48,256994145940,True,528000000,4330200,532330200,False,8
2926,validator_33,47439133230,True,697200000,30985580,728185580,False,1
2927,validator_7,105270045426,True,611180005,30695220,641875225,True,3
2928,validator_15,430740738749,True,577140000,42007540,619147540,True,13
2929,validator_18,160428002281,True,623420001,7231270,630651271,True,5
2930,validator_1,107091546624,True,822120000,24438630,846558630,True,3
2931,validator_2,52028072073,True,801260004,11400910,812660914,True,1
2932,validator_18,161019022244,True,580040003,10979960,591019963,True,5
2933,validator_41,98873917450,True,658100000,26516040,684616040,False,3
2934,validator_22,103555500409,True,561700003,6249720,567949723,True,3
2935,validator_35,135117876190,True,633000000,3460100,636460100,False,4
2936,validator_27,142716833430,True,621400000,10190520,631590520,False,4
2937,validator_34,409220278590,True,479000000,1985780,480985780,False,12
2938,validator_34,409733726100,True,508200000,5247510,513447510,False,12
2939,validator_34,410583106930,True,847300000,2080830,849380830,False,12
2940,validator_35,135583789010,True,459700000,6212820,465912820,False,4
2941,validator_19,99103135345,True,676099994,31075290,707175284,True,3
2942,validator_7,105970645824,True,697599998,3000400,700600398,True,3
2943,validator_15,431522999550,True,772800001,9460800,782260801,True,13
2944,validator_34,411246739570,True,661200000,2432640,663632640,False,12
2945,validator_26,49392122550,True,744200000,2953440,747153440,False,1
2946,validator_27,143347862810,True,610300000,20729380,631029380,False,4
2947,validator_22,104352551327,True,770415998,26634920,797050918,True,3
2948,validator_1,107702703720,True,592939996,18217100,611157096,True,3
2949,validator_14,176061038336,True,742320005,6336460,748656465,True,5
2950,validator_41,99561624580,True,675300000,12407130,687707130,False,3
2951,validator_48,257553255140,True,552700000,6409200,559109200,False,8
2952,validator_44,145124442310,True,718500000,32165720,750665720,False,4
2953,validator_17,260047426461,True,726739996,17605920,744345916,True,8
2954,validator_18,161743782739,True,714600005,10160490,724760495,True,5
2955,validator_43,94974002340,True,555600000,15925860,571525860,False,2
2956,validator_37,100157207790,True,568200000,17511530,585711530,False,3
2957,validator_48,258294890680,True,732700000,8935540,741635540,False,8
2958,validator_15,432340926348,True,796819998,21106800,817926798,True,13
2959,validator_33,48136065150,True,678100000,18831920,696931920,False,1
2960,validator_15,433156487694,True,813000006,2561340,815561346,True,13
2961,validator_34,412034753970,True,768100000,19914400,788014400,False,12
2962,validator_26,49993742350,True,581100000,20519800,601619800,False,1
2963,validator_5,104204056465,True,438919998,37555380,476475378,True,3
2964,validator_15,433758813442,True,593259998,9065750,602325748,True,13
2965,validator_34,412487821970,True,433400000,19668000,453068000,False,12
2966,validator_34,413056588890,True,559500000,9266920,568766920,False,12
2967,validator_15,434570034771,True,792899999,18321330,811221329,True,13
2968,validator_22,104950873784,True,595600007,2722450,598322457,True,3
2969,validator_8,49099715722,True,661299997,14366720,675666717,True,1
2970,validator_42,45811269370,True,716500000,12556210,729056210,False,1
2971,validator_26,50741642080,True,745600000,2299730,747899730,False,1
2972,validator_49,100850937260,True,735300000,4045130,739345130,False,3
2973,validator_14,176620593931,True,547939995,11615600,559555595,True,5
2974,validator_17,260625997070,True,565359999,13210610,578570609,True,8
2975,validator_31,256554253390,True,808500000,3000140,811500140,False,8
2976,validator_31,257161424130,True,604900000,2270740,607170740,False,8
2977,validator_12,157142797542,True,688935998,21425600,710361598,True,4
2978,validator_35,136230246280,True,645700000,757270,646457270,False,4
2979,validator_48,259045129980,True,746700000,3539300,750239300,False,8
2980,validator_13,52298436238,True,603000005,17120940,620120945,True,1
2981,validator_12,157803925142,True,658700000,2427600,661127600,True,4
2982,validator_12,158376950683,True,563300001,9725540,573025541,True,4
2983,validator_12,159119756180,True,732099997,10705500,742805497,True,4
2984,validator_15,435249966172,True,670700001,9231400,679931401,True,13
2985,validator_41,100097929180,True,534800000,1504600,536304600,False,3
2986,validator_15,435986422172,True,734200000,2256000,736456000,True,13
2987,validator_7,106743585326,True,750610002,22329500,772939502,True,3
2988,validator_30,93142590460,True,519470000,7184040,526654040,False,2
2989,validator_31,257816818510,True,653000000,2394380,655394380,False,8
2990,validator_41,100693865600,True,576000000,19936420,595936420,False,3
2991,validator_18,162421182842,True,655500003,21900100,677400103,True,5
2992,validator_18,163169535156,True,738600004,9752310,748352314,True,5
2993,validator_12,160099467005,True,955139995,24570830,979710825,True,5
2994,validator_13,52725794250,True,408300002,19058010,427358012,True,1
2995,validator_34,413615813190,True,540200000,19024300,559224300,False,12
2996,validator_27,143980754100,True,623900000,8991290,632891290,False,4
2997,validator_7,107416494679,True,648900003,24009350,672909353,True,3
2998,validator_30,93720421530,True,574000000,3831070,577831070,False,2
2999,validator_18,163870554417,True,676620001,24399260,701019261,True,5
3000,validator_14,177393115873,True,762820002,9701940,772521942,True,5
3001,validator_18,164502276137,True,606960000,24761720,631721720,True,5
3002,validator_14,178051193959,True,613000006,45078080,658078086,True,5
3003,validator_13,53184742591,True,437800001,21148340,458948341,True,1
3004,validator_14,178669809562,True,608700003,9915600,618615603,True,5
3005,validator_42,46305665300,True,491400000,2995930,494395930,False,1
3006,validator_36,145918905120,True,612400000,20315380,632715380,False,4
3007,validator_15,436899202808,True,877940006,34840630,912780636,True,13
3008,validator_46,150012373690,True,762500000,1807100,764307100,False,4
3009,validator_46,150516474470,True,501170000,2930780,504100780,False,4
3010,validator_49,101580601560,True,723700000,5964300,729664300,False,3
3011,validator_35,136878544900,True,620600000,27698620,648298620,False,4
3012,validator_27,144520477910,True,518700000,21023810,539723810,False,4
3013,validator_17,261230987671,True,538320001,66670600,604990601,True,8
3014,validator_35,137556450800,True,654600000,23305900,677905900,False,4
3015,validator_42,46813198740,True,505370000,2163440,507533440,False,1
3016,validator_19,99889165590,True,746760005,39270240,786030245,True,3
3017,validator_17,261881733569,True,607119998,43625900,650745898,True,8
3018,validator_17,262579984903,True,638031994,60219340,698251334,True,8
3019,validator_21,96368615349,True,779814004,58138540,837952544,True,3
3020,validator_44,145589040600,True,454800000,9798290,464598290,False,4
3021,validator_41,101314002800,True,618200000,1937200,620137200,False,3
3022,validator_24,52842160094,True,619639999,19323640,638963639,True,1
3023,validator_19,100816529117,True,895639997,31723530,927363527,True,3
3024,validator_27,145044627520,True,513100000,11049610,524149610,False,4
3025,validator_17,263274448571,True,666579998,27883670,694463668,True,8
3026,validator_47,99194603530,True,659800000,1928880,661728880,False,3
3027,validator_0,47318220333,True,671280005,74408500,745688505,True,1
3028,validator_34,414166013990,True,521700000,28500800,550200800,False,12
3029,validator_23,47055724410,True,641486000,15819900,657305900,True,1
3030,validator_36,146548591080,True,610200000,19485960,629685960,False,4
3031,validator_21,96977853880,True,584600001,24638530,609238531,True,3
3032,validator_41,101779149030,True,458500000,6646230,465146230,False,3
3033,validator_35,138184394800,True,619000000,8944000,627944000,False,4
3034,validator_35,139021054160,True,824300000,12359360,836659360,False,4
3035,validator_4,46772308320,True,930079995,12139140,942219135,True,1
3036,validator_3,51593960932,True,739299995,2891130,742191125,True,1
3037,validator_7,108121262377,True,698599998,6167700,704767698,True,3
3038,validator_46,151322336200,True,796000000,9861730,805861730,False,4
3039,validator_48,259546961890,True,499300000,2531910,501831910,False,8
3040,validator_36,147061221280,True,506200000,6430200,512630200,False,4
3041,validator_18,165244756628,True,726840001,15640490,742480491,True,5
3042,validator_15,437739632102,True,819239994,21189300,840429294,True,13
3043,validator_19,101732986447,True,878700000,37757330,916457330,True,3
3044,validator_27,145675112600,True,609500000,20985080,630485080,False,4
3045,validator_31,258228542050,True,408900000,2823540,411723540,False,8
3046,validator_44,146246492150,True,654800000,2651550,657451550,False,4
3047,validator_24,53746548000,True,858820006,45567900,904387906,True,1
3048,validator_43,95759446100,True,779600000,5843760,785443760,False,2
3049,validator_15,438370815299,True,615699997,15483200,631183197,True,13
3050,validator_15,439135011409,True,750440000,13756110,764196110,True,13
3051,validator_15,439824167732,True,670820003,18336320,689156323,True,13
3052,validator_44,146957068050,True,699000000,11575900,710575900,False,4
3053,validator_15,440383549373,True,536960001,22421640,559381641,True,13
3054,validator_0,47924270681,True,575360008,30690340,606050348,True,1
3055,validator_3,52352250824,True,731200002,27089890,758289892,True,1
3056,validator_27,146406133200,True,727900000,3120600,731020600,False,4
3057,validator_18,166138832082,True,885839994,8235460,894075454,True,5
3058,validator_33,48793555690,True,642300000,15190540,657490540,False,1
3059,validator_25,51973738240,True,667500000,4557060,672057060,False,1
3060,validator_15,441208039496,True,814940003,9550120,824490123,True,13
3061,validator_15,441887991600,True,670020004,9932100,679952104,True,13
3062,validator_21,97524530552,True,544340002,2336670,546676672,True,3
3063,validator_16,54622764559,True,547039996,9365500,556405496,True,1
3064,validator_48,260273593560,True,705300000,21331670,726631670,False,8
3065,validator_31,258834495710,True,572000000,33953660,605953660,False,8
3066,validator_15,442423159279,True,493820009,41347670,535167679,True,13
3067,validator_17,263771576929,True,490380008,6748350,497128358,True,8
3068,validator_14,179332271462,True,643520000,18941900,662461900,True,5
3069,validator_41,102454506510,True,671500000,3857480,675357480,False,3
3070,validator_15,443050606246,True,607653997,19792970,627446967,True,13
3071,validator_39,50784331560,True,715100000,1463340,716563340,False,1
3072,validator_1,108343702550,True,629958000,11040830,640998830,True,3
3073,validator_5,104843175663,True,636999998,2119200,639119198,True,3
3074,validator_17,264485012938,True,710160009,3276000,713436009,True,8
3075,validator_49,102005552810,True,414800000,10151250,424951250,False,3
3076,validator_15,443757001708,True,703499992,2895470,706395462,True,13
3077,validator_34,414743791640,True,549700000,28077650,577777650,False,12
3078,validator_17,265077043032,True,588499994,3530100,592030094,True,8
3079,validator_31,259516492080,True,675800000,6196370,681996370,False,8
3080,validator_15,444314442258,True,551000000,6440550,557440550,True,13
3081,validator_15,445119669057,True,786699999,18526800,805226799,True,13
3082,validator_36,147649789280,True,584190000,4378000,588568000,False,4
3083,validator_7,108952248609,True,770180002,60806230,830986232,True,3
3084,validator_31,260135885580,True,616900000,2493500,619393500,False,8
3085,validator_17,265737965302,True,655799990,5122280,660922270,True,8
3086,validator_15,445774469685,True,650199998,4600630,654800628,True,13
3087,validator_48,260821231450,True,539000000,8637890,547637890,False,8
3088,validator_31,260560717530,True,417930000,6901950,424831950,False,8
3089,validator_13,54078432694,True,878200003,15490100,893690103,True,1
3090,validator_17,266280705204,True,503240002,39499900,542739902,True,8
3091,validator_22,105323731816,True,369100002,3758030,372858032,True,3
3092,validator_18,167113280482,True,955000000,19448400,974448400,True,5
3093,validator_48,261522996750,True,682600000,19165300,701765300,False,8
3094,validator_30,94379012830,True,648200000,10391300,658591300,False,2
3095,validator_18,167835864384,True,670700002,51883900,722583902,True,5
3096,validator_28,50417158980,True,533700000,6931010,540631010,False,1
3097,validator_36,148122452880,True,471000000,1663600,472663600,False,4
3098,validator_36,148847311860,True,722600000,2258980,724858980,False,4
3099,validator_15,446489068585,True,694000000,20598900,714598900,True,13
3100,validator_41,103056820700,True,596800000,5514190,602314190,False,3
3101,validator_21,98238177794,True,667540002,46107240,713647242,True,3
3102,validator_38,48715738040,True,518500000,3004540,521504540,False,1
3103,validator_34,415250972840,True,500000000,7181200,507181200,False,12
3104,validator_5,105387104052,True,505099999,38828390,543928389,True,3
3105,validator_37,100782775150,True,619500000,6067360,625567360,False,3
3106,validator_41,103849127100,True,790700000,1606400,792306400,False,3
3107,validator_27,147034523120,True,623800000,4589920,628389920,False,4
3108,validator_4,47335800856,True,540940006,22552530,563492536,True,1
3109,validator_15,446963800571,True,471000006,3731980,474731986,True,13
3110,validator_15,447628605977,True,658540006,6265400,664805406,True,13
3111,validator_26,51393840440,True,648800000,3398360,652198360,False,1
3112,validator_44,147593975880,True,635100000,1807830,636907830,False,4
3113,validator_19,102438112348,True,698220001,6905900,705125901,True,3
3114,validator_14,180116749637,True,774900005,9578170,784478175,True,5
3115,validator_17,266969427734,True,645600000,43122530,688722530,True,8
3116,validator_39,51268639430,True,482700000,1607870,484307870,False,1
3117,validator_31,261302183020,True,738900000,2565490,741465490,False,8
3118,validator_47,99770224640,True,556700000,18921110,575621110,False,3
3119,validator_47,100426661570,True,647600000,8836930,656436930,False,3
3120,validator_5,106047579594,True,650100002,10375540,660475542,True,3
3121,validator_36,149474562860,True,622500000,4751000,627251000,False,4
3122,validator_36,150290291570,True,795400000,20328710,815728710,False,4
3123,validator_5,106644602993,True,563359999,33663400,597023399,True,3
3124,validator_31,261853047320,True,547510000,3354300,550864300,False,8
3125,validator_1,109467568886,True,1110359996,13506340,1123866336,True,3
3126,validator_34,415760790260,True,507800000,2017420,509817420,False,12
3127,validator_15,448192579915,True,559199998,4773940,563973938,True,14
3128,validator_5,107402184613,True,734228000,23353620,757581620,True,3
3129,validator_19,103026203572,True,557439994,30651230,588091224,True,3
3130,validator_1,109990026198,True,497580002,24877310,522457312,True,3
3131,validator_31,262319194820,True,435000000,31147500,466147500,False,8
3132,validator_15,448760536756,True,516158001,51798840,567956841,True,14
3133,validator_31,263079222620,True,756300000,3727800,760027800,False,8
3134,validator_37,101285052040,True,477900000,24376890,502276890,False,3
3135,validator_33,49397151110,True,582500000,21095420,603595420,False,1
3136,validator_14,180932574161,True,795399994,20424530,815824524,True,5
3137,validator_19,103703462679,True,637900007,39359100,677259107,True,3
3138,validator_31,263865998260,True,784800000,1975640,786775640,False,8
3139,validator_17,267557889842,True,550320008,38142100,588462108,True,8
3140,validator_48,262108523450,True,576400000,9126700,585526700,False,8
3141,validator_15,449552281698,True,719668002,72076940,791744942,True,14
3142,validator_48,262743668050,True,627200000,7944600,635144600,False,8
3143,validator_17,268386980940,True,771033998,58057100,829091098,True,8
3144,validator_36,150935515270,True,624200000,21023700,645223700,False,4
3145,validator_34,416416537410,True,635800000,19947150,655747150,False,13
3146,validator_12,160958180607,True,821000002,37713600,858713602,True,5
3147,validator_44,147989825280,True,393120000,2729400,395849400,False,4
3148,validator_34,416982830940,True,557700000,8593530,566293530,False,13
3149,validator_30,94874936130,True,494000000,1923300,495923300,False,2
3150,validator_31,264500700590,True,632800000,1902330,634702330,False,8
3151,validator_19,104372329584,True,662880005,5986900,668866905,True,3
3152,validator_15,450273819001,True,720600003,937300,721537303,True,14
3153,validator_13,54624691122,True,542700008,3558420,546258428,True,1
3154,validator_33,50245573710,True,845600000,2822600,848422600,False,1
3155,validator_15,450785562128,True,484639997,27103130,511743127,True,14
3156,validator_35,139671900930,True,630700000,20146770,650846770,False,4
3157,validator_17,269022635811,True,634099991,1554880,635654871,True,8
3158,validator_46,151837610380,True,504600000,10674180,515274180,False,4
3159,validator_27,147488061990,True,447700000,5838870,453538870,False,4
3160,validator_5,108094414040,True,681600007,10629420,692229427,True,3
3161,validator_15,451680745334,True,877594006,17589200,895183206,True,14
3162,validator_43,96344812950,True,575600000,9766850,585366850,False,3
3163,validator_48,263353290090,True,604400000,5222040,609622040,False,8
3164,validator_31,264970668990,True,463600000,6368400,469968400,False,8
3165,validator_22,106099853046,True,757610010,18511220,776121230,True,3
3166,validator_48,263873580520,True,517300000,2990430,520290430,False,8
3167,validator_46,152587450980,True,725800000,24040600,749840600,False,4
3168,validator_15,452215224851,True,531599997,2879520,534479517,True,14
3169,validator_28,50963566780,True,545000000,1407800,546407800,False,1
3170,validator_1,110584791264,True,553520006,41245060,594765066,True,3
3171,validator_48,264526572420,True,650700000,2291900,652991900,False,8
3172,validator_11,47584867419,True,507090003,47249400,554339403,True,1
3173,validator_15,452903122637,True,678259996,9637790,687897786,True,14
3174,validator_17,269631363552,True,566760001,41967740,608727741,True,8
3175,validator_34,417388352440,True,403500000,2021500,405521500,False,13
3176,validator_49,102499674700,True,483200000,10921890,494121890,False,3
3177,validator_16,55294494722,True,660099993,11630170,671730163,True,1
3178,validator_12,161800570102,True,833439995,8949500,842389495,True,5
3179,validator_17,270410206419,True,746339997,32502870,778842867,True,8
3180,validator_27,147966361290,True,471900000,6399300,478299300,False,4
3181,validator_24,54336188983,True,587700003,1940980,589640983,True,1
3182,validator_22,106687580845,True,569779999,17947800,587727799,True,3
3183,validator_41,104399048900,True,546900000,3021800,549921800,False,3
3184,validator_7,109753186618,True,762040009,38898000,800938009,True,3
3185,validator_15,453335678441,True,413000004,19555800,432555804,True,14
3186,validator_36,151408426970,True,466100000,6811700,472911700,False,4
3187,validator_44,148465627760,True,465500000,10302480,475802480,False,4
3188,validator_41,105091298530,True,690600000,1649630,692249630,False,3
3189,validator_31,265501034320,True,528000000,2365330,530365330,False,8
3190,validator_48,265069632160,True,535900000,7159740,543059740,False,8
3191,validator_34,418056001910,True,639700000,27949470,667649470,False,13
3192,validator_34,418548167140,True,490400000,1765230,492165230,False,13
3193,validator_48,265641694500,True,563900000,8162340,572062340,False,8
3194,validator_0,48711670413,True,784500002,2899730,787399732,True,1
3195,validator_43,96861938850,True,514770000,2355900,517125900,False,3
3196,validator_34,419081401480,True,531000000,2234340,533234340,False,13
3197,validator_48,266339248420,True,693900000,3653920,697553920,False,8
3198,validator_48,267026387930,True,684700000,2439510,687139510,False,8
3199,validator_44,148785869290,True,317400000,2841530,320241530,False,4
3200,validator_12,162516837230,True,696719998,19547130,716267128,True,5
3201,validator_47,101094794970,True,659100000,9033400,668133400,False,3
3202,validator_22,107525308050,True,805740005,31987200,837727205,True,3
3203,validator_34,419817489180,True,733900000,2187700,736087700,False,13
3204,validator_49,103090062210,True,577900000,12487510,590387510,False,3
3205,validator_34,420495593710,True,669600000,8504530,678104530,False,13
3206,validator_14,181788837567,True,846740006,9523400,856263406,True,5
3207,validator_21,98997731791,True,755999997,3554000,759553997,True,3
3208,validator_15,453941988452,True,586240001,20070010,606310011,True,14
3209,validator_49,103615538500,True,524300000,1176290,525476290,False,3
3210,validator_43,97390902520,True,525800000,3163670,528963670,False,3
3211,validator_34,421059169530,True,547000000,16575820,563575820,False,13
3212,validator_35,140270801260,True,574100000,24800330,598900330,False,4
3213,validator_14,182379631074,True,583239997,7553510,590793507,True,5
3214,validator_16,56147002843,True,842480001,10028120,852508121,True,1
3215,validator_14,183014966772,True,603959998,31375700,635335698,True,5
3216,validator_5,108862243537,True,766899997,929500,767829497,True,3
3217,validator_15,454639471579,True,651900007,45583120,697483127,True,14
3218,validator_17,270917585794,True,486819995,20559380,507379375,True,8
3219,validator_5,109679229860,True,799640003,17346320,816986323,True,3
3220,validator_27,148745093470,True,759600000,19132180,778732180,False,4
3221,validator_34,421676370060,True,612900000,4300530,617200530,False,13
3222,validator_6,55041381621,True,593759995,41621400,635381395,True,1
3223,validator_26,52022590600,True,626200000,2550160,628750160,False,1
3224,validator_7,110496569282,True,698910004,44472660,743382664,True,3
3225,validator_9,54570962087,True,662539996,51801350,714341346,True,1
3226,validator_20,49091706666,True,666435998,49350100,715786098,True,1
3227,validator_19,104937801582,True,527197998,38274000,565471998,True,3
3228,validator_17,271551106227,True,624239993,9280440,633520433,True,8
3229,validator_35,140882519360,True,608300000,3418100,611718100,False,4
3230,validator_15,455596090296,True,932019997,24598720,956618717,True,14
3231,validator_20,49675156204,True,569919998,13529540,583449538,True,1
3232,validator_48,267622999570,True,588100000,8511640,596611640,False,8
3233,validator_34,422302509870,True,617100000,9039810,626139810,False,13
3234,validator_43,97936242600,True,521800000,23540080,545340080,False,3
3235,validator_18,168557601468,True,697404004,24333080,721737084,True,5
3236,validator_17,272339235430,True,768740003,19389200,788129203,True,8
3237,validator_22,108343483262,True,783640002,34535210,818175212,True,3
3238,validator_48,268324881980,True,687300000,14582410,701882410,False,8
3239,validator_12,163192153636,True,660280006,15036400,675316406,True,5
3240,validator_34,422945015600,True,641700000,805730,642505730,False,13
3241,validator_22,109185784409,True,831699997,10601150,842301147,True,3
3242,validator_15,456310344789,True,695799993,18454500,714254493,True,14
3243,validator_37,101818428800,True,530970000,2406760,533376760,False,3
3244,validator_47,101821291940,True,720400000,6096970,726496970,False,3
3245,validator_49,103980969110,True,355900000,9530610,365430610,False,3
3246,validator_18,169426634393,True,864900005,4132920,869032925,True,5
3247,validator_48,268808407310,True,481000000,2525330,483525330,False,8
3248,validator_7,111171194850,True,636943998,37681570,674625568,True,3
3249,validator_9,55323255769,True,746000002,6293680,752293682,True,1
3250,validator_3,53313034619,True,922839995,37943800,960783795,True,1
3251,validator_10,53823114386,True,1005799997,2391000,1008190997,True,1
3252,validator_14,183840986004,True,818800002,7219230,826019232,True,5
3253,validator_41,105545086390,True,434700000,19087860,453787860,False,3
3254,validator_22,110238392532,True,1040328003,12280120,1052608123,True,3
3255,validator_12,163841976054,True,628299998,21522420,649822418,True,5
3256,validator_34,423551593870,True,605000000,1578270,606578270,False,13
3257,validator_22,110959492654,True,677780002,43320120,721100122,True,3
3258,validator_44,149330537790,True,542400000,2268500,544668500,False,4
3259,validator_30,95489646660,True,612400000,2310530,614710530,False,2
3260,validator_35,141495642560,True,607000000,6123200,613123200,False,4
3261,validator_28,51676204820,True,709000000,3638040,712638040,False,1
3262,validator_23,47710957111,True,609200001,46032700,655232701,True,1
3263,validator_27,149723152290,True,939500000,38558820,978058820,False,4
3264,validator_49,104545013600,True,554200000,9844490,564044490,False,3
3265,validator_22,111590210498,True,624820004,5897840,630717844,True,3
3266,validator_2,52615002071,True,563099998,23830000,586929998,True,1
3267,validator_44,150042604800,True,704600000,7467010,712067010,False,4
3268,validator_30,96093579930,True,601000000,2933270,603933270,False,3
3269,validator_35,142189488870,True,690500000,3346310,693846310,False,4
3270,validator_41,106171188490,True,618300000,7802100,626102100,False,3
3271,validator_34,424060417220,True,505100000,3723350,508823350,False,13
3272,validator_7,111795443215,True,614200005,10048360,624248365,True,3
3273,validator_18,170356752912,True,854815999,75302520,930118519,True,5
3274,validator_27,150193185370,True,443600000,26433080,470033080,False,4
3275,validator_18,171192152113,True,797440001,37959200,835399201,True,5
3276,validator_43,98638896240,True,701000000,1653640,702653640,False,3
3277,validator_46,153189576160,True,596700000,5425180,602125180,False,4
3278,validator_15,456888463895,True,553320006,24799100,578119106,True,14
3279,validator_47,102364119150,True,541100000,1727210,542827210,False,3
3280,validator_26,52733086980,True,707400000,3096380,710496380,False,1
3281,validator_7,112178955865,True,373400000,10112650,383512650,True,3
3282,validator_42,47445051870,True,612100000,19753130,631853130,False,1
3283,validator_49,105263144830,True,691200000,26931230,718131230,False,3
3284,validator_42,48034057540,True,580100000,8905670,589005670,False,1
3285,validator_36,152043574110,True,632200000,2947140,635147140,False,4
3286,validator_15,457623581191,True,685149996,49967300,735117296,True,14
3287,validator_47,102749428090,True,350370000,34938940,385308940,False,3
3288,validator_24,55061730778,True,708900005,16641790,725541795,True,1
3289,validator_9,55875737206,True,534500007,17981430,552481437,True,1
3290,validator_15,458254246063,True,601880002,28784870,630664872,True,14
3291,validator_0,49257052617,True,517160004,28222200,545382204,True,1
3292,validator_48,269610959330,True,796200000,6352020,802552020,False,8
3293,validator_15,458934959114,True,670199991,10513060,680713051,True,14
3294,validator_21,99640500544,True,607620003,35148750,642768753,True,3
3295,validator_14,184541983407,True,675940003,25057400,700997403,True,5
3296,validator_46,153772075040,True,556600000,25898880,582498880,False,4
3297,validator_12,164536972062,True,684453988,10542020,694996008,True,5
3298,validator_46,154408835050,True,635300000,1460010,636760010,False,4
3299,validator_38,49158733630,True,441600000,1395590,442995590,False,1
3300,validator_6,55777075845,True,725700004,9994220,735694224,True,1
3301,validator_48,270151659730,True,516100000,24600400,540700400,False,8
3302,validator_18,171965890416,True,769700003,4038300,773738303,True,5
3303,validator_46,155121314940,True,693800000,18679890,712479890,False,4
3304,validator_47,103409773170,True,658700000,1645080,660345080,False,3
3305,validator_15,459796797020,True,808200006,53637900,861837906,True,14
3306,validator_25,52587326340,True,611000000,2588100,613588100,False,1
3307,validator_29,43674625440,True,507900000,19240610,527140610,False,1
3308,validator_37,102467469790,True,625800000,23240990,649040990,False,3
3309,validator_26,53282973880,True,546500000,3386900,549886900,False,1
3310,validator_7,112974884260,True,749060005,46868390,795928395,True,3
3311,validator_40,49402576920,True,616500000,675930,617175930,False,1
3312,validator_15,460671661219,True,839439999,35424200,874864199,True,14
3313,validator_34,424673939020,True,610700000,2821800,613521800,False,13
3314,validator_11,48253638222,True,642540003,26230800,668770803,True,1
3315,validator_17,272956987330,True,614240000,3511900,617751900,True,8
3316,validator_30,96857559150,True,750600000,13379220,763979220,False,3
3317,validator_49,105964686460,True,698000000,3541630,701541630,False,3
3318,validator_47,103993026830,True,573900000,9353660,583253660,False,3
3319,validator_21,100222583514,True,578900000,3182970,582082970,True,3
3320,validator_48,270770641900,True,613000000,5982170,618982170,False,8
3321,validator_34,425114138380,True,437600000,2599360,440199360,False,13
3322,validator_15,461255811022,True,539640003,44509800,584149803,True,14
3323,validator_49,106667543620,True,699600000,3257160,702857160,False,3
3324,validator_37,103244961390,True,769900000,7591600,777491600,False,3
3325,validator_15,461800256064,True,517696002,26749040,544445042,True,14
3326,validator_1,111220541901,True,604499997,31250640,635750637,True,3
3327,validator_5,110355531162,True,668560002,7741300,676301302,True,3
3328,validator_39,52187429230,True,899100000,19689800,918789800,False,1
3329,validator_37,104106073590,True,816900000,44212200,861112200,False,3
3330,validator_27,150893608530,True,690100000,10323160,700423160,False,4
3331,validator_23,48297728674,True,548360003,38411560,586771563,True,1
3332,validator_44,150711557000,True,648000000,20952200,668952200,False,4
3333,validator_43,99129757040,True,489800000,1060800,490860800,False,3
3334,validator_12,165425383474,True,884700002,3711410,888411412,True,5
3335,validator_7,113710792152,True,710646002,25261890,735907892,True,3
3336,validator_34,425651269390,True,530300000,6831010,537131010,False,13
3337,validator_31,266042556710,True,539500000,2022390,541522390,False,8
3338,validator_17,273876833402,True,912800002,7046070,919846072,True,8
3339,validator_43,99996621360,True,864600000,2264320,866864320,False,3
3340,validator_17,274665648562,True,773700000,15115160,788815160,True,8
3341,validator_30,97522256720,True,663900000,797570,664697570,False,3
3342,validator_34,426179730050,True,515500000,12960660,528460660,False,13
3343,validator_15,462573197261,True,752079997,20861200,772941197,True,14
3344,validator_22,112524724786,True,922439998,12074290,934514288,True,3
3345,validator_15,463318973060,True,744439999,1335800,745775799,True,14
3346,validator_22,113255264565,True,687600009,42939770,730539779,True,3
3347,validator_17,275448096667,True,757920005,24528100,782448105,True,8
3348,validator_19,105606817186,True,635140004,33875600,669015604,True,3
3349,validator_16,56738706674,True,590500001,1203830,591703831,True,1
3350,validator_46,155670300870,True,545500000,3485930,548985930,False,4
3351,validator_31,266586398210,True,542100000,1741500,543841500,False,8
3352,validator_17,276040766473,True,577940006,14729800,592669806,True,8
3353,validator_21,100968680487,True,721474003,24622970,746096973,True,3
3354,validator_18,172770847417,True,776240001,28717000,804957001,True,5
3355,validator_37,104831820410,True,719500000,6246820,725746820,False,3
3356,validator_34,426953231530,True,767900000,5601480,773501480,False,13
3357,validator_15,464181582759,True,860799999,1809700,862609699,True,14
3358,validator_31,267172352930,True,583600000,2354720,585954720,False,8
3359,validator_44,151385443890,True,668100000,5786890,673886890,False,4
3360,validator_15,464961034861,True,749980002,29472100,779452102,True,14
3361,validator_35,142908143010,True,715900000,2754140,718654140,False,4
3362,validator_48,271602756830,True,830200000,1914930,832114930,False,8
3363,validator_18,173449972827,True,635693990,43431420,679125410,True,5
3364,validator_12,166187380603,True,720035999,41961130,761997129,True,5
3365,validator_35,143543361510,True,631800000,3418500,635218500,False,4
3366,validator_14,185149105580,True,605020003,2102170,607122173,True,5
3367,validator_23,48967784143,True,637579999,32475470,670055469,True,1
3368,validator_27,151452320530,True,554100000,4612000,558712000,False,4
3369,validator_12,166857577904,True,666300001,3897300,670197301,True,5
3370,validator_32,46323814790,True,676400000,4294050,680694050,False,1
3371,validator_46,156205717050,True,529400000,6016180,535416180,False,4
3372,validator_44,152081831630,True,695000000,1387740,696387740,False,4
3373,validator_16,57226481409,True,465640005,22134730,487774735,True,1
3374,validator_15,465692408127,True,721599996,9773270,731373266,True,14
3375,validator_40,49878107790,True,472300000,3230870,475530870,False,1
3376,validator_20,50319551811,True,625440007,18955600,644395607,True,1
3377,validator_15,466188834093,True,487740006,8685960,496425966,True,14
3378,validator_18,174357684647,True,869620000,38091820,907711820,True,5
3379,validator_44,152555979730,True,453600000,20548100,474148100,False,4
3380,validator_37,105478288210,True,641300000,5167800,646467800,False,3
3381,validator_15,466693352722,True,495459999,9058630,504518629,True,14
3382,validator_35,143967897650,True,420700000,3836140,424536140,False,4
3383,validator_36,152711944280,True,646800000,21570170,668370170,False,4
3384,validator_15,467442784746,True,716760004,32672020,749432024,True,14
3385,validator_2,53231946672,True,589960001,26984600,616944601,True,1
3386,validator_15,468197057419,True,725440003,28832670,754272673,True,14
3387,validator_38,49618355870,True,448800000,10822240,459622240,False,1
3388,validator_16,57743715132,True,513700003,3533720,517233723,True,1
3389,validator_15,468956218522,True,730940003,28221100,759161103,True,14
3390,validator_46,157003719450,True,796800000,1202400,798002400,False,4
3391,validator_40,50647852020,True,759800000,9944230,769744230,False,1
3392,validator_12,167587769040,True,700448006,29743130,730191136,True,5
3393,validator_46,157686189630,True,673400000,9070180,682470180,False,4
3394,validator_21,101682672585,True,702899998,11092100,713992098,True,3
3395,validator_34,427643351840,True,686200000,3920310,690120310,False,13
3396,validator_35,144691003890,True,719400000,3706240,723106240,False,4
3397,validator_15,469580346920,True,617099998,7028400,624128398,True,14
3398,validator_17,276789131274,True,747800001,564800,748364801,True,8
3399,validator_18,174926327310,True,557459993,11182670,568642663,True,5
3400,validator_0,49957385735,True,688940008,11393110,700333118,True,1
3401,validator_46,158071471100,True,381200000,4081470,385281470,False,4
3402,validator_27,152156737250,True,690300000,14116720,704416720,False,4
3403,validator_19,106246743766,True,627670000,12256580,639926580,True,3
3404,validator_27,152782942300,True,624000000,2205050,626205050,False,4
3405,validator_14,186061763882,True,887000002,25658300,912658302,True,5
3406,validator_34,428151470230,True,498100000,10018390,508118390,False,13
3407,validator_31,267810709780,True,627630000,10726850,638356850,False,8
3408,validator_30,98360154870,True,836200000,1698150,837898150,False,3
3409,validator_8,49695681415,True,570199993,25765700,595965693,True,1
3410,validator_46,158796171660,True,705100000,19600560,724700560,False,4
3411,validator_34,428655107130,True,500300000,3336900,503636900,False,13
3412,validator_45,51633629770,True,666800000,1631600,668431600,False,1
3413,validator_14,186857553060,True,752820008,42969170,795789178,True,5
3414,validator_17,277427407983,True,622980009,15296700,638276709,True,8
3415,validator_14,187561788850,True,676820010,27415780,704235790,True,5
3416,validator_9,56520240612,True,589420006,55083400,644503406,True,1
3417,validator_21,102364471489,True,654920004,26878900,681798904,True,3
3418,validator_28,52325580680,True,643400000,5975860,649375860,False,1
3419,validator_7,114390323759,True,652700007,26831600,679531607,True,3
3420,validator_41,106869162470,True,696520000,1453980,697973980,False,3
3421,validator_17,278067456844,True,616786001,23262860,640048861,True,8
3422,validator_14,188322887691,True,730580001,30518840,761098841,True,5
3423,validator_27,153491144340,True,698000000,10202040,708202040,False,4
3424,validator_17,278865543138,True,778399994,19686300,798086294,True,8
3425,validator_34,429344203780,True,680100000,8996650,689096650,False,13
3426,validator_44,153190763530,True,627800000,6983800,634783800,False,4
3427,validator_14,189191211209,True,846519998,21803520,868323518,True,5
3428,validator_49,107157468130,True,478200000,11724510,489924510,False,3
3429,validator_35,145288474630,True,595900000,1570740,597470740,False,4
3430,validator_15,470183379127,True,562937997,40094210,603032207,True,14
3431,validator_9,57140264145,True,606600003,13423530,620023533,True,1
3432,validator_7,114972334275,True,557339996,24670520,582010516,True,3
3433,validator_27,154132236480,True,613400000,27692140,641092140,False,4
3434,validator_17,279669715834,True,791739996,12432700,804172696,True,8
3435,validator_9,57857479235,True,698260010,18955080,717215090,True,1
3436,validator_46,159296963940,True,494700000,6092280,500792280,False,4
3437,validator_12,168165510547,True,554220007,23521500,577741507,True,5
3438,validator_18,175614932067,True,661419997,27184760,688604757,True,5
3439,validator_34,430021217460,True,674700000,2313680,677013680,False,13
3440,validator_49,107714703730,True,536600000,20635600,557235600,False,3
3441,validator_38,50311530450,True,673500000,19674580,693174580,False,1
3442,validator_36,153540943880,True,826900000,2099600,828999600,False,4
3443,validator_17,280203120336,True,526094002,7310500,533404502,True,8
3444,validator_15,470743793618,True,535320001,25094490,560414491,True,14
3445,validator_47,104726809650,True,700400000,33382820,733782820,False,3
3446,validator_13,55470380607,True,810039995,35649490,845689485,True,1
3447,validator_15,471749290796,True,999799998,5697180,1005497178,True,14
3448,validator_19,106812690576,True,550820010,15126800,565946810,True,3
3449,validator_7,115550973399,True,558200004,20439120,578639124,True,3
3450,validator_21,102873650129,True,504320000,4858640,509178640,True,3
3451,validator_46,160173171170,True,866300000,9907230,876207230,False,5
3452,validator_34,430527262630,True,500000000,6045170,506045170,False,13
3453,validator_34,431025683960,True,488900000,9521330,498421330,False,13
3454,validator_21,103505971702,True,612239993,20081580,632321573,True,3
3455,validator_5,111023536877,True,654397995,13607720,668005715,True,3
3456,validator_48,272262415130,True,646900000,12758300,659658300,False,8
3457,validator_41,107496579200,True,620500000,6916730,627416730,False,3
3458,validator_34,431592604690,True,560400000,6520730,566920730,False,13
3459,validator_31,268383789330,True,571100000,1979550,573079550,False,8
3460,validator_17,280800289628,True,595300002,1869290,597169292,True,8
3461,validator_15,472549497097,True,793540011,6666290,800206301,True,14
3462,validator_46,160763086840,True,586300000,3615670,589915670,False,5
3463,validator_7,116132855696,True,577500007,4382290,581882297,True,3
3464,validator_36,154024001630,True,476380000,6677750,483057750,False,4
3465,validator_43,100528357100,True,527100000,4635740,531735740,False,3
3466,validator_37,106004164350,True,520510000,5366140,525876140,False,3
3467,validator_12,168719063085,True,546699998,6852540,553552538,True,5
3468,validator_15,472985601293,True,408039996,28064200,436104196,True,14
3469,validator_27,154492386320,True,351270000,8879840,360149840,False,4
3470,validator_24,55777954972,True,706024004,10200190,716224194,True,1
3471,validator_34,432034555660,True,422000000,19950970,441950970,False,13
3472,validator_43,101301049900,True,747500000,25192800,772692800,False,3
3473,validator_36,154612264370,True,584500000,3762740,588262740,False,4
3474,validator_2,53702722592,True,444380000,26395920,470775920,True,1
3475,validator_35,145788786950,True,499050000,1262320,500312320,False,4
3476,validator_47,105494171730,True,761000000,6362080,767362080,False,3
3477,validator_12,169313909969,True,591800004,3046880,594846884,True,5
3478,validator_43,101879308490,True,575400000,2858590,578258590,False,3
3479,validator_32,47040611520,True,704100000,12696730,716796730,False,1
3480,validator_15,473708364864,True,701806001,20957570,722763571,True,14
3481,validator_4,47971728439,True,631800003,4127580,635927583,True,1
3482,validator_31,268922206530,True,527700000,10717200,538417200,False,8
3483,validator_21,104316462100,True,802699998,7790400,810490398,True,3
3484,validator_15,474649372592,True,902480008,38527720,941007728,True,14
3485,validator_34,432686117990,True,632300000,19262330,651562330,False,13
3486,validator_34,433288830830,True,597400000,5312840,602712840,False,13
3487,validator_29,44193750040,True,516400000,2724600,519124600,False,1
3488,validator_25,53208842240,True,603200000,18315900,621515900,False,1
3489,validator_30,98839040770,True,468500000,10385900,478885900,False,3
3490,validator_18,176171488051,True,552820004,3735980,556555984,True,5
3491,validator_48,272936517010,True,670400000,3701880,674101880,False,8
3492,validator_1,112026175600,True,782999999,22633700,805633699,True,3
3493,validator_29,44693043270,True,489500000,9793230,499293230,False,1
3494,validator_18,176712613823,True,538500002,2625770,541125772,True,5
3495,validator_35,146397253250,True,600700000,7766300,608466300,False,4
3496,validator_9,58574166233,True,712939998,3747000,716686998,True,1
3497,validator_12,170206168640,True,877220001,15038670,892258671,True,5
3498,validator_29,45272612410,True,578600000,969140,579569140,False,1
3499,validator_48,273654130400,True,690500000,27113390,717613390,False,8
3500,validator_47,106000971970,True,504600000,2200240,506800240,False,3
3501,validator_30,99186548690,True,343900000,3607920,347507920,False,3
3502,validator_49,108216566560,True,498300000,3562830,501862830,False,3
3503,validator_46,161361386640,True,560500000,37799800,598299800,False,5
3504,validator_18,177342407959,True,616740006,13054130,629794136,True,5
3505,validator_49,108594492530,True,377100000,825970,377925970,False,3
3506,validator_48,274333728240,True,676100000,3497840,679597840,False,8
3507,validator_37,106598725910,True,574200000,20361560,594561560,False,3
3508,validator_31,269341930530,True,410500000,9224000,419724000,False,8
3509,validator_17,281628586351,True,753659993,74636730,828296723,True,8
3510,validator_29,45914279290,True,639200000,2466880,641666880,False,1
3511,validator_34,433827979100,True,514700000,24448270,539148270,False,13
3512,validator_46,161902625440,True,538300000,2938800,541238800,False,5
3513,validator_31,269823708710,True,471700000,10078180,481778180,False,8
3514,validator_34,434562784500,True,715000000,19805400,734805400,False,13
3515,validator_15,475515938392,True,831660000,34905800,866565800,True,14
3516,validator_16,58549192837,True,764484005,40993700,805477705,True,1
3517,validator_17,282422049051,True,768600000,24862700,793462700,True,8
3518,validator_17,283237953734,True,780088003,35816680,815904683,True,8
3519,validator_27,155033164220,True,538300000,2477900,540777900,False,4
3520,validator_44,153768655660,True,574000000,3892130,577892130,False,4
3521,validator_34,435179787610,True,614200000,2803110,617003110,False,13
3522,validator_48,275255320650,True,913200000,8392410,921592410,False,8
3523,validator_31,270529044770,True,695600000,9736060,705336060,False,8
3524,validator_17,283883947979,True,618000005,27994240,645994245,True,8
3525,validator_19,107505261013,True,687239997,5330440,692570437,True,3
3526,validator_25,54095277220,True,884100000,2334980,886434980,False,1
3527,validator_19,108251375273,True,720240000,25874260,746114260,True,3
3528,validator_24,56495527199,True,690319997,27252230,717572227,True,1
3529,validator_47,106616878350,True,600700000,15206380,615906380,False,3
3530,validator_15,476059679329,True,522359997,21380940,543740937,True,14
3531,validator_37,107214775040,True,612900000,3149130,616049130,False,3
3532,validator_46,162555544360,True,652200000,718920,652918920,False,5
3533,validator_34,435709936530,True,528300000,1848920,530148920,False,13
3534,validator_48,275832477750,True,551310000,25847100,577157100,False,8
3535,validator_34,436379380370,True,665600000,3843840,669443840,False,13
3536,validator_34,437209452190,True,828500000,1571820,830071820,False,13
3537,validator_15,476581258276,True,513000007,8578940,521578947,True,14
3538,validator_21,105007272616,True,681399996,9410520,690810516,True,3
3539,validator_1,112587586327,True,559200007,2210720,561410727,True,3
3540,validator_7,117024732492,True,857140006,34736790,891876796,True,3
3541,validator_27,155523905460,True,477500000,13241240,490741240,False,4
3542,validator_34,437939330830,True,725400000,4478640,729878640,False,13
3543,validator_31,271180346490,True,636800000,14501720,651301720,False,8
3544,validator_15,477276673376,True,691500000,3915100,695415100,True,14
3545,validator_25,54705044240,True,608300000,1467020,609767020,False,1
3546,validator_48,276443136580,True,603100000,7558830,610658830,False,8
3547,validator_15,478073115686,True,786060000,10382310,796442310,True,14
3548,validator_1,113239129263,True,642439996,9102940,651542936,True,3
3549,validator_0,50803556173,True,826019998,20150440,846170438,True,1
3550,validator_34,438554853370,True,613500000,2022540,615522540,False,13
3551,validator_1,113911176581,True,633625998,38421320,672047318,True,3
3552,validator_34,439496429160,True,939900000,1675790,941575790,False,13
3553,validator_5,111819593675,True,785639998,10416800,796056798,True,3
3554,validator_37,107673159640,True,454300000,4084600,458384600,False,3
3555,validator_14,189963630689,True,758786000,13633480,772419480,True,5
3556,validator_47,107006841400,True,388400000,1563050,389963050,False,3
3557,validator_36,155218494050,True,605000000,1229680,606229680,False,4
3558,validator_36,155733651900,True,512700000,2457850,515157850,False,4
3559,validator_23,49746509562,True,770819999,7905420,778725419,True,1
3560,validator_12,170812154975,True,599100005,6886330,605986335,True,5
3561,validator_15,478578877026,True,476834000,28927340,505761340,True,14
3562,validator_23,50430255962,True,678600000,5146400,683746400,True,1
3563,validator_31,271950627490,True,766700000,3581000,770281000,False,8
3564,validator_35,146984450310,True,582170000,5027060,587197060,False,4
3565,validator_17,284652026454,True,740673995,27404480,768078475,True,8
3566,validator_31,272446272990,True,486370000,9275500,495645500,False,8
3567,validator_31,273065868830,True,611200000,8395840,619595840,False,8
3568,validator_36,156245992040,True,510100000,2240140,512340140,False,4
3569,validator_23,51042360854,True,609799992,2304900,612104892,True,1
3570,validator_48,276935556480,True,489900000,2519900,492419900,False,8
3571,validator_17,285435523258,True,738900004,44596800,783496804,True,8
3572,validator_12,171448671599,True,629999994,6516630,636516624,True,5
3573,validator_7,117695324631,True,667999999,2592140,670592139,True,3
3574,validator_48,277746884370,True,808900000,2427890,811327890,False,8
3575,validator_18,178095749278,True,708820009,44521310,753341319,True,5
3576,validator_8,50224076783,True,523039998,5355370,528395368,True,1
3577,validator_5,112282707279,True,443860004,19253600,463113604,True,3
3578,validator_34,440001715040,True,502500000,2785880,505285880,False,13
3579,validator_21,105601061317,True,582240001,11548700,593788701,True,3
3580,validator_14,190466293252,True,475239993,27422570,502662563,True,5
3581,validator_40,51221614060,True,545400000,28362040,573762040,False,1
3582,validator_37,108571024140,True,895700000,2164500,897864500,False,3
3583,validator_45,52142264960,True,497800000,10835190,508635190,False,1
3584,validator_49,109330436830,True,689900000,46044300,735944300,False,3
3585,validator_1,114785352443,True,859095992,15079870,874175862,True,3
3586,validator_44,154390983590,True,603300000,19027930,622327930,False,4
3587,validator_49,109839979480,True,491200000,18342650,509542650,False,3
3588,validator_37,109229382550,True,654300000,4058410,658358410,False,3
3589,validator_34,440607407240,True,597100000,8592200,605692200,False,13
3590,validator_31,273798448710,True,730900000,1679880,732579880,False,8
3591,validator_18,178648605462,True,546774004,6082180,552856184,True,5
3592,validator_49,110549534540,True,689800000,19755060,709555060,False,3
3593,validator_41,108135631800,True,634700000,4352600,639052600,False,3
3594,validator_48,278442458670,True,690500000,5074300,695574300,False,8
3595,validator_15,479556512326,True,969500000,8135300,977635300,True,14
3596,validator_35,147569823010,True,583900000,1472700,585372700,False,4
3597,validator_15,480196304150,True,611539994,28251830,639791824,True,15
3598,validator_15,480838888116,True,594399996,48183970,642583966,True,15
3599,validator_35,148090203450,True,499400000,20980440,520380440,False,4
3600,validator_14,190991831558,True,497406006,28132300,525538306,True,5
3601,validator_48,279176934410,True,727400000,7075740,734475740,False,8
3602,validator_34,441363751960,True,748100000,8244720,756344720,False,13
3603,validator_48,279768438430,True,578100000,13404020,591504020,False,8
3604,validator_46,163161556600,True,598000000,8012240,606012240,False,5
3605,validator_12,172405660704,True,955400005,1589100,956989105,True,5
3606,validator_17,286002525986,True,565699998,1302730,567002728,True,8
3607,validator_41,108785560720,True,646600000,3328920,649928920,False,3
3608,validator_29,46338857630,True,423300000,1278340,424578340,False,1
3609,validator_6,56296199095,True,508020000,11103250,519123250,True,1
3610,validator_17,286751008261,True,732228005,16254270,748482275,True,8
3611,validator_19,109066764005,True,803540002,11848730,815388732,True,3
3612,validator_46,163608132530,True,438900000,7675930,446575930,False,5
3613,validator_31,274400505850,True,598400000,3657140,602057140,False,8
3614,validator_37,109771543900,True,539800000,2361350,542161350,False,3
3615,validator_34,441938749690,True,565100000,9897730,574997730,False,13
3616,validator_17,287501250562,True,722040001,28202300,750242301,True,8
3617,validator_42,48829198450,True,756100000,39040910,795140910,False,1
3618,validator_44,155099490690,True,702800000,5707100,708507100,False,4
3619,validator_41,109618446550,True,813900000,18985830,832885830,False,3
3620,validator_13,56029068677,True,553120000,5568070,558688070,True,1
3621,validator_18,179315700560,True,607919998,59175100,667095098,True,5
3622,validator_19,109654123606,True,581900001,5459600,587359601,True,3
3623,validator_28,52976200400,True,613970000,36649720,650619720,False,1
3624,validator_10,54474830777,True,626939991,24776400,651716391,True,1
3625,validator_36,157025903240,True,776100000,3811200,779911200,False,4
3626,validator_15,481386948157,True,524140001,23920040,548060041,True,15
3627,validator_34,442465326690,True,484900000,41677000,526577000,False,13
3628,validator_27,155988031790,True,461760000,2366330,464126330,False,4
3629,validator_34,443288424400,True,813900000,9197710,823097710,False,13
3630,validator_31,274982656150,True,579600000,2550300,582150300,False,8
3631,validator_34,443841864950,True,529100000,24340550,553440550,False,13
3632,validator_18,180032878259,True,702595999,14581700,717177699,True,5
3633,validator_18,180749179864,True,670520005,45781600,716301605,True,5
3634,validator_17,288068420163,True,565200001,1969600,567169601,True,9
3635,validator_43,102518446360,True,605600000,33537870,639137870,False,3
3636,validator_30,99762575960,True,567600000,8427270,576027270,False,3
3637,validator_48,280161998620,True,372700000,20860190,393560190,False,8
3638,validator_5,112867075683,True,578240004,6128400,584368404,True,3
3639,validator_49,111018604250,True,460800000,8269710,469069710,False,3
3640,validator_34,444575281690,True,731300000,2116740,733416740,False,13
3641,validator_49,111569308500,True,549300000,1404250,550704250,False,3
3642,validator_34,445159265460,True,553500000,30483770,583983770,False,13
3643,validator_27,156606394790,True,603100000,15263000,618363000,False,4
3644,validator_13,56658931311,True,598320004,31542630,629862634,True,1
3645,validator_42,49483669470,True,646200000,8271020,654471020,False,1
3646,validator_35,148591791110,True,498500000,3087660,501587660,False,4
3647,validator_10,55151027044,True,654899997,21296270,676196267,True,1
3648,validator_34,445899486500,True,735300000,4921040,740221040,False,13
3649,validator_18,181541104343,True,765859999,26064480,791924479,True,5
3650,validator_19,110446622894,True,785759998,6739290,792499288,True,3
3651,validator_48,280822240580,True,658750000,1491960,660241960,False,8
3652,validator_12,172976523616,True,551839992,19022920,570862912,True,5
3653,validator_18,182353368353,True,793566010,18698000,812264010,True,5
3654,validator_12,173864175212,True,885799996,1851600,887651596,True,5
3655,validator_30,100472542840,True,686600000,23366880,709966880,False,3
3656,validator_17,288904172959,True,796959996,38792800,835752796,True,9
3657,validator_36,157489917650,True,454700000,9314410,464014410,False,4
3658,validator_49,112083164370,True,512000000,1855870,513855870,False,3
3659,validator_15,482053793962,True,642420005,24425800,666845805,True,15
3660,validator_42,50100584230,True,615600000,1314760,616914760,False,1
3661,validator_34,446437059360,True,535400000,2172860,537572860,False,13
3662,validator_46,164212785970,True,602900000,1753440,604653440,False,5
3663,validator_20,51254689413,True,915000002,20137600,935137602,True,1
3664,validator_4,48552792777,True,578199998,2864340,581064338,True,1
3665,validator_36,158137979470,True,624900000,23161820,648061820,False,4
3666,validator_35,149004512350,True,403900000,8821240,412721240,False,4
3667,validator_14,191979161956,True,955059998,32270400,987330398,True,5
3668,validator_35,149755232840,True,748100000,2620490,750720490,False,4
3669,validator_34,447346116320,True,868600000,40456960,909056960,False,13
3670,validator_49,112661891010,True,575400000,3326640,578726640,False,3
3671,validator_37,110298176230,True,525100000,1532330,526632330,False,3
3672,validator_17,289526450726,True,591853997,30423770,622277767,True,9
3673,validator_34,447888041080,True,535300000,6624760,541924760,False,13
3674,validator_31,275557892420,True,562000000,13236270,575236270,False,8
3675,validator_48,281371477660,True,511600000,37637080,549237080,False,8
3676,validator_17,290325836606,True,774700000,24685880,799385880,True,9
3677,validator_48,282112424980,True,717700000,23247320,740947320,False,8
3678,validator_14,192636401149,True,622099993,35139200,657239193,True,6
3679,validator_15,482694096782,True,638800000,1502820,640302820,True,15
3680,validator_46,164646339550,True,430700000,2853580,433553580,False,5
3681,validator_12,174525642217,True,621120005,40347000,661467005,True,5
3682,validator_43,102946845230,True,427410000,988870,428398870,False,3
3683,validator_45,52702873410,True,557200000,3408450,560608450,False,1
3684,validator_17,291244103053,True,898900007,19366440,918266447,True,9
3685,validator_44,155570040480,True,470000000,549790,470549790,False,4
3686,validator_14,193310615672,True,668200003,6014520,674214523,True,6
3687,validator_48,282816663110,True,700900000,3338130,704238130,False,8
3688,validator_15,483173932721,True,478199999,1635940,479835939,True,15
3689,validator_45,53281067930,True,576100000,2094520,578194520,False,1
3690,validator_44,156061646950,True,478600000,13006470,491606470,False,4
3691,validator_34,448416017950,True,518700000,9276870,527976870,False,14
3692,validator_35,150157504560,True,400810000,1461720,402271720,False,4
3693,validator_30,101104086770,True,627800000,3743930,631543930,False,3
3694,validator_12,175443498717,True,914800000,3056500,917856500,True,5
3695,validator_34,448794103380,True,375700000,2385430,378085430,False,14
3696,validator_22,113943631681,True,656100006,32267110,688367116,True,3
3697,validator_29,47116499280,True,775300000,2341650,777641650,False,1
3698,validator_4,49327220498,True,767400001,7027720,774427721,True,1
3699,validator_18,183036884852,True,670239999,13276500,683516499,True,5
3700,validator_24,57058621726,True,559739997,3354530,563094527,True,1
3701,validator_17,291948479292,True,658653989,45722250,704376239,True,9
3702,validator_49,113301496500,True,632700000,6905490,639605490,False,3
3703,validator_36,158705562250,True,559400000,8182780,567582780,False,4
3704,validator_27,157161440730,True,536100000,18945940,555045940,False,4
3705,validator_15,483918217521,True,673550000,70734800,744284800,True,15
3706,validator_40,51729675360,True,505800000,2261300,508061300,False,1
3707,validator_34,449592681940,True,775300000,23278560,798578560,False,14
3708,validator_17,292807318467,True,855499995,3339180,858839175,True,9
3709,validator_34,450142598440,True,531000000,18916500,549916500,False,14
3710,validator_31,276199278340,True,638800000,2585920,641385920,False,8
3711,validator_15,484626962875,True,687959994,20785360,708745354,True,15
3712,validator_44,156572211770,True,486600000,23964820,510564820,False,4
3713,validator_37,110934840780,True,628800000,7864550,636664550,False,3
3714,validator_40,52342649340,True,586900000,26073980,612973980,False,1
3715,validator_34,450689686480,True,537500000,9588040,547088040,False,14
3716,validator_43,103535781150,True,584700000,4235920,588935920,False,3
3717,validator_30,101838789770,True,727000000,7703000,734703000,False,3
3718,validator_34,451227855380,True,528400000,9768900,538168900,False,14
3719,validator_14,193956796578,True,635226006,10954900,646180906,True,6
3720,validator_47,107645683500,True,636000000,2842100,638842100,False,3
3721,validator_12,176098415515,True,627699998,27216800,654916798,True,5
3722,validator_34,451979847240,True,749700000,2291860,751991860,False,14
3723,validator_15,485129750235,True,474700000,28087360,502787360,True,15
3724,validator_3,53993902222,True,675758003,5109600,680867603,True,1
3725,validator_17,293563140423,True,754999996,821960,755821956,True,9
3726,validator_33,50976388660,True,709500000,21314950,730814950,False,1
3727,validator_8,50951833680,True,687679997,40076900,727756897,True,1
3728,validator_12,176878964859,True,757300004,23249340,780549344,True,5
3729,validator_43,104219560740,True,681100000,2679590,683779590,False,3
3730,validator_24,57702680207,True,598840001,45218480,644058481,True,1
3731,validator_17,294315276826,True,723914003,28222400,752136403,True,9
3732,validator_43,104648325370,True,419300000,9464630,428764630,False,3
3733,validator_49,113834378100,True,531500000,1381600,532881600,False,3
3734,validator_37,111494734490,True,558700000,1193710,559893710,False,3
3735,validator_30,102402558500,True,548000000,15768730,563768730,False,3
3736,validator_18,183809916308,True,757979996,15051460,773031456,True,5
3737,validator_48,283382131170,True,562800000,2668060,565468060,False,8
3738,validator_48,283989706050,True,602800000,4774880,607574880,False,8
3739,validator_36,159259059510,True,550600000,2897260,553497260,False,4
3740,validator_46,165340510590,True,667100000,27071040,694171040,False,5
3741,validator_14,194665986446,True,662879998,46309870,709189868,True,6
3742,validator_22,114607204253,True,654019992,9552580,663572572,True,3
3743,validator_41,110228194630,True,607500000,2248080,609748080,False,3
3744,validator_27,157736346450,True,573100000,1805720,574905720,False,4
3745,validator_34,452715399660,True,727000000,8552420,735552420,False,14
3746,validator_10,55756202341,True,598299997,6875300,605175297,True,1
3747,validator_48,284535392580,True,543600000,2086530,545686530,False,8
3748,validator_34,453516248190,True,790600000,10248530,800848530,False,14
3749,validator_40,52914233130,True,569600000,1983790,571583790,False,1
3750,validator_12,177455362336,True,487736007,88661470,576397477,True,5
3751,validator_45,53955366630,True,663400000,10898700,674298700,False,1
3752,validator_48,285197823140,True,643400000,19030560,662430560,False,8
3753,validator_10,56421996386,True,641500005,24294040,665794045,True,1
3754,validator_48,285813282430,True,611800000,3659290,615459290,False,8
3755,validator_31,276683590110,True,483200000,1111770,484311770,False,8
3756,validator_17,295109391709,True,779350003,14764880,794114883,True,9
3757,validator_12,178158968859,True,678540003,25066520,703606523,True,5
3758,validator_35,150737875380,True,559100000,21270820,580370820,False,4
3759,validator_22,115303678199,True,663459996,33013950,696473946,True,3
3760,validator_7,118227742045,True,503430004,28987410,532417414,True,3
3761,validator_47,108260303120,True,595100000,19519620,614619620,False,3
3762,validator_48,286405741670,True,582200000,10259240,592459240,False,8
3763,validator_13,57140891254,True,459120003,22839940,481959943,True,1
3764,validator_47,108760380920,True,499100000,977800,500077800,False,3
3765,validator_44,157055023600,True,478800000,4011830,482811830,False,4
3766,validator_12,178681916300,True,496476001,26471440,522947441,True,5
3767,validator_31,277121339930,True,429300000,8449820,437749820,False,8
3768,validator_35,151356173280,True,615600000,2697900,618297900,False,4
3769,validator_5,113407554482,True,538699999,1778800,540478799,True,3
3770,validator_1,115687215575,True,885140002,16723130,901863132,True,3
3771,validator_22,115812910720,True,468820001,40412520,509232521,True,3
3772,validator_36,159839557010,True,572200000,8297500,580497500,False,4
3773,validator_44,157863111330,True,806100000,1987730,808087730,False,4
3774,validator_12,179095514438,True,406400008,7198130,413598138,True,5
3775,validator_48,286984607050,True,575300000,3565380,578865380,False,8
3776,validator_36,160454031030,True,592500000,21974020,614474020,False,5
3777,validator_34,454182141620,True,663150000,2743430,665893430,False,14
3778,validator_29,47637551780,True,514300000,6752500,521052500,False,1
3779,validator_15,486019171256,True,872400001,17021020,889421021,True,15
3780,validator_36,160992145430,True,535400000,2714400,538114400,False,5
3781,validator_3,54668302136,True,649369994,25029920,674399914,True,1
3782,validator_31,277789109850,True,647000000,20769920,667769920,False,8
3783,validator_43,105404727930,True,735600000,20802560,756402560,False,3
3784,validator_18,184681800011,True,855340003,16543700,871883703,True,5
3785,validator_47,109263378620,True,473800000,29197700,502997700,False,3
3786,validator_44,158407371930,True,524200000,20060600,544260600,False,4
3787,validator_22,116633744993,True,806699993,14134280,820834273,True,3
3788,validator_46,165927947120,True,583000000,4436530,587436530,False,5
3789,validator_15,486511263226,True,450240000,41851970,492091970,True,15
3790,validator_41,110849810090,True,619100000,2515460,621615460,False,3
3791,validator_34,454589822310,True,404900000,2780690,407680690,False,14
3792,validator_17,295772592812,True,648926003,14275100,663201103,True,9
3793,validator_49,114366433040,True,531000000,1054940,532054940,False,3
3794,validator_34,454993896300,True,402700000,1373990,404073990,False,14
3795,validator_47,110030733240,True,766400000,954620,767354620,False,3
3796,validator_15,487408412356,True,896200000,949130,897149130,True,15
3797,validator_7,118890141229,True,659200004,3199180,662399184,True,3
3798,validator_17,296592474814,True,780840002,39042000,819882002,True,9
3799,validator_36,161798625550,True,803500000,2980120,806480120,False,5
3800,validator_12,179774225200,True,659000002,19710760,678710762,True,5
3801,validator_28,53403157740,True,420500000,6457340,426957340,False,1
3802,validator_35,151968087720,True,606500000,5414440,611914440,False,4
3803,validator_44,159263869910,True,837200000,19297980,856497980,False,4
3804,validator_10,57233550305,True,806039999,5513920,811553919,True,1
3805,validator_41,111517704110,True,646400000,21494020,667894020,False,3
3806,validator_44,159935947350,True,662600000,9477440,672077440,False,4
3807,validator_7,119645246743,True,751999994,3105520,755105514,True,3
3808,validator_34,455582425940,True,584900000,3629640,588529640,False,14
3809,validator_34,456091583840,True,483470000,25687900,509157900,False,14
3810,validator_7,120279025238,True,632300005,1478490,633778495,True,3
3811,validator_7,121074955008,True,775814000,20115770,795929770,True,3
3812,validator_32,47628446160,True,567800000,20034640,587834640,False,1
3813,validator_12,180424862499,True,619999999,30637300,650637299,True,5
3814,validator_36,162424716520,True,624700000,1390970,626090970,False,5
3815,validator_34,456755707490,True,643200000,20923650,664123650,False,14
3816,validator_44,160538893750,True,594600000,8346400,602946400,False,5
3817,validator_21,106441477958,True,802670001,37746640,840416641,True,3
3818,validator_21,107030377667,True,565020009,23879700,588899709,True,3
3819,validator_18,185408836307,True,706499996,20536300,727036296,True,5
3820,validator_47,110501654940,True,457000000,13921700,470921700,False,3
3821,validator_27,158424241770,True,678000000,9895320,687895320,False,4
3822,validator_36,162938349940,True,509200000,4433420,513633420,False,5
3823,validator_12,180954398595,True,505119996,24416100,529536096,True,5
3824,validator_31,278422199550,True,611300000,21789700,633089700,False,8
3825,validator_48,287658210660,True,671000000,2603610,673603610,False,8
3826,validator_15,488256850659,True,832040003,16398300,848438303,True,15
3827,validator_49,115014685150,True,638200000,10052110,648252110,False,3
3828,validator_13,57962921899,True,818899995,3130650,822030645,True,1
3829,validator_36,163415571200,True,448600000,28621260,477221260,False,5
3830,validator_36,164180431200,True,759100000,5760000,764860000,False,5
3831,validator_30,103195942480,True,756100000,37283980,793383980,False,3
3832,validator_45,54614600120,True,654100000,5133490,659233490,False,1
3833,validator_33,51925197070,True,940700000,8108410,948808410,False,1
3834,validator_36,164799129310,True,612300000,6398110,618698110,False,5
3835,validator_12,181616292827,True,637630002,24264230,661894232,True,5
3836,validator_35,152619882460,True,649900000,1894740,651794740,False,4
3837,validator_3,55440430149,True,763300003,8828010,772128013,True,1
3838,validator_18,186191248245,True,755720008,26691930,782411938,True,5
3839,validator_36,165357017140,True,555200000,2687830,557887830,False,5
3840,validator_25,55263047960,True,556000000,2003720,558003720,False,1
3841,validator_17,297340739557,True,698440003,49824740,748264743,True,9
3842,validator_17,298051320233,True,683409996,27170680,710580676,True,9
3843,validator_48,288313706820,True,652100000,3396160,655496160,False,9
3844,validator_48,289082935960,True,730800000,38429140,769229140,False,9
3845,validator_48,289707982580,True,614220000,10826620,625046620,False,9
3846,validator_4,49981396796,True,598519998,55656300,654176298,True,1
3847,validator_43,105927413550,True,520300000,2385620,522685620,False,3
3848,validator_46,166582128050,True,629800000,24380930,654180930,False,5
3849,validator_30,103849623980,True,650500000,3181500,653681500,False,3
3850,validator_40,53442846320,True,508370000,20243190,528613190,False,1
3851,validator_17,298941656963,True,879819990,10516740,890336730,True,9
3852,validator_36,165998303860,True,631500000,9786720,641286720,False,5
3853,validator_22,117424380822,True,758619999,32015830,790635829,True,3
3854,validator_31,278942963380,True,507900000,12863830,520763830,False,8
3855,validator_14,195558654385,True,876169999,16497940,892667939,True,6
3856,validator_28,54287196920,True,863900000,20139180,884039180,False,1
3857,validator_1,116453659410,True,762299995,4143840,766443835,True,3
3858,validator_17,299635371863,True,667920000,25794900,693714900,True,9
3859,validator_15,488727877547,True,454719998,16306890,471026888,True,15
3860,validator_5,114269882275,True,854519993,7807800,862327793,True,3
3861,validator_43,106458946790,True,527200000,4333240,531533240,False,3
3862,validator_21,107639330208,True,589500001,19452540,608952541,True,3
3863,validator_32,48255813980,True,624500000,2867820,627367820,False,1
3864,validator_47,111300240800,True,795700000,2885860,798585860,False,3
3865,validator_48,290235073280,True,526700000,390700,527090700,False,9
3866,validator_15,489288104171,True,556399994,3826630,560226624,True,15
3867,validator_31,279433969180,True,479500000,11505800,491005800,False,8
3868,validator_34,457442636510,True,685500000,1429020,686929020,False,14
3869,validator_27,159120322860,True,689800000,6281090,696081090,False,4
3870,validator_34,457984946370,True,538000000,4309860,542309860,False,14
3871,validator_37,112158256520,True,646300000,17222030,663522030,False,3
3872,validator_44,161153430860,True,612200000,2337110,614537110,False,5
3873,validator_24,58516169510,True,775500003,37989300,813489303,True,1
3874,validator_34,458396001430,True,371900000,39155060,411055060,False,14
3875,validator_28,54821474550,True,531700000,2577630,534277630,False,1
3876,validator_37,112807101500,True,647000000,1844980,648844980,False,3
3877,validator_44,161615370160,True,460050000,1889300,461939300,False,5
3878,validator_37,113359754920,True,549900000,2753420,552653420,False,3
3879,validator_31,279981911970,True,546100000,1842790,547942790,False,8
3880,validator_31,280564746000,True,582200000,634030,582834030,False,8
3881,validator_46,167146394070,True,558700000,5566020,564266020,False,5
3882,validator_17,300505469366,True,849600003,20497500,870097503,True,9
3883,validator_39,52825630620,True,635200000,3001390,638201390,False,1
3884,validator_44,162408955940,True,789000000,4585780,793585780,False,5
3885,validator_17,301315418063,True,788519997,21428700,809948697,True,9
3886,validator_48,290702976220,True,458990000,8912940,467902940,False,9
3887,validator_15,489736242828,True,444899997,3238660,448138657,True,15
3888,validator_1,117257709607,True,779199997,24850200,804050197,True,3
3889,validator_5,114974848109,True,692140004,12825830,704965834,True,3
3890,validator_15,490504521436,True,764700008,3578600,768278608,True,15
3891,validator_35,153394538250,True,755000000,19655790,774655790,False,4
3892,validator_14,196395172983,True,833000008,3518590,836518598,True,6
3893,validator_22,118154488624,True,725800002,4307800,730107802,True,3
3894,validator_17,302193475182,True,874599999,3457120,878057119,True,9
3895,validator_20,51868860167,True,583980004,30190750,614170754,True,1
3896,validator_27,159708147480,True,553800000,34024620,587824620,False,4
3897,validator_44,163094305570,True,661200000,24149630,685349630,False,5
3898,validator_36,166679080860,True,651900000,28877000,680777000,False,5
3899,validator_48,291343968770,True,637400000,3592550,640992550,False,9
3900,validator_1,117940346234,True,653479997,29156630,682636627,True,3
3901,validator_49,115644775310,True,621800000,8290160,630090160,False,3
3902,validator_37,113950549080,True,587400000,3394160,590794160,False,3
3903,validator_41,112096251150,True,570400000,8147040,578547040,False,3
3904,validator_41,112560756750,True,463300000,1205600,464505600,False,3
3905,validator_38,50918158980,True,585800000,20828530,606628530,False,1
3906,validator_5,115671487828,True,682363999,14275720,696639719,True,3
3907,validator_36,167223427070,True,523400000,20946210,544346210,False,5
3908,validator_27,160294219720,True,579300000,6772240,586072240,False,5
3909,validator_8,51763906851,True,796186001,15887170,812073171,True,1
3910,validator_14,197019554306,True,617140003,7241320,624381323,True,6
3911,validator_18,186867144545,True,636800000,39096300,675896300,True,5
3912,validator_15,491070360038,True,560000002,5838600,565838602,True,15
3913,validator_2,54320697628,True,612640006,5335030,617975036,True,1
3914,validator_14,197617398107,True,587400001,10443800,597843801,True,6
3915,validator_17,302820879479,True,618919997,8484300,627404297,True,9
3916,validator_17,303764372678,True,931799999,11693200,943493199,True,9
3917,validator_34,458995601170,True,597300000,2299740,599599740,False,14
3918,validator_44,163681687670,True,577600000,9782100,587382100,False,5
3919,validator_17,304292287874,True,525699996,2215200,527915196,True,9
3920,validator_44,164347819000,True,657200000,8931330,666131330,False,5
3921,validator_5,116414946960,True,733700002,9759130,743459132,True,3
3922,validator_8,52454798434,True,653254003,37637580,690891583,True,1
3923,validator_41,113141558810,True,579700000,1102060,580802060,False,3
3924,validator_17,305072664833,True,762153999,18222960,780376959,True,9
3925,validator_18,187424142919,True,542078004,14920370,556998374,True,5
3926,validator_21,108398974251,True,714619993,45024050,759644043,True,3
3927,validator_46,167624892590,True,475600000,2898520,478498520,False,5
3928,validator_38,51610662720,True,689400000,3103740,692503740,False,1
3929,validator_15,491681641462,True,603080004,8201420,611281424,True,15
3930,validator_44,164974018920,True,591800000,34399920,626199920,False,5
3931,validator_37,114436527320,True,480600000,5378240,485978240,False,3
3932,validator_15,492225311978,True,530399996,13270520,543670516,True,15
3933,validator_14,198245909405,True,577959998,50551300,628511298,True,6
3934,validator_34,459474959490,True,452270000,27088320,479358320,False,14
3935,validator_14,198828957123,True,576499998,6547720,583047718,True,6
3936,validator_49,116547041230,True,894300000,7965920,902265920,False,3
3937,validator_21,109246961922,True,840900001,7087670,847987671,True,3
3938,validator_15,492885488110,True,656700002,3476130,660176132,True,15
3939,validator_38,52492158320,True,875000000,6495600,881495600,False,1
3940,validator_31,281185682930,True,617900000,3036930,620936930,False,8
3941,validator_14,199485893160,True,648899997,8036040,656936037,True,6
3942,validator_21,110061068917,True,785720005,28386990,814106995,True,3
3943,validator_1,118612430091,True,654739997,17343860,672083857,True,3
3944,validator_1,119248202702,True,612846011,22926600,635772611,True,3
3945,validator_14,200161203422,True,664499992,10810270,675310262,True,6
3946,validator_1,119758572108,True,476440006,33929400,510369406,True,3
3947,validator_17,305805610358,True,729899995,3045530,732945525,True,9
3948,validator_34,460141594440,True,658600000,8034950,666634950,False,14
3949,validator_27,161068982220,True,772800000,1962500,774762500,False,5
3950,validator_46,168055903650,True,429900000,1111060,431011060,False,5
3951,validator_17,306656652258,True,825804000,25237900,851041900,True,9
3952,validator_17,307437407554,True,735689996,45065300,780755296,True,9
3953,validator_6,56839812513,True,512719998,30893420,543613418,True,1
3954,validator_17,308032632119,True,575339995,19884570,595224565,True,9
3955,validator_1,120343445910,True,551320002,33553800,584873802,True,3
3956,validator_17,308941274666,True,864213997,44428550,908642547,True,9
3957,validator_8,53205532834,True,713120000,37614400,750734400,True,1
3958,validator_3,56137180389,True,671594000,25156240,696750240,True,1
3959,validator_12,182273733727,True,609140000,48300900,657440900,True,5
3960,validator_34,460700228300,True,556500000,2133860,558633860,False,14
3961,validator_44,165510417350,True,535200000,1198430,536398430,False,5
3962,validator_17,309518190589,True,563180003,13735920,576915923,True,9
3963,validator_34,461144677200,True,443200000,1248900,444448900,False,14
3964,validator_31,281811477800,True,622600000,3194870,625794870,False,8
3965,validator_7,121754145312,True,676239994,2950310,679190304,True,3
3966,validator_34,461542954600,True,388900000,9377400,398277400,False,14
3967,validator_18,188090475869,True,613540000,52792950,666332950,True,5
3968,validator_0,51438223742,True,611039999,23627570,634667569,True,1
3969,validator_35,154029623150,True,633300000,1784900,635084900,False,4
3970,validator_31,282515762100,True,701700000,2584300,704284300,False,8
3971,validator_32,48755714440,True,497400000,2500460,499900460,False,1
3972,validator_15,493501530143,True,577600003,38442030,616042033,True,15
3973,validator_46,168808971770,True,745000000,8068120,753068120,False,5
3974,validator_34,462319437800,True,757400000,19083200,776483200,False,14
3975,validator_7,122787556629,True,1011699997,21711320,1033411317,True,3
3976,validator_17,310012824696,True,474640007,19994100,494634107,True,9
3977,validator_49,117170470410,True,586700000,36729180,623429180,False,3
3978,validator_18,188944609196,True,836339997,17793330,854133327,True,5
3979,validator_34,462829394230,True,489500000,20456430,509956430,False,14
3980,validator_5,117163250615,True,734939995,13363660,748303655,True,3
3981,validator_23,51727108570,True,662399996,22347720,684747716,True,1
3982,validator_7,123398734872,True,586040003,25138240,611178243,True,3
3983,validator_31,283151944630,True,634500000,1682530,636182530,False,8
3984,validator_31,283939880400,True,783900000,4035770,787935770,False,8
3985,validator_27,161594810630,True,523600000,2228410,525828410,False,5
3986,validator_34,463365101020,True,532400000,3306790,535706790,False,14
3987,validator_17,310680218047,True,664900001,2493350,667393351,True,9
3988,validator_30,104288659950,True,433000000,6035970,439035970,False,3
3989,validator_10,58021511513,True,786000008,1961200,787961208,True,1
3990,validator_30,104945562590,True,647800000,9102640,656902640,False,3
3991,validator_36,167796104490,True,541500000,31177420,572677420,False,5
3992,validator_10,58807942612,True,770519999,15911100,786431099,True,1
3993,validator_15,494199349355,True,666680002,31139210,697819212,True,15
3994,validator_36,168500492080,True,700700000,3687590,704387590,False,5
3995,validator_20,52501172646,True,617199999,15112480,632312479,True,1
3996,validator_34,463972834960,True,595800000,11933940,607733940,False,14
3997,validator_27,162088580170,True,489430000,4339540,493769540,False,5
3998,validator_17,311360470178,True,668466001,11786130,680252131,True,9
3999,validator_30,105490659590,True,543100000,1997000,545097000,False,3
4000,validator_34,464439269780,True,447600000,18834820,466434820,False,14
4001,validator_27,162732512410,True,640900000,3032240,643932240,False,5
4002,validator_15,494987571661,True,781239996,6982310,788222306,True,15
4003,validator_40,54043602410,True,596600000,4156090,600756090,False,1
4004,validator_31,284518099820,True,571100000,7119420,578219420,False,8
4005,validator_5,117630732317,True,448400002,19081700,467481702,True,3
4006,validator_25,55752600340,True,485900000,3652380,489552380,False,1
4007,validator_15,495649378966,True,659640005,2167300,661807305,True,15
4008,validator_15,496276935999,True,625700003,1857030,627557033,True,15
4009,validator_31,285177267300,True,653200000,5967480,659167480,False,8
4010,validator_15,497278733159,True,941400000,60397160,1001797160,True,15
4011,validator_34,464856149310,True,411300000,5579530,416879530,False,14
4012,validator_37,114955026360,True,516900000,1599040,518499040,False,3
4013,validator_22,118746938357,True,582420003,10029730,592449733,True,3
4014,validator_15,497784523888,True,493619999,12170730,505790729,True,15
4015,validator_43,106988113220,True,519500000,9666430,529166430,False,3
4016,validator_36,169112662180,True,609100000,3070100,612170100,False,5
4017,validator_37,115676914080,True,716200000,5687720,721887720,False,3
4018,validator_15,498554947567,True,752409999,18013680,770423679,True,15
4019,validator_43,107681080340,True,681500000,11467120,692967120,False,3
4020,validator_37,116216636880,True,519200000,20522800,539722800,False,3
4021,validator_15,499185130953,True,622699996,7483390,630183386,True,15
4022,validator_21,110947920216,True,883899999,2951300,886851299,True,3
4023,validator_44,166006059880,True,485000000,10642530,495642530,False,5
4024,validator_43,108389561490,True,706400000,2081150,708481150,False,3
4025,validator_15,499904380051,True,705799998,13449100,719249098,True,15
4026,validator_44,166566142940,True,558500000,1583060,560083060,False,5
4027,validator_17,311964552273,True,576539995,27542100,604082095,True,9
4028,validator_44,166918893260,True,345900000,6850320,352750320,False,5
4029,validator_17,312743056703,True,767420000,11084430,778504430,True,9
4030,validator_23,52339591698,True,596300008,16183120,612483128,True,1
4031,validator_34,465439568930,True,522000000,61419620,583419620,False,14
4032,validator_27,163356795050,True,618100000,6182640,624282640,False,5
4033,validator_17,313350958636,True,568948003,38953930,607901933,True,9
4034,validator_12,183030764064,True,730739997,26290340,757030337,True,5
4035,validator_34,466027135060,True,585800000,1766130,587566130,False,14
4036,validator_38,53289962040,True,795500000,2303720,797803720,False,1
4037,validator_41,113790255550,True,646900000,1796740,648696740,False,3
4038,validator_8,53684800736,True,455778002,23489900,479267902,True,1
4039,validator_8,54454983629,True,742159993,28022900,770182893,True,1
4040,validator_43,108907723330,True,495500000,22661840,518161840,False,3
4041,validator_27,163948893300,True,578700000,13398250,592098250,False,5
4042,validator_20,53104772549,True,572160003,31439900,603599903,True,1
4043,validator_4,50586748237,True,602100001,3251440,605351441,True,1
4044,validator_32,49267418360,True,492900000,18803920,511703920,False,1
4045,validator_34,466573482170,True,544500000,1847110,546347110,False,14
4046,validator_5,118365121300,True,711600003,22788980,734388983,True,3
4047,validator_18,189494002122,True,528619996,20772930,549392926,True,5
4048,validator_15,500419331347,True,490335996,24615300,514951296,True,15
4049,validator_34,467175548990,True,582000000,20066820,602066820,False,14
4050,validator_24,59143514508,True,618719998,8625000,627344998,True,1
4051,validator_31,285599438090,True,421170000,1000790,422170790,False,8
4052,validator_29,48118674340,True,479700000,1422560,481122560,False,1
4053,validator_15,500917352346,True,487959999,10061000,498020999,True,15
4054,validator_13,58536197702,True,541459993,31815810,573275803,True,1
4055,validator_30,106141512150,True,648100000,2752560,650852560,False,3
4056,validator_34,467787239110,True,610000000,1690120,611690120,False,14
4057,validator_21,111446009718,True,463959992,34129510,498089502,True,3
4058,validator_48,291892127960,True,544800000,3359190,548159190,False,9
4059,validator_39,53362411220,True,534300000,2480600,536780600,False,1
4060,validator_48,292634395350,True,737300000,4967390,742267390,False,9
4061,validator_49,117792647270,True,603300000,18876860,622176860,False,3
4062,validator_1,120997690092,True,628157992,26086190,654244182,True,3
4063,validator_19,111039491005,True,584600001,8268110,592868111,True,3
4064,validator_47,111822475000,True,520500000,1734200,522234200,False,3
4065,validator_21,112067181235,True,616699997,4471520,621171517,True,3
4066,validator_37,116921188330,True,684600000,19951450,704551450,False,3
4067,validator_24,59928578726,True,782399998,2664220,785064218,True,1
4068,validator_49,118562882270,True,763000000,7235000,770235000,False,3
4069,validator_17,314118930124,True,758700008,9271480,767971488,True,9
4070,validator_27,164468731940,True,493800000,26038640,519838640,False,5
4071,validator_34,468334950540,True,545400000,2311430,547711430,False,14
4072,validator_9,59382381145,True,801580002,6634910,808214912,True,1
4073,validator_37,117457227080,True,534100000,1938750,536038750,False,3
4074,validator_36,169510292040,True,376000000,21629860,397629860,False,5
4075,validator_34,468937252540,True,599200000,3102000,602302000,False,14
4076,validator_25,56462950960,True,683000000,27350620,710350620,False,1
4077,validator_46,169510774360,True,699500000,2302590,701802590,False,5
4078,validator_34,469563663840,True,619000000,7411300,626411300,False,14
4079,validator_29,48883856040,True,763600000,1581700,765181700,False,1
4080,validator_31,286187321990,True,583900000,3983900,587883900,False,8
4081,validator_35,154505471720,True,473900000,1948570,475848570,False,4
4082,validator_47,112418999020,True,589400000,7124020,596524020,False,3
4083,validator_36,169968844340,True,455300000,3252300,458552300,False,5
4084,validator_15,501778504312,True,828319996,32831970,861151966,True,15
4085,validator_48,293170965310,True,528100000,8469960,536569960,False,9
4086,validator_44,167555311160,True,628200000,8217900,636417900,False,5
4087,validator_25,56941402300,True,469100000,9351340,478451340,False,1
4088,validator_10,59391784802,True,581200000,2642190,583842190,True,1
4089,validator_48,293744853890,True,566700000,7188580,573888580,False,9
4090,validator_31,286668321820,True,471800000,9199830,480999830,False,8
4091,validator_0,52061047538,True,615139996,7683800,622823796,True,1
4092,validator_31,287347766460,True,655700000,23744640,679444640,False,8
4093,validator_39,53969555120,True,604400000,2743900,607143900,False,1
4094,validator_24,60661713797,True,711020001,22115070,733135071,True,1
4095,validator_19,111658766749,True,604900004,14375740,619275744,True,3
4096,validator_14,200916753541,True,742759999,12790120,755550119,True,6
4097,validator_46,169858347160,True,344120000,3452800,347572800,False,5
4098,validator_31,288034475400,True,684600000,2108940,686708940,False,9
4099,validator_34,470306290900,True,730800000,11827060,742627060,False,14
4100,validator_15,502210401215,True,411320003,20576900,431896903,True,15
4101,validator_37,118126847100,True,667500000,2120020,669620020,False,3
4102,validator_30,106871506940,True,724600000,5394790,729994790,False,3
4103,validator_22,119482798087,True,724940000,10919730,735859730,True,3
4104,validator_15,503198139320,True,942240005,45498100,987738105,True,15
4105,validator_15,503957875059,True,719093999,40641740,759735739,True,15
4106,validator_41,114425048850,True,632900000,1893300,634793300,False,3
4107,validator_19,112346121238,True,666339999,21014490,687354489,True,3
4108,validator_10,60052146246,True,636500004,23861440,660361444,True,1
4109,validator_46,170671098460,True,809500000,3251300,812751300,False,5
4110,validator_27,165015373390,True,511900000,34741450,546641450,False,5
4111,validator_5,119117884131,True,733900001,18862830,752762831,True,3
4112,validator_4,51249998474,True,651919997,11330240,663250237,True,1
4113,validator_18,190275636540,True,714925998,66708420,781634418,True,5
4114,validator_15,504572276465,True,612000006,2401400,614401406,True,15
4115,validator_34,470800772700,True,493100000,1381800,494481800,False,14
4116,validator_17,314829142821,True,707900007,2312690,710212697,True,9
4117,validator_17,315438009818,True,529979997,78887000,608866997,True,9
4118,validator_17,316217273326,True,771920008,7343500,779263508,True,9
4119,validator_44,168266793580,True,667200000,44282420,711482420,False,5
4120,validator_34,471454835400,True,649600000,4462700,654062700,False,14
4121,validator_34,471960671170,True,497600000,8235770,505835770,False,14
4122,validator_12,183764849275,True,705859991,28225220,734085211,True,5
4123,validator_18,190964450838,True,678719998,10094300,688814298,True,5
4124,validator_28,55336089800,True,510300000,4315250,514615250,False,1
4125,validator_34,472774599560,True,812400000,1528390,813928390,False,14
4126,validator_23,52987945099,True,640440001,7913400,648353401,True,1
4127,validator_29,49533366430,True,644100000,5410390,649510390,False,1
4128,validator_38,53805985800,True,513000000,3023760,516023760,False,1
4129,validator_18,191926577791,True,933800003,28326950,962126953,True,5
4130,validator_38,54410615300,True,594000000,10629500,604629500,False,1
4131,validator_12,184549923313,True,758299998,26774040,785074038,True,5
4132,validator_44,168995317000,True,725900000,2623420,728523420,False,5
4133,validator_38,54953775360,True,537200000,5960060,543160060,False,1
4134,validator_49,118968093600,True,397200000,8011330,405211330,False,3
4135,validator_34,473480665400,True,703900000,2165840,706065840,False,14
4136,validator_34,474015135870,True,531400000,3070470,534470470,False,14
4137,validator_34,474588992850,True,569900000,3956980,573856980,False,14
4138,validator_31,288592922920,True,554970000,3477520,558447520,False,9
4139,validator_31,289219297820,True,606700000,19674900,626374900,False,9
4140,validator_15,505571816497,True,998100002,1440030,999540032,True,15
4141,validator_7,123989406210,True,588200008,2471330,590671338,True,3
4142,validator_31,289887556500,True,650500000,17758680,668258680,False,9
4143,validator_7,124685634510,True,690000000,6228300,696228300,True,3
4144,validator_40,54503694640,True,451700000,8392230,460092230,False,1
4145,validator_24,61254682698,True,591900001,1068900,592968901,True,1
4146,validator_45,55152656500,True,534500000,3556380,538056380,False,1
4147,validator_46,171333027740,True,641800000,20129280,661929280,False,5
4148,validator_15,506160714126,True,572519999,16377630,588897629,True,15
4149,validator_16,59175766561,True,603340004,23233720,626573724,True,1
4150,validator_14,201519277730,True,595039999,7484190,602524189,True,6
4151,validator_17,316772524706,True,530368000,24883380,555251380,True,9
4152,validator_17,317417026432,True,633746006,10755720,644501726,True,9
4153,validator_19,113005299667,True,635159999,24018430,659178429,True,3
4154,validator_47,112941944150,True,515100000,7845130,522945130,False,3
4155,validator_31,290527724130,True,634000000,6167630,640167630,False,9
4156,validator_34,475178433550,True,585800000,3640700,589440700,False,14
4157,validator_27,165547222420,True,529200000,2649030,531849030,False,5
4158,validator_21,112772847965,True,676298000,29368730,705666730,True,3
4159,validator_17,318078555332,True,595676000,65852900,661528900,True,9
4160,validator_18,192718908691,True,768240000,24090900,792330900,True,6
4161,validator_35,154926023850,True,419260000,1292130,420552130,False,4
4162,validator_27,166082566610,True,516100000,19244190,535344190,False,5
4163,validator_46,172078432190,True,706240000,39164450,745404450,False,5
4164,validator_44,169652760320,True,655100000,2343320,657443320,False,5
4165,validator_12,185173934536,True,620400003,3611220,624011223,True,5
4166,validator_15,507033235264,True,867199998,5321140,872521138,True,15
4167,validator_48,294258893880,True,511100000,2939990,514039990,False,9
4168,validator_22,120209247489,True,693900002,32549400,726449402,True,3
4169,validator_24,61978827521,True,705220003,18924820,724144823,True,1
4170,validator_19,113709195143,True,684940006,18955470,703895476,True,3
4171,validator_27,166790231550,True,705800000,1864940,707664940,False,5
4172,validator_34,475919267780,True,731700000,9134230,740834230,False,14
4173,validator_5,119903353728,True,783099997,2369600,785469597,True,3
4174,validator_31,291286374930,True,756600000,2050800,758650800,False,9
4175,validator_15,507547581379,True,506400005,7946110,514346115,True,15
4176,validator_34,476538932830,True,608700000,10965050,619665050,False,14
4177,validator_44,170206988190,True,545900000,8327870,554227870,False,5
4178,validator_44,170598000530,True,383720000,7292340,391012340,False,5
4179,validator_37,118584408960,True,456000000,1561860,457561860,False,3
4180,validator_48,294664535080,True,402600000,3041200,405641200,False,9
4181,validator_33,52740046900,True,812900000,1949830,814849830,False,1
4182,validator_14,202207600028,True,604249998,84072300,688322298,True,6
4183,validator_43,109406182390,True,496600000,1859060,498459060,False,3
4184,validator_31,291942665150,True,652200000,4090220,656290220,False,9
4185,validator_34,477009776500,True,448970000,21873670,470843670,False,14
4186,validator_48,295201131410,True,525800000,10796330,536596330,False,9
4187,validator_33,53328475640,True,568300000,20128740,588428740,False,1
4188,validator_34,477633343380,True,620700000,2866880,623566880,False,14
4189,validator_31,292527843740,True,556600000,28578590,585178590,False,9
4190,validator_15,508211913484,True,598220005,66112100,664332105,True,15
4191,validator_14,202936333548,True,708440000,20293520,728733520,True,6
4192,validator_31,293164679940,True,634100000,2736200,636836200,False,9
4193,validator_33,54264821340,True,897700000,38645700,936345700,False,1
4194,validator_18,193391381133,True,669500002,2972440,672472442,True,6
4195,validator_34,478205142300,True,565400000,6398920,571798920,False,14
4196,validator_18,193854040761,True,456179998,6479630,462659628,True,6
4197,validator_34,478860695240,True,628800000,26752940,655552940,False,14
4198,validator_41,115052093280,True,621600000,5444430,627044430,False,3
4199,validator_31,293837259840,True,650800000,21779900,672579900,False,9
4200,validator_21,113370810747,True,584100002,13862780,597962782,True,3
4201,validator_34,479511223770,True,642500000,8028530,650528530,False,14
4202,validator_6,57506443711,True,616599998,50031200,666631198,True,1
4203,validator_11,48877410682,True,584720000,39052460,623772460,True,1
4204,validator_44,171058269970,True,456150000,4119440,460269440,False,5
4205,validator_12,185865387133,True,658679997,32772600,691452597,True,5
4206,validator_15,509016283085,True,794140001,10229600,804369601,True,15
4207,validator_17,318604188227,True,490860005,34772890,525632895,True,9
4208,validator_15,509785025348,True,728820003,39922260,768742263,True,15
4209,validator_25,57577613040,True,633400000,2810740,636210740,False,1
4210,validator_30,107411745140,True,539100000,1138200,540238200,False,3
4211,validator_48,295949785260,True,743900000,4753850,748653850,False,9
4212,validator_46,172619751890,True,537400000,3919700,541319700,False,5
4213,validator_36,170712650420,True,733800000,10006080,743806080,False,5
4214,validator_4,51828467370,True,574299996,4168900,578468896,True,1
4215,validator_34,480098641770,True,578900000,8518000,587418000,False,15
4216,validator_17,319423283774,True,810820007,8275540,819095547,True,9
4217,validator_35,155586016020,True,657700000,2292170,659992170,False,4
4218,validator_30,108046232450,True,632800000,1687310,634487310,False,3
4219,validator_11,49577982522,True,682240000,18331840,700571840,True,1
4220,validator_12,186455374444,True,569120001,20867310,589987311,True,5
4221,validator_15,510485979345,True,656297997,44656000,700953997,True,15
4222,validator_34,480748282640,True,641500000,8140870,649640870,False,15
4223,validator_35,156244984580,True,647400000,11568560,658968560,False,4
4224,validator_18,194397080829,True,538500008,4540060,543040068,True,6
4225,validator_47,113457801050,True,513700000,2156900,515856900,False,3
4226,validator_41,115742894360,True,688700000,2101080,690801080,False,3
4227,validator_19,114176404317,True,448546004,18663170,467209174,True,3
4228,validator_46,173480246830,True,858200000,2294940,860494940,False,5
4229,validator_46,174234984930,True,744900000,9838100,754738100,False,5
4230,validator_27,167416619380,True,625400000,987830,626387830,False,5
4231,validator_9,59968274422,True,564299997,21593280,585893277,True,1
4232,validator_15,511187109930,True,686119995,15010590,701130585,True,15
4233,validator_48,296552033660,True,601100000,1148400,602248400,False,9
4234,validator_48,297157647760,True,605000000,614100,605614100,False,9
4235,validator_15,511815285659,True,608739999,19435730,628175729,True,15
4236,validator_15,512461377349,True,631680000,14411690,646091690,True,16
4237,validator_44,171573758780,True,511800000,3688810,515488810,False,5
4238,validator_34,481339883240,True,589000000,2600600,591600600,False,15
4239,validator_21,113798249056,True,418758009,8680300,427438309,True,3
4240,validator_9,60866348924,True,895200002,2874500,898074502,True,1
4241,validator_7,125266532312,True,567500002,13397800,580897802,True,3
4242,validator_15,513107344650,True,617620001,28347300,645967301,True,16
4243,validator_48,297819457780,True,641600000,20210020,661810020,False,9
4244,validator_37,119299241250,True,694100000,20732290,714832290,False,3
4245,validator_0,52855851089,True,792300001,2503550,794803551,True,1
4246,validator_43,109921857730,True,513100000,2575340,515675340,False,3
4247,validator_5,120558494731,True,645200003,9941000,655141003,True,3
4248,validator_46,174770820730,True,532500000,3335800,535835800,False,5
4249,validator_48,298444740410,True,610700000,14582630,625282630,False,9
4250,validator_34,481994194760,True,652400000,1911520,654311520,False,15
4251,validator_1,121902142937,True,883800005,20652840,904452845,True,3
4252,validator_15,513799850350,True,680940000,11565700,692505700,True,16
4253,validator_7,125847257308,True,577999996,2725000,580724996,True,3
4254,validator_18,195132925060,True,706300001,29544230,735844231,True,6
4255,validator_17,320294651618,True,835260004,36107840,871367844,True,10
4256,validator_17,321001396520,True,686000002,20744900,706744902,True,10
4257,validator_1,122716795355,True,794699998,19952420,814652418,True,3
4258,validator_21,114720133855,True,913639999,8244800,921884799,True,3
4259,validator_43,110459440770,True,512700000,24883040,537583040,False,3
4260,validator_31,294485942830,True,647100000,1582990,648682990,False,9
4261,validator_34,482547138660,True,550000000,2943900,552943900,False,15
4262,validator_19,115077984451,True,873240004,28340130,901580134,True,3
4263,validator_31,295184555230,True,689100000,9512400,698612400,False,9
4264,validator_18,195735964003,True,568458003,34580940,603038943,True,6
4265,validator_30,108763798900,True,708500000,9066450,717566450,False,3
4266,validator_48,299184689110,True,727000000,12948700,739948700,False,9
4267,validator_15,514608446391,True,800100001,8496040,808596041,True,16
4268,validator_12,187177099243,True,658217999,63506800,721724799,True,5
4269,validator_49,119659096860,True,688900000,2103260,691003260,False,3
4270,validator_34,483142860230,True,572600000,23121570,595721570,False,15
4271,validator_43,111069972190,True,591200000,19331420,610531420,False,3
4272,validator_34,483695785370,True,520600000,32325140,552925140,False,15
4273,validator_10,60832584680,True,736186004,44252430,780438434,True,1
4274,validator_44,172165683380,True,581900000,10024600,591924600,False,5
4275,validator_34,484208300370,True,463000000,49515000,512515000,False,15
4276,validator_15,515261391179,True,628300008,24644780,652944788,True,16
4277,validator_28,55915148500,True,576200000,2858700,579058700,False,1
4278,validator_34,484871090310,True,641200000,21589940,662789940,False,15
4279,validator_49,120036204960,True,373600000,3508100,377108100,False,3
4280,validator_34,485692243530,True,800900000,20253220,821153220,False,15
4281,validator_27,167980080200,True,560900000,2560820,563460820,False,5
4282,validator_34,486195532570,True,487000000,16289040,503289040,False,15
4283,validator_46,175386158960,True,605000000,10338230,615338230,False,5
4284,validator_14,203591262248,True,641480000,13448700,654928700,True,6
4285,validator_37,119885915810,True,581400000,5274560,586674560,False,3
4286,validator_43,111587410200,True,507900000,9538010,517438010,False,3
4287,validator_44,172778766300,True,612100000,982920,613082920,False,5
4288,validator_40,55048407040,True,538100000,6612400,544712400,False,1
4289,validator_14,204355327924,True,762399996,1665680,764065676,True,6
4290,validator_14,205165890452,True,807399998,3162530,810562528,True,6
4291,validator_15,516072859207,True,807539998,3928030,811468028,True,16
4292,validator_22,120744495016,True,521379997,13867530,535247527,True,3
4293,validator_19,116144105636,True,1049400005,16721180,1066121185,True,3
4294,validator_31,295765595250,True,577900000,3140020,581040020,False,9
4295,validator_12,187853920422,True,659019999,17801180,676821179,True,5
4296,validator_15,516963758011,True,820196004,70702800,890898804,True,16
4297,validator_15,517697241447,True,704163996,29319440,733483436,True,16
4298,validator_19,116659754310,True,513400004,2248670,515648674,True,3
4299,validator_30,109287971530,True,520900000,3272630,524172630,False,3
4300,validator_40,55632493740,True,581600000,2486700,584086700,False,1
4301,validator_1,123474765150,True,730539995,27429800,757969795,True,3
4302,validator_26,53906242900,True,619900000,3369020,623269020,False,1
4303,validator_34,486966445400,True,751100000,19812830,770912830,False,15
4304,validator_35,156787503760,True,532000000,10519180,542519180,False,4
4305,validator_48,299697860230,True,512400000,771120,513171120,False,9
4306,validator_21,115514634593,True,791199998,3300740,794500738,True,3
4307,validator_34,487628619840,True,658400000,3774440,662174440,False,15
4308,validator_21,116201174488,True,683499995,3039900,686539895,True,3
4309,validator_15,518430306365,True,695379998,37684920,733064918,True,16
4310,validator_9,61593647267,True,701460003,25838340,727298343,True,1
4311,validator_16,59921731135,True,718159994,27804580,745964574,True,1
4312,validator_34,488138041330,True,508200000,1221490,509421490,False,15
4313,validator_44,173248604790,True,450800000,19038490,469838490,False,5
4314,validator_48,300175982830,True,476300000,1822600,478122600,False,9
4315,validator_22,121483881241,True,736899995,2486230,739386225,True,3
4316,validator_1,124190912147,True,710439997,5707000,716146997,True,3
4317,validator_48,300635630230,True,458400000,1247400,459647400,False,9
4318,validator_12,188409929318,True,554799996,1208900,556008896,True,5
4319,validator_14,205815428295,True,598168003,51369840,649537843,True,6
4320,validator_31,296309650220,True,524400000,19654970,544054970,False,9
4321,validator_48,301223916930,True,586800000,1486700,588286700,False,9
4322,validator_28,56572558500,True,653800000,3610000,657410000,False,1
4323,validator_36,171466104450,True,749200000,4254030,753454030,False,5
4324,validator_34,488943560930,True,785700000,19819600,805519600,False,15
4325,validator_49,120679097950,True,636600000,6292990,642892990,False,3
4326,validator_17,321889420034,True,886700004,1323510,888023514,True,10
4327,validator_34,489565823150,True,619100000,3162220,622262220,False,15
4328,validator_20,53704504554,True,587640005,12092000,599732005,True,1
4329,validator_1,124977269476,True,765799999,20557330,786357329,True,3
4330,validator_6,58260317245,True,707739994,46133540,753873534,True,1
4331,validator_22,122316311826,True,811200005,21230580,832430585,True,3
4332,validator_39,54577368270,True,580900000,26913150,607813150,False,1
4333,validator_17,322700672223,True,808899999,2352190,811252189,True,10
4334,validator_1,125595876968,True,608619992,9987500,618607492,True,3
4335,validator_31,297093078650,True,763000000,20428430,783428430,False,9
4336,validator_17,323160576230,True,450240007,9664000,459904007,True,10
4337,validator_36,172058570580,True,587900000,4566130,592466130,False,5
4338,validator_48,301749370920,True,524300000,1153990,525453990,False,9
4339,validator_22,122971578434,True,624679998,30586610,655266608,True,3
4340,validator_17,324148786653,True,955059993,33150430,988210423,True,10
4341,validator_31,297709409730,True,612000000,4331080,616331080,False,9
4342,validator_34,490205591480,True,638200000,1568330,639768330,False,15
4343,validator_15,519478675763,True,1012769998,35599400,1048369398,True,16
4344,validator_11,50207086047,True,622139995,6963530,629103525,True,1
4345,validator_19,117215217380,True,523638000,31825070,555463070,True,3
4346,validator_34,490750596320,True,542800000,2204840,545004840,False,15
4347,validator_15,519930521542,True,426879989,24965790,451845779,True,16
4348,validator_18,196322815668,True,560699995,26151670,586851665,True,6
4349,validator_34,491322488100,True,548400000,23491780,571891780,False,15
4350,validator_36,172593689800,True,532500000,2619220,535119220,False,5
4351,validator_48,302344831200,True,593300000,2160280,595460280,False,9
4352,validator_48,302992914430,True,644800000,3283230,648083230,False,9
4353,validator_33,54909355800,True,642300000,2234460,644534460,False,1
4354,validator_31,298172519250,True,460700000,2409520,463109520,False,9
4355,validator_34,491838213820,True,496500000,19225720,515725720,False,15
4356,validator_12,189147468607,True,729859989,7679300,737539289,True,5
4357,validator_41,116252184390,True,494900000,14390030,509290030,False,3
4358,validator_27,168517551000,True,534700000,2770800,537470800,False,5
4359,validator_47,114109624050,True,646800000,5023000,651823000,False,3
4360,validator_46,175810062550,True,420310000,3593590,423903590,False,5
4361,validator_43,112183444230,True,576400000,19634030,596034030,False,3
4362,validator_35,157341844400,True,530100000,24240640,554340640,False,4
4363,validator_1,126251806805,True,634799997,21129840,655929837,True,3
4364,validator_36,173125100990,True,528600000,2811190,531411190,False,5
4365,validator_43,112693711470,True,508900000,1367240,510267240,False,3
4366,validator_14,206512216687,True,677320002,19468390,696788392,True,6
4367,validator_27,169125093630,True,604600000,2942630,607542630,False,5
4368,validator_36,173744028130,True,609900000,9027140,618927140,False,5
4369,validator_14,207069073384,True,535939997,20916700,556856697,True,6
4370,validator_17,324705132302,True,549999999,6345650,556345649,True,10
4371,validator_15,520440876874,True,464720002,45635330,510355332,True,16
4372,validator_3,56793383386,True,643009997,13193000,656202997,True,1
4373,validator_31,298701383180,True,527400000,1463930,528863930,False,9
4374,validator_14,207636273885,True,550800001,16400500,567200501,True,6
4375,validator_21,117001010615,True,763200007,36636120,799836127,True,3
4376,validator_30,109968630170,True,677300000,3358640,680658640,False,3
4377,validator_26,54485955200,True,572300000,7412300,579712300,False,1
4378,validator_1,126997092220,True,725099995,20185420,745285415,True,3
4379,validator_34,492604294780,True,753200000,12880960,766080960,False,15
4380,validator_15,521224436171,True,763239997,20319300,783559297,True,16
4381,validator_31,299424035720,True,715700000,6952540,722652540,False,9
4382,validator_15,521843529964,True,582320003,36773790,619093793,True,16
4383,validator_36,174312916610,True,560200000,8688480,568888480,False,5
4384,validator_14,208349713023,True,699689998,13749140,713439138,True,6
4385,validator_27,169946481810,True,817400000,3988180,821388180,False,5
4386,validator_15,522575108578,True,707054004,24524610,731578614,True,16
4387,validator_31,300139322720,True,712500000,2787000,715287000,False,9
4388,validator_15,523245136166,True,666499988,3527600,670027588,True,16
4389,validator_47,114691348270,True,579800000,1924220,581724220,False,3
4390,validator_5,121082818610,True,485399999,38923880,524323879,True,3
4391,validator_46,176673065230,True,853100000,9902680,863002680,False,5
4392,validator_31,300735630330,True,587200000,9107610,596307610,False,9
4393,validator_34,493192228190,True,578000000,9933410,587933410,False,15
4394,validator_30,110456971170,True,478700000,9641000,488341000,False,3
4395,validator_20,54478239357,True,741960003,31774800,773734803,True,1
4396,validator_27,170401532850,True,434500000,20551040,455051040,False,5
4397,validator_18,196960887143,True,625300005,12771470,638071475,True,6
4398,validator_48,303568496770,True,567600000,7982340,575582340,False,9
4399,validator_40,56432772370,True,792300000,7978630,800278630,False,1
4400,validator_41,116852910710,True,580500000,20226320,600726320,False,3
4401,validator_7,126607179110,True,731540002,28381800,759921802,True,3
4402,validator_31,301170005950,True,412500000,21875620,434375620,False,9
4403,validator_41,117481883810,True,627800000,1173100,628973100,False,3
4404,validator_34,493761557710,True,567300000,2029520,569329520,False,15
4405,validator_34,494320988200,True,528100000,31330490,559430490,False,15
4406,validator_5,121761078245,True,655139995,23119640,678259635,True,3
4407,validator_12,189989342264,True,817839997,24033660,841873657,True,5
4408,validator_16,60391606795,True,441580000,28295660,469875660,True,1
4409,validator_5,122364171928,True,586900003,16193680,603093683,True,3
4410,validator_27,171160211090,True,755600000,3078240,758678240,False,5
4411,validator_32,50210366100,True,906100000,36847740,942947740,False,1
4412,validator_34,494846978900,True,505900000,20090700,525990700,False,15
4413,validator_48,304100054230,True,528700000,2857460,531557460,False,9
4414,validator_43,113194668360,True,498270000,2686890,500956890,False,3
4415,validator_1,127765775055,True,765120005,3562830,768682835,True,3
4416,validator_36,174960449240,True,624400000,23132630,647532630,False,5
4417,validator_48,304528955770,True,419800000,9101540,428901540,False,9
4418,validator_20,55176171393,True,656999996,40932040,697932036,True,1
4419,validator_47,115243107870,True,548700000,3059600,551759600,False,3
4420,validator_34,495569915400,True,720500000,2436500,722936500,False,15
4421,validator_29,50136897230,True,594800000,8730800,603530800,False,1
4422,validator_15,524044478772,True,741900006,57442600,799342606,True,16
4423,validator_15,524942508874,True,884500002,13530100,898030102,True,16
4424,validator_46,177382115630,True,699500000,9550400,709050400,False,5
4425,validator_17,325505475037,True,766120005,34222730,800342735,True,10
4426,validator_17,326216403858,True,694800001,16128820,710928821,True,10
4427,validator_21,117630889069,True,611699994,18178460,629878454,True,3
4428,validator_24,62671855514,True,683900003,9127990,693027993,True,1
4429,validator_14,209214194124,True,825540001,38941100,864481101,True,6
4430,validator_17,326701188472,True,458580004,26204610,484784614,True,10
4431,validator_5,122805562757,True,422899999,18490830,441390829,True,3
4432,validator_19,118042674799,True,820199999,7257420,827457419,True,3
4433,validator_48,304988715410,True,458500000,1259640,459759640,False,9
4434,validator_44,173995375380,True,744800000,1970590,746770590,False,5
4435,validator_15,525850497862,True,866519998,41468990,907988988,True,16
4436,validator_5,123463247005,True,620500008,37184240,657684248,True,3
4437,validator_1,128498812353,True,723919998,9117300,733037298,True,4
4438,validator_34,496053851870,True,462900000,21036470,483936470,False,15
4439,validator_48,305786646730,True,778000000,19931320,797931320,False,9
4440,validator_25,58147848040,True,550400000,19835000,570235000,False,1
4441,validator_12,190604626746,True,613300002,1984480,615284482,True,5
4442,validator_19,118566548793,True,478125994,45748000,523873994,True,3
4443,validator_15,526443138103,True,583100001,9540240,592640241,True,16
4444,validator_14,209798110622,True,568439998,15476500,583916498,True,6
4445,validator_15,527028331011,True,571239998,13952910,585192908,True,16
4446,validator_39,55043251200,True,463300000,2582930,465882930,False,1
4447,validator_15,527678571191,True,602316000,47924180,650240180,True,16
4448,validator_34,496621548570,True,565200000,2496700,567696700,False,15
4449,validator_48,306317838930,True,529800000,1392200,531192200,False,9
4450,validator_46,177893511410,True,510900000,495780,511395780,False,5
4451,validator_17,327761180162,True,1031099990,28891700,1059991690,True,10
4452,validator_1,129110494787,True,586099994,25582440,611682434,True,4
4453,validator_12,191405766895,True,799399999,1740150,801140149,True,5
4454,validator_28,57182788840,True,589200000,21030340,610230340,False,1
4455,validator_19,119222419990,True,633125997,22745200,655871197,True,3
4456,validator_48,306960463800,True,635200000,7424870,642624870,False,9
4457,validator_34,497250417970,True,627000000,1869400,628869400,False,15
4458,validator_31,301647270950,True,475600000,1665000,477265000,False,9
4459,validator_15,528401512005,True,689380004,33560810,722940814,True,16
4460,validator_47,116060352870,True,813700000,3545000,817245000,False,3
4461,validator_3,57551033425,True,753599999,4050040,757650039,True,1
4462,validator_14,210422367399,True,608560007,15696770,624256777,True,6
4463,validator_18,197563538987,True,594300004,8351840,602651844,True,6
4464,validator_15,528887457307,True,470640002,15305300,485945302,True,16
4465,validator_11,50866339148,True,647080001,12173100,659253101,True,1
4466,validator_48,307480833780,True,514900000,5469980,520369980,False,9
4467,validator_36,175600173260,True,620000000,19724020,639724020,False,5
4468,validator_17,328465161689,True,701299997,2681530,703981527,True,10
4469,validator_34,497650066220,True,393900000,5748250,399648250,False,15
4470,validator_34,498317540870,True,663200000,4274650,667474650,False,15
4471,validator_46,178538433210,True,639200000,5721800,644921800,False,5
4472,validator_15,529498977832,True,567119995,44400530,611520525,True,16
4473,validator_15,530222161230,True,716439998,6743400,723183398,True,16
4474,validator_15,531159221904,True,892004004,45056670,937060674,True,16
4475,validator_34,498995159970,True,657000000,20619100,677619100,False,15
4476,validator_48,308099381810,True,593500000,25048030,618548030,False,9
4477,validator_17,329135493288,True,661459999,8871600,670331599,True,10
4478,validator_20,55911216341,True,710020008,25024940,735044948,True,1
4479,validator_27,171904097390,True,733900000,9986300,743886300,False,5
4480,validator_26,55117745000,True,630400000,1389800,631789800,False,1
4481,validator_48,308782588510,True,659800000,23406700,683206700,False,9
4482,validator_46,179305981900,True,751700000,15848690,767548690,False,5
4483,validator_21,118181048902,True,548200003,1959830,550159833,True,3
4484,validator_34,499526028510,True,522700000,8168540,530868540,False,15
4485,validator_15,531965600987,True,802100003,4279080,806379083,True,16
4486,validator_34,500128401520,True,601200000,1173010,602373010,False,15
4487,validator_9,62179209666,True,544099999,41462400,585562399,True,1
4488,validator_28,57927583900,True,737800000,6995060,744795060,False,1
4489,validator_1,129774505645,True,621527998,42482860,664010858,True,4
4490,validator_17,329889374855,True,735019997,18861570,753881567,True,10
4491,validator_39,55609859990,True,564600000,2008790,566608790,False,1
4492,validator_42,50788427470,True,681600000,6243240,687843240,False,1
4493,validator_21,118781692323,True,593520001,7123420,600643421,True,3
4494,validator_43,113719396260,True,522500000,2227900,524727900,False,3
4495,validator_43,114315939960,True,559200000,37343700,596543700,False,3
4496,validator_14,211321963056,True,895300007,4295650,899595657,True,6
4497,validator_49,121313715090,True,611310000,23307140,634617140,False,3
4498,validator_14,212031437448,True,681400002,28074390,709474392,True,6
4499,validator_36,176158998760,True,556500000,2325500,558825500,False,5
4500,validator_15,532735089664,True,755359997,14128680,769488677,True,16
4501,validator_12,192129004587,True,719640002,3597690,723237692,True,6
4502,validator_31,302042746950,True,393400000,2076000,395476000,False,9
4503,validator_12,192913987580,True,731899993,53083000,784982993,True,6
4504,validator_44,174487344920,True,490300000,1669540,491969540,False,5
4505,validator_18,198338168406,True,767599999,7029420,774629419,True,6
4506,validator_31,302450680750,True,405300000,2633800,407933800,False,9
4507,validator_15,533349571444,True,595520000,18961780,614481780,True,16
4508,validator_27,172585229790,True,678500000,2632400,681132400,False,5
4509,validator_16,61067124636,True,660260001,15257840,675517841,True,1
4510,validator_27,173072030670,True,467300000,19500880,486800880,False,5
4511,validator_12,193586561508,True,651539998,21033930,672573928,True,6
4512,validator_46,179896996800,True,582400000,8614900,591014900,False,5
4513,validator_48,309392852030,True,599700000,10563520,610263520,False,9
4514,validator_32,50669407700,True,439600000,19441600,459041600,False,1
4515,validator_14,212844705204,True,784759996,28507760,813267756,True,6
4516,validator_44,175126756120,True,636900000,2511200,639411200,False,5
4517,validator_43,114842217540,True,518200000,8077580,526277580,False,3
4518,validator_12,194226579806,True,611997998,28020300,640018298,True,6
4519,validator_34,500794388320,True,650800000,15186800,665986800,False,15
4520,validator_34,501456050320,True,654300000,7362000,661662000,False,15
4521,validator_12,194896430984,True,655579998,14271180,669851178,True,6
4522,validator_12,195497120247,True,599900003,789260,600689263,True,6
4523,validator_10,61659870636,True,807273996,20011960,827285956,True,1
4524,validator_17,330725762465,True,823700000,12687610,836387610,True,10
4525,validator_15,534200572995,True,823160001,27841550,851001551,True,16
4526,validator_48,310055149430,True,660600000,1697400,662297400,False,9
4527,validator_44,175783150350,True,654700000,1694230,656394230,False,5
4528,validator_27,173811789070,True,712700000,27058400,739758400,False,5
4529,validator_46,180401104890,True,484900000,19208090,504108090,False,5
4530,validator_46,180841993170,True,427300000,13588280,440888280,False,5
4531,validator_31,303316393410,True,864000000,1712660,865712660,False,9
4532,validator_8,55161359467,True,697639998,8735840,706375838,True,1
4533,validator_3,58113435426,True,559000001,3402000,562402001,True,1
4534,validator_15,534890964476,True,662700001,27691480,690391481,True,16
4535,validator_35,157892597160,True,548300000,2452760,550752760,False,4
4536,validator_6,58930394651,True,656680006,13397400,670077406,True,1
4537,validator_43,115495752860,True,632300000,21235320,653535320,False,3
4538,validator_15,535477640893,True,545559997,41116420,586676417,True,16
4539,validator_48,310796041070,True,730400000,10491640,740891640,False,9
4540,validator_34,502104144960,True,639300000,8794640,648094640,False,15
4541,validator_11,51508462362,True,634600004,7523210,642123214,True,1
4542,validator_27,174222477910,True,406500000,4188840,410688840,False,5
4543,validator_48,311373708540,True,575800000,1867470,577667470,False,9
4544,validator_46,181420753390,True,577100000,1660220,578760220,False,5
4545,validator_0,53470416398,True,603180009,11385300,614565309,True,1
4546,validator_22,123828149731,True,826449997,30121300,856571297,True,3
4547,validator_34,502687307260,True,580800000,2362300,583162300,False,15
4548,validator_17,331314413541,True,563339996,25311080,588651076,True,10
4549,validator_27,174822380210,True,598800000,1102300,599902300,False,5
4550,validator_32,51259100050,True,580700000,8992350,589692350,False,1
4551,validator_37,120423134270,True,534600000,2618460,537218460,False,3
4552,validator_14,213665363995,True,781139991,39518800,820658791,True,6
4553,validator_7,127244390433,True,621700003,15511320,637211323,True,3
4554,validator_48,312002125740,True,626100000,2317200,628417200,False,9
4555,validator_25,58952425840,True,783700000,20877800,804577800,False,1
4556,validator_29,50758260150,True,617300000,4062920,621362920,False,1
4557,validator_46,181944290970,True,505100000,18437580,523537580,False,5
4558,validator_8,55878662196,True,695940009,21362720,717302729,True,1
4559,validator_48,312704264480,True,699600000,2538740,702138740,False,9
4560,validator_17,331963863673,True,621460002,27990130,649450132,True,10
4561,validator_21,119840970034,True,1008193991,51083720,1059277711,True,3
4562,validator_37,120844322770,True,419200000,1988500,421188500,False,3
4563,validator_36,176887263860,True,708300000,19965100,728265100,False,5
4564,validator_17,332806601672,True,819113999,23624000,842737999,True,10
4565,validator_22,124330533567,True,489000006,13383830,502383836,True,3
4566,validator_18,198947755784,True,585199998,24387380,609587378,True,6
4567,validator_17,333495714261,True,685999999,3112590,689112589,True,10
4568,validator_45,55673341730,True,514000000,6685230,520685230,False,1
4569,validator_35,158318619600,True,422000000,4022440,426022440,False,4
4570,validator_31,304066876810,True,749200000,1283400,750483400,False,9
4571,validator_42,51207800740,True,417800000,1573270,419373270,False,1
4572,validator_15,536298241490,True,817499997,3100600,820600597,True,16
4573,validator_46,182533033040,True,575100000,13642070,588742070,False,5
4574,validator_32,52002364750,True,740600000,2664700,743264700,False,1
4575,validator_41,118449910210,True,966900000,1126400,968026400,False,3
4576,validator_48,313252123980,True,542000000,5859500,547859500,False,9
4577,validator_22,124974688498,True,641920001,2234930,644154931,True,3
4578,validator_37,121287902640,True,436500000,7079870,443579870,False,3
4579,validator_15,536887976753,True,529556003,60179260,589735263,True,16
4580,validator_46,183132551100,True,596200000,3318060,599518060,False,5
4581,validator_34,503250090260,True,553800000,8983000,562783000,False,15
4582,validator_48,313778437310,True,506000000,20313330,526313330,False,9
4583,validator_48,314350837030,True,565700000,6699720,572399720,False,9
4584,validator_37,121987536740,True,698400000,1234100,699634100,False,3
4585,validator_15,537552024882,True,639965999,24082130,664048129,True,16
4586,validator_17,334413706726,True,911100005,6892460,917992465,True,10
4587,validator_30,111196724430,True,736300000,3453260,739753260,False,3
4588,validator_48,315222582380,True,870400000,1345350,871745350,False,9
4589,validator_31,304616313650,True,536600000,12836840,549436840,False,9
4590,validator_48,315878188340,True,652600000,3005960,655605960,False,9
4591,validator_22,125890015825,True,858139997,57187330,915327327,True,3
4592,validator_22,126694764007,True,796200002,8548180,804748182,True,3
4593,validator_44,176422323150,True,637800000,1372800,639172800,False,5
4594,validator_19,120265492585,True,986600005,56472590,1043072595,True,3
4595,validator_34,503872044750,True,615000000,6954490,621954490,False,15
4596,validator_46,183595960310,True,456400000,7009210,463409210,False,5
4597,validator_18,199547278402,True,592699998,6822620,599522618,True,6
4598,validator_8,56494184503,True,590068007,25454300,615522307,True,1
4599,validator_36,177436189190,True,544000000,4925330,548925330,False,5
4600,validator_20,56541473108,True,619219997,11036770,630256767,True,1
4601,validator_36,177996090890,True,549400000,10501700,559901700,False,5
4602,validator_34,504468694850,True,594300000,2350100,596650100,False,15
4603,validator_26,55700514930,True,581010000,1759930,582769930,False,1
4604,validator_31,305054441130,True,434400000,3727480,438127480,False,9
4605,validator_34,505089808570,True,566000000,55113720,621113720,False,15
4606,validator_15,538295701778,True,715019996,28656900,743676896,True,16
4607,validator_48,316434286530,True,554000000,2098190,556098190,False,9
4608,validator_49,121869018250,True,551900000,3403160,555303160,False,3
4609,validator_34,505791661170,True,696200000,5652600,701852600,False,15
4610,validator_7,128112181330,True,861019997,6770900,867790897,True,4
4611,validator_48,317097149570,True,656300000,6563040,662863040,False,9
4612,validator_46,184179317970,True,565200000,18157660,583357660,False,5
4613,validator_44,177103809650,True,680300000,1186500,681486500,False,5
4614,validator_47,116522561670,True,457700000,4508800,462208800,False,3
4615,validator_47,117034148690,True,510000000,1587020,511587020,False,3
4616,validator_31,305687302170,True,630100000,2761040,632861040,False,9
4617,validator_10,62344104547,True,657940001,26293910,684233911,True,1
4618,validator_41,119019119490,True,563700000,5509280,569209280,False,3
4619,validator_43,115867896620,True,368450000,3693760,372143760,False,3
4620,validator_17,335379693529,True,953040003,12946800,965986803,True,10
4621,validator_12,196073165247,True,554100000,21945000,576045000,True,6
4622,validator_12,196839913879,True,757919992,8828640,766748632,True,6
4623,validator_44,177594157770,True,465600000,24748120,490348120,False,5
4624,validator_28,58400966280,True,462600000,10782380,473382380,False,1
4625,validator_17,336018874650,True,617980001,21201120,639181121,True,10
4626,validator_16,61601214724,True,504559998,29530090,534090088,True,1
4627,validator_48,317828333070,True,712400000,18783500,731183500,False,9
4628,validator_34,506301809400,True,499500000,10648230,510148230,False,15
4629,validator_22,127442267256,True,727319999,20183250,747503249,True,3
4630,validator_46,184923588690,True,742900000,1370720,744270720,False,5
4631,validator_5,124129228393,True,631457998,34523390,665981388,True,3
4632,validator_31,306175336970,True,486300000,1734800,488034800,False,9
4633,validator_12,197522332581,True,659440002,22978700,682418702,True,6
4634,validator_35,158997144720,True,673100000,5425120,678525120,False,4
4635,validator_47,117728197350,True,690500000,3548660,694048660,False,3
4636,validator_31,306848088500,True,665800000,6951530,672751530,False,9
4637,validator_21,120443216450,True,592763996,9482420,602246416,True,3
4638,validator_37,122578530260,True,588800000,2193520,590993520,False,3
4639,validator_34,506899860810,True,590900000,7151410,598051410,False,15
4640,validator_3,58884327166,True,754360000,16531740,770891740,True,1
4641,validator_49,122450033750,True,542000000,39015500,581015500,False,3
4642,validator_46,185493744530,True,567300000,2855840,570155840,False,5
4643,validator_47,118251330700,True,521000000,2133350,523133350,False,3
4644,validator_14,214388045833,True,721399998,1281840,722681838,True,6
4645,validator_36,178392612730,True,393700000,2821840,396521840,False,5
4646,validator_14,214862615841,True,460620008,13950000,474570008,True,6
4647,validator_25,59597527040,True,623500000,21601200,645101200,False,1
4648,validator_26,56295696010,True,575800000,19381080,595181080,False,1
4649,validator_40,57038997670,True,605400000,825300,606225300,False,1
4650,validator_2,54892325612,True,551439994,20187990,571627984,True,1
4651,validator_15,539013905858,True,681200010,37004070,718204080,True,16
4652,validator_22,128194027010,True,740140004,11619750,751759754,True,4
4653,validator_43,116548188490,True,670500000,9791870,680291870,False,3
4654,validator_21,121127853446,True,674719996,9917000,684636996,True,3
4655,validator_49,122968028060,True,516200000,1794310,517994310,False,3
4656,validator_15,539543464759,True,528300001,1258900,529558901,True,16
4657,validator_34,507608470690,True,683600000,25009880,708609880,False,15
4658,validator_17,336714550747,True,682139997,13536100,695676097,True,10
4659,validator_48,318417266210,True,560900000,28033140,588933140,False,9
4660,validator_35,159543436870,True,543000000,3292150,546292150,False,4
4661,validator_17,337391272244,True,667999997,8721500,676721497,True,10
4662,validator_17,338210633186,True,808640002,10720940,819360942,True,10
4663,validator_1,130588841545,True,788440000,25895900,814335900,True,4
4664,validator_46,185997164930,True,502400000,1020400,503420400,False,5
4665,validator_48,319256961630,True,835200000,4495420,839695420,False,9
4666,validator_47,118979013990,True,702300000,25383290,727683290,False,3
4667,validator_40,57554245050,True,514240000,1007380,515247380,False,1
4668,validator_38,55674406240,True,717400000,3230880,720630880,False,1
4669,validator_39,56128914400,True,498600000,20454410,519054410,False,1
4670,validator_14,215367588426,True,473129995,31842590,504972585,True,6
4671,validator_37,123136645870,True,555900000,2215610,558115610,False,3
4672,validator_47,119536448490,True,556500000,934500,557434500,False,3
4673,validator_20,57334112516,True,774779998,17859410,792639408,True,1
4674,validator_7,129047845436,True,871240006,64424100,935664106,True,4
4675,validator_41,119458510020,True,438200000,1190530,439390530,False,3
4676,validator_30,111655313530,True,455800000,2789100,458589100,False,3
4677,validator_15,540227970988,True,615919999,68586230,684506229,True,16
4678,validator_44,178114610100,True,518900000,1552330,520452330,False,5
4679,validator_14,216221124111,True,832460005,21075680,853535685,True,6
4680,validator_34,508297798670,True,664900000,24427980,689327980,False,15
4681,validator_34,508937547170,True,638700000,1048500,639748500,False,15
4682,validator_10,63343245447,True,960120000,39020900,999140900,True,1
4683,validator_34,509562435190,True,603000000,21888020,624888020,False,15
4684,validator_32,52674020160,True,642900000,28755410,671655410,False,1
4685,validator_14,217205393009,True,957235998,27032900,984268898,True,6
4686,validator_14,217804223048,True,590639999,8190040,598830039,True,6
4687,validator_12,198184355426,True,655740005,6282840,662022845,True,6
4688,validator_27,175379571340,True,553500000,3691130,557191130,False,5
4689,validator_49,123604949360,True,626000000,10921300,636921300,False,3
4690,validator_31,307418293800,True,568700000,1505300,570205300,False,9
4691,validator_47,120210643320,True,653500000,20694830,674194830,False,3
4692,validator_5,124620948531,True,464299998,27420140,491720138,True,3
4693,validator_20,57949071755,True,607939999,7019240,614959239,True,1
4694,validator_17,338890184771,True,676900005,2651580,679551585,True,10
4695,validator_36,178808114120,True,408700000,6801390,415501390,False,5
4696,validator_37,123721632090,True,583200000,1786220,584986220,False,3
4697,validator_39,56786470100,True,654500000,3055700,657555700,False,1
4698,validator_21,121773330510,True,613460004,32017060,645477064,True,3
4699,validator_17,339567068299,True,637939998,38943530,676883528,True,10
4700,validator_15,541011689904,True,781900006,1818910,783718916,True,16
4701,validator_27,176153438420,True,771100000,2767080,773867080,False,5
4702,validator_21,122537493010,True,739820000,24342500,764162500,True,3
4703,validator_17,340132130117,True,563199998,1861820,565061818,True,10
4704,validator_25,60289278920,True,686900000,4851880,691751880,False,1
4705,validator_48,320105485360,True,842800000,5723730,848523730,False,10
4706,validator_18,200667712021,True,1045739999,74693620,1120433619,True,6
4707,validator_27,176830836420,True,674400000,2998000,677398000,False,5
4708,validator_23,53732551029,True,721020000,23585930,744605930,True,1
4709,validator_37,124422060030,True,696700000,3727940,700427940,False,3
4710,validator_18,201577261928,True,905500007,4049900,909549907,True,6
4711,validator_11,52320693830,True,791099998,21131470,812231468,True,1
4712,validator_31,308025403710,True,598700000,8409910,607109910,False,9
4713,validator_30,112369175830,True,676500000,37362300,713862300,False,3
4714,validator_23,54598365996,True,828499997,37314970,865814967,True,1
4715,validator_15,541536605274,True,521820000,3095370,524915370,True,16
4716,validator_40,58152144990,True,548600000,49299940,597899940,False,1
4717,validator_15,542497685857,True,958900003,2180580,961080583,True,16
4718,validator_24,63234390414,True,533820000,28714900,562534900,True,1
4719,validator_48,320613322050,True,505800000,2036690,507836690,False,10
4720,validator_48,321256252150,True,641000000,1930100,642930100,False,10
4721,validator_5,125203788008,True,573939997,8899480,582839477,True,3
4722,validator_15,543131549961,True,612666004,21198100,633864104,True,16
4723,validator_10,63928921052,True,562040005,23635600,585675605,True,1
4724,validator_17,340851795666,True,674595999,45069550,719665549,True,10
4725,validator_48,321940575750,True,672600000,11723600,684323600,False,10
4726,validator_30,112879252130,True,507600000,2476300,510076300,False,3
4727,validator_31,308655147580,True,617800000,11943870,629743870,False,9
4728,validator_22,128730940396,True,529499996,7413390,536913386,True,4
4729,validator_30,113618530770,True,737700000,1578640,739278640,False,3
4730,validator_31,309302835940,True,647000000,688360,647688360,False,9
4731,validator_31,309962562040,True,645500000,14226100,659726100,False,9
4732,validator_29,51321984850,True,551800000,11924700,563724700,False,1
4733,validator_44,178922168220,True,779600000,27958120,807558120,False,5
4734,validator_36,179401775200,True,585100000,8561080,593661080,False,5
4735,validator_15,543885250659,True,716039998,37660700,753700698,True,16
4736,validator_22,129337597418,True,583980002,22677020,606657022,True,4
4737,validator_30,114047834610,True,413590000,15713840,429303840,False,3
4738,validator_23,55274237053,True,663999997,11871060,675871057,True,1
4739,validator_26,57033135700,True,728100000,9339690,737439690,False,1
4740,validator_46,186769969360,True,762000000,10804430,772804430,False,5
4741,validator_15,544791147058,True,901699999,4196400,905896399,True,17
4742,validator_34,510255915670,True,686800000,6680480,693480480,False,15
4743,validator_35,160274192310,True,709100000,21655440,730755440,False,5
4744,validator_15,545678761313,True,867999995,19614260,887614255,True,17
4745,validator_46,187286552890,True,514500000,2083530,516583530,False,5
4746,validator_31,310665711330,True,700800000,2349290,703149290,False,9
4747,validator_30,114772428730,True,705100000,19494120,724594120,False,3
4748,validator_20,58591201040,True,637479995,4649290,642129285,True,1
4749,validator_19,121094065656,True,814460001,14113070,828573071,True,3
4750,validator_48,322622966470,True,662400000,19990720,682390720,False,10
4751,validator_18,202300473590,True,708000002,15211660,723211662,True,6
4752,validator_48,323253476510,True,629200000,1310040,630510040,False,10
4753,validator_12,198935946165,True,733639999,17950740,751590739,True,6
4754,validator_17,341492055534,True,619319998,20939870,640259868,True,10
4755,validator_46,188053996530,True,738800000,28643640,767443640,False,5
4756,validator_28,59058724980,True,656700000,1058700,657758700,False,1
4757,validator_15,546511694729,True,807119996,25813420,832933416,True,17
4758,validator_34,510979519240,True,722200000,1403570,723603570,False,15
4759,validator_34,511638991240,True,653500000,5972000,659472000,False,15
4760,validator_0,54187147315,True,688739997,27990920,716730917,True,1
4761,validator_33,55477744400,True,564200000,4188600,568388600,False,1
4762,validator_18,203184954167,True,863359997,21120580,884480577,True,6
4763,validator_28,59769735770,True,692000000,19010790,711010790,False,1
4764,validator_12,199545311202,True,588319997,21045040,609365037,True,6
4765,validator_16,62305674582,True,688400008,16059850,704459858,True,1
4766,validator_15,547106231995,True,591900006,2637260,594537266,True,17
4767,validator_29,51924004050,True,598700000,3319200,602019200,False,1
4768,validator_12,200210562244,True,650140002,15111040,665251042,True,6
4769,validator_38,56359137070,True,683100000,1630830,684730830,False,1
4770,validator_7,129798169643,True,707680007,42644200,750324207,True,4
4771,validator_21,123189040605,True,619359995,32187600,651547595,True,3
4772,validator_10,64522821725,True,583119993,10780680,593900673,True,2
4773,validator_49,124109445100,True,485300000,19195740,504495740,False,3
4774,validator_14,218434238831,True,622659993,7355790,630015783,True,6
4775,validator_40,58834519500,True,663500000,18874510,682374510,False,1
4776,validator_12,200909488924,True,643666000,55260680,698926680,True,6
4777,validator_40,59535663600,True,674700000,26444100,701144100,False,1
4778,validator_7,130552497164,True,749800001,4527520,754327521,True,4
4779,validator_1,131232410937,True,614999992,28569400,643569392,True,4
4780,validator_12,201320716464,True,372537990,38689550,411227540,True,6
4781,validator_14,219032356078,True,584959997,13157250,598117247,True,6
4782,validator_41,120067754120,True,605600000,3644100,609244100,False,3
4783,validator_34,512222092310,True,571000000,12101070,583101070,False,16
4784,validator_27,177366730120,True,498600000,37293700,535893700,False,5
4785,validator_1,132099794113,True,851139996,16243180,867383176,True,4
4786,validator_18,203675045158,True,468964001,21126990,490090991,True,6
4787,validator_31,311329348250,True,663040000,596920,663636920,False,9
4788,validator_28,60323580400,True,550200000,3644630,553844630,False,1
4789,validator_34,512876193380,True,651400000,2701070,654101070,False,16
4790,validator_22,130111906724,True,762240006,12069300,774309306,True,4
4791,validator_21,123846594762,True,655199997,2354160,657554157,True,3
4792,validator_46,188612407090,True,550300000,8110560,558410560,False,5
4793,validator_35,160855461700,True,577000000,4269390,581269390,False,5
4794,validator_12,202031585765,True,691040001,19829300,710869301,True,6
4795,validator_44,179557735200,True,633100000,2466980,635566980,False,5
4796,validator_15,547826064453,True,717439998,2392460,719832458,True,17
4797,validator_5,125857601950,True,650599992,3213950,653813942,True,3
4798,validator_31,311971994950,True,634000000,8646700,642646700,False,9
4799,validator_15,548650723440,True,753079997,71578990,824658987,True,17
4800,validator_48,323961916060,True,706500000,1939550,708439550,False,10
4801,validator_1,132810752538,True,672966005,37992420,710958425,True,4
4802,validator_48,324528937670,True,533300000,33721610,567021610,False,10
4803,validator_3,59793063583,True,889379997,19356420,908736417,True,1
4804,validator_43,116971402840,True,418750000,4464350,423214350,False,3
4805,validator_43,117502089000,True,519800000,10886160,530686160,False,3
4806,validator_27,177918619640,True,549900000,1989520,551889520,False,5
4807,validator_48,325170873900,True,640200000,1736230,641936230,False,10
4808,validator_34,513550264390,True,672000000,2071010,674071010,False,16
4809,validator_18,204504577442,True,818240004,11292280,829532284,True,6
4810,validator_21,124579280964,True,697940002,34746200,732686202,True,3
4811,validator_14,219591073148,True,550600000,8117070,558717070,True,6
4812,validator_21,125259383484,True,675800000,4302520,680102520,True,3
4813,validator_17,342341167332,True,844499998,4611800,849111798,True,10
4814,validator_14,220435510554,True,842299996,2137410,844437406,True,6
4815,validator_44,180325919220,True,765700000,2484020,768184020,False,5
4816,validator_34,513992527030,True,421700000,20562640,442262640,False,16
4817,validator_22,131065809360,True,932368006,21534630,953902636,True,4
4818,validator_15,549283079840,True,626520000,5836400,632356400,True,17
4819,validator_27,178616736290,True,691500000,6616650,698116650,False,5
4820,validator_48,325897824880,True,720100000,6850980,726950980,False,10
4821,validator_49,124745015300,True,629300000,6270200,635570200,False,3
4822,validator_15,549983592775,True,674779995,25732940,700512935,True,17
4823,validator_35,161559248880,True,660400000,43387180,703787180,False,5
4824,validator_13,59191079148,True,631020006,23861440,654881446,True,1
4825,validator_36,179983591730,True,580980000,836530,581816530,False,5
4826,validator_34,514571605750,True,559100000,19978720,579078720,False,16
4827,validator_15,550859857887,True,850200002,26065110,876265112,True,17
4828,validator_15,551645127988,True,702526001,82744100,785270101,True,17
4829,validator_18,205073692743,True,558316001,10799300,569115301,True,6
4830,validator_7,131237459797,True,671900003,13062630,684962633,True,4
4831,validator_34,515183114180,True,610000000,1508430,611508430,False,16
4832,validator_14,221145171478,True,703210004,6450920,709660924,True,6
4833,validator_5,126617084354,True,733200004,26282400,759482404,True,3
4834,validator_48,326628832400,True,724000000,7007520,731007520,False,10
4835,validator_21,126140507583,True,851439999,29684100,881124099,True,3
4836,validator_48,327195825260,True,559700000,7292860,566992860,False,10
4837,validator_34,515849993380,True,665100000,1779200,666879200,False,16
4838,validator_15,552197360595,True,544364007,7868600,552232607,True,17
4839,validator_6,59697476182,True,747100011,19981520,767081531,True,1
4840,validator_15,552824330683,True,609199998,17770090,626970088,True,17
4841,validator_30,115310951610,True,527700000,10822880,538522880,False,3
4842,validator_25,60808672000,True,510400000,8993080,519393080,False,1
4843,validator_40,60346858600,True,806000000,5195000,811195000,False,1
4844,validator_34,516427786120,True,572200000,5592740,577792740,False,16
4845,validator_12,202741850493,True,699619998,10644730,710264728,True,6
4846,validator_17,342988085507,True,630840005,16078170,646918175,True,10
4847,validator_34,517118157760,True,686000000,4371640,690371640,False,16
4848,validator_31,312521295650,True,546800000,2500700,549300700,False,9
4849,validator_0,55152493949,True,949739994,15606640,965346634,True,1
4850,validator_15,553568037667,True,735440004,8266980,743706984,True,17
4851,validator_15,554235363147,True,660100000,7225480,667325480,True,17
4852,validator_39,57339804200,True,547100000,6234100,553334100,False,1
4853,validator_49,125408947140,True,662500000,1431840,663931840,False,3
4854,validator_18,205723020876,True,622214003,27114130,649328133,True,6
4855,validator_34,517585850720,True,463200000,4492960,467692960,False,16
4856,validator_14,221869729352,True,704600004,19957870,724557874,True,6
4857,validator_36,180459284370,True,470660000,5032640,475692640,False,5
4858,validator_21,126742780224,True,555620001,46652640,602272641,True,3
4859,validator_43,118008946840,True,504200000,2657840,506857840,False,3
4860,validator_18,206595247361,True,815919995,56306490,872226485,True,6
4861,validator_49,126010725730,True,581700000,20078590,601778590,False,3
4862,validator_1,133404258916,True,569319998,24186380,593506378,True,4
4863,validator_48,327764861690,True,568400000,636430,569036430,False,10
4864,validator_21,127453907949,True,704739995,6387730,711127725,True,3
4865,validator_15,554900992054,True,639003997,26624910,665628907,True,17
4866,validator_15,555488730097,True,568400003,19338040,587738043,True,17
4867,validator_48,328477638730,True,678600000,34177040,712777040,False,10
4868,validator_49,126656341320,True,643600000,2015590,645615590,False,3
4869,validator_41,120638890950,True,570000000,1136830,571136830,False,3
4870,validator_5,127108589029,True,471939995,19564680,491504675,True,3
4871,validator_49,127210534230,True,547700000,6492910,554192910,False,3
4872,validator_34,518273089170,True,684000000,3238450,687238450,False,16
4873,validator_12,203412835363,True,641260000,29724870,670984870,True,6
4874,validator_46,189304826480,True,691400000,1019390,692419390,False,5
4875,validator_10,65312818792,True,773439997,16557070,789997067,True,2
4876,validator_42,51843113940,True,634300000,1013200,635313200,False,1
4877,validator_44,181034265420,True,704500000,3846200,708346200,False,5
4878,validator_17,343771807837,True,746680000,37042330,783722330,True,10
4879,validator_18,207253286364,True,640940003,17099000,658039003,True,6
4880,validator_49,127719792070,True,506800000,2457840,509257840,False,3
4881,validator_22,131579405071,True,490140001,23455710,513595711,True,4
4882,validator_31,312915145470,True,386100000,7749820,393849820,False,9
4883,validator_33,56153370370,True,672800000,2825970,675625970,False,1
4884,validator_19,121743522393,True,646199997,3256740,649456737,True,3
4885,validator_14,222445621589,True,565746007,10146230,575892237,True,6
4886,validator_6,60300444644,True,601140002,1828460,602968462,True,1
4887,validator_44,181492383030,True,438200000,19917610,458117610,False,5
4888,validator_40,60871019600,True,521600000,2561000,524161000,False,1
4889,validator_31,313482770800,True,558400000,9225330,567625330,False,9
4890,validator_5,127726556052,True,611200003,6767020,617967023,True,3
4891,validator_31,314037256630,True,551700000,2785830,554485830,False,9
4892,validator_31,314726718370,True,670400000,19061740,689461740,False,9
4893,validator_18,207985976652,True,705419998,27270290,732690288,True,6
4894,validator_31,315297251920,True,545100000,25433550,570533550,False,9
4895,validator_22,132072489472,True,490099991,2984410,493084401,True,4
4896,validator_46,189936995980,True,625500000,6669500,632169500,False,5
4897,validator_15,556189653269,True,689840002,11083170,700923172,True,17
4898,validator_1,134200218315,True,784699999,11259400,795959399,True,4
4899,validator_10,66158839298,True,836920006,9100500,846020506,True,2
4900,validator_27,179295357190,True,664600000,14020900,678620900,False,5
4901,validator_34,518773402190,True,468600000,31713020,500313020,False,16
4902,validator_14,223271916403,True,825199994,1094820,826294814,True,6
4903,validator_30,115760998310,True,447200000,2846700,450046700,False,3
4904,validator_36,181073242810,True,587200000,26758440,613958440,False,5
4905,validator_34,519275070100,True,498900000,2767910,501667910,False,16
4906,validator_17,344145815333,True,362079996,11927500,374007496,True,10
4907,validator_15,556810195727,True,580605998,39936460,620542458,True,17
4908,validator_38,56916064900,True,553700000,3227830,556927830,False,1
4909,validator_44,182004166400,True,507300000,4483370,511783370,False,5
4910,validator_22,133272540874,True,1175874002,24177400,1200051402,True,4
4911,validator_15,557421006408,True,594600001,16210680,610810681,True,17
4912,validator_41,121222354510,True,581500000,1963560,583463560,False,3
4913,validator_22,133942369456,True,659864002,9964580,669828582,True,4
4914,validator_41,121772128350,True,546900000,2873840,549773840,False,3
4915,validator_17,344814706741,True,654920008,13971400,668891408,True,10
4916,validator_45,56377917340,True,698600000,5975610,704575610,False,1
4917,validator_14,224131008707,True,857000004,2092300,859092304,True,7
4918,validator_16,62709969587,True,377280005,27015000,404295005,True,1
4919,validator_25,61281886000,True,463500000,9714000,473214000,False,1
4920,validator_18,208670838917,True,678346005,6516260,684862265,True,6
4921,validator_47,120868795790,True,651800000,6352470,658152470,False,3
4922,validator_27,179892852080,True,553500000,43994890,597494890,False,5
4923,validator_19,122419457495,True,656300002,19635100,675935102,True,3
4924,validator_30,116165965270,True,404000000,966960,404966960,False,3
4925,validator_20,59347104143,True,724060003,31843100,755903103,True,1
4926,validator_34,519988743060,True,709900000,3772960,713672960,False,16
4927,validator_34,520622818670,True,630600000,3475610,634075610,False,16
4928,validator_47,121434199430,True,564400000,1003640,565403640,False,3
4929,validator_34,521272188010,True,608400000,40969340,649369340,False,16
4930,validator_48,329005556670,True,518700000,9217940,527917940,False,10
4931,validator_7,132158452238,True,917600001,3392440,920992441,True,4
4932,validator_1,134840035815,True,630600000,9217500,639817500,True,4
4933,validator_48,329549029120,True,528100000,15372450,543472450,False,10
4934,validator_6,61162656505,True,802620001,59591860,862211861,True,1
4935,validator_33,56845724560,True,685300000,7054190,692354190,False,1
4936,validator_46,190631100490,True,691300000,2804510,694104510,False,5
4937,validator_36,181682981130,True,604500000,5238320,609738320,False,5
4938,validator_15,558043751403,True,597319995,25425000,622744995,True,17
4939,validator_17,345685201573,True,867200002,3294830,870494832,True,10
4940,validator_15,558631713980,True,559219997,28742580,587962577,True,17
4941,validator_18,209305236430,True,631199993,3197520,634397513,True,6
4942,validator_17,346272933199,True,561105996,26625630,587731626,True,10
4943,validator_49,128413994670,True,691600000,2602600,694202600,False,4
4944,validator_5,128417656827,True,670145995,20954780,691100775,True,4
4945,validator_31,316064523950,True,757500000,9772030,767272030,False,9
4946,validator_46,191245553910,True,593100000,21353420,614453420,False,5
4947,validator_36,182543000590,True,856300000,3719460,860019460,False,5
4948,validator_48,330166839560,True,614200000,3610440,617810440,False,10
4949,validator_1,135425574935,True,575360000,10179120,585539120,True,4
4950,validator_44,182863267310,True,848200000,10900910,859100910,False,5
4951,validator_49,128981719830,True,564800000,2925160,567725160,False,4
4952,validator_19,123003793607,True,583400002,936110,584336112,True,3
4953,validator_14,224679886801,True,540659994,8218100,548878094,True,7
4954,validator_17,346965348587,True,648299988,44115400,692415388,True,10
4955,validator_5,129031114625,True,606099998,7357800,613457798,True,4
4956,validator_27,180576950530,True,680900000,3198450,684098450,False,5
4957,validator_39,57828949300,True,478100000,11045100,489145100,False,1
4958,validator_15,559554652936,True,919999996,2938960,922938956,True,17
4959,validator_31,316613907150,True,546700000,2683200,549383200,False,9
4960,validator_22,134764822970,True,807959994,14493520,822453514,True,4
4961,validator_15,560163588715,True,563317999,45617780,608935779,True,17
4962,validator_40,61577449080,True,699800000,6629480,706429480,False,1
4963,validator_44,183295216710,True,429600000,2349400,431949400,False,5
4964,validator_34,521868320410,True,586000000,10132400,596132400,False,16
4965,validator_19,123636027929,True,607800002,24434320,632234322,True,3
4966,validator_48,330540068290,True,367660000,5568730,373228730,False,10
4967,validator_19,124274067931,True,613600002,24440000,638040002,True,3
4968,validator_15,560693765584,True,525999999,4176870,530176869,True,17
4969,validator_31,317184722280,True,562100000,8715130,570815130,False,9
4970,validator_34,522496473980,True,607100000,21053570,628153570,False,16
4971,validator_34,523020468960,True,522900000,1094980,523994980,False,16
4972,validator_6,62032294907,True,868400002,1238400,869638402,True,1
4973,validator_22,135431389341,True,613660001,52906370,666566371,True,4
4974,validator_5,129723715829,True,679760004,12841200,692601204,True,4
4975,validator_49,129502296610,True,519100000,1476780,520576780,False,4
4976,validator_0,55956110279,True,782114000,21502330,803616330,True,1
4977,validator_15,561360861185,True,642340001,24755600,667095601,True,17
4978,validator_48,331114702410,True,553500000,21134120,574634120,False,10
4979,validator_17,347597734467,True,622399990,9985890,632385880,True,10
4980,validator_15,561878944647,True,490840002,27243460,518083462,True,17
4981,validator_49,130204758580,True,698500000,3961970,702461970,False,4
4982,validator_17,348500128198,True,896600001,5793730,902393731,True,10
4983,validator_44,183916985520,True,615200000,6568810,621768810,False,5
4984,validator_36,183161025930,True,611800000,6225340,618025340,False,5
4985,validator_34,523742817260,True,697900000,24448300,722348300,False,16
4986,validator_49,130763473320,True,551500000,7214740,558714740,False,4
4987,validator_1,136020644237,True,566120002,28949300,595069302,True,4
4988,validator_25,61894669000,True,609900000,2883000,612783000,False,1
4989,validator_34,524286654690,True,542300000,1537430,543837430,False,16
4990,validator_15,562548651048,True,620280001,49426400,669706401,True,17
4991,validator_17,348905926697,True,394057999,11740500,405798499,True,10
4992,validator_17,349633835724,True,726599997,1309030,727909027,True,10
4993,validator_44,184373324750,True,432620000,23719230,456339230,False,5
4994,validator_5,130398225818,True,635099999,39409990,674509989,True,4
4995,validator_15,563258979769,True,681580001,28748720,710328721,True,17
4996,validator_33,57602160950,True,735700000,20736390,756436390,False,1
4997,validator_46,192157494690,True,910200000,1740780,911940780,False,6
4998,validator_1,136719438880,True,652920003,45874640,698794643,True,4
4999,validator_47,121928658170,True,474200000,20258740,494458740,False,3
5000,validator_21,128276588380,True,816020011,6660420,822680431,True,4
5001,validator_15,563926651364,True,657460005,10211590,667671595,True,17
5002,validator_47,122443536570,True,512100000,2778400,514878400,False,3
5003,validator_49,131211170890,True,441700000,5997570,447697570,False,4
5004,validator_15,564783524834,True,846170000,10703470,856873470,True,17
5005,validator_34,524751207390,True,455500000,9052700,464552700,False,16
5006,validator_48,331631164120,True,497400000,19061710,516461710,False,10
5007,validator_34,525597636800,True,822500000,23929410,846429410,False,16
5008,validator_48,332220562820,True,586800000,2598700,589398700,False,10
5009,validator_49,131722301630,True,503900000,7230740,511130740,False,4
5010,validator_7,132867663967,True,664637999,44573730,709211729,True,4
5011,validator_46,192678104230,True,519400000,1209540,520609540,False,6
5012,validator_21,128950202045,True,663799995,9813670,673613665,True,4
5013,validator_31,318020241780,True,828900000,6619500,835519500,False,9
5014,validator_25,62516153950,True,609100000,12384950,621484950,False,1
5015,validator_42,52604096130,True,747300000,13682190,760982190,False,1
5016,validator_2,55835033111,True,899119999,43587500,942707499,True,1
5017,validator_46,193269791330,True,582000000,9687100,591687100,False,6
5018,validator_15,565413960928,True,603669994,26766100,630436094,True,17
5019,validator_43,118782031280,True,771700000,1384440,773084440,False,3
5020,validator_17,350213253525,True,576200001,3217800,579417801,True,10
5021,validator_21,129464906749,True,503060004,11644700,514704704,True,4
5022,validator_12,203972998490,True,542139997,18023130,560163127,True,6
5023,validator_3,60460121378,True,658620005,8437790,667057795,True,1
5024,validator_35,162164217490,True,603200000,1768610,604968610,False,5
5025,validator_34,526225952990,True,626000000,2316190,628316190,False,16
5026,validator_23,56202074076,True,876780003,51057020,927837023,True,1
5027,validator_46,193800349620,True,528000000,2558290,530558290,False,6
5028,validator_34,526707809490,True,465500000,16356500,481856500,False,16
5029,validator_31,318516581720,True,494900000,1439940,496339940,False,9
5030,validator_14,225653083047,True,936996006,36200240,973196246,True,7
5031,validator_10,66914288981,True,708520003,46929680,755449683,True,2
5032,validator_44,184871540150,True,471600000,26615400,498215400,False,5
5033,validator_1,137358797901,True,620460001,18899020,639359021,True,4
5034,validator_42,53518081520,True,894300000,19685390,913985390,False,1
5035,validator_27,181131976390,True,529600000,25425860,555025860,False,5
5036,validator_36,183627555860,True,464400000,2129930,466529930,False,5
5037,validator_37,124999965670,True,576300000,1605640,577905640,False,3
5038,validator_25,63166794250,True,647900000,2740300,650640300,False,1
5039,validator_7,133712330096,True,824043999,20622130,844666129,True,4
5040,validator_48,332947853870,True,726000000,1291050,727291050,False,10
5041,validator_12,204464604188,True,452299998,39305700,491605698,True,6
5042,validator_27,181575666930,True,435900000,7790540,443690540,False,5
5043,validator_17,350867420417,True,638460002,15706890,654166892,True,10
5044,validator_1,138195950804,True,833600003,3552900,837152903,True,4
5045,validator_31,319009388440,True,468570000,24236720,492806720,False,9
5046,validator_25,63715948600,True,529300000,19854350,549154350,False,1
5047,validator_24,63849248927,True,601939993,12918520,614858513,True,1
5048,validator_28,60908747600,True,578800000,6367200,585167200,False,1
5049,validator_17,351550097889,True,681400002,1277470,682677472,True,10
5050,validator_49,132337122760,True,604000000,10821130,614821130,False,4
5051,validator_30,116550671930,True,373100000,11606660,384706660,False,3
5052,validator_34,527337084840,True,625900000,3375350,629275350,False,16
5053,validator_34,527940503970,True,601400000,2019130,603419130,False,16
5054,validator_20,60174153852,True,769460009,57589700,827049709,True,1
5055,validator_30,117246530830,True,693400000,2458900,695858900,False,3
5056,validator_46,194401238180,True,591700000,9188560,600888560,False,6
5057,validator_34,528494094850,True,532800000,20790880,553590880,False,16
5058,validator_37,125749629420,True,740500000,9163750,749663750,False,3
5059,validator_10,67384282980,True,432979999,37014000,469993999,True,2
5060,validator_37,126438167680,True,686000000,2538260,688538260,False,3
5061,validator_37,126923520690,True,475300000,10053010,485353010,False,3
5062,validator_34,529168895720,True,668200000,6600870,674800870,False,16
5063,validator_33,58204731710,True,600800000,1770760,602570760,False,1
5064,validator_7,134315882694,True,592923998,10628600,603552598,True,4
5065,validator_22,136328858665,True,887820004,9649320,897469324,True,4
5066,validator_39,58454998370,True,623500000,2549070,626049070,False,1
5067,validator_19,125104774230,True,812473999,18232300,830706299,True,3
5068,validator_12,205259536092,True,768058004,26873900,794931904,True,6
5069,validator_17,352120917696,True,546240007,24579800,570819807,True,11
5070,validator_21,130047286741,True,537040002,45339990,582379992,True,4
5071,validator_14,226368309751,True,700220004,15006700,715226704,True,7
5072,validator_15,566038698152,True,586999994,37737230,624737224,True,17
5073,validator_48,333560498400,True,602300000,10344530,612644530,False,10
5074,validator_44,185401207340,True,527400000,2267190,529667190,False,5
5075,validator_36,184225879860,True,597000000,1324000,598324000,False,5
5076,validator_35,162775984530,True,602000000,9767040,611767040,False,5
5077,validator_10,68098547988,True,704599998,9665010,714265008,True,2
5078,validator_20,60849310198,True,671740006,3416340,675156346,True,1
5079,validator_7,134927901824,True,590608000,21411130,612019130,True,4
5080,validator_48,334064790380,True,501500000,2791980,504291980,False,10
5081,validator_7,135731675473,True,799700009,4073640,803773649,True,4
5082,validator_34,529988243720,True,818200000,1148000,819348000,False,16
5083,validator_48,334677090460,True,593600000,18700080,612300080,False,10
5084,validator_7,136428861301,True,664489998,32695830,697185828,True,4
5085,validator_17,352632476860,True,488200004,23359160,511559164,True,11
5086,validator_34,530594354700,True,596600000,9510980,606110980,False,16
5087,validator_34,531196512610,True,595300000,6857910,602157910,False,16
5088,validator_34,531730300270,True,531400000,2387660,533787660,False,16
5089,validator_15,566951896139,True,891379997,21817990,913197987,True,17
5090,validator_40,62114618060,True,535000000,2168980,537168980,False,1
5091,validator_27,182034026330,True,433900000,24459400,458359400,False,5
5092,validator_48,335277208460,True,580000000,20118000,600118000,False,10
5093,validator_34,532484953420,True,752600000,2053150,754653150,False,16
5094,validator_48,335933798180,True,647600000,8989720,656589720,False,10
5095,validator_36,184716517060,True,476800000,13837200,490637200,False,5
5096,validator_15,567663169476,True,687259997,24013340,711273337,True,17
5097,validator_27,182541280350,True,501500000,5754020,507254020,False,5
5098,validator_13,59827564546,True,631799998,4685400,636485398,True,1
5099,validator_48,336550712070,True,607900000,9013890,616913890,False,10
5100,validator_15,568517499133,True,843839997,10489660,854329657,True,17
5101,validator_27,183096727970,True,553400000,2047620,555447620,False,5
5102,validator_48,337101805830,True,548900000,2193760,551093760,False,10
5103,validator_5,131150710195,True,715219997,37264380,752484377,True,4
5104,validator_46,195009360140,True,605200000,2921960,608121960,False,6
5105,validator_48,337488193730,True,384800000,1587900,386387900,False,10
5106,validator_48,338089046460,True,599300000,1552730,600852730,False,10
5107,validator_34,533130418310,True,626700000,18764890,645464890,False,16
5108,validator_4,52542524374,True,673319994,40737010,714057004,True,1
5109,validator_17,353307854543,True,658560003,16817680,675377683,True,11
5110,validator_44,185868671080,True,463800000,3663740,467463740,False,5
5111,validator_7,137087836539,True,614659998,44315240,658975238,True,4
5112,validator_22,136973227487,True,608520002,35848820,644368822,True,4
5113,validator_12,206062917598,True,764620006,38761500,803381506,True,6
5114,validator_34,533630121010,True,497600000,2102700,499702700,False,16
5115,validator_18,210145924117,True,825160007,15527680,840687687,True,6
5116,validator_21,130730929787,True,666380006,17263040,683643046,True,4
5117,validator_17,354267848947,True,926085994,33908410,959994404,True,11
5118,validator_5,131854779280,True,682339995,21729090,704069085,True,4
5119,validator_15,569094311729,True,529579996,47232600,576812596,True,17
5120,validator_31,319719228240,True,697000000,12839800,709839800,False,9
5121,validator_41,122502523170,True,727600000,2794820,730394820,False,3
5122,validator_41,123087299530,True,582200000,2576360,584776360,False,3
5123,validator_44,186498273660,True,626600000,3002580,629602580,False,5
5124,validator_0,56607124533,True,632480004,18534250,651014254,True,1
5125,validator_46,195620421590,True,609700000,1361450,611061450,False,6
5126,validator_46,196136368800,True,514100000,1847210,515947210,False,6
5127,validator_31,320312385860,True,582800000,10357620,593157620,False,10
5128,validator_15,569881489334,True,758940005,28237600,787177605,True,17
5129,validator_31,320948432920,True,626000000,10047060,636047060,False,10
5130,validator_34,534385835800,True,735900000,19814790,755714790,False,16
5131,validator_46,196812108340,True,661300000,14439540,675739540,False,6
5132,validator_21,131482894122,True,748239995,3724340,751964335,True,4
5133,validator_15,570657421535,True,740100001,35832200,775932201,True,17
5134,validator_37,127556191180,True,630200000,2470490,632670490,False,3
5135,validator_14,227318225964,True,943499993,6416220,949916213,True,7
5136,validator_31,321346171640,True,391400000,6338720,397738720,False,10
5137,validator_47,122912260120,True,466900000,1823550,468723550,False,3
5138,validator_23,56917350752,True,691500006,23776670,715276676,True,1
5139,validator_41,123555422560,True,458100000,10023030,468123030,False,3
5140,validator_4,53260467359,True,693394005,24548980,717942985,True,1
5141,validator_14,228080549751,True,748680007,13643780,762323787,True,7
5142,validator_18,210650970499,True,467600002,37446380,505046382,True,6
5143,validator_13,60634508142,True,743113996,63829600,806943596,True,1
5144,validator_30,117849622750,True,600600000,2491920,603091920,False,3
5145,validator_31,322039284050,True,672200000,20912410,693112410,False,10
5146,validator_15,571304022646,True,635600001,11001110,646601111,True,17
5147,validator_8,57179455746,True,644500003,40771240,685271243,True,1
5148,validator_46,197561102880,True,746500000,2494540,748994540,False,6
5149,validator_1,138786890226,True,584619992,6319430,590939422,True,4
5150,validator_15,571709970882,True,379340006,26608230,405948236,True,17
5151,validator_15,572268768618,True,544860006,13937730,558797736,True,17
5152,validator_49,132946261050,True,597000000,12138290,609138290,False,4
5153,validator_44,187070523740,True,560500000,11750080,572250080,False,5
5154,validator_31,322502073620,True,461500000,1289570,462789570,False,10
5155,validator_31,323163080780,True,647200000,13807160,661007160,False,10
5156,validator_38,57458342300,True,520000000,22277400,542277400,False,1
5157,validator_17,354751637968,True,445034001,38755020,483789021,True,11
5158,validator_47,123381463860,True,442200000,27003740,469203740,False,3
5159,validator_15,572938584046,True,647836008,21979420,669815428,True,17
5160,validator_31,323633445530,True,460000000,10364750,470364750,False,10
5161,validator_18,211339768081,True,643160002,45637580,688797582,True,6
5162,validator_14,228820838946,True,723619995,16669200,740289195,True,7
5163,validator_41,123955025160,True,397000000,2602600,399602600,False,3
5164,validator_7,137767817820,True,671360001,8621280,679981281,True,4
5165,validator_12,206839033037,True,766819999,9295440,776115439,True,6
5166,validator_48,338789228790,True,671700000,28482330,700182330,False,10
5167,validator_35,163493303070,True,697300000,20018540,717318540,False,5
5168,validator_49,133713255270,True,764900000,2094220,766994220,False,4
5169,validator_47,123948144420,True,558100000,8580560,566680560,False,3
5170,validator_15,573655177444,True,695919998,20673400,716593398,True,17
5171,validator_49,134231421070,True,516400000,1765800,518165800,False,4
5172,validator_31,324261402360,True,626900000,1056830,627956830,False,10
5173,validator_27,183758000270,True,652400000,8872300,661272300,False,5
5174,validator_43,119587849340,True,790100000,15718060,805818060,False,3
5175,validator_18,212040994745,True,655620004,45606660,701226664,True,6
5176,validator_5,132433932850,True,573220000,5933570,579153570,True,4
5177,validator_14,229565646846,True,689780000,55027900,744807900,True,7
5178,validator_15,574380739042,True,705893998,19667600,725561598,True,17
5179,validator_34,535070886460,True,681400000,3650660,685050660,False,16
5180,validator_7,138455090623,True,648500003,38772800,687272803,True,4
5181,validator_17,355401672200,True,620830002,29204230,650034232,True,11
5182,validator_39,59018727320,True,556500000,7228950,563728950,False,1
5183,validator_34,535574073960,True,500600000,2587500,503187500,False,16
5184,validator_48,339174887090,True,383800000,1858300,385658300,False,10
5185,validator_17,356199911659,True,795199999,3039460,798239459,True,11
5186,validator_27,184477379040,True,716200000,3178770,719378770,False,5
5187,validator_23,57605621054,True,681640002,6630300,688270302,True,1
5188,validator_22,137611444121,True,631400004,6816630,638216634,True,4
5189,validator_47,124524117020,True,573100000,2872600,575972600,False,3
5190,validator_43,120283288250,True,692200000,3238910,695438910,False,3
5191,validator_20,61435906627,True,581119999,5476430,586596429,True,1
5192,validator_27,185151954560,True,672600000,1975520,674575520,False,5
5193,validator_15,575047576784,True,648658002,18179740,666837742,True,17
5194,validator_10,68746612617,True,640899999,7164630,648064629,True,2
5195,validator_34,536164933410,True,588200000,2659450,590859450,False,16
5196,validator_48,339820993830,True,643200000,2906740,646106740,False,10
5197,validator_16,63345169414,True,626340007,8859820,635199827,True,1
5198,validator_46,198280086320,True,717000000,1983440,718983440,False,6
5199,validator_31,324756336600,True,488500000,6434240,494934240,False,10
5200,validator_22,138399352027,True,784800006,3107900,787907906,True,4
5201,validator_19,125674796971,True,543440001,26582740,570022741,True,3
5202,validator_17,356770770336,True,560067997,10790680,570858677,True,11
5203,validator_34,536773631110,True,587000000,21697700,608697700,False,16
5204,validator_17,357511565813,True,729519997,11275480,740795477,True,11
5205,validator_21,132287561370,True,796339998,8327250,804667248,True,4
5206,validator_12,207465858651,True,599220004,27605610,626825614,True,6
5207,validator_49,134674830710,True,441400000,2009640,443409640,False,4
5208,validator_15,575709349284,True,659000000,2772500,661772500,True,17
5209,validator_19,126414283102,True,732800001,6686130,739486131,True,3
5210,validator_27,185827007140,True,671900000,3152580,675052580,False,5
5211,validator_0,57345779245,True,711946002,26708710,738654712,True,1
5212,validator_7,139150065400,True,684199997,10774780,694974777,True,4
5213,validator_25,64145870030,True,427400000,2521430,429921430,False,2
5214,validator_48,340628972590,True,788600000,19378760,807978760,False,10
5215,validator_15,576360543584,True,647800000,3394300,651194300,True,18
5216,validator_21,132979843689,True,691199999,1082320,692282319,True,4
5217,validator_48,341264337330,True,633800000,1564740,635364740,False,10
5218,validator_30,118590744160,True,738400000,2721410,741121410,False,3
5219,validator_47,125100940010,True,574300000,2522990,576822990,False,3
5220,validator_17,358211538547,True,678400004,21572730,699972734,True,11
5221,validator_43,120944933180,True,640900000,20744930,661644930,False,3
5222,validator_15,576956748043,True,558779999,37424460,596204459,True,18
5223,validator_15,577500227041,True,533599998,9879000,543478998,True,18
5224,validator_41,124457834860,True,500600000,2209700,502809700,False,3
5225,validator_34,537366892270,True,583700000,9561160,593261160,False,16
5226,validator_5,133458816994,True,1006140004,18744140,1024884144,True,4
5227,validator_34,537795542170,True,418100000,10549900,428649900,False,16
5228,validator_46,198887000730,True,587000000,19914410,606914410,False,6
5229,validator_1,139686460974,True,870800008,28770740,899570748,True,4
5230,validator_35,164127968060,True,624800000,9864990,634664990,False,5
5231,validator_44,187775186100,True,702500000,2162360,704662360,False,5
5232,validator_36,185339840070,True,619900000,3423010,623323010,False,5
5233,validator_16,63986412714,True,609900000,31343300,641243300,True,1
5234,validator_23,58345535361,True,728740007,11174300,739914307,True,1
5235,validator_49,135188883200,True,511800000,2252490,514052490,False,4
5236,validator_33,58977006710,True,761000000,11275000,772275000,False,1
5237,validator_48,341936820030,True,671200000,1282700,672482700,False,10
5238,validator_14,230279842426,True,712600010,1595570,714195580,True,7
5239,validator_47,125581017480,True,464400000,15677470,480077470,False,3
5240,validator_5,134155224195,True,646960001,49447200,696407201,True,4
5241,validator_1,140506942192,True,798339998,22141220,820481218,True,4
5242,validator_46,199443422910,True,554200000,2222180,556422180,False,6
5243,validator_20,62102040784,True,657799997,8334160,666134157,True,1
5244,validator_6,62780001131,True,726660004,21046220,747706224,True,1
5245,validator_14,230771704817,True,469540001,22322390,491862391,True,7
5246,validator_34,538295198930,True,493800000,5856760,499656760,False,16
5247,validator_12,208344576937,True,874740006,3978280,878718286,True,6
5248,validator_46,200006329010,True,556000000,6906100,562906100,False,6
5249,validator_44,188390833000,True,577800000,37846900,615646900,False,5
5250,validator_30,119374872440,True,765000000,19128280,784128280,False,3
5251,validator_31,325308687000,True,545500000,6850400,552350400,False,10
5252,validator_28,61556241640,True,645300000,2194040,647494040,False,1
5253,validator_0,57972480327,True,622700002,4001080,626701082,True,1
5254,validator_48,342550132610,True,607500000,5812580,613312580,False,10
5255,validator_41,125026886940,True,558500000,10552080,569052080,False,3
5256,validator_7,139770515996,True,613699996,6750600,620450596,True,4
5257,validator_46,200626472570,True,618500000,1643560,620143560,False,6
5258,validator_15,577989093412,True,487000001,1866370,488866371,True,18
5259,validator_27,186362266100,True,532600000,2658960,535258960,False,5
5260,validator_27,186940791380,True,575700000,2825280,578525280,False,5
5261,validator_48,343488647530,True,936600000,1914920,938514920,False,10
5262,validator_15,578706772951,True,671529999,46149540,717679539,True,18
5263,validator_2,56484013048,True,642300007,6679930,648979937,True,1
5264,validator_17,358846056189,True,619880002,14637640,634517642,True,11
5265,validator_34,538839577600,True,524000000,20378670,544378670,False,16
5266,validator_14,231576785347,True,790780000,14300530,805080530,True,7
5267,validator_10,69423640541,True,661440004,15587920,677027924,True,2
5268,validator_34,539387410210,True,546400000,1432610,547832610,False,16
5269,validator_48,344090394750,True,582800000,18947220,601747220,False,10
5270,validator_34,540100679800,True,705100000,8169590,713269590,False,16
5271,validator_15,579241903257,True,521360006,13770300,535130306,True,18
5272,validator_46,201104318760,True,457400000,20446190,477846190,False,6
5273,validator_49,135915122180,True,706000000,20238980,726238980,False,4
5274,validator_13,61331767702,True,690940000,6319560,697259560,True,1
5275,validator_18,212702557744,True,625979999,35583000,661562999,True,6
5276,validator_47,126248473880,True,657300000,10156400,667456400,False,3
5277,validator_12,208898999138,True,546000001,8422200,554422201,True,6
5278,validator_43,121580439560,True,624400000,11106380,635506380,False,3
5279,validator_38,58121102340,True,661400000,1360040,662760040,False,1
5280,validator_24,64667313984,True,811899997,6165060,818065057,True,2
5281,validator_21,133614492314,True,632499995,2148630,634648625,True,4
5282,validator_18,213360936227,True,656000003,2378480,658378483,True,6
5283,validator_34,540762644280,True,654600000,7364480,661964480,False,16
5284,validator_22,139091198044,True,683505997,8340020,691846017,True,4
5285,validator_21,134301677233,True,656279999,30904920,687184919,True,4
5286,validator_15,579682710339,True,433940002,6867080,440807082,True,18
5287,validator_49,136548868330,True,632500000,1246150,633746150,False,4
5288,validator_22,139690588640,True,579339996,20050600,599390596,True,4
5289,validator_37,128230264220,True,670900000,3173040,674073040,False,4
5290,validator_18,213853335328,True,467540001,24859100,492399101,True,6
5291,validator_46,201766153660,True,659700000,2134900,661834900,False,6
5292,validator_17,359663377385,True,783365996,33955200,817321196,True,11
5293,validator_4,53890459338,True,618739999,11251980,629991979,True,1
5294,validator_32,53354659210,True,671100000,9539050,680639050,False,1
5295,validator_41,125528221340,True,492900000,8434400,501334400,False,3
5296,validator_7,140501653778,True,707577992,23559790,731137782,True,4
5297,validator_32,54228459230,True,863400000,10400020,873800020,False,1
5298,validator_1,141189261425,True,644420003,37899230,682319233,True,4
5299,validator_19,127133015644,True,700400002,18332540,718732542,True,3
5300,validator_15,580271570069,True,545520000,43339730,588859730,True,18
5301,validator_7,141125295282,True,604780004,18861500,623641504,True,4
5302,validator_20,62771316186,True,648694002,20581400,669275402,True,1
5303,validator_37,128826751400,True,593200000,3287180,596487180,False,4
5304,validator_15,581096698485,True,819499996,5628420,825128416,True,18
5305,validator_17,360312217509,True,611387994,37452130,648840124,True,11
5306,validator_34,541425062280,True,659400000,3018000,662418000,False,16
5307,validator_17,361118195920,True,799040001,6938410,805978411,True,11
5308,validator_14,232271736347,True,666578000,28373000,694951000,True,7
5309,validator_25,64859491580,True,711400000,2221550,713621550,False,2
5310,validator_14,233252276480,True,951140003,29400130,980540133,True,7
5311,validator_22,140510789357,True,800869997,19330720,820200717,True,4
5312,validator_17,361966329250,True,821200000,26933330,848133330,True,11
5313,validator_15,581792933880,True,652739995,43495400,696235395,True,18
5314,validator_42,54055759420,True,511600000,26077900,537677900,False,1
5315,validator_41,126242303260,True,711000000,3081920,714081920,False,3
5316,validator_1,141835910501,True,637699996,8949080,646649076,True,4
5317,validator_34,542054038720,True,621800000,7176440,628976440,False,16
5318,validator_25,65314858240,True,446000000,9366660,455366660,False,2
5319,validator_44,188905451050,True,513710000,908050,514618050,False,5
5320,validator_17,362541961510,True,538936000,36696260,575632260,True,11
5321,validator_4,54491589263,True,582159995,18969930,601129925,True,1
5322,validator_21,135151852300,True,758479997,91695070,850175067,True,4
5323,validator_34,542538487310,True,474200000,10248590,484448590,False,16
5324,validator_48,344584442930,True,491700000,2348180,494048180,False,10
5325,validator_34,543057226570,True,507200000,11539260,518739260,False,16
5326,validator_14,234063201201,True,801800001,9124720,810924721,True,7
5327,validator_34,543765521890,True,704900000,3395320,708295320,False,16
5328,validator_27,187613227260,True,664500000,7935880,672435880,False,5
5329,validator_41,126822423990,True,574200000,5920730,580120730,False,3
5330,validator_41,127454236050,True,630300000,1512060,631812060,False,3
5331,validator_23,59090869891,True,718800000,26534530,745334530,True,1
5332,validator_11,53078212717,True,748420007,9098880,757518887,True,1
5333,validator_34,544343246760,True,567700000,10024870,577724870,False,17
5334,validator_15,582561385669,True,738499999,29951790,768451789,True,18
5335,validator_37,129453076830,True,620100000,6225430,626325430,False,4
5336,validator_8,57730585625,True,549199999,1929880,551129879,True,1
5337,validator_12,209526889316,True,617095998,10794180,627890178,True,6
5338,validator_11,53741814681,True,610264004,53337960,663601964,True,1
5339,validator_40,62527572990,True,412000000,954930,412954930,False,1
5340,validator_34,544975038030,True,625900000,5891270,631791270,False,17
5341,validator_12,210378782815,True,810683999,41209500,851893499,True,6
5342,validator_41,128027867750,True,571900000,1731700,573631700,False,4
5343,validator_49,137162118530,True,612200000,1050200,613250200,False,4
5344,validator_45,56897598120,True,498100000,21580780,519680780,False,1
5345,validator_43,122146991250,True,558300000,8251690,566551690,False,3
5346,validator_24,65151854387,True,470630003,13910400,484540403,True,2
5347,validator_16,64832260217,True,827300003,18547500,845847503,True,2
5348,validator_7,141812618281,True,632199999,55123000,687322999,True,4
5349,validator_35,164672431840,True,514300000,30163780,544463780,False,5
5350,validator_17,363239654717,True,695440007,2253200,697693207,True,11
5351,validator_34,545622213720,True,644400000,2775690,647175690,False,17
5352,validator_43,122817247560,True,666900000,3356310,670256310,False,3
5353,validator_15,583219338493,True,630500004,27452820,657952824,True,18
5354,validator_48,345202481560,True,615600000,2438630,618038630,False,10
5355,validator_19,128038898739,True,880639995,25243100,905883095,True,4
5356,validator_18,214529816269,True,665740001,10740940,676480941,True,6
5357,validator_48,345784276660,True,576900000,4895100,581795100,False,10
5358,validator_38,58777754660,True,649600000,7052320,656652320,False,1
5359,validator_37,130188707180,True,732400000,3230350,735630350,False,4
5360,validator_34,546159899250,True,528000000,9685530,537685530,False,17
5361,validator_38,59364566610,True,566600000,20211950,586811950,False,1
5362,validator_15,584249352107,True,1006300004,23713610,1030013614,True,18
5363,validator_15,584905005557,True,641900000,13753450,655653450,True,18
5364,validator_18,215045393937,True,513499998,2077670,515577668,True,6
5365,validator_34,546774544630,True,612400000,2245380,614645380,False,17
5366,validator_18,215839182272,True,740040005,53748330,793788335,True,6
5367,validator_27,188248933110,True,609700000,26005850,635705850,False,5
5368,validator_40,63046669590,True,517900000,1196600,519096600,False,1
5369,validator_46,202387141490,True,594300000,26687830,620987830,False,6
5370,validator_19,128871541243,True,805967994,26674510,832642504,True,4
5371,validator_15,585534820576,True,609899999,19915020,629815019,True,18
5372,validator_34,547543979730,True,759000000,10435100,769435100,False,17
5373,validator_13,62208375198,True,867599996,9007500,876607496,True,1
5374,validator_15,586098146218,True,544660002,18665640,563325642,True,18
5375,validator_17,364008455445,True,758319998,10480730,768800728,True,11
5376,validator_17,364628278759,True,610720004,9103310,619823314,True,11
5377,validator_49,137659443730,True,495800000,1525200,497325200,False,4
5378,validator_13,62604920604,True,372719996,23825410,396545406,True,1
5379,validator_41,128740510420,True,704800000,7842670,712642670,False,4
5380,validator_44,189445373070,True,538000000,1922020,539922020,False,5
5381,validator_19,129782143624,True,860960001,49642380,910602381,True,4
5382,validator_0,58663321148,True,674760001,16080820,690840821,True,1
5383,validator_7,142446866566,True,623639995,10608290,634248285,True,4
5384,validator_30,120156556140,True,780300000,1383700,781683700,False,3
5385,validator_31,326018850450,True,709200000,963450,710163450,False,10
5386,validator_27,188730332870,True,470700000,10699760,481399760,False,5
5387,validator_44,189820127400,True,372500000,2254330,374754330,False,5
5388,validator_6,63607050437,True,812420006,14629300,827049306,True,1
5389,validator_34,548416782130,True,833400000,39402400,872802400,False,17
5390,validator_32,54952068730,True,722900000,709500,723609500,False,1
5391,validator_49,138305352200,True,644700000,1208470,645908470,False,4
5392,validator_35,165270581020,True,594800000,3349180,598149180,False,5
5393,validator_7,143090309887,True,608288001,35155320,643443321,True,4
5394,validator_16,65741153117,True,865500000,43392900,908892900,True,2
5395,validator_15,586921887585,True,797320007,26421360,823741367,True,18
5396,validator_38,60132696450,True,766100000,2029840,768129840,False,1
5397,validator_31,326567572050,True,538200000,10521600,548721600,False,10
5398,validator_22,141232948862,True,719999995,2159510,722159505,True,4
5399,validator_41,129414903950,True,666200000,8193530,674393530,False,4
5400,validator_15,587887309086,True,935140001,30281500,965421501,True,18
5401,validator_17,365468858854,True,825400005,15180090,840580095,True,11
5402,validator_15,588552092483,True,641953997,22829400,664783397,True,18
5403,validator_16,66585163775,True,817099998,26910660,844010658,True,2
5404,validator_47,127097345180,True,807200000,41671300,848871300,False,3
5405,validator_48,346373934660,True,588400000,1258000,589658000,False,10
5406,validator_1,142358370318,True,497700007,24759810,522459817,True,4
5407,validator_31,327170607330,True,565800000,37235280,603035280,False,10
5408,validator_18,216630841868,True,748939996,42719600,791659596,True,6
5409,validator_15,589061550725,True,497640002,11818240,509458242,True,18
5410,validator_9,63127605969,True,888960003,59436300,948396303,True,1
5411,validator_22,141947885543,True,713100001,1836680,714936681,True,4
5412,validator_48,346882366160,True,507100000,1331500,508431500,False,10
5413,validator_49,138912376430,True,578600000,28424230,607024230,False,4
5414,validator_48,347357420990,True,471700000,3354830,475054830,False,10
5415,validator_34,549104724530,True,686400000,1542400,687942400,False,17
5416,validator_12,210985238546,True,586600001,19855730,606455731,True,6
5417,validator_37,130799957000,True,608600000,2649820,611249820,False,4
5418,validator_40,63830854670,True,782600000,1585080,784185080,False,1
5419,validator_34,549680110870,True,554500000,20886340,575386340,False,17
5420,validator_21,135880865802,True,726200002,2813500,729013502,True,4
5421,validator_10,70129955671,True,678240000,28075130,706315130,True,2
5422,validator_16,67250290072,True,636819997,28306300,665126297,True,2
5423,validator_17,366296836045,True,800445991,27531200,827977191,True,11
5424,validator_46,203059823710,True,671900000,782220,672682220,False,6
5425,validator_34,550229105960,True,511500000,37495090,548995090,False,17
5426,validator_15,590081896895,True,982668000,37678170,1020346170,True,18
5427,validator_48,347948591530,True,581900000,9270540,591170540,False,10
5428,validator_34,550850168330,True,600200000,20862370,621062370,False,17
5429,validator_49,139500368350,True,587400000,591920,587991920,False,4
5430,validator_41,130093659200,True,676000000,2755250,678755250,False,4
5431,validator_37,131334933820,True,531210000,3766820,534976820,False,4
5432,validator_43,123203247860,True,383900000,2100300,386000300,False,3
5433,validator_24,65985616075,True,813500008,20261680,833761688,True,2
5434,validator_31,327968599630,True,795700000,2292300,797992300,False,10
5435,validator_24,66664921137,True,659660002,19645060,679305062,True,2
5436,validator_37,132040831020,True,686700000,19197200,705897200,False,4
5437,validator_41,130608446710,True,504800000,9987510,514787510,False,4
5438,validator_31,328725059910,True,753900000,2560280,756460280,False,10
5439,validator_34,551498017670,True,644500000,3349340,647849340,False,17
5440,validator_20,63328349284,True,532963998,24069100,557033098,True,1
5441,validator_36,185890430870,True,523900000,26690800,550590800,False,5
5442,validator_17,366974968438,True,657779993,20352400,678132393,True,11
5443,validator_0,59296912620,True,621400002,12191470,633591472,True,1
5444,validator_34,551953350710,True,446400000,8933040,455333040,False,17
5445,validator_48,348590106830,True,639500000,2015300,641515300,False,10
5446,validator_34,552799708010,True,843100000,3257300,846357300,False,17
5447,validator_48,349060335150,True,451010000,19218320,470228320,False,10
5448,validator_22,142556390673,True,588020000,20485130,608505130,True,4
5449,validator_25,65983931920,True,661000000,8073680,669073680,False,2
5450,validator_15,590615926999,True,516700004,17330100,534030104,True,18
5451,validator_19,130398051854,True,590040000,25868230,615908230,True,4
5452,validator_15,591210535809,True,555900000,38708810,594608810,True,18
5453,validator_7,143806327583,True,713399996,2617700,716017696,True,4
5454,validator_39,59637734960,True,562600000,56407640,619007640,False,1
5455,validator_34,553604215030,True,800100000,4407020,804507020,False,17
5456,validator_10,70956503564,True,796086003,30461890,826547893,True,2
5457,validator_17,367610886043,True,572178005,63739600,635917605,True,11
5458,validator_48,349739311830,True,675000000,3976680,678976680,False,10
5459,validator_30,120821152480,True,661500000,3096340,664596340,False,3
5460,validator_48,350567281820,True,790700000,37269990,827969990,False,10
5461,validator_15,592010371415,True,773496006,26339600,799835606,True,18
5462,validator_31,329377676080,True,651200000,1416170,652616170,False,10
5463,validator_31,330044170980,True,655600000,10894900,666494900,False,10
5464,validator_48,351014546990,True,445100000,2165170,447265170,False,10
5465,validator_5,134926416136,True,727960001,43231940,771191941,True,4
5466,validator_15,593029265715,True,988760000,30134300,1018894300,True,18
5467,validator_36,186569794890,True,652900000,26464020,679364020,False,5
5468,validator_17,368287041106,True,664760003,11395060,676155063,True,11
5469,validator_15,593701026223,True,647459998,24300510,671760508,True,18
5470,validator_48,351717689430,True,698400000,4742440,703142440,False,10
5471,validator_34,554141128110,True,534200000,2713080,536913080,False,17
5472,validator_15,594424563822,True,722699999,837600,723537599,True,18
5473,validator_27,189489122230,True,738600000,20189360,758789360,False,5
5474,validator_34,554675630600,True,531200000,3302490,534502490,False,17
5475,validator_5,135770597040,True,815438004,28742900,844180904,True,4
5476,validator_34,555321712800,True,642900000,3182200,646082200,False,17
5477,validator_31,330647727580,True,599800000,3756600,603556600,False,10
5478,validator_7,144543729687,True,713340004,24062100,737402104,True,4
5479,validator_15,595226821899,True,795568007,6690070,802258077,True,18
5480,validator_31,331167193960,True,510200000,9266380,519466380,False,10
5481,validator_15,595874583687,True,628820008,18941780,647761788,True,18
5482,validator_44,190555381800,True,715800000,19454400,735254400,False,5
5483,validator_17,369125648350,True,819016004,19591240,838607244,True,11
5484,validator_14,234775117207,True,708900006,3016000,711916006,True,7
5485,validator_1,143263822016,True,878199998,27251700,905451698,True,4
5486,validator_48,352128192930,True,405600000,4903500,410503500,False,11
5487,validator_14,235462194993,True,676699996,10377790,687077786,True,7
5488,validator_31,331761709190,True,592000000,2515230,594515230,False,10
5489,validator_46,203693318010,True,613500000,19994300,633494300,False,6
5490,validator_34,555740238250,True,416500000,2025450,418525450,False,17
5491,validator_28,62221527340,True,655300000,9985700,665285700,False,1
5492,validator_7,145270727323,True,703419996,23577640,726997636,True,4
5493,validator_24,67614499162,True,902386005,47192020,949578025,True,2
5494,validator_24,68432923102,True,806520000,11903940,818423940,True,2
5495,validator_27,190021963890,True,523800000,9041660,532841660,False,5
5496,validator_46,204313236410,True,618800000,1118400,619918400,False,6
5497,validator_27,190632673390,True,608700000,2009500,610709500,False,5
5498,validator_25,66588461820,True,584200000,20329900,604529900,False,2
5499,validator_1,144056096802,True,783639996,8634790,792274786,True,4
5500,validator_15,596729442951,True,834820004,20039260,854859264,True,18
5501,validator_36,187349737600,True,764300000,15642710,779942710,False,5
5502,validator_19,131028570061,True,566466007,64052200,630518207,True,4
5503,validator_34,556274936440,True,532000000,2698190,534698190,False,17
5504,validator_34,556829951920,True,548400000,6615480,555015480,False,17
5505,validator_41,131294190610,True,683000000,2743900,685743900,False,4
5506,validator_34,557356743590,True,515300000,11491670,526791670,False,17
5507,validator_37,132651969180,True,603500000,7638160,611138160,False,4
5508,validator_15,597255160350,True,516719999,8997400,525717399,True,18
5509,validator_22,143121247463,True,524770000,40086790,564856790,True,4
5510,validator_36,187994038700,True,641100000,3201100,644301100,False,5
5511,validator_16,68116492548,True,828645996,37556480,866202476,True,2
5512,validator_22,143816300068,True,671020005,24032600,695052605,True,4
5513,validator_29,52413908290,True,478200000,11704240,489904240,False,1
5514,validator_37,133169117280,True,497300000,19848100,517148100,False,4
5515,validator_5,136455095360,True,657080000,27418320,684498320,True,4
5516,validator_48,352894824560,True,747300000,19331630,766631630,False,11
5517,validator_40,64285138810,True,452160000,2124140,454284140,False,2
5518,validator_12,211745151346,True,756900000,3012800,759912800,True,6
5519,validator_34,557837950390,True,479300000,1906800,481206800,False,17
5520,validator_41,131973018270,True,676800000,2027660,678827660,False,4
5521,validator_18,217482226266,True,785179998,66204400,851384398,True,6
5522,validator_8,58582775028,True,830140003,22049400,852189403,True,1
5523,validator_45,57326504320,True,426600000,2306200,428906200,False,1
5524,validator_23,59751057428,True,604919997,55267540,660187537,True,1
5525,validator_12,212531968443,True,743139997,43677100,786817097,True,6
5526,validator_46,205153541590,True,801700000,38605180,840305180,False,6
5527,validator_32,55804744920,True,830800000,21876190,852676190,False,1
5528,validator_19,131771323739,True,734759998,7993680,742753678,True,4
5529,validator_34,558565788260,True,720600000,7237870,727837870,False,17
5530,validator_36,188576059030,True,578700000,3320330,582020330,False,5
5531,validator_31,332246591490,True,458200000,26682300,484882300,False,10
5532,validator_1,144958063524,True,899600002,2366720,901966722,True,4
5533,validator_34,559114227110,True,538800000,9638850,548438850,False,17
5534,validator_44,191128236180,True,565000000,7854380,572854380,False,5
5535,validator_27,191260863510,True,623300000,4890120,628190120,False,5
5536,validator_34,559475790120,True,355400000,6163010,361563010,False,17
5537,validator_37,133778100170,True,607700000,1282890,608982890,False,4
5538,validator_46,205747174390,True,592600000,1032800,593632800,False,6
5539,validator_24,69206217921,True,739959999,33334820,773294819,True,2
5540,validator_15,598040293280,True,770240000,14892930,785132930,True,18
5541,validator_6,64371465760,True,755500003,8915320,764415323,True,2
5542,validator_27,191991924110,True,720800000,10260600,731060600,False,5
5543,validator_47,127807244580,True,700400000,9499400,709899400,False,3
5544,validator_17,369774482546,True,642599996,6234200,648834196,True,11
5545,validator_15,598697881377,True,636995997,20592100,657588097,True,18
5546,validator_46,206361844890,True,611600000,3070500,614670500,False,6
5547,validator_31,333031557490,True,759000000,25966000,784966000,False,10
5548,validator_34,560119698120,True,633900000,10008000,643908000,False,17
5549,validator_41,132797045720,True,804200000,19827450,824027450,False,4
5550,validator_42,54789145420,True,727200000,6186000,733386000,False,1
5551,validator_22,144680706793,True,825100005,39306720,864406725,True,4
5552,validator_19,132532993184,True,727645995,34023450,761669445,True,4
5553,validator_7,146152936414,True,871440001,10769090,882209091,True,4
5554,validator_18,218065275765,True,564819999,18229500,583049499,True,6
5555,validator_8,59551689243,True,924735995,44178220,968914215,True,1
5556,validator_1,145689338351,True,710382007,20892820,731274827,True,4
5557,validator_17,370492008180,True,667120004,50405630,717525634,True,11
5558,validator_22,145770525096,True,1082800003,7018300,1089818303,True,4
5559,validator_37,134234280440,True,454500000,1680270,456180270,False,4
5560,validator_31,333703495420,True,650900000,21037930,671937930,False,10
5561,validator_38,60609180050,True,474700000,1783600,476483600,False,1
5562,validator_14,236440916251,True,972999998,5721260,978721258,True,7
5563,validator_12,213333246778,True,799700005,1578330,801278335,True,6
5564,validator_15,599390693123,True,670114006,22697740,692811746,True,18
5565,validator_18,219025133271,True,942320006,17537500,959857506,True,6
5566,validator_41,133419096740,True,601500000,20551020,622051020,False,4
5567,validator_47,128377861490,True,568200000,2416910,570616910,False,4
5568,validator_19,133122341624,True,568620000,20728440,589348440,True,4
5569,validator_22,146454980298,True,646048002,38407200,684455202,True,4
5570,validator_15,599862079684,True,438160001,33226560,471386561,True,18
5571,validator_44,191821980380,True,691300000,2444200,693744200,False,5
5572,validator_21,136484590803,True,590020001,13705000,603725001,True,4
5573,validator_12,214060192819,True,699840001,27106040,726946041,True,6
5574,validator_37,134819650460,True,578300000,7070020,585370020,False,4
5575,validator_43,123580200990,True,367900000,9053130,376953130,False,3
5576,validator_15,600686495015,True,747880001,76535330,824415331,True,18
5577,validator_12,214890911119,True,811500000,19218300,830718300,True,6
5578,validator_26,57566309430,True,525200000,7973730,533173730,False,1
5579,validator_39,60187993600,True,548500000,1758640,550258640,False,1
5580,validator_36,189111852330,True,532800000,2993300,535793300,False,5
5581,validator_27,192591049430,True,589000000,10125320,599125320,False,6
5582,validator_42,55408679520,True,618670000,864100,619534100,False,1
5583,validator_15,601367528414,True,649997999,31035400,681033399,True,18
5584,validator_3,61132704719,True,670200001,2383340,672583341,True,1
5585,validator_37,135287639390,True,465400000,2588930,467988930,False,4
5586,validator_22,147140017702,True,682700004,2337400,685037404,True,4
5587,validator_35,165905251820,True,631800000,2870800,634670800,False,5
5588,validator_30,121233456140,True,394700000,17603660,412303660,False,3
5589,validator_34,560967224220,True,844900000,2626100,847526100,False,17
5590,validator_39,60802071800,True,609700000,4378200,614078200,False,1
5591,validator_20,63943468782,True,613199998,1919500,615119498,True,1
5592,validator_6,65053076282,True,679900002,1710520,681610522,True,2
5593,validator_12,215602208277,True,701199998,10097160,711297158,True,6
5594,validator_5,136994814411,True,535920001,3799050,539719051,True,4
5595,validator_31,334353121150,True,645900000,3725730,649625730,False,10
5596,validator_14,237384033453,True,941300002,1817200,943117202,True,7
5597,validator_44,192479450150,True,636600000,20869770,657469770,False,6
5598,validator_15,602212745490,True,808725996,36491080,845217076,True,18
5599,validator_14,238139706876,True,734400003,21273420,755673423,True,7
5600,validator_44,193021188850,True,539000000,2738700,541738700,False,6
5601,validator_17,371125359817,True,620895997,12455640,633351637,True,11
5602,validator_18,219523818519,True,478555998,20129250,498685248,True,6
5603,validator_15,602811816664,True,596740004,2331170,599071174,True,18
5604,validator_31,335034546370,True,670400000,11025220,681425220,False,10
5605,validator_1,146522315949,True,794339998,38637600,832977598,True,4
5606,validator_14,238881825261,True,718000005,24118380,742118385,True,7
5607,validator_31,335752091790,True,697700000,19845420,717545420,False,10
5608,validator_48,353390761040,True,493800000,2136480,495936480,False,11
5609,validator_46,206849542220,True,480000000,7697330,487697330,False,6
5610,validator_23,60459615020,True,680499992,28057600,708557592,True,1
5611,validator_43,124123356630,True,516700000,26455640,543155640,False,3
5612,validator_18,220216250568,True,681899999,10532050,692432049,True,6
5613,validator_19,134013267203,True,842019999,48905580,890925579,True,4
5614,validator_13,63265934193,True,613785999,47227590,661013589,True,1
5615,validator_20,64656540352,True,688400010,24671560,713071570,True,2
5616,validator_15,603671119437,True,844000003,15302770,859302773,True,18
5617,validator_35,166341833520,True,432600000,3981700,436581700,False,5
5618,validator_34,561571530830,True,584040000,20266610,604306610,False,17
5619,validator_36,189866408830,True,746800000,7756500,754556500,False,5
5620,validator_15,604293066072,True,602300005,19646630,621946635,True,18
5621,validator_40,65132581720,True,839400000,8042910,847442910,False,2
5622,validator_22,147652782204,True,480660002,32104500,512764502,True,4
5623,validator_47,128979269890,True,598500000,2908400,601408400,False,4
5624,validator_44,193618789170,True,592000000,5600320,597600320,False,6
5625,validator_44,194133723380,True,487100000,27834210,514934210,False,6
5626,validator_39,61287520120,True,482100000,3348320,485448320,False,1
5627,validator_31,336269054190,True,516500000,462400,516962400,False,10
5628,validator_15,604975682508,True,668440006,14176430,682616436,True,18
5629,validator_42,55946089420,True,522900000,14509900,537409900,False,1
5630,validator_21,137216397385,True,707400002,24406580,731806582,True,4
5631,validator_37,135949247480,True,651500000,10108090,661608090,False,4
5632,validator_48,354088252390,True,695300000,2191350,697491350,False,11
5633,validator_34,562080779960,True,504600000,4649130,509249130,False,17
5634,validator_15,605708625610,True,721358002,11585100,732943102,True,18
5635,validator_46,207252277520,True,401440000,1295300,402735300,False,6
5636,validator_7,146893970131,True,709039997,31993720,741033717,True,4
5637,validator_15,606590915912,True,848240002,34050300,882290302,True,18
5638,validator_40,65702151220,True,553500000,16069500,569569500,False,2
5639,validator_49,140121974580,True,618800000,2806230,621606230,False,4
5640,validator_15,607238559892,True,639500000,8143980,647643980,True,18
5641,validator_27,193130307940,True,517400000,21858510,539258510,False,6
5642,validator_44,194631682360,True,490500000,7458980,497958980,False,6
5643,validator_41,134066012650,True,645800000,1115910,646915910,False,4
5644,validator_37,136574112880,True,581700000,43165400,624865400,False,4
5645,validator_36,190485553430,True,617800000,1344600,619144600,False,5
5646,validator_41,134616483350,True,547300000,3170700,550470700,False,4
5647,validator_10,71818789157,True,837339993,24945600,862285593,True,2
5648,validator_3,61901243717,True,715800008,52738990,768538998,True,1
5649,validator_41,135302485040,True,684700000,1301690,686001690,False,4
5650,validator_22,148183821203,True,522199999,8839000,531038999,True,4
5651,validator_21,137699577083,True,455239998,27939700,483179698,True,4
5652,validator_15,607950810412,True,702000000,10250520,712250520,True,18
5653,validator_14,239518299479,True,609799998,26674220,636474218,True,7
5654,validator_34,562789974940,True,705900000,3294980,709194980,False,17
5655,validator_1,147168992686,True,633999997,12676740,646676737,True,4
5656,validator_37,137030948210,True,453030000,3805330,456835330,False,4
5657,validator_48,354579775670,True,490500000,1023280,491523280,False,11
5658,validator_44,195156267390,True,518300000,6285030,524585030,False,6
5659,validator_43,124555387290,True,423280000,8750660,432030660,False,3
5660,validator_34,563397357340,True,605500000,1882400,607382400,False,17
5661,validator_15,608378008014,True,395686002,31511600,427197602,True,19
5662,validator_7,147666690970,True,730759999,41960840,772720839,True,4
5663,validator_22,148925304383,True,723540000,17943180,741483180,True,4
5664,validator_27,193789465970,True,656800000,2358030,659158030,False,6
5665,validator_47,129625208460,True,637500000,8438570,645938570,False,4
5666,validator_1,147672654661,True,473995995,29665980,503661975,True,4
5667,validator_44,195708237620,True,542000000,9970230,551970230,False,6
5668,validator_1,148430578531,True,753400000,4523870,757923870,True,4
5669,validator_44,196328369820,True,615100000,5032200,620132200,False,6
5670,validator_48,355066050270,True,485400000,874600,486274600,False,11
5671,validator_49,140968811980,True,838100000,8737400,846837400,False,4
5672,validator_49,141509851620,True,539100000,1939640,541039640,False,4
5673,validator_15,609100035015,True,719300001,2727000,722027001,True,19
5674,validator_33,59530008780,True,550700000,2302070,553002070,False,1
5675,validator_17,371523870376,True,371339999,27170560,398510559,True,11
5676,validator_15,609577773371,True,476100006,1638350,477738356,True,19
5677,validator_36,190923275470,True,435100000,2622040,437722040,False,5
5678,validator_14,240054249780,True,516340001,19610300,535950301,True,7
5679,validator_30,121918251730,True,665800000,18995590,684795590,False,3
5680,validator_15,610452983631,True,872700000,2510260,875210260,True,19
5681,validator_15,610878273959,True,406000008,19290320,425290328,True,19
5682,validator_25,67190623250,True,598700000,3461430,602161430,False,2
5683,validator_48,355979369970,True,910800000,2519700,913319700,False,11
5684,validator_36,191682892180,True,753300000,6316710,759616710,False,5
5685,validator_17,372202479412,True,675300006,3309030,678609036,True,11
5686,validator_15,611610295254,True,675999995,56021300,732021295,True,19
5687,validator_10,72399778359,True,560590002,20399200,580989202,True,2
5688,validator_15,612171591457,True,547640003,13656200,561296203,True,19
5689,validator_15,612766919618,True,593900001,1428160,595328161,True,19
5690,validator_46,207883742850,True,621400000,10065330,631465330,False,6
5691,validator_49,142216885660,True,705300000,1734040,707034040,False,4
5692,validator_3,62726873937,True,793760000,31870220,825630220,True,1
5693,validator_15,613420754947,True,618254009,35581320,653835329,True,19
5694,validator_47,130191909890,True,560300000,6401430,566701430,False,4
5695,validator_43,125193226010,True,635700000,2138720,637838720,False,3
5696,validator_22,149712768878,True,752833995,34630500,787464495,True,4
5697,validator_15,614063161285,True,635059998,7346340,642406338,True,19
5698,validator_31,336985818250,True,708400000,8364060,716764060,False,10
5699,validator_18,220894633275,True,664890007,13492700,678382707,True,6
5700,validator_34,564037818670,True,632800000,7661330,640461330,False,17
5701,validator_36,192406442410,True,719900000,3650230,723550230,False,6
5702,validator_47,130766545230,True,570300000,4335340,574635340,False,4
5703,validator_34,564639583670,True,591000000,10765000,601765000,False,17
5704,validator_43,125893851110,True,697200000,3425100,700625100,False,3
5705,validator_48,356522586270,True,541000000,2216300,543216300,False,11
5706,validator_17,372945259353,True,688698001,54081940,742779941,True,11
5707,validator_48,357179583330,True,608400000,48597060,656997060,False,11
5708,validator_12,216302744314,True,678973997,21562040,700536037,True,6
5709,validator_18,221692992863,True,748739998,49619590,798359588,True,6
5710,validator_14,240647704112,True,537574002,55880330,593454332,True,7
5711,validator_15,614883357524,True,785919999,34276240,820196239,True,19
5712,validator_34,565347581580,True,697000000,10997910,707997910,False,17
5713,validator_46,208490314230,True,603300000,3271380,606571380,False,6
5714,validator_14,241145191893,True,494080001,3407780,497487781,True,7
5715,validator_34,566161605180,True,810800000,3223600,814023600,False,17
5716,validator_18,222283308067,True,553180004,37135200,590315204,True,6
5717,validator_18,222786666064,True,486959997,16398000,503357997,True,6
5718,validator_48,358076205330,True,876400000,20222000,896622000,False,11
5719,validator_29,53014338790,True,593000000,7430500,600430500,False,1
5720,validator_48,358490878030,True,408200000,6472700,414672700,False,11
5721,validator_34,566857734480,True,676400000,19729300,696129300,False,17
5722,validator_15,615511705847,True,562460003,65888320,628348323,True,19
5723,validator_7,148389675906,True,678007996,44976940,722984936,True,4
5724,validator_15,616405659840,True,882140003,11813990,893953993,True,19
5725,validator_18,223725481789,True,911408005,27407720,938815725,True,6
5726,validator_48,359156474930,True,640600000,24996900,665596900,False,11
5727,validator_14,241887861878,True,723464005,19205980,742669985,True,7
5728,validator_48,359807399050,True,627600000,23324120,650924120,False,11
5729,validator_7,149139644725,True,695539999,54428820,749968819,True,4
5730,validator_19,134726678704,True,688680001,24731500,713411501,True,4
5731,validator_5,137445876202,True,409240001,41821790,451061791,True,4
5732,validator_41,135904965210,True,601200000,1280170,602480170,False,4
5733,validator_18,224219988957,True,487299998,7207170,494507168,True,7
5734,validator_34,567333354710,True,473300000,2320230,475620230,False,17
5735,validator_19,135476504234,True,736780000,13045530,749825530,True,4
5736,validator_15,617327016643,True,911300003,10056800,921356803,True,19
5737,validator_30,122513572540,True,585020000,10300810,595320810,False,3
5738,validator_31,337379996270,True,390850000,3328020,394178020,False,10
5739,validator_15,617921883743,True,587420000,7447100,594867100,True,19
5740,validator_17,373577408684,True,593680001,38469330,632149331,True,11
5741,validator_46,209018154800,True,490700000,37140570,527840570,False,6
5742,validator_47,131307294910,True,538800000,1949680,540749680,False,4
5743,validator_48,360426247350,True,588770000,30078300,618848300,False,11
5744,validator_3,63412120973,True,676499996,8747040,685247036,True,1
5745,validator_17,374273330480,True,681139996,14781800,695921796,True,11
5746,validator_31,337954799010,True,573500000,1302740,574802740,False,10
5747,validator_49,142812273700,True,592200000,3188040,595388040,False,4
5748,validator_41,136624998940,True,714800000,5233730,720033730,False,4
5749,validator_31,338614911810,True,656800000,3312800,660112800,False,10
5750,validator_31,339215128110,True,595700000,4516300,600216300,False,10
5751,validator_14,242358137795,True,438295997,31979920,470275917,True,7
5752,validator_34,567861249250,True,517200000,10694540,527894540,False,17
5753,validator_14,243103663564,True,733799999,11725770,745525769,True,7
5754,validator_31,339686665650,True,444400000,27137540,471537540,False,10
5755,validator_22,150350030299,True,636000001,1261420,637261421,True,4
5756,validator_49,143214915590,True,395200000,7441890,402641890,False,4
5757,validator_48,361312250250,True,884000000,2002900,886002900,False,11
5758,validator_47,131914952010,True,597700000,9957100,607657100,False,4
5759,validator_35,167012367570,True,668900000,1634050,670534050,False,5
5760,validator_17,375063735479,True,744859999,45545000,790404999,True,11
5761,validator_34,568457228280,True,594000000,1979030,595979030,False,17
5762,validator_15,618421190445,True,486236002,13070700,499306702,True,19
5763,validator_34,569056231850,True,596700000,2303570,599003570,False,17
5764,validator_24,69969977748,True,738599997,25159830,763759827,True,2
5765,validator_14,243619964245,True,503239991,13060690,516300681,True,7
5766,validator_18,225075535860,True,828160003,27386900,855546903,True,7
5767,validator_34,569486995470,True,429400000,1363620,430763620,False,17
5768,validator_35,167732856170,True,711900000,8588600,720488600,False,5
5769,validator_16,68787730097,True,643459999,27777550,671237549,True,2
5770,validator_27,194584978670,True,758600000,36912700,795512700,False,6
5771,validator_35,168459572790,True,724500000,2216620,726716620,False,5
5772,validator_47,132695089840,True,776600000,3537830,780137830,False,4
5773,validator_18,225825462461,True,730464001,19462600,749926601,True,7
5774,validator_34,570333720000,True,826700000,20024530,846724530,False,17
5775,validator_44,196897724490,True,559500000,9854670,569354670,False,6
5776,validator_15,619006161876,True,559340001,25631430,584971431,True,19
5777,validator_22,151073631385,True,684979996,38621090,723601086,True,4
5778,validator_1,149104506689,True,643299998,30628160,673928158,True,4
5779,validator_29,53736875690,True,695600000,26936900,722536900,False,1
5780,validator_19,136179406611,True,693699997,9202380,702902377,True,4
5781,validator_12,217063317714,True,751400000,9173400,760573400,True,6
5782,validator_48,361956714150,True,641400000,3063900,644463900,False,11
5783,validator_40,66295587900,True,589900000,3536680,593436680,False,2
5784,validator_30,123312613920,True,795100000,3941380,799041380,False,3
5785,validator_14,244529697277,True,890820002,18913030,909733032,True,7
5786,validator_27,195294875800,True,706300000,3597130,709897130,False,6
5787,validator_23,61369573694,True,880495994,29462680,909958674,True,1
5788,validator_34,570870047590,True,524700000,11627590,536327590,False,17
5789,validator_1,149890930085,True,774979996,11443400,786423396,True,4
5790,validator_2,57175823992,True,666020004,25790940,691810944,True,1
5791,validator_17,375861184597,True,738179998,59269120,797449118,True,11
5792,validator_18,226441871466,True,570180005,46229000,616409005,True,7
5793,validator_12,217772521812,True,661199998,48004100,709204098,True,6
5794,validator_24,70606757551,True,581960003,54819800,636779803,True,2
5795,validator_27,195950206530,True,652600000,2730730,655330730,False,6
5796,validator_31,340233735870,True,546200000,870220,547070220,False,10
5797,validator_47,133113385820,True,415600000,2695980,418295980,False,4
5798,validator_30,123775213560,True,442300000,20299640,462599640,False,3
5799,validator_48,362561512450,True,599300000,5498300,604798300,False,11
5800,validator_15,619712001311,True,685180005,20659430,705839435,True,19
5801,validator_35,169105261770,True,625900000,19788980,645688980,False,5
5802,validator_27,196529744270,True,575800000,3737740,579537740,False,6
5803,validator_19,136780950473,True,595320002,6223860,601543862,True,4
5804,validator_6,65718923464,True,655930002,9917180,665847182,True,2
5805,validator_18,227438308903,True,989470007,6967430,996437437,True,7
5806,validator_48,363176886770,True,613900000,1474320,615374320,False,11
5807,validator_37,137789538080,True,738800000,19789870,758589870,False,4
5808,validator_35,169665656600,True,547800000,12594830,560394830,False,5
5809,validator_34,571432761880,True,552450000,10264290,562714290,False,17
5810,validator_34,571841857620,True,406500000,2595740,409095740,False,17
5811,validator_42,56808277800,True,855300000,6888380,862188380,False,1
5812,validator_34,572545397520,True,701700000,1839900,703539900,False,17
5813,validator_46,209608085800,True,565100000,24831000,589931000,False,6
5814,validator_23,62023947293,True,643999999,10373600,654373599,True,1
5815,validator_41,137234713490,True,607800000,1914550,609714550,False,4
5816,validator_2,57799245491,True,598979999,24441500,623421499,True,1
5817,validator_31,341042710310,True,788800000,20174440,808974440,False,10
5818,validator_2,58523319829,True,695560008,28514330,724074338,True,1
5819,validator_31,341835483230,True,771900000,20872920,792772920,False,10
5820,validator_31,342278947830,True,441400000,2064600,443464600,False,10
5821,validator_48,363791345110,True,594000000,20458340,614458340,False,11
5822,validator_31,343075551480,True,790300000,6303650,796603650,False,10
5823,validator_7,149850633321,True,690563996,20424600,710988596,True,4
5824,validator_27,197162544790,True,631000000,1800520,632800520,False,6
5825,validator_8,60254322942,True,688299999,14333700,702633699,True,1
5826,validator_22,151786725943,True,692399998,20694560,713094558,True,4
5827,validator_46,210306528890,True,689700000,8743090,698443090,False,6
5828,validator_10,72993812182,True,549600003,44433820,594033823,True,2
5829,validator_21,138500084316,True,774640003,25867230,800507233,True,4
5830,validator_14,245199828892,True,657019995,13111620,670131615,True,7
5831,validator_40,66906249300,True,590200000,20461400,610661400,False,2
5832,validator_47,133818256550,True,679100000,25770730,704870730,False,4
5833,validator_12,218428289397,True,631700005,24067580,655767585,True,6
5834,validator_30,124393046020,True,614500000,3332460,617832460,False,3
5835,validator_34,573107708660,True,559800000,2511140,562311140,False,17
5836,validator_48,364299624710,True,489500000,18779600,508279600,False,11
5837,validator_15,620233811214,True,435822003,85987900,521809903,True,19
5838,validator_44,197305863410,True,405200000,2938920,408138920,False,6
5839,validator_14,245765527357,True,539259995,26438470,565698465,True,7
5840,validator_49,143778448450,True,543400000,20132860,563532860,False,4
5841,validator_48,365116469110,True,813500000,3344400,816844400,False,11
5842,validator_14,246339831495,True,535279998,39024140,574304138,True,7
5843,validator_44,197804324320,True,489300000,9160910,498460910,False,6
5844,validator_31,343667035540,True,588400000,3084060,591484060,False,10
5845,validator_41,137686156410,True,450000000,1442920,451442920,False,4
5846,validator_48,365717094400,True,593100000,7525290,600625290,False,11
5847,validator_48,366252162590,True,526000000,9068190,535068190,False,11
5848,validator_17,376447585300,True,584100003,2300700,586400703,True,11
5849,validator_11,54229251679,True,478019998,9417000,487436998,True,1
5850,validator_49,144458028280,True,653100000,26479830,679579830,False,4
5851,validator_34,573716813560,True,607900000,1204900,609104900,False,17
5852,validator_47,134643355570,True,801500000,23599020,825099020,False,4
5853,validator_7,150415142881,True,535120000,29389560,564509560,True,4
5854,validator_17,377226228599,True,774999999,3643300,778643299,True,11
5855,validator_41,138324020140,True,612000000,25863730,637863730,False,4
5856,validator_43,126658485430,True,744300000,20334320,764634320,False,3
5857,validator_19,137371654621,True,565440008,25264140,590704148,True,4
5858,validator_34,574317861750,True,598600000,2448190,601048190,False,17
5859,validator_34,574758879500,True,420800000,20217750,441017750,False,17
5860,validator_14,247079480607,True,724100002,15549110,739649112,True,7
5861,validator_48,366936091400,True,682700000,1228810,683928810,False,11
5862,validator_47,135166340000,True,519900000,3084430,522984430,False,4
5863,validator_5,138142864313,True,684120001,12868110,696988111,True,4
5864,validator_14,247875594414,True,756639997,39473810,796113807,True,7
5865,validator_34,575492182200,True,731300000,2002700,733302700,False,17
5866,validator_34,576124665690,True,622900000,9583490,632483490,False,18
5867,validator_22,152543419343,True,725920000,30773400,756693400,True,4
5868,validator_46,210906263930,True,597000000,2735040,599735040,False,6
5869,validator_11,54834328487,True,582134008,22942800,605076808,True,1
5870,validator_34,576849497810,True,722100000,2732120,724832120,False,18
5871,validator_22,153251707649,True,700840006,7448300,708288306,True,4
5872,validator_15,621059747585,True,792240001,33696370,825936371,True,19
5873,validator_5,139123682264,True,969320001,11497950,980817951,True,4
5874,validator_18,228070718448,True,628899995,3509550,632409545,True,7
5875,validator_43,127320819070,True,653500000,8833640,662333640,False,3
5876,validator_34,577306600300,True,455800000,1302490,457102490,False,18
5877,validator_17,377975958786,True,723180007,26550180,749730187,True,11
5878,validator_41,138858287720,True,515900000,18367580,534267580,False,4
5879,validator_14,248551398758,True,665500004,10304340,675804344,True,7
5880,validator_39,61931606850,True,641900000,2186730,644086730,False,1
5881,validator_38,61086038510,True,473560000,3298460,476858460,False,1
5882,validator_25,67695837640,True,503900000,1314390,505214390,False,2
5883,validator_49,145134132780,True,665600000,10504500,676104500,False,4
5884,validator_35,170177012370,True,508800000,2555770,511355770,False,5
5885,validator_37,138404171420,True,612300000,2333340,614633340,False,4
5886,validator_15,621814990366,True,733140001,22102780,755242781,True,19
5887,validator_15,622599035000,True,773379994,10664640,784044634,True,19
5888,validator_31,344322193840,True,648700000,6458300,655158300,False,10
5889,validator_5,139670126964,True,541000000,5444700,546444700,True,4
5890,validator_15,623080247599,True,478999999,2212600,481212599,True,19
5891,validator_48,367601328540,True,663400000,1837140,665237140,False,11
5892,validator_20,65245594135,True,577220003,11833780,589053783,True,2
5893,validator_33,60216489280,True,683400000,3080500,686480500,False,1
5894,validator_32,56363573440,True,554900000,3928520,558828520,False,1
5895,validator_33,60964541340,True,746100000,1952060,748052060,False,1
5896,validator_36,193045341010,True,636400000,2498600,638898600,False,6
5897,validator_15,623698540629,True,576060000,42233030,618293030,True,19
5898,validator_48,368123698870,True,502800000,19570330,522370330,False,11
5899,validator_30,125163043950,True,767600000,2397930,769997930,False,3
5900,validator_15,624575450541,True,867499992,9409920,876909912,True,19
5901,validator_31,344885884040,True,554500000,9190200,563690200,False,10
5902,validator_41,139541142850,True,673700000,9155130,682855130,False,4
5903,validator_31,345602005640,True,713900000,2221600,716121600,False,10
5904,validator_14,249205968160,True,644400002,10169400,654569402,True,7
5905,validator_27,197736009290,True,549900000,23564500,573464500,False,6
5906,validator_48,368668995750,True,542600000,2696880,545296880,False,11
5907,validator_6,66212538449,True,489300005,4314980,493614985,True,2
5908,validator_42,57366063500,True,554000000,3785700,557785700,False,1
5909,validator_17,378478855866,True,470016000,32881080,502897080,True,11
5910,validator_48,369312759830,True,635500000,8264080,643764080,False,11
5911,validator_46,211604588620,True,692600000,5724690,698324690,False,6
5912,validator_15,625662747439,True,1079299998,7996900,1087296898,True,19
5913,validator_36,193644459510,True,596700000,2418500,599118500,False,6
5914,validator_23,62762205370,True,735500007,2758070,738258077,True,1
5915,validator_27,198339672670,True,601900000,1763380,603663380,False,6
5916,validator_11,55761682270,True,918600003,8753780,927353783,True,1
5917,validator_15,626346062641,True,655024002,28291200,683315202,True,19
5918,validator_19,138162830259,True,760673998,30501640,791175638,True,4
5919,validator_47,135831629440,True,645200000,20089440,665289440,False,4
5920,validator_49,145714798620,True,575500000,5165840,580665840,False,4
5921,validator_34,577963108910,True,650500000,6008610,656508610,False,18
5922,validator_44,198357214840,True,551500000,1390520,552890520,False,6
5923,validator_47,136505920210,True,659500000,14790770,674290770,False,4
5924,validator_8,60882439202,True,622600010,5516250,628116260,True,1
5925,validator_39,62402772380,True,468200000,2965530,471165530,False,1
5926,validator_35,170826747700,True,642100000,7635330,649735330,False,5
5927,validator_2,59135808873,True,604139994,8349050,612489044,True,1
5928,validator_12,219303962591,True,835479994,40193200,875673194,True,6
5929,validator_17,379438081366,True,923940000,35285500,959225500,True,11
5930,validator_19,138977881863,True,804420004,10631600,815051604,True,4
5931,validator_36,194107023510,True,452440000,10124000,462564000,False,6
5932,validator_34,578610688770,True,645600000,1979860,647579860,False,18
5933,validator_12,219904948707,True,567579996,33406120,600986116,True,6
5934,validator_34,579326733880,True,714100000,1945110,716045110,False,18
5935,validator_14,250080924742,True,851600002,23356580,874956582,True,7
5936,validator_35,171535464730,True,706700000,2017030,708717030,False,5
5937,validator_20,65941352548,True,676474003,19284410,695758413,True,2
5938,validator_18,228689950079,True,594640001,24591630,619231631,True,7
5939,validator_48,369855640820,True,537900000,4980990,542880990,False,11
5940,validator_36,194895077150,True,767700000,20353640,788053640,False,6
5941,validator_15,626982876150,True,614359999,22453510,636813509,True,19
5942,validator_48,370396994590,True,538800000,2553770,541353770,False,11
5943,validator_4,55203857278,True,708999995,3268020,712268015,True,1
5944,validator_6,66828150469,True,610300000,5312020,615612020,True,2
5945,validator_27,198960159710,True,596700000,23787040,620487040,False,6
5946,validator_12,220542841103,True,594639996,43252400,637892396,True,6
5947,validator_45,58110103580,True,754300000,29299260,783599260,False,1
5948,validator_37,139305459360,True,890300000,10987940,901287940,False,4
5949,validator_31,346210489410,True,601900000,6583770,608483770,False,10
5950,validator_5,140400784526,True,692289992,38367570,730657562,True,4
5951,validator_21,138975081952,True,465599996,9397640,474997636,True,4
5952,validator_15,627615202133,True,618458003,13867980,632325983,True,19
5953,validator_3,64083455142,True,650600009,20734160,671334169,True,2
5954,validator_15,628333176671,True,713599998,4374540,717974538,True,19
5955,validator_34,579913790520,True,567700000,19356640,587056640,False,18
5956,validator_34,580444963810,True,528100000,3073290,531173290,False,18
5957,validator_19,139712747867,True,714900004,19966000,734866004,True,4
5958,validator_17,380037096863,True,554079997,44935500,599015497,True,11
5959,validator_46,212098113050,True,492700000,824430,493524430,False,6
5960,validator_44,199068980880,True,710400000,1366040,711766040,False,6
5961,validator_41,140289369430,True,735700000,12526580,748226580,False,4
5962,validator_23,63460880400,True,678239990,20435040,698675030,True,1
5963,validator_49,146326448820,True,608400000,3250200,611650200,False,4
5964,validator_17,380801940728,True,740939995,23903870,764843865,True,11
5965,validator_31,346718965870,True,488600000,19876460,508476460,False,10
5966,validator_48,370975182250,True,576400000,1787660,578187660,False,11
5967,validator_14,250758793972,True,675700000,2169230,677869230,True,7
5968,validator_27,199565619740,True,602900000,2560030,605460030,False,6
5969,validator_27,200324660690,True,756000000,3040950,759040950,False,6
5970,validator_14,251533063907,True,730520005,43749930,774269935,True,7
5971,validator_37,139707985530,True,392300000,10226170,402526170,False,4
5972,validator_17,381715572627,True,901899999,11731900,913631899,True,11
5973,validator_34,581085316830,True,636500000,3853020,640353020,False,18
5974,validator_29,54337837450,True,592400000,8561760,600961760,False,1
5975,validator_6,67351057673,True,514620004,8287200,522907204,True,2
5976,validator_27,200964844490,True,630000000,10183800,640183800,False,6
5977,validator_15,629086555998,True,744299997,9079330,753379327,True,19
5978,validator_42,57987343320,True,611000000,10279820,621279820,False,1
5979,validator_40,67466783570,True,549100000,11434270,560534270,False,2
5980,validator_38,61893612220,True,806600000,973710,807573710,False,1
5981,validator_48,371743128150,True,766200000,1745900,767945900,False,11
5982,validator_38,62466123410,True,565700000,6811190,572511190,False,1
5983,validator_27,201733251420,True,766500000,1906930,768406930,False,6
5984,validator_26,58086309950,True,517600000,2400520,520000520,False,1
5985,validator_34,581831264950,True,743200000,2748120,745948120,False,18
5986,validator_15,629758321513,True,670499995,1265520,671765515,True,19
5987,validator_22,154033402526,True,772619997,9074880,781694877,True,4
5988,validator_15,630574002701,True,814199998,1481190,815681188,True,19
5989,validator_41,140793113920,True,501800000,1944490,503744490,False,4
5990,validator_34,582421146470,True,570000000,19881520,589881520,False,18
5991,validator_20,66822296808,True,858040000,22904260,880944260,True,2
5992,validator_31,347294743870,True,573100000,2678000,575778000,False,10
5993,validator_47,137067802150,True,557800000,4081940,561881940,False,4
5994,validator_7,150975347714,True,529639993,30564840,560204833,True,4
5995,validator_37,140280526060,True,567100000,5440530,572540530,False,4
5996,validator_15,630994010920,True,415539999,4468220,420008219,True,19
5997,validator_11,56442320042,True,656400002,24237770,680637772,True,1
5998,validator_23,64331577400,True,851600000,19097000,870697000,True,2
5999,validator_37,140780838300,True,497800000,2512240,500312240,False,4
6000,validator_15,631689826218,True,672659998,23155300,695815298,True,19
6001,validator_9,63940502293,True,809800004,3096320,812896324,True,1
6002,validator_46,212727338730,True,626500000,2725680,629225680,False,6
6003,validator_48,372255281700,True,503700000,8453550,512153550,False,11
6004,validator_48,372973031280,True,710600000,7149580,717749580,False,11
6005,validator_35,172020813930,True,484300000,1049200,485349200,False,5
6006,validator_19,140765491834,True,1049699997,3043970,1052743967,True,4
6007,validator_15,632532712056,True,787639998,55245840,842885838,True,19
6008,validator_44,199572341780,True,501700000,1660900,503360900,False,6
6009,validator_17,382300563644,True,549019997,35971020,584991017,True,11
6010,validator_29,54900062930,True,552400000,9825480,562225480,False,1
6011,validator_36,195506692080,True,602500000,9114930,611614930,False,6
6012,validator_46,213506946370,True,768200000,11407640,779607640,False,6
6013,validator_44,200219217280,True,644200000,2675500,646875500,False,6
6014,validator_34,583059473730,True,637000000,1327260,638327260,False,18
6015,validator_36,196199222080,True,671600000,20930000,692530000,False,6
6016,validator_35,172579557780,True,550100000,8643850,558743850,False,5
6017,validator_11,57073437969,True,583339997,47777930,631117927,True,1
6018,validator_14,252162973038,True,620320001,9589130,629909131,True,7
6019,validator_15,633283278299,True,714880003,35686240,750566243,True,19
6020,validator_36,197004099080,True,802900000,1977000,804877000,False,6
6021,validator_15,633919327703,True,610108004,25941400,636049404,True,19
6022,validator_15,634602856681,True,659519998,24008980,683528978,True,19
6023,validator_34,583677302970,True,597600000,20229240,617829240,False,18
6024,validator_41,141622991010,True,825800000,4077090,829877090,False,4
6025,validator_48,373409740350,True,433900000,2809070,436709070,False,11
6026,validator_24,71084428883,True,453239992,24431340,477671332,True,2
6027,validator_17,382979138739,True,671799995,6775100,678575095,True,11
6028,validator_15,635275131338,True,643005997,29268660,672274657,True,19
6029,validator_15,635856044868,True,521894000,59019530,580913530,True,19
6030,validator_44,200773505740,True,547400000,6888460,554288460,False,6
6031,validator_48,373975926770,True,564400000,1786420,566186420,False,11
6032,validator_48,374539528390,True,560000000,3601620,563601620,False,11
6033,validator_43,127896334170,True,572100000,3415100,575515100,False,3
6034,validator_15,636730955387,True,864039999,10870520,874910519,True,19
6035,validator_15,637321308823,True,569139996,21213440,590353436,True,19
6036,validator_46,214062332250,True,545300000,10085880,555385880,False,6
6037,validator_47,137773635750,True,704500000,1333600,705833600,False,4
6038,validator_30,125709794360,True,544900000,1850410,546750410,False,3
6039,validator_44,201370549520,True,595300000,1743780,597043780,False,6
6040,validator_27,202274914360,True,539300000,2362940,541662940,False,6
6041,validator_20,67386607838,True,532030000,32281030,564311030,True,2
6042,validator_41,142340230770,True,698000000,19239760,717239760,False,4
6043,validator_15,638092780053,True,733700000,37771230,771471230,True,19
6044,validator_14,252877503551,True,710200013,4330500,714530513,True,7
6045,validator_43,128527342040,True,625500000,5507870,631007870,False,4
6046,validator_17,383598991639,True,589184000,30668900,619852900,True,11
6047,validator_31,347968083450,True,671800000,1539580,673339580,False,10
6048,validator_34,584470189270,True,789500000,3386300,792886300,False,18
6049,validator_19,141455674077,True,684020003,6162240,690182243,True,4
6050,validator_18,229455482269,True,745080000,20452190,765532190,True,7
6051,validator_12,221308113792,True,738699999,26572690,765272689,True,6
6052,validator_46,214683121150,True,618100000,2688900,620788900,False,6
6053,validator_36,197730332010,True,724300000,1932930,726232930,False,6
6054,validator_36,198252803490,True,518900000,3571480,522471480,False,6
6055,validator_14,253688639347,True,790259996,20875800,811135796,True,7
6056,validator_17,384147844536,True,527439997,21412900,548852897,True,12
6057,validator_48,375229930230,True,688300000,2101840,690401840,False,11
6058,validator_31,348615975650,True,620700000,27192200,647892200,False,10
6059,validator_27,202876855460,True,599400000,2541100,601941100,False,6
6060,validator_19,142166334896,True,685959999,24700820,710660819,True,4
6061,validator_17,384703920036,True,550300000,5775500,556075500,True,12
6062,validator_14,254332801657,True,615340010,28822300,644162310,True,7
6063,validator_35,173273967580,True,692400000,2009800,694409800,False,5
6064,validator_5,141253187602,True,824319996,28083080,852403076,True,4
6065,validator_34,584976627710,True,503900000,2538440,506438440,False,18
6066,validator_34,585655545310,True,676600000,2317600,678917600,False,18
6067,validator_22,154557690628,True,493620002,30668100,524288102,True,4
6068,validator_12,222111085695,True,793820003,9151900,802971903,True,6
6069,validator_27,203363677000,True,462400000,24421540,486821540,False,6
6070,validator_15,638915301855,True,773020002,49501800,822521802,True,19
6071,validator_35,173767857920,True,473900000,19990340,493890340,False,5
6072,validator_17,385338050534,True,631900008,2230490,634130498,True,12
6073,validator_12,222780090474,True,573326009,95678770,669004779,True,6
6074,validator_31,349186721300,True,569100000,1645650,570745650,False,10
6075,validator_31,349773345200,True,567000000,19623900,586623900,False,10
6076,validator_30,126177071180,True,460400000,6876820,467276820,False,3
6077,validator_34,586252273940,True,586700000,10028630,596728630,False,18
6078,validator_46,215408062530,True,721500000,3441380,724941380,False,6
6079,validator_29,55383159880,True,473200000,9896950,483096950,False,1
6080,validator_35,174485943100,True,704800000,13285180,718085180,False,5
6081,validator_34,586817504440,True,531590000,33640500,565230500,False,18
6082,validator_35,175109963130,True,621000000,3020030,624020030,False,5
6083,validator_0,60016900315,True,703070005,16917690,719987695,True,1
6084,validator_34,587238158100,True,417900000,2753660,420653660,False,18
6085,validator_14,255059896681,True,706179994,20915030,727095024,True,7
6086,validator_40,68101641370,True,633300000,1557800,634857800,False,2
6087,validator_22,155201620969,True,604520001,39410340,643930341,True,4
6088,validator_17,385847683120,True,502099996,7532590,509632586,True,12
6089,validator_19,142723517420,True,528000004,29182520,557182524,True,4
6090,validator_19,143634289715,True,890449995,20322300,910772295,True,4
6091,validator_27,204055210630,True,686400000,5133630,691533630,False,6
6092,validator_44,201910055400,True,536400000,3105880,539505880,False,6
6093,validator_15,639602461519,True,663599994,23559670,687159664,True,19
6094,validator_28,62819489800,True,588400000,9562460,597962460,False,1
6095,validator_28,63404902130,True,565500000,19912330,585412330,False,1
6096,validator_23,65012521531,True,675000001,5944130,680944131,True,2
6097,validator_34,587974982760,True,698700000,38124660,736824660,False,18
6098,validator_27,204697122060,True,637100000,4811430,641911430,False,6
6099,validator_22,155942761379,True,723400000,17740410,741140410,True,4
6100,validator_38,63033624740,True,558400000,9101330,567501330,False,1
6101,validator_34,588570194980,True,585600000,9612220,595212220,False,18
6102,validator_37,141332052530,True,550100000,1114230,551214230,False,4
6103,validator_0,60690389824,True,661699999,11789510,673489509,True,1
6104,validator_15,640256097211,True,616080002,37555690,653635692,True,20
6105,validator_36,198844489930,True,590000000,1686440,591686440,False,6
6106,validator_25,68319646430,True,615000000,8808790,623808790,False,2
6107,validator_33,61442055170,True,459900000,17613830,477513830,False,1
6108,validator_18,230109799378,True,607466009,46851100,654317109,True,7
6109,validator_48,375924826110,True,688000000,6895880,694895880,False,11
6110,validator_14,255838755762,True,771400001,7459080,778859081,True,7
6111,validator_47,138431344640,True,654800000,2908890,657708890,False,4
6112,validator_44,202479784260,True,548100000,21628860,569728860,False,6
6113,validator_30,126808906290,True,625700000,6135110,631835110,False,3
6114,validator_27,205360920090,True,655200000,8598030,663798030,False,6
6115,validator_5,142145404204,True,888340002,3876600,892216602,True,4
6116,validator_1,150613812422,True,713157997,9724340,722882337,True,4
6117,validator_15,641220484014,True,879858003,84528800,964386803,True,20
6118,validator_28,64080842530,True,673800000,2140400,675940400,False,2
6119,validator_43,128927139770,True,398300000,1497730,399797730,False,4
6120,validator_49,147092100520,True,760300000,5351700,765651700,False,4
6121,validator_48,376377895340,True,449700000,3369230,453069230,False,11
6122,validator_19,144165201751,True,524900006,6012030,530912036,True,4
6123,validator_18,230524549158,True,399326000,15423780,414749780,True,7
6124,validator_25,68735230970,True,413400000,2184540,415584540,False,2
6125,validator_3,64784675946,True,655080004,46140800,701220804,True,2
6126,validator_21,139636566973,True,631420001,30065020,661485021,True,4
6127,validator_18,231336579524,True,772299996,39730370,812030366,True,7
6128,validator_14,256359134660,True,490099998,30278900,520378898,True,8
6129,validator_27,205992482130,True,623300000,8262040,631562040,False,6
6130,validator_22,156655973952,True,687174003,26038570,713212573,True,4
6131,validator_12,223579013678,True,783316004,15607200,798923204,True,6
6132,validator_31,350312237810,True,517400000,21492610,538892610,False,10
6133,validator_1,151291074545,True,657699993,19562130,677262123,True,4
6134,validator_12,224235833614,True,616375996,40443940,656819936,True,7
6135,validator_46,216230938030,True,817700000,5175500,822875500,False,6
6136,validator_46,216766285890,True,525200000,10147860,535347860,False,6
6137,validator_19,144894161646,True,708673995,20285900,728959895,True,4
6138,validator_15,642014052515,True,747740001,45828500,793568501,True,20
6139,validator_44,203100680000,True,611700000,9195740,620895740,False,6
6140,validator_14,257239163557,True,807299997,72728900,880028897,True,8
6141,validator_49,147881601690,True,777700000,11801170,789501170,False,4
6142,validator_31,350846855010,True,533100000,1517200,534617200,False,10
6143,validator_49,148454738890,True,563000000,10137200,573137200,False,4
6144,validator_5,142823494493,True,668999999,9090290,678090289,True,4
6145,validator_35,175720440450,True,604400000,6077320,610477320,False,5
6146,validator_44,203621867800,True,516400000,4787800,521187800,False,6
6147,validator_14,258035176151,True,791099994,4912600,796012594,True,8
6148,validator_10,73837931339,True,818240007,25879150,844119157,True,2
6149,validator_43,129565731000,True,635000000,3591230,638591230,False,4
6150,validator_21,140238554903,True,587540000,14447930,601987930,True,4
6151,validator_47,139057730290,True,624000000,2385650,626385650,False,4
6152,validator_49,149235002790,True,759900000,20363900,780263900,False,4
6153,validator_44,204322411990,True,675600000,24944190,700544190,False,6
6154,validator_4,55902875275,True,678899997,20118000,699017997,True,1
6155,validator_36,199358033050,True,509600000,3943120,513543120,False,6
6156,validator_35,176341624680,True,618300000,2884230,621184230,False,5
6157,validator_31,351361051460,True,511200000,2996450,514196450,False,10
6158,validator_13,64075244687,True,779854004,29456490,809310494,True,2
6159,validator_17,386508823413,True,659699993,1440300,661140293,True,12
6160,validator_49,149811702400,True,574500000,2199610,576699610,False,4
6161,validator_14,258515293375,True,453700004,26417220,480117224,True,8
6162,validator_19,145396810144,True,492499998,10148500,502648498,True,4
6163,validator_34,589218170780,True,646200000,1775800,647975800,False,18
6164,validator_34,589768443050,True,542240000,8032270,550272270,False,18
6165,validator_27,206578722030,True,584700000,1539900,586239900,False,6
6166,validator_47,139637160350,True,560200000,19230060,579430060,False,4
6167,validator_27,207260091430,True,661700000,19669400,681369400,False,6
6168,validator_40,68523200560,True,413170000,8389190,421559190,False,2
6169,validator_34,590253109550,True,482700000,1966500,484666500,False,18
6170,validator_12,225087014209,True,840640005,10540590,851180595,True,7
6171,validator_9,64432082519,True,471699996,19880230,491580226,True,2
6172,validator_31,351965896900,True,599200000,5645440,604845440,False,10
6173,validator_37,141998065850,True,645400000,20613320,666013320,False,4
6174,validator_43,130165986300,True,598500000,1755300,600255300,False,4
6175,validator_28,64636613070,True,553700000,2070540,555770540,False,2
6176,validator_0,61249828823,True,535759999,23679000,559438999,True,1
6177,validator_47,140162601050,True,521600000,3840700,525440700,False,4
6178,validator_25,69414946270,True,669100000,10615300,679715300,False,2
6179,validator_41,143063503110,True,719500000,3772340,723272340,False,4
6180,validator_34,590767406740,True,511600000,2697190,514297190,False,18
6181,validator_2,60022054159,True,831439996,54805290,886245286,True,1
6182,validator_38,63729869250,True,694500000,1744510,696244510,False,1
6183,validator_27,207878824640,True,599200000,19533210,618733210,False,6
6184,validator_15,642831199416,True,790640001,26506900,817146901,True,20
6185,validator_17,387335109715,True,785320002,40966300,826286302,True,12
6186,validator_34,591368371180,True,598300000,2664440,600964440,False,18
6187,validator_49,150551660500,True,729400000,10558100,739958100,False,4
6188,validator_25,69952970470,True,535700000,2324200,538024200,False,2
6189,validator_35,176942948940,True,594100000,7224260,601324260,False,5
6190,validator_46,217481459360,True,704800000,10373470,715173470,False,6
6191,validator_6,68177824499,True,801700006,25066820,826766826,True,2
6192,validator_17,387977667511,True,615139996,27417800,642557796,True,12
6193,validator_36,200008604350,True,645900000,4671300,650571300,False,6
6194,validator_8,61470064908,True,545899996,41725710,587625706,True,1
6195,validator_17,388631352130,True,630919999,22764620,653684619,True,12
6196,validator_46,218135316700,True,652500000,1357340,653857340,False,6
6197,validator_48,377275582920,True,894400000,3287580,897687580,False,11
6198,validator_5,143740830613,True,896200000,21136120,917336120,True,4
6199,validator_17,389277556251,True,622400001,23804120,646204121,True,12
6200,validator_34,592038144550,True,666300000,3473370,669773370,False,18
6201,validator_17,390117033655,True,818140004,21337400,839477404,True,12
6202,validator_2,60914903189,True,869096000,23753030,892849030,True,1
6203,validator_18,231904327327,True,523220003,44527800,567747803,True,7
6204,validator_34,592618321450,True,575100000,5076900,580176900,False,18
6205,validator_15,643673094840,True,814116004,27779420,841895424,True,20
6206,validator_14,259189187082,True,662900007,10993700,673893707,True,8
6207,validator_36,200623830410,True,607200000,8026060,615226060,False,6
6208,validator_34,593270833230,True,649300000,3211780,652511780,False,18
6209,validator_47,140759267150,True,595600000,1066100,596666100,False,4
6210,validator_6,68728105797,True,546759998,3521300,550281298,True,2
6211,validator_12,225706881394,True,594819995,25047190,619867185,True,7
6212,validator_15,644373558934,True,673670004,26794090,700464094,True,20
6213,validator_48,378039952240,True,760200000,4169320,764369320,False,11
6214,validator_17,390981557181,True,805739996,58783530,864523526,True,12
6215,validator_32,56936636340,True,570200000,2862900,573062900,False,1
6216,validator_7,151772319111,True,794419997,2551400,796971397,True,4
6217,validator_24,71882408608,True,790340005,7639720,797979725,True,2
6218,validator_15,645199109336,True,753760002,71790400,825550402,True,20
6219,validator_0,61958947249,True,662563996,46554430,709118426,True,1
6220,validator_46,218686244150,True,537400000,13527450,550927450,False,6
6221,validator_1,151960685046,True,641684001,27926500,669610501,True,4
6222,validator_14,260056608578,True,803439996,63981500,867421496,True,8
6223,validator_34,593934757980,True,652000000,11924750,663924750,False,18
6224,validator_12,226659827831,True,943040007,9906430,952946437,True,7
6225,validator_44,204941582390,True,605600000,13570400,619170400,False,6
6226,validator_20,67931723938,True,542500000,2616100,545116100,True,2
6227,validator_25,70460898680,True,486600000,21328210,507928210,False,2
6228,validator_31,352459779760,True,475300000,18582860,493882860,False,11
6229,validator_31,352968602750,True,490900000,17922990,508822990,False,11
6230,validator_46,219234517980,True,537680000,10593830,548273830,False,6
6231,validator_8,62283066836,True,756799998,56201930,813001928,True,1
6232,validator_31,353609344390,True,639400000,1341640,640741640,False,11
6233,validator_15,645975661966,True,725060000,51492630,776552630,True,20
6234,validator_36,201297092710,True,653100000,20162300,673262300,False,6
6235,validator_13,64754504715,True,652995998,26264030,679260028,True,2
6236,validator_15,646634647671,True,627994005,30991700,658985705,True,20
6237,validator_14,260761893674,True,653479996,51805100,705285096,True,8
6238,validator_17,391606299480,True,623299999,1442300,624742299,True,12
6239,validator_11,57656797599,True,582800000,559630,583359630,True,1
6240,validator_15,647367300673,True,731000002,1653000,732653002,True,20
6241,validator_34,594487452560,True,548600000,4094580,552694580,False,18
6242,validator_15,648032219772,True,649739999,15179100,664919099,True,20
6243,validator_41,143628634410,True,559900000,5231300,565131300,False,4
6244,validator_31,354127300890,True,513600000,4356500,517956500,False,11
6245,validator_37,142534710950,True,534300000,2345100,536645100,False,4
6246,validator_46,219763061610,True,523700000,4843630,528543630,False,6
6247,validator_31,354750680950,True,613800000,9580060,623380060,False,11
6248,validator_21,140971832315,True,722940002,10337410,733277412,True,4
6249,validator_46,220220183230,True,449200000,7921620,457121620,False,6
6250,validator_9,65118089469,True,685300000,706950,686006950,True,2
6251,validator_27,208459072750,True,578600000,1648110,580248110,False,6
6252,validator_36,201759598450,True,460400000,2105740,462505740,False,6
6253,validator_17,392201354208,True,570013998,25040730,595054728,True,12
6254,validator_40,69198919800,True,670200000,5519240,675719240,False,2
6255,validator_7,152457899734,True,674774003,10806620,685580623,True,4
6256,validator_43,130781141600,True,575600000,39555300,615155300,False,4
6257,validator_48,378722441300,True,679300000,3189060,682489060,False,11
6258,validator_5,144468977577,True,707020004,21126960,728146964,True,4
6259,validator_5,145177648873,True,658057996,50613300,708671296,True,4
6260,validator_48,379405132400,True,672800000,9891100,682691100,False,11
6261,validator_20,68424387368,True,485000000,7663430,492663430,True,2
6262,validator_32,57611877160,True,666100000,9140820,675240820,False,1
6263,validator_31,355290126830,True,536200000,3245880,539445880,False,11
6264,validator_4,56795248100,True,866360005,26012820,892372825,True,1
6265,validator_33,62060943250,True,601200000,17688080,618888080,False,1
6266,validator_9,66012198572,True,878560003,15549100,894109103,True,2
6267,validator_12,227425008481,True,706108000,59072650,765180650,True,7
6268,validator_31,355994105800,True,684200000,19778970,703978970,False,11
6269,validator_27,209083654650,True,622500000,2081900,624581900,False,6
6270,validator_7,153184544209,True,704480005,22164470,726644475,True,4
6271,validator_15,648629371411,True,594199999,2951640,597151639,True,20
6272,validator_40,69723994540,True,511700000,13374740,525074740,False,2
6273,validator_26,58823296090,True,719500000,17486140,736986140,False,1
6274,validator_18,232485785623,True,570756006,10702290,581458296,True,7
6275,validator_31,356665423600,True,669100000,2217800,671317800,False,11
6276,validator_17,392842834393,True,621640005,19840180,641480185,True,12
6277,validator_49,151298349200,True,735700000,10988700,746688700,False,4
6278,validator_15,649558284656,True,886620005,42293240,928913245,True,20
6279,validator_10,74620874262,True,780700003,2242920,782942923,True,2
6280,validator_34,595238937560,True,747800000,3685000,751485000,False,18
6281,validator_44,205578467750,True,617300000,19585360,636885360,False,6
6282,validator_35,177463557200,True,500300000,20308260,520608260,False,5
6283,validator_11,58312540033,True,605780004,49962430,655742434,True,1
6284,validator_35,178092580000,True,627300000,1722800,629022800,False,5
6285,validator_34,595826041090,True,584300000,2803530,587103530,False,18
6286,validator_36,202355121570,True,592900000,2623120,595523120,False,6
6287,validator_48,380082065070,True,662400000,14532670,676932670,False,11
6288,validator_15,650378408318,True,799879992,20243670,820123662,True,20
6289,validator_46,220804621150,True,583000000,1437920,584437920,False,6
6290,validator_22,157265068570,True,598879998,10214620,609094618,True,4
6291,validator_21,141641306043,True,626188008,43285720,669473728,True,4
6292,validator_14,261449492712,True,659219998,28379040,687599038,True,8
6293,validator_15,651104150100,True,699540002,26201780,725741782,True,20
6294,validator_41,144144391560,True,505800000,9957150,515757150,False,4
6295,validator_48,380506172100,True,422400000,1707030,424107030,False,11
6296,validator_21,142311295064,True,660960001,9029020,669989021,True,4
6297,validator_19,146412235217,True,999516003,15909070,1015425073,True,4
6298,validator_31,357293588590,True,626300000,1864990,628164990,False,11
6299,validator_41,144628144480,True,477500000,6252920,483752920,False,4
6300,validator_18,233192892318,True,704899995,2206700,707106695,True,7
6301,validator_46,221465132910,True,653700000,6811760,660511760,False,6
6302,validator_44,206289544680,True,691000000,20076930,711076930,False,6
6303,validator_14,262336873716,True,874400004,12981000,887381004,True,8
6304,validator_27,209650121690,True,562600000,3867040,566467040,False,6
6305,validator_5,145724014479,True,532320006,14045600,546365606,True,4
6306,validator_18,234008867927,True,807099999,8875610,815975609,True,7
6307,validator_30,127551672590,True,737500000,5266300,742766300,False,3
6308,validator_9,66820089451,True,800819999,7070880,807890879,True,2
6309,validator_17,393616259718,True,752319995,21105330,773425325,True,12
6310,validator_15,651749925535,True,639159995,6615440,645775435,True,20
6311,validator_47,141493021230,True,722900000,10854080,733754080,False,4
6312,validator_17,394280481314,True,650959996,13261600,664221596,True,12
6313,validator_47,142082228830,True,580000000,9207600,589207600,False,4
6314,validator_18,234558194327,True,545400000,3926400,549326400,True,7
6315,validator_5,146279085655,True,540619996,14451180,555071176,True,4
6316,validator_2,61866930364,True,931040005,20987170,952027175,True,1
6317,validator_34,596322264800,True,481700000,14523710,496223710,False,18
6318,validator_15,652462359800,True,701428005,11006260,712434265,True,20
6319,validator_40,70186094600,True,441200000,20900060,462100060,False,2
6320,validator_34,596956382200,True,625700000,8417400,634117400,False,18
6321,validator_6,69690625388,True,959200001,3319590,962519591,True,2
6322,validator_34,597573157680,True,610200000,6575480,616775480,False,18
6323,validator_3,65466880059,True,678559993,3644120,682204113,True,2
6324,validator_34,598306772230,True,723000000,10614550,733614550,False,18
6325,validator_24,72768801757,True,877839989,8553160,886393149,True,2
6326,validator_31,357895643430,True,599800000,2254840,602054840,False,11
6327,validator_46,222096878170,True,622700000,9045260,631745260,False,6
6328,validator_17,394946028554,True,641400000,24147240,665547240,True,12
6329,validator_43,131405197400,True,621300000,2755800,624055800,False,4
6330,validator_30,127996880020,True,436800000,8407430,445207430,False,3
6331,validator_6,70466946565,True,758399997,17921180,776321177,True,2
6332,validator_15,653196555400,True,719700000,14495600,734195600,True,20
6333,validator_15,653657800974,True,457820004,3425570,461245574,True,20
6334,validator_19,147056236521,True,624300004,19701300,644001304,True,4
6335,validator_37,143253094920,True,705600000,12783970,718383970,False,4
6336,validator_21,142958000286,True,623719992,22985230,646705222,True,4
6337,validator_34,598989024360,True,679200000,3052130,682252130,False,18
6338,validator_15,654352872024,True,655870000,39201050,695071050,True,20
6339,validator_27,210388082040,True,736300000,1660350,737960350,False,6
6340,validator_31,358533551270,True,629100000,8807840,637907840,False,11
6341,validator_17,395637270959,True,673504005,17738400,691242405,True,12
6342,validator_34,599830495860,True,839400000,2071500,841471500,False,18
6343,validator_17,396417724861,True,771620002,8833900,780453902,True,12
6344,validator_19,147694424875,True,631299994,6888360,638188354,True,4
6345,validator_49,151942735300,True,605300000,39086100,644386100,False,4
6346,validator_31,359250963670,True,702800000,14612400,717412400,False,11
6347,validator_48,380950989450,True,442000000,2817350,444817350,False,11
6348,validator_27,211124807180,True,733500000,3225140,736725140,False,6
6349,validator_35,178794583870,True,693700000,8303870,702003870,False,5
6350,validator_7,153789344133,True,596120004,8679920,604799924,True,4
6351,validator_18,235147223972,True,569789995,19239650,589029645,True,7
6352,validator_15,654891669829,True,534899995,3897810,538797805,True,20
6353,validator_20,69364011768,True,931200000,8424400,939624400,True,2
6354,validator_17,397043277495,True,602080004,23472630,625552634,True,12
6355,validator_49,152561107600,True,606500000,11872300,618372300,False,4
6356,validator_46,222829036570,True,730100000,2058400,732158400,False,6
6357,validator_41,145169522540,True,533700000,7678060,541378060,False,4
6358,validator_34,600521681480,True,690300000,885620,691185620,False,18
6359,validator_46,223357648470,True,515600000,13011900,528611900,False,6
6360,validator_29,55875737450,True,483140000,9437570,492577570,False,1
6361,validator_20,70247675483,True,854640005,29023710,883663715,True,2
6362,validator_15,655620049432,True,675980003,52399600,728379603,True,20
6363,validator_17,397690955436,True,609198001,38479940,647677941,True,12
6364,validator_12,228160428184,True,720740003,14679700,735419703,True,7
6365,validator_12,228828642991,True,660957997,7256810,668214807,True,7
6366,validator_18,235904670144,True,754900002,2546170,757446172,True,7
6367,validator_18,236894915941,True,951799997,38445800,990245797,True,7
6368,validator_27,211716193580,True,572000000,19386400,591386400,False,6
6369,validator_48,381521698860,True,568200000,2509410,570709410,False,11
6370,validator_31,359991234630,True,734000000,6270960,740270960,False,11
6371,validator_5,146897201452,True,615599997,2515800,618115797,True,4
6372,validator_43,132070944730,True,661700000,4047330,665747330,False,4
6373,validator_14,262901299693,True,543539997,20885980,564425977,True,8
6374,validator_15,656097667932,True,475500000,2118500,477618500,True,20
6375,validator_34,601209625690,True,668500000,19444210,687944210,False,18
6376,validator_46,223899259670,True,539000000,2611200,541611200,False,6
6377,validator_34,601677821830,True,467400000,796140,468196140,False,18
6378,validator_22,157888629123,True,620599993,2960560,623560553,True,4
6379,validator_15,656830852195,True,722299993,10884270,733184263,True,20
6380,validator_27,212236205530,True,517400000,2611950,520011950,False,6
6381,validator_16,69543778085,True,735700008,20347980,756047988,True,2
6382,validator_15,657558740432,True,672597997,55290240,727888237,True,20
6383,validator_46,224478818330,True,575800000,3758660,579558660,False,7
6384,validator_1,152402927871,True,439599995,2642830,442242825,True,4
6385,validator_0,62943911152,True,961600003,23363900,984963903,True,1
6386,validator_31,360647624820,True,654100000,2290190,656390190,False,11
6387,validator_38,64250723870,True,514900000,5954620,520854620,False,2
6388,validator_34,602136207260,True,433300000,25085430,458385430,False,18
6389,validator_31,361266590670,True,615900000,3065850,618965850,False,11
6390,validator_36,203036169470,True,678200000,2847900,681047900,False,6
6391,validator_37,143956612980,True,701500000,2018060,703518060,False,4
6392,validator_36,203786612020,True,749800000,642550,750442550,False,6
6393,validator_48,382127640330,True,591700000,14241470,605941470,False,11
6394,validator_22,158671318064,True,778460001,4228940,782688941,True,4
6395,validator_45,58613960030,True,501070000,2786450,503856450,False,1
6396,validator_48,382783599740,True,648900000,7059410,655959410,False,11
6397,validator_29,56416191850,True,515900000,24554400,540454400,False,1
6398,validator_15,658323588747,True,747639995,17208320,764848315,True,20
6399,validator_49,153038668180,True,471000000,6560580,477560580,False,4
6400,validator_20,70771674989,True,506620006,17379500,523999506,True,2
6401,validator_48,383310310820,True,523300000,3411080,526711080,False,11
6402,validator_46,225148824240,True,663300000,6705910,670005910,False,7
6403,validator_4,57372328768,True,563070008,14010660,577080668,True,1
6404,validator_49,153734227680,True,693800000,1759500,695559500,False,4
6405,validator_35,179343406850,True,523600000,25222980,548822980,False,5
6406,validator_48,383916350250,True,587000000,19039430,606039430,False,11
6407,validator_15,659075987649,True,678780002,73618900,752398902,True,20
6408,validator_35,180038858290,True,686700000,8751440,695451440,False,5
6409,validator_31,361835011810,True,560600000,7821140,568421140,False,11
6410,validator_16,70544458295,True,986434000,14246210,1000680210,True,2
6411,validator_17,398514131003,True,814800007,8375560,823175567,True,12
6412,validator_9,68063152448,True,1218380007,24682990,1243062997,True,2
6413,validator_15,659595020376,True,477806007,41226720,519032727,True,20
6414,validator_13,65424377366,True,646300001,23572650,669872651,True,2
6415,validator_34,602689591260,True,552500000,884000,553384000,False,18
6416,validator_14,264018172325,True,1112800002,4072630,1116872632,True,8
6417,validator_27,212725468040,True,470500000,18762510,489262510,False,6
6418,validator_36,204219147750,True,428900000,3635730,432535730,False,6
6419,validator_12,229680156519,True,820163998,31349530,851513528,True,7
6420,validator_20,71393670280,True,620500001,1495290,621995291,True,2
6421,validator_39,62975149880,True,569800000,2577500,572377500,False,1
6422,validator_27,213350360620,True,622800000,2092580,624892580,False,6
6423,validator_41,145852771500,True,672800000,10448960,683248960,False,4
6424,validator_19,148351100374,True,628799999,27875500,656675499,True,4
6425,validator_12,230297311478,True,606619999,10534960,617154959,True,7
6426,validator_15,660172416818,True,574700002,2696440,577396442,True,20
6427,validator_42,58595686120,True,597800000,10542800,608342800,False,1
6428,validator_15,660910483490,True,734810002,3256670,738066672,True,20
6429,validator_28,65159057040,True,514100000,8343970,522443970,False,2
6430,validator_21,143655851964,True,673999998,23851680,697851678,True,4
6431,validator_27,213998143990,True,642200000,5583370,647783370,False,6
6432,validator_41,146562426910,True,689100000,20555410,709655410,False,4
6433,validator_47,142805214530,True,715400000,7585700,722985700,False,4
6434,validator_10,75560484159,True,932345997,7263900,939609897,True,2
6435,validator_25,70849024520,True,377130000,10995840,388125840,False,2
6436,validator_34,603275551840,True,585300000,660580,585960580,False,18
6437,validator_17,399066279605,True,541960002,10188600,552148602,True,12
6438,validator_49,154286605660,True,543100000,9277980,552377980,False,4
6439,validator_22,159435173170,True,719117996,44737110,763855106,True,4
6440,validator_15,661709308366,True,770619996,28204880,798824876,True,20
6441,validator_48,384458329690,True,539800000,2179440,541979440,False,12
6442,validator_47,143474386330,True,648500000,20671800,669171800,False,4
6443,validator_2,62716859914,True,817800000,32129550,849929550,True,1
6444,validator_12,230968918386,True,661666008,9940900,671606908,True,7
6445,validator_34,604024837720,True,725200000,24085880,749285880,False,18
6446,validator_48,385113063890,True,636600000,18134200,654734200,False,12
6447,validator_34,604684123750,True,656800000,2486030,659286030,False,18
6448,validator_31,362372905190,True,531700000,6193380,537893380,False,11
6449,validator_31,363157424090,True,781100000,3418900,784518900,False,11
6450,validator_31,363783112300,True,623000000,2688210,625688210,False,11
6451,validator_15,662309824467,True,591880001,8636100,600516101,True,20
6452,validator_18,237670129772,True,764420001,10793830,775213831,True,7
6453,validator_28,65616431980,True,454940000,2434940,457374940,False,2
6454,validator_21,144289675665,True,631100001,2723700,633823701,True,4
6455,validator_11,59114129370,True,738343997,63245340,801589337,True,1
6456,validator_48,385861487080,True,746500000,1923190,748423190,False,12
6457,validator_46,225676029260,True,505900000,21305020,527205020,False,7
6458,validator_35,180818453490,True,778100000,1495200,779595200,False,5
6459,validator_15,663218808865,True,880599998,28384400,908984398,True,20
6460,validator_31,364368177400,True,578900000,6165100,585065100,False,11
6461,validator_34,605297397770,True,609800000,3474020,613274020,False,18
6462,validator_17,399718631329,True,623913994,28437730,652351724,True,12
6463,validator_15,663834011686,True,592919991,22282830,615202821,True,20
6464,validator_37,144595364720,True,616700000,22051740,638751740,False,4
6465,validator_46,226348032070,True,651700000,20302810,672002810,False,7
6466,validator_12,231661347826,True,668460000,23969440,692429440,True,7
6467,validator_1,153195322216,True,768160005,24234340,792394345,True,4
6468,validator_19,148924177769,True,560679995,12397400,573077395,True,4
6469,validator_21,144893503465,True,601700000,2127800,603827800,True,4
6470,validator_34,605951359370,True,650600000,3361600,653961600,False,18
6471,validator_14,264673060322,True,640860007,14027990,654887997,True,8
6472,validator_34,606448933970,True,477700000,19874600,497574600,False,18
6473,validator_15,664595147513,True,738699997,22435830,761135827,True,20
6474,validator_15,665370860512,True,774399999,1313000,775712999,True,20
6475,validator_49,154909671680,True,621600000,1466020,623066020,False,4
6476,validator_8,62889565729,True,599360003,7138890,606498893,True,1
6477,validator_24,73672330660,True,879000003,24528900,903528903,True,2
6478,validator_30,128558689250,True,558800000,3009230,561809230,False,4
6479,validator_49,155574587500,True,645000000,19915820,664915820,False,4
6480,validator_31,364918360220,True,533000000,17182820,550182820,False,11
6481,validator_44,206755334100,True,461500000,4289420,465789420,False,6
6482,validator_49,156063706400,True,481400000,7718900,489118900,False,4
6483,validator_44,207389231190,True,631770000,2127090,633897090,False,6
6484,validator_34,607067404090,True,607000000,11470120,618470120,False,18
6485,validator_17,400409338054,True,645940005,44766720,690706725,True,12
6486,validator_25,71543025520,True,682300000,11701000,694001000,False,2
6487,validator_48,386411725580,True,526600000,23638500,550238500,False,12
6488,validator_29,57044293750,True,606900000,21201900,628101900,False,1
6489,validator_17,401062051219,True,643719995,8993170,652713165,True,12
6490,validator_35,181518012660,True,697600000,1959170,699559170,False,5
6491,validator_46,226981925550,True,631300000,2593480,633893480,False,7
6492,validator_30,129400893010,True,832500000,9703760,842203760,False,4
6493,validator_12,232227783834,True,559299998,7136010,566436008,True,7
6494,validator_46,227666922350,True,672800000,12196800,684996800,False,7
6495,validator_38,64909427070,True,651700000,7003200,658703200,False,2
6496,validator_10,76196865662,True,604479993,31901510,636381503,True,2
6497,validator_5,147495674675,True,591999993,6473230,598473223,True,4
6498,validator_44,207866071890,True,474500000,2340700,476840700,False,6
6499,validator_23,65857056431,True,813270000,31264900,844534900,True,2
6500,validator_9,68717082938,True,646500000,7430490,653930490,True,2
6501,validator_17,401789824225,True,690000006,37773000,727773006,True,12
6502,validator_14,265158703766,True,461300004,24343440,485643444,True,8
6503,validator_33,62733835590,True,671300000,1592340,672892340,False,1
6504,validator_43,132587401350,True,512800000,3656620,516456620,False,4
6505,validator_15,666031752411,True,659499999,1391900,660891899,True,20
6506,validator_12,232867696732,True,624199998,15712900,639912898,True,7
6507,validator_17,402559960474,True,762257999,7878250,770136249,True,12
6508,validator_48,387107393760,True,686800000,8868180,695668180,False,12
6509,validator_23,66593421723,True,715580002,20785290,736365292,True,2
6510,validator_30,130173257010,True,770600000,1764000,772364000,False,4
6511,validator_48,387699564460,True,590000000,2170700,592170700,False,12
6512,validator_44,208375964200,True,509100000,792310,509892310,False,6
6513,validator_1,154039266250,True,804953994,38990040,843944034,True,4
6514,validator_35,182163396040,True,634600000,10783380,645383380,False,5
6515,validator_9,69407940979,True,682820001,8038040,690858041,True,2
6516,validator_17,403210627863,True,639199999,11467390,650667389,True,12
6517,validator_28,66291684860,True,674100000,1152880,675252880,False,2
6518,validator_41,147231057270,True,665910000,2720360,668630360,False,4
6519,validator_31,365673598020,True,745100000,10137800,755237800,False,11
6520,validator_7,154381734063,True,562354000,30035930,592389930,True,4
6521,validator_15,666821185774,True,782800003,6633360,789433363,True,20
6522,validator_46,228160295430,True,491300000,2073080,493373080,False,7
6523,validator_15,667571631914,True,711700010,38746130,750446140,True,20
6524,validator_6,71118924766,True,645720001,6258200,651978201,True,2
6525,validator_3,66206783456,True,702219997,37683400,739903397,True,2
6526,validator_34,607515297120,True,441900000,5993030,447893030,False,18
6527,validator_22,160229664412,True,791900002,2591240,794491242,True,5
6528,validator_15,668244035217,True,654000003,18403300,672403303,True,20
6529,validator_17,403791664048,True,541500005,39536180,581036185,True,12
6530,validator_34,608000797740,True,483100000,2400620,485500620,False,19
6531,validator_39,63690961960,True,712700000,3112080,715812080,False,1
6532,validator_44,208926681830,True,546200000,4517630,550717630,False,6
6533,validator_44,209450298450,True,521100000,2516620,523616620,False,6
6534,validator_27,214398554730,True,397400000,3010740,400410740,False,6
6535,validator_48,388291641360,True,590600000,1476900,592076900,False,12
6536,validator_14,265783214271,True,598620005,25890500,624510505,True,8
6537,validator_48,388934119260,True,640500000,1977900,642477900,False,12
6538,validator_46,228826075330,True,657100000,8679900,665779900,False,7
6539,validator_15,668741993522,True,435880005,62078300,497958305,True,20
6540,validator_22,160766712782,True,530000010,7048360,537048370,True,5
6541,validator_9,69965843803,True,520979994,36922830,557902824,True,2
6542,validator_30,130669765830,True,486600000,9908820,496508820,False,4
6543,validator_18,238353072798,True,663920006,19023020,682943026,True,7
6544,validator_41,147818382510,True,584300000,3025240,587325240,False,4
6545,validator_43,133139119780,True,548200000,3518430,551718430,False,4
6546,validator_34,608530602530,True,509700000,20104790,529804790,False,19
6547,validator_31,366315215260,True,637700000,3917240,641617240,False,11
6548,validator_3,66872217867,True,644700001,20734410,665434411,True,2
6549,validator_37,145148780920,True,548800000,4616200,553416200,False,4
6550,validator_10,76827305663,True,616300001,14140000,630440001,True,2
6551,validator_18,238963219967,True,593485999,16661170,610147169,True,7
6552,validator_18,239862943928,True,877040001,22683960,899723961,True,7
6553,validator_28,66877777450,True,575000000,11092590,586092590,False,2
6554,validator_1,154678214050,True,629100000,9847800,638947800,True,4
6555,validator_19,149505334207,True,572279998,8876440,581156438,True,4
6556,validator_41,148283058030,True,462600000,2075520,464675520,False,4
6557,validator_14,266327821202,True,534400001,10206930,544606931,True,8
6558,validator_18,240675647480,True,793100002,19603550,812703552,True,7
6559,validator_19,150337229932,True,822100005,9795720,831895725,True,4
6560,validator_34,609238983910,True,706600000,1781380,708381380,False,19
6561,validator_1,155317464755,True,614400005,24850700,639250705,True,4
6562,validator_48,389558441690,True,621900000,2422430,624322430,False,12
6563,validator_35,182664225450,True,498800000,2029410,500829410,False,5
6564,validator_43,133816279220,True,655400000,21759440,677159440,False,4
6565,validator_7,155004688809,True,595300006,27654740,622954746,True,4
6566,validator_40,70717714730,True,520100000,11520130,531620130,False,2
6567,validator_34,609833045240,True,592400000,1661330,594061330,False,19
6568,validator_39,64378660160,True,685100000,2598200,687698200,False,2
6569,validator_17,404417437026,True,615663998,10108980,625772978,True,12
6570,validator_13,66220178032,True,778200006,17600660,795800666,True,2
6571,validator_45,59122195640,True,506610000,1625610,508235610,False,1
6572,validator_34,610534510000,True,673300000,28164760,701464760,False,19
6573,validator_36,204917709750,True,691000000,7562000,698562000,False,6
6574,validator_48,390340348800,True,780200000,1707110,781907110,False,12
6575,validator_28,67564323430,True,677100000,9445980,686545980,False,2
6576,validator_47,144114795460,True,621100000,19309130,640409130,False,4
6577,validator_49,156558513460,True,473100000,21707060,494807060,False,4
6578,validator_12,233455495733,True,579320001,8479000,587799001,True,7
6579,validator_31,366975793600,True,646700000,13878340,660578340,False,11
6580,validator_16,71097454470,True,514140005,38856170,552996175,True,2
6581,validator_48,391081338780,True,714900000,26089980,740989980,False,12
6582,validator_15,669425261084,True,680700002,2567560,683267562,True,20
6583,validator_43,134621531200,True,804200000,1051980,805251980,False,4
6584,validator_17,405065436802,True,636339996,11659780,647999776,True,12
6585,validator_25,72208312570,True,657800000,7487050,665287050,False,2
6586,validator_15,670153564720,True,685183996,43119640,728303636,True,20
6587,validator_4,58166011087,True,748459999,45222320,793682319,True,1
6588,validator_41,148951397610,True,667800000,539580,668339580,False,4
6589,validator_41,149386828510,True,432100000,3330900,435430900,False,4
6590,validator_46,229465104350,True,636000000,3029020,639029020,False,7
6591,validator_41,149938556650,True,548400000,3328140,551728140,False,4
6592,validator_29,57668268180,True,614100000,9874430,623974430,False,1
6593,validator_9,70599868409,True,593060006,40964600,634024606,True,2
6594,validator_47,144640776530,True,523300000,2681070,525981070,False,4
6595,validator_43,135082152270,True,454400000,6221070,460621070,False,4
6596,validator_44,210105889500,True,648400000,7191050,655591050,False,6
6597,validator_22,161651461714,True,875739992,9008940,884748932,True,5
6598,validator_15,670887362213,True,720139993,13657500,733797493,True,20
6599,validator_33,63326510620,True,590500000,2175030,592675030,False,1
6600,validator_34,611268120200,True,730800000,2810200,733610200,False,19
6601,validator_37,145723503420,True,558600000,16122500,574722500,False,4
6602,validator_17,405800571242,True,710020000,25114440,735134440,True,12
6603,validator_30,131361172770,True,671300000,20106940,691406940,False,4
6604,validator_14,267066530413,True,730420001,8289210,738709211,True,8
6605,validator_46,230154951360,True,678900000,10947010,689847010,False,7
6606,validator_49,157292491570,True,720100000,13878110,733978110,False,4
6607,validator_31,367589227200,True,610800000,2633600,613433600,False,11
6608,validator_18,241193998601,True,516900001,1451120,518351121,True,7
6609,validator_16,71610032209,True,510199999,2377740,512577739,True,2
6610,validator_27,215040382900,True,639700000,2128170,641828170,False,6
6611,validator_34,611791342500,True,520500000,2722300,523222300,False,19
6612,validator_26,59582329790,True,751300000,7733700,759033700,False,1
6613,validator_18,241982680230,True,737699999,50981630,788681629,True,7
6614,validator_48,391637033540,True,544200000,11494760,555694760,False,12
6615,validator_29,58170832520,True,498000000,4564340,502564340,False,1
6616,validator_5,148079661612,True,577768007,6218930,583986937,True,4
6617,validator_44,210708659890,True,586700000,16070390,602770390,False,6
6618,validator_21,145727916058,True,823470003,10942590,834412593,True,4
6619,validator_35,183391032730,True,720500000,6307280,726807280,False,5
6620,validator_28,68217465800,True,650610000,2532370,653142370,False,2
6621,validator_15,671556936515,True,635474002,34100300,669574302,True,20
6622,validator_34,612414209870,True,618300000,4567370,622867370,False,19
6623,validator_44,211333885980,True,605800000,19426090,625226090,False,6
6624,validator_32,58348412150,True,727200000,9334990,736534990,False,1
6625,validator_19,151006073830,True,642739998,26103900,668843898,True,4
6626,validator_39,64905862060,True,523400000,3801900,527201900,False,2
6627,validator_18,242561737231,True,577100001,1957000,579057001,True,7
6628,validator_35,183869337880,True,473200000,5105150,478305150,False,5
6629,validator_49,157881512960,True,586100000,2921390,589021390,False,4
6630,validator_15,672231210837,True,625746002,48528320,674274322,True,21
6631,validator_31,368245793930,True,654500000,2066730,656566730,False,11
6632,validator_14,267845761737,True,755720004,23511320,779231324,True,8
6633,validator_17,406493941284,True,689840002,3530040,693370042,True,12
6634,validator_15,673040869150,True,749467993,60190320,809658313,True,21
6635,validator_31,368838849870,True,582500000,10555940,593055940,False,11
6636,validator_34,612884893670,True,454700000,15983800,470683800,False,19
6637,validator_14,268464316725,True,589399998,29154990,618554988,True,8
6638,validator_48,392197451300,True,559500000,917760,560417760,False,12
6639,validator_44,211921963930,True,585600000,2477950,588077950,False,6
6640,validator_15,673884712018,True,789753998,54088870,843842868,True,21
6641,validator_34,613505856400,True,586200000,34762730,620962730,False,19
6642,validator_15,674457759110,True,570600002,2447090,573047092,True,21
6643,validator_48,392636401890,True,436200000,2750590,438950590,False,12
6644,validator_47,145221800230,True,576100000,4923700,581023700,False,4
6645,validator_49,158489949360,True,607800000,636400,608436400,False,4
6646,validator_48,393188417280,True,550000000,2015390,552015390,False,12
6647,validator_49,159052737310,True,560300000,2487950,562787950,False,4
6648,validator_43,135812298970,True,720300000,9846700,730146700,False,4
6649,validator_3,67646560466,True,771299999,3042600,774342599,True,2
6650,validator_48,393696432900,True,502100000,5915620,508015620,False,12
6651,validator_46,230581775950,True,407200000,19624590,426824590,False,7
6652,validator_7,155712536995,True,688639996,19208190,707848186,True,4
6653,validator_46,231239477170,True,652100000,5601220,657701220,False,7
6654,validator_25,72753520890,True,534400000,10808320,545208320,False,2
6655,validator_19,151795385627,True,757097997,32213800,789311797,True,4
6656,validator_15,675167562267,True,688119997,21683160,709803157,True,21
6657,validator_48,394213122280,True,511300000,5389380,516689380,False,12
6658,validator_27,215575832580,True,532000000,3449680,535449680,False,6
6659,validator_17,407070762088,True,573560004,3260800,576820804,True,12
6660,validator_34,614109645980,True,600100000,3689580,603789580,False,19
6661,validator_12,234064904632,True,593863999,15544900,609408899,True,7
6662,validator_25,73294102130,True,520200000,20381240,540581240,False,2
6663,validator_18,243227770858,True,662499997,3533630,666033627,True,7
6664,validator_31,369383156770,True,542100000,2206900,544306900,False,11
6665,validator_49,159989644610,True,934400000,2507300,936907300,False,4
6666,validator_49,160639282690,True,645600000,4038080,649638080,False,5
6667,validator_17,407783198774,True,707900006,4536680,712436686,True,12
6668,validator_28,68638352840,True,400500000,20387040,420887040,False,2
6669,validator_12,235309711421,True,1242300009,2506780,1244806789,True,7
6670,validator_47,145649375770,True,424200000,3375540,427575540,False,4
6671,validator_8,63734653282,True,833700003,11387550,845087553,True,1
6672,validator_35,184552227360,True,671200000,11689480,682889480,False,5
6673,validator_45,59682051080,True,556900000,2955440,559855440,False,1
6674,validator_24,74436296559,True,732799999,31165900,763965899,True,2
6675,validator_44,212432462730,True,508700000,1798800,510498800,False,6
6676,validator_19,152523181964,True,689498007,38298330,727796337,True,4
6677,validator_18,243908883658,True,661300000,19812800,681112800,True,7
6678,validator_13,66929534128,True,687719996,21636100,709356096,True,2
6679,validator_34,614576496000,True,462900000,3950020,466850020,False,19
6680,validator_46,231733426170,True,490410000,3539000,493949000,False,7
6681,validator_48,394763848010,True,547900000,2825730,550725730,False,12
6682,validator_41,150610506230,True,655100000,16849580,671949580,False,4
6683,validator_17,408526608152,True,728019998,15389380,743409378,True,12
6684,validator_40,71367358970,True,646700000,2944240,649644240,False,2
6685,validator_10,77610876366,True,770800003,12770700,783570703,True,2
6686,validator_18,244462312441,True,552199993,1228790,553428783,True,7
6687,validator_47,146410414770,True,759100000,1939000,761039000,False,4
6688,validator_7,156368351599,True,634350004,21464600,655814604,True,4
6689,validator_0,63829689837,True,865439995,20338690,885778685,True,1
6690,validator_48,395340937780,True,574200000,2889770,577089770,False,12
6691,validator_15,675896952862,True,720799995,8590600,729390595,True,21
6692,validator_34,615049299640,True,471040000,1763640,472803640,False,19
6693,validator_34,615453468740,True,401500000,2669100,404169100,False,19
6694,validator_17,409188558191,True,617219999,44730040,661950039,True,12
6695,validator_17,409757832587,True,567299996,1974400,569274396,True,12
6696,validator_31,369923667170,True,536100000,4410400,540510400,False,11
6697,validator_17,410570666987,True,795800000,17034400,812834400,True,12
6698,validator_48,396068050310,True,715800000,11312530,727112530,False,12
6699,validator_27,216118796530,True,531200000,11763950,542963950,False,6
6700,validator_15,676624933581,True,692659989,35320730,727980719,True,21
6701,validator_44,213100221750,True,664800000,2959020,667759020,False,6
6702,validator_4,58970070140,True,778599993,25459060,804059053,True,1
6703,validator_15,677434101679,True,782460008,26708090,809168098,True,21
6704,validator_11,59611397306,True,494120006,3147930,497267936,True,1
6705,validator_16,72288410705,True,647139996,31238500,678378496,True,2
6706,validator_39,65499807900,True,586000000,7945840,593945840,False,2
6707,validator_15,678044620350,True,587380001,23138670,610518671,True,21
6708,validator_34,615944916260,True,471600000,19847520,491447520,False,19
6709,validator_34,616428907560,True,481000000,2991300,483991300,False,19
6710,validator_27,216840195440,True,718700000,2698910,721398910,False,6
6711,validator_19,153197749098,True,628539994,46027140,674567134,True,4
6712,validator_48,396646602410,True,549100000,29452100,578552100,False,12
6713,validator_6,71763904580,True,623699994,21279820,644979814,True,2
6714,validator_46,232423264110,True,686400000,3437940,689837940,False,7
6715,validator_36,205546710590,True,627300000,1700840,629000840,False,6
6716,validator_35,185183203600,True,629200000,1776240,630976240,False,5
6717,validator_12,235939501642,True,626320001,3470220,629790221,True,7
6718,validator_33,63867847990,True,536900000,4437370,541337370,False,1
6719,validator_14,269255328148,True,771240003,19771420,791011423,True,8
6720,validator_22,162578776218,True,877608004,49706500,927314504,True,5
6721,validator_46,233200757000,True,759200000,18292890,777492890,False,7
6722,validator_31,370537986520,True,611300000,3019350,614319350,False,11
6723,validator_41,151181370180,True,565100000,5763950,570863950,False,4
6724,validator_46,233886891160,True,682700000,3434160,686134160,False,7
6725,validator_34,616973846760,True,538700000,6239200,544939200,False,19
6726,validator_7,157086869816,True,691699997,26818220,718518217,True,4
6727,validator_31,371144240120,True,595600000,10653600,606253600,False,11
6728,validator_10,78114488070,True,489908004,13703700,503611704,True,2
6729,validator_34,617445890560,True,452100000,19943800,472043800,False,19
6730,validator_17,411397892892,True,816640005,10585900,827225905,True,12
6731,validator_34,618038102660,True,571600000,20612100,592212100,False,19
6732,validator_48,397296075290,True,639100000,10372880,649472880,False,12
6733,validator_3,68365465494,True,687999998,30905030,718905028,True,2
6734,validator_5,148777590151,True,695499999,2428540,697928539,True,4
6735,validator_19,153946614376,True,716259998,32605280,748865278,True,4
6736,validator_35,185653388600,True,439200000,30985000,470185000,False,5
6737,validator_1,156009084636,True,661620001,29999880,691619881,True,4
6738,validator_18,245105818044,True,635400003,8105600,643505603,True,7
6739,validator_15,678721409447,True,656999997,19789100,676789097,True,21
6740,validator_18,245935767995,True,811740001,18209950,829949951,True,7
6741,validator_20,71978176425,True,558640005,25866140,584506145,True,2
6742,validator_40,71747075800,True,378000000,1716830,379716830,False,2
6743,validator_8,64398136120,True,646139998,17342840,663482838,True,2
6744,validator_5,149405923099,True,599820008,28512940,628332948,True,4
6745,validator_12,236838089944,True,859220002,39368300,898588302,True,7
6746,validator_31,371869820160,True,699400000,26180040,725580040,False,11
6747,validator_14,269920774375,True,628899997,36546230,665446227,True,8
6748,validator_34,618634008890,True,586500000,9406230,595906230,False,19
6749,validator_35,186219947490,True,565300000,1258890,566558890,False,5
6750,validator_6,72326130123,True,543100003,19125540,562225543,True,2
6751,validator_27,217408182470,True,559600000,8387030,567987030,False,6
6752,validator_49,161181116120,True,541300000,533430,541833430,False,5
6753,validator_48,398086974930,True,789400000,1499640,790899640,False,12
6754,validator_18,246633056710,True,675559995,21728720,697288715,True,7
6755,validator_48,398703700750,True,615500000,1225820,616725820,False,12
6756,validator_23,67389253869,True,764619996,31212150,795832146,True,2
6757,validator_36,206272195090,True,718300000,7184500,725484500,False,6
6758,validator_30,132014443860,True,651200000,2071090,653271090,False,4
6759,validator_44,213564306290,True,460880000,3204540,464084540,False,6
6760,validator_49,162064877460,True,877600000,6161340,883761340,False,5
6761,validator_45,60280873630,True,595900000,2922550,598822550,False,1
6762,validator_44,214053567390,True,468400000,20861100,489261100,False,6
6763,validator_40,72246228130,True,496900000,2252330,499152330,False,2
6764,validator_49,162802413690,True,717000000,20536230,737536230,False,5
6765,validator_17,411929812497,True,475618005,56301600,531919605,True,12
6766,validator_43,136407198100,True,575200000,19699130,594899130,False,4
6767,validator_31,372563628400,True,683000000,10808240,693808240,False,11
6768,validator_19,154761211776,True,797520000,17077400,814597400,True,4
6769,validator_25,73836152750,True,539200000,2850620,542050620,False,2
6770,validator_47,146882932510,True,452970000,19547740,472517740,False,4
6771,validator_47,147590450420,True,703600000,3917910,707517910,False,4
6772,validator_43,137080683360,True,671000000,2485260,673485260,False,4
6773,validator_15,679335893100,True,591014003,23469650,614483653,True,21
6774,validator_34,619211870230,True,576200000,1661340,577861340,False,19
6775,validator_44,214784728360,True,725100000,6060970,731160970,False,6
6776,validator_20,72546694060,True,548440005,20077630,568517635,True,2
6777,validator_41,151804104780,True,615600000,7134600,622734600,False,4
6778,validator_48,399161806550,True,451850000,6255800,458105800,False,12
6779,validator_15,679775933632,True,436860002,3180530,440040532,True,21
6780,validator_35,186845636680,True,590100000,35589190,625689190,False,5
6781,validator_43,137524434280,True,442100000,1650920,443750920,False,4
6782,validator_35,187636188130,True,781200000,9351450,790551450,False,5
6783,validator_34,619677387510,True,450900000,14617280,465517280,False,19
6784,validator_9,71516192315,True,909400006,6923900,916323906,True,2
6785,validator_34,620267245500,True,585700000,4157990,589857990,False,19
6786,validator_34,620888609760,True,613000000,8364260,621364260,False,19
6787,validator_34,621333321390,True,434800000,9911630,444711630,False,19
6788,validator_36,206840497500,True,566800000,1502410,568302410,False,6
6789,validator_29,58764273620,True,585900000,7541100,593441100,False,1
6790,validator_17,412415397042,True,474700005,10884540,485584545,True,12
6791,validator_31,373058195910,True,493200000,1367510,494567510,False,11
6792,validator_49,163365779640,True,556700000,6665950,563365950,False,5
6793,validator_34,621900442320,True,562900000,4220930,567120930,False,19
6794,validator_34,622496274660,True,588100000,7732340,595832340,False,19
6795,validator_34,623048454980,True,545000000,7180320,552180320,False,19
6796,validator_45,60760442830,True,476800000,2769200,479569200,False,1
6797,validator_31,373784487810,True,684100000,42191900,726291900,False,11
6798,validator_31,374461846010,True,675900000,1458200,677358200,False,11
6799,validator_34,623658613480,True,604400000,5758500,610158500,False,19
6800,validator_11,60506371545,True,886939999,8034240,894974239,True,1
6801,validator_34,624313319180,True,617400000,37305700,654705700,False,19
6802,validator_14,270512947039,True,571426004,20746660,592172664,True,8
6803,validator_37,146323049860,True,588100000,11446440,599546440,False,4
6804,validator_17,412957115174,True,541000002,718130,541718132,True,12
6805,validator_24,75284468137,True,805919998,42251580,848171578,True,2
6806,validator_48,399815265340,True,651500000,1958790,653458790,False,12
6807,validator_12,237615944307,True,768800003,9054360,777854363,True,7
6808,validator_35,188307117070,True,661600000,9328940,670928940,False,5
6809,validator_34,624854361910,True,533100000,7942730,541042730,False,19
6810,validator_48,400377809290,True,560500000,2043950,562543950,False,12
6811,validator_15,680450647433,True,639080001,35633800,674713801,True,21
6812,validator_17,413619045174,True,659900000,2030000,661930000,True,12
6813,validator_24,76180385451,True,882600004,13317310,895917314,True,2
6814,validator_12,238402499275,True,723799998,62754970,786554968,True,7
6815,validator_15,681320227849,True,813239996,56340420,869580416,True,21
6816,validator_41,152530882370,True,725000000,1777590,726777590,False,4
6817,validator_39,66063265800,True,543200000,20257900,563457900,False,2
6818,validator_18,247302477766,True,610560006,58861050,669421056,True,7
6819,validator_14,271300814038,True,778999999,8867000,787866999,True,8
6820,validator_34,625265303280,True,402600000,8341370,410941370,False,19
6821,validator_44,215707687360,True,901900000,21059000,922959000,False,6
6822,validator_1,156731812542,True,701300006,21427900,722727906,True,4
6823,validator_47,148004847340,True,413200000,1196920,414396920,False,4
6824,validator_46,234528854060,True,638900000,3062900,641962900,False,7
6825,validator_31,375028575510,True,565800000,929500,566729500,False,11
6826,validator_34,625831947080,True,546700000,19943800,566643800,False,19
6827,validator_34,626506103970,True,637200000,36956890,674156890,False,19
6828,validator_48,401036022320,True,654500000,3713030,658213030,False,12
6829,validator_17,414167559403,True,518639999,29874230,548514229,True,12
6830,validator_34,627172464510,True,663200000,3160540,666360540,False,19
6831,validator_15,681973741481,True,645600002,7913630,653513632,True,21
6832,validator_26,60101042850,True,499300000,19413060,518713060,False,1
6833,validator_25,74445957880,True,607000000,2805130,609805130,False,2
6834,validator_17,414949526647,True,761900004,20067240,781967244,True,12
6835,validator_7,157690126785,True,584419999,18836970,603256969,True,4
6836,validator_15,682765704724,True,785720003,6243240,791963243,True,21
6837,validator_41,153161389110,True,628800000,1706740,630506740,False,4
6838,validator_30,132604999660,True,587800000,2755800,590555800,False,4
6839,validator_12,238990781713,True,578599998,9682440,588282438,True,7
6840,validator_31,375613278910,True,573800000,10903400,584703400,False,11
6841,validator_39,66659247090,True,591500000,4481290,595981290,False,2
6842,validator_35,188915800000,True,586500000,22182930,608682930,False,5
6843,validator_37,146980253700,True,652500000,4703840,657203840,False,4
6844,validator_9,72087741209,True,547440004,24108890,571548894,True,2
6845,validator_5,150173416235,True,731560006,35933130,767493136,True,4
6846,validator_5,150963882327,True,758443992,32022100,790466092,True,4
6847,validator_15,683471458085,True,659240001,46513360,705753361,True,21
6848,validator_29,59314574920,True,536960000,13341300,550301300,False,1
6849,validator_14,271840150085,True,498820007,40516040,539336047,True,8
6850,validator_5,151791408728,True,799080001,28446400,827526401,True,4
6851,validator_14,272604964673,True,754499998,10314590,764814588,True,8
6852,validator_35,189757470280,True,838500000,3170280,841670280,False,5
6853,validator_37,147976669430,True,977400000,19015730,996415730,False,4
6854,validator_15,684351813794,True,876599999,3755710,880355709,True,21
6855,validator_1,157509871150,True,765746008,12312600,778058608,True,4
6856,validator_19,155527740308,True,751254002,15274530,766528532,True,4
6857,validator_44,216384999760,True,661800000,15512400,677312400,False,6
6858,validator_34,627578659530,True,402800000,3395020,406195020,False,19
6859,validator_21,146251066081,True,502600013,20550010,523150023,True,4
6860,validator_36,207300962480,True,457000000,3464980,460464980,False,6
6861,validator_31,376215970520,True,592600000,10091610,602691610,False,11
6862,validator_14,273297822116,True,665678003,27179440,692857443,True,8
6863,validator_47,148736136340,True,690400000,40889000,731289000,False,4
6864,validator_36,208038498580,True,734500000,3036100,737536100,False,6
6865,validator_18,247880200557,True,545599991,32122800,577722791,True,7
6866,validator_46,235369387760,True,838400000,2133700,840533700,False,7
6867,validator_1,158147421837,True,634999997,2550690,637550687,True,4
6868,validator_48,401592853220,True,550600000,6230900,556830900,False,12
6869,validator_15,685100816752,True,721819998,27182960,749002958,True,21
6870,validator_44,217099972140,True,714000000,972380,714972380,False,6
6871,validator_35,190504759480,True,738700000,8589200,747289200,False,5
6872,validator_29,59810691740,True,490200000,5916820,496116820,False,1
6873,validator_22,163372177717,True,754473999,38927500,793401499,True,5
6874,validator_15,685794391960,True,678460008,15115200,693575208,True,21
6875,validator_34,628312373220,True,732300000,1413690,733713690,False,19
6876,validator_48,402077225690,True,480100000,4272470,484372470,False,12
6877,validator_15,686433528599,True,629899999,9236640,639136639,True,21
6878,validator_15,687063068825,True,606840006,22700220,629540226,True,21
6879,validator_21,147044836706,True,791700005,2070620,793770625,True,4
6880,validator_34,628739363440,True,425600000,1390220,426990220,False,19
6881,validator_7,158819046956,True,1102560001,26360170,1128920171,True,4
6882,validator_6,73060828848,True,697380005,37318720,734698725,True,2
6883,validator_6,73807976441,True,737040003,10107590,747147593,True,2
6884,validator_13,67700184656,True,752300008,18350520,770650528,True,2
6885,validator_15,687616314091,True,528119996,25125270,553245266,True,21
6886,validator_41,153720239670,True,555900000,2950560,558850560,False,4
6887,validator_5,152487304429,True,694100001,1795700,695895701,True,4
6888,validator_14,274018743647,True,717320001,3601530,720921531,True,8
6889,validator_18,248715059283,True,789467996,45390730,834858726,True,7
6890,validator_19,156313040235,True,776619997,8679930,785299927,True,4
6891,validator_15,688303997228,True,667639997,20043140,687683137,True,21
6892,validator_48,402800097390,True,719600000,3271700,722871700,False,12
6893,validator_48,403529030120,True,727200000,1732730,728932730,False,12
6894,validator_30,133138464940,True,531800000,1665280,533465280,False,4
6895,validator_31,376712846290,True,494600000,2275770,496875770,False,11
6896,validator_1,158771593037,True,618340000,5831200,624171200,True,4
6897,validator_15,689014791923,True,703999995,6794700,710794695,True,21
6898,validator_27,218148168000,True,736000000,3985530,739985530,False,6
6899,validator_27,218858585930,True,693700000,16717930,710417930,False,6
6900,validator_34,629182456880,True,441400000,1693440,443093440,False,19
6901,validator_37,148610894830,True,629300000,4925400,634225400,False,4
6902,validator_0,64648664432,True,802299995,16674600,818974595,True,2
6903,validator_15,689880054165,True,846000002,19262240,865262242,True,21
6904,validator_15,690577470437,True,695299992,2116280,697416272,True,21
6905,validator_14,274741362839,True,716299992,6319200,722619192,True,8
6906,validator_1,159548258953,True,738419996,38245920,776665916,True,4
6907,validator_15,691247311048,True,662458011,7382600,669840611,True,21
6908,validator_43,138049911220,True,513900000,11576940,525476940,False,4
6909,validator_31,377216958310,True,501100000,3012020,504112020,False,11
6910,validator_46,235866636400,True,492600000,4648640,497248640,False,7
6911,validator_35,191073453380,True,542500000,26193900,568693900,False,5
6912,validator_18,249249785550,True,495925997,38800270,534726267,True,7
6913,validator_37,149194975860,True,581100000,2981030,584081030,False,4
6914,validator_34,629801495890,True,610600000,8439010,619039010,False,19
6915,validator_35,191775067980,True,698500000,3114600,701614600,False,5
6916,validator_17,415667177685,True,652359998,65291040,717651038,True,12
6917,validator_35,192319558180,True,526550000,17940200,544490200,False,6
6918,validator_24,76886291614,True,703300003,2606160,705906163,True,2
6919,validator_34,630484505100,True,680700000,2309210,683009210,False,19
6920,validator_17,416149722369,True,460399994,22144690,482544684,True,13
6921,validator_34,631123671750,True,607180000,31986650,639166650,False,19
6922,validator_20,73341508502,True,743480002,51334440,794814442,True,2
6923,validator_40,72934615650,True,675600000,12787520,688387520,False,2
6924,validator_25,74955072600,True,503050000,6064720,509114720,False,2
6925,validator_21,147813209327,True,753780001,14592620,768372621,True,4
6926,validator_41,154386973010,True,663000000,3733340,666733340,False,4
6927,validator_15,691814675336,True,545639998,21724290,567364288,True,21
6928,validator_36,208485991140,True,446100000,1392560,447492560,False,6
6929,validator_17,416885087144,True,707945995,27418780,735364775,True,13
6930,validator_27,219679923420,True,819000000,2337490,821337490,False,6
6931,validator_26,60629448290,True,526700000,1705440,528405440,False,1
6932,validator_22,164042135856,True,649939999,20018140,669958139,True,5
6933,validator_26,61414794240,True,782000000,3345950,785345950,False,1
6934,validator_18,250041522153,True,782639993,9096610,791736603,True,7
6935,validator_38,65595351070,True,678200000,7724000,685924000,False,2
6936,validator_17,417827197573,True,896313999,45796430,942110429,True,13
6937,validator_25,75646227870,True,677900000,13255270,691155270,False,2
6938,validator_49,163959785010,True,583500000,10505370,594005370,False,5
6939,validator_47,149211179430,True,465300000,9743090,475043090,False,4
6940,validator_46,236456405100,True,586600000,3168700,589768700,False,7
6941,validator_21,148679974890,True,844410003,22355560,866765563,True,4
6942,validator_31,377709019510,True,489200000,2861200,492061200,False,11
6943,validator_5,153423280214,True,899359995,36615790,935975785,True,4
6944,validator_49,164560686810,True,598500000,2401800,600901800,False,5
6945,validator_34,631967122600,True,835300000,8150850,843450850,False,19
6946,validator_24,77426531886,True,512428002,27812270,540240272,True,2
6947,validator_48,404330134730,True,792200000,8904610,801104610,False,12
6948,validator_43,138828333020,True,769800000,8621800,778421800,False,4
6949,validator_17,418506730364,True,678300001,1232790,679532791,True,13
6950,validator_17,419285707792,True,770199998,8777430,778977428,True,13
6951,validator_17,420012593505,True,699800003,27085710,726885713,True,13
6952,validator_38,66180955380,True,583900000,1704310,585604310,False,2
6953,validator_14,275522816764,True,755540005,25913920,781453925,True,8
6954,validator_34,632676700400,True,707900000,1677800,709577800,False,19
6955,validator_7,159233273887,True,412140001,2086930,414226931,True,4
6956,validator_5,153974610412,True,514759998,36570200,551330198,True,4
6957,validator_13,68212588352,True,485979996,26423700,512403696,True,2
6958,validator_47,149685368790,True,472000000,2189360,474189360,False,4
6959,validator_46,236847087820,True,389380000,1302720,390682720,False,7
6960,validator_30,133574092820,True,433100000,2527880,435627880,False,4
6961,validator_49,165212678740,True,651100000,891930,651991930,False,5
6962,validator_41,154831791210,True,411300000,33518200,444818200,False,4
6963,validator_34,633327654210,True,639100000,11853810,650953810,False,19
6964,validator_33,64497791290,True,627400000,2543300,629943300,False,2
6965,validator_34,633930928750,True,577800000,25474540,603274540,False,19
6966,validator_48,404990066950,True,652300000,7632220,659932220,False,12
6967,validator_48,405735293900,True,725900000,19326950,745226950,False,12
6968,validator_24,77983939715,True,523239999,34167830,557407829,True,2
6969,validator_17,420877144970,True,853899995,10651470,864551465,True,13
6970,validator_39,67396728680,True,730200000,7281590,737481590,False,2
6971,validator_10,78827656009,True,690039999,23127940,713167939,True,2
6972,validator_34,634627581610,True,676600000,20052860,696652860,False,19
6973,validator_7,160001107737,True,749300000,18533850,767833850,True,5
6974,validator_11,60939808820,True,403039995,30397280,433437275,True,1
6975,validator_31,378192268910,True,481300000,1949400,483249400,False,11
6976,validator_34,635340898860,True,693200000,20117250,713317250,False,19
6977,validator_48,406299099340,True,562100000,1705440,563805440,False,12
6978,validator_49,165722098640,True,504600000,4819900,509419900,False,5
6979,validator_31,378923938980,True,730100000,1570070,731670070,False,11
6980,validator_27,220411503240,True,723500000,8079820,731579820,False,6
6981,validator_48,406800163750,True,500000000,1064410,501064410,False,12
6982,validator_14,276308026365,True,738156001,47053600,785209601,True,8
6983,validator_15,692501517033,True,665639997,21201700,686841697,True,21
6984,validator_22,164745988573,True,683739997,20112720,703852717,True,5
6985,validator_34,636156530950,True,795900000,19732090,815632090,False,19
6986,validator_35,192870732430,True,544700000,6474250,551174250,False,6
6987,validator_15,693300896627,True,750800004,48579590,799379594,True,21
6988,validator_24,78755777554,True,744473999,27363840,771837839,True,2
6989,validator_47,150581686670,True,891600000,4717880,896317880,False,4
6990,validator_43,139630638300,True,799000000,3305280,802305280,False,4
6991,validator_39,67927046710,True,510780000,19538030,530318030,False,2
6992,validator_12,239664513242,True,665699999,8031530,673731529,True,7
6993,validator_48,407506359910,True,695900000,10296160,706196160,False,12
6994,validator_23,68064645865,True,668499996,6892000,675391996,True,2
6995,validator_16,73021016901,True,703106006,29500190,732606196,True,2
6996,validator_15,693968994506,True,660299999,7797880,668097879,True,21
6997,validator_41,155677820150,True,822600000,23428940,846028940,False,4
6998,validator_15,694598339228,True,593379992,35964730,629344722,True,21
6999,validator_17,421524537498,True,634779998,12612530,647392528,True,13
7000,validator_15,695131681141,True,513699993,19641920,533341913,True,21
7001,validator_25,76019169670,True,369000000,3941800,372941800,False,2
7002,validator_34,636792574830,True,598400000,37643880,636043880,False,19
7003,validator_43,140219759600,True,577200000,11921300,589121300,False,4
7004,validator_43,140768581100,True,539000000,9821500,548821500,False,4
7005,validator_15,695822912725,True,672400004,18831580,691231584,True,21
7006,validator_3,69154515990,True,762639996,26410500,789050496,True,2
7007,validator_31,379443813970,True,500900000,18974990,519874990,False,11
7008,validator_27,220970480050,True,539400000,19576810,558976810,False,6
7009,validator_7,160844546395,True,816139998,27298660,843438658,True,5
7010,validator_1,160130878266,True,572439993,10179320,582619313,True,5
7011,validator_40,73572594180,True,630200000,7778530,637978530,False,2
7012,validator_31,380164403330,True,700000000,20589360,720589360,False,11
7013,validator_46,237495356220,True,647000000,1268400,648268400,False,7
7014,validator_46,238235650060,True,731700000,8593840,740293840,False,7
7015,validator_46,238757116090,True,518000000,3466030,521466030,False,7
7016,validator_18,250826410151,True,745553998,39334000,784887998,True,7
7017,validator_42,59093333440,True,487600000,10047320,497647320,False,1
7018,validator_44,217613822720,True,471700000,42150580,513850580,False,6
7019,validator_11,61717357062,True,756700002,20848240,777548242,True,1
7020,validator_33,65200231320,True,700600000,1840030,702440030,False,2
7021,validator_26,61954603240,True,536200000,3609000,539809000,False,1
7022,validator_4,59708377440,True,731320010,6987290,738307300,True,1
7023,validator_34,637322255950,True,525300000,4381120,529681120,False,19
7024,validator_21,149476583392,True,789100002,7508500,796608502,True,4
7025,validator_1,160782791946,True,649500000,2413680,651913680,True,5
7026,validator_40,74093682320,True,503300000,17788140,521088140,False,2
7027,validator_17,422180611935,True,617895997,38178440,656074437,True,13
7028,validator_17,422884701813,True,690299998,13789880,704089878,True,13
7029,validator_30,134393305660,True,813400000,5812840,819212840,False,4
7030,validator_15,696795700918,True,970000003,2788190,972788193,True,21
7031,validator_24,79554040870,True,731488006,66775310,798263316,True,2
7032,validator_34,637774422370,True,441740000,10426420,452166420,False,19
7033,validator_31,380966093570,True,791900000,9790240,801690240,False,11
7034,validator_17,423522213605,True,617000002,20511790,637511792,True,13
7035,validator_30,134916127250,True,519800000,3021590,522821590,False,4
7036,validator_46,239430914930,True,657600000,16198840,673798840,False,7
7037,validator_43,141290893590,True,511400000,10912490,522312490,False,4
7038,validator_49,166225447120,True,502100000,1248480,503348480,False,5
7039,validator_46,239912107660,True,472700000,8492730,481192730,False,7
7040,validator_0,65320902434,True,667299992,4938010,672238002,True,2
7041,validator_49,166807764420,True,577000000,5317300,582317300,False,5
7042,validator_35,193327594290,True,447310000,9551860,456861860,False,6
7043,validator_1,161649722197,True,856669991,10260260,866930251,True,5
7044,validator_18,251366464153,True,530300002,9754000,540054002,True,7
7045,validator_37,149794139300,True,597100000,2063440,599163440,False,4
7046,validator_15,697679258244,True,879999996,3557330,883557326,True,21
7047,validator_29,60439606340,True,626200000,2714600,628914600,False,1
7048,validator_37,150661787780,True,863600000,4048480,867648480,False,4
7049,validator_36,209091726040,True,603300000,2434900,605734900,False,6
7050,validator_13,68704288075,True,461200003,30499720,491699723,True,2
7051,validator_22,165484813251,True,723419998,15404680,738824678,True,5
7052,validator_6,74484263433,True,651499992,24787000,676286992,True,2
7053,validator_32,58870349450,True,513800000,8137300,521937300,False,1
7054,validator_17,423972989231,True,446539996,4235630,450775626,True,13
7055,validator_23,68782321968,True,699070003,18606100,717676103,True,2
7056,validator_36,209605120770,True,476200000,37194730,513394730,False,6
7057,validator_8,65022120555,True,615539995,8444440,623984435,True,2
7058,validator_34,638331065520,True,554200000,2443150,556643150,False,19
7059,validator_15,698361909643,True,673339999,9311400,682651399,True,21
7060,validator_3,69811137913,True,650840003,5781920,656621923,True,2
7061,validator_36,210447309370,True,804000000,38188600,842188600,False,6
7062,validator_36,211173437950,True,691900000,34228580,726128580,False,6
7063,validator_35,194222467090,True,881900000,12972800,894872800,False,6
7064,validator_16,73632085963,True,578019992,33049070,611069062,True,2
7065,validator_31,381710626710,True,742700000,1833140,744533140,False,11
7066,validator_3,70484966211,True,650719998,23108300,673828298,True,2
7067,validator_18,251957222291,True,567853998,22904140,590758138,True,7
7068,validator_15,699249677450,True,849840007,37927800,887767807,True,21
7069,validator_34,639123191180,True,772300000,19825660,792125660,False,19
7070,validator_16,74321856197,True,672860004,16910230,689770234,True,2
7071,validator_46,240644833860,True,713200000,19526200,732726200,False,7
7072,validator_37,151399014330,True,721100000,16126550,737226550,False,4
7073,validator_5,154834197391,True,836640009,22946970,859586979,True,4
7074,validator_35,194870909490,True,619700000,28742400,648442400,False,6
7075,validator_17,424750258602,True,740034001,37235370,777269371,True,13
7076,validator_37,152023420530,True,610500000,13906200,624406200,False,4
7077,validator_41,156272139850,True,574500000,19819700,594319700,False,4
7078,validator_34,639672371710,True,548400000,780530,549180530,False,19
7079,validator_48,408100934180,True,592000000,2574270,594574270,False,12
7080,validator_18,252524629489,True,533299998,34107200,567407198,True,7
7081,validator_35,195663276270,True,788400000,3966780,792366780,False,6
7082,validator_3,71283805528,True,761773997,37065320,798839317,True,2
7083,validator_18,253069571086,True,542319997,2621600,544941597,True,7
7084,validator_15,699947495674,True,683540004,14278220,697818224,True,21
7085,validator_10,79379537850,True,542400001,9481840,551881841,True,2
7086,validator_38,66676729360,True,490300000,5473980,495773980,False,2
7087,validator_43,141920794490,True,628500000,1400900,629900900,False,4
7088,validator_18,253955560564,True,863559998,22429480,885989478,True,7
7089,validator_49,167349247900,True,539300000,2183480,541483480,False,5
7090,validator_48,408777448700,True,675100000,1414520,676514520,False,12
7091,validator_34,640251674200,True,577200000,2102490,579302490,False,20
7092,validator_34,640852470930,True,599400000,1396730,600796730,False,20
7093,validator_34,641481285430,True,615600000,13214500,628814500,False,20
7094,validator_15,700469633647,True,507520003,14617970,522137973,True,21
7095,validator_34,642016398600,True,526500000,8613170,535113170,False,20
7096,validator_22,166323325885,True,826919994,11592640,838512634,True,5
7097,validator_48,409420577760,True,640700000,2429060,643129060,False,12
7098,validator_17,425428981767,True,651359995,27363170,678723165,True,13
7099,validator_15,701222410073,True,712733996,40042430,752776426,True,21
7100,validator_31,382321460340,True,602600000,8233630,610833630,False,11
7101,validator_9,73009715748,True,867799999,54174540,921974539,True,2
7102,validator_24,80389614352,True,832399992,3173490,835573482,True,2
7103,validator_35,196366457170,True,700000000,3180900,703180900,False,6
7104,validator_15,701812691677,True,578499994,11781610,590281604,True,21
7105,validator_16,75140160098,True,806660001,11643900,818303901,True,2
7106,validator_18,254856598983,True,883800009,17238410,901038419,True,7
7107,validator_5,155574814431,True,730400010,10217030,740617040,True,4
7108,validator_48,409936216070,True,513700000,1938310,515638310,False,12
7109,validator_34,642611971670,True,585500000,10073070,595573070,False,20
7110,validator_5,156259494791,True,652860000,31820360,684680360,True,4
7111,validator_19,157073097436,True,756000001,4057200,760057201,True,4
7112,validator_36,211800101850,True,624400000,2263900,626663900,False,6
7113,validator_35,196877348830,True,508300000,2591660,510891660,False,6
7114,validator_36,212543306230,True,740000000,3204380,743204380,False,6
7115,validator_41,156839019810,True,563100000,3779960,566879960,False,4
7116,validator_18,255620741685,True,754440002,9702700,764142702,True,7
7117,validator_34,643309363770,True,694400000,2992100,697392100,False,20
7118,validator_34,643739652770,True,420700000,9589000,430289000,False,20
7119,validator_31,382915562670,True,584800000,9302330,594102330,False,11
7120,validator_39,68684567610,True,755700000,1820900,757520900,False,2
7121,validator_13,69745139607,True,995400012,45451520,1040851532,True,2
7122,validator_12,240524313569,True,846167997,13632330,859800327,True,7
7123,validator_34,644268163920,True,519900000,8611150,528511150,False,20
7124,validator_17,426172588766,True,736419999,7187000,743606999,True,13
7125,validator_34,645012322090,True,741700000,2458170,744158170,False,20
7126,validator_18,256390029986,True,741220001,28068300,769288301,True,8
7127,validator_22,166884072329,True,528540004,32206440,560746444,True,5
7128,validator_34,645574651360,True,561000000,1329270,562329270,False,20
7129,validator_35,197649510110,True,766100000,6061280,772161280,False,6
7130,validator_35,198132664950,True,472600000,10554840,483154840,False,6
7131,validator_34,646084796570,True,509100000,1045210,510145210,False,20
7132,validator_15,702395438362,True,573640005,9106680,582746685,True,21
7133,validator_18,257092256484,True,698399998,3826500,702226498,True,8
7134,validator_4,60414380819,True,689067999,16935380,706003379,True,1
7135,validator_37,152640545560,True,607400000,9725030,617125030,False,4
7136,validator_12,241245916616,True,705619997,15983050,721603047,True,7
7137,validator_17,426915702711,True,732180005,10933940,743113945,True,13
7138,validator_19,157605651262,True,520780006,11773820,532553826,True,4
7139,validator_31,383530152400,True,602100000,12489730,614589730,False,11
7140,validator_41,157511123130,True,662400000,9703320,672103320,False,4
7141,validator_17,427584555982,True,664100001,4753270,668853271,True,13
7142,validator_19,158070541861,True,457739999,7150600,464890599,True,4
7143,validator_24,81231701272,True,837800000,4286920,842086920,True,2
7144,validator_21,150045873897,True,553758005,15532500,569290505,True,4
7145,validator_27,221487912350,True,513100000,4332300,517432300,False,6
7146,validator_35,198706264590,True,572300000,1299640,573599640,False,6
7147,validator_15,703185275204,True,780340002,9496840,789836842,True,21
7148,validator_17,428314237413,True,723058001,6623430,729681431,True,13
7149,validator_31,384146866990,True,614700000,2014590,616714590,False,12
7150,validator_15,703923837222,True,706120008,32442010,738562018,True,21
7151,validator_22,167617578172,True,709580003,23925840,733505843,True,5
7152,validator_21,150810336829,True,760540002,3922930,764462932,True,4
7153,validator_31,384886865630,True,736200000,3798640,739998640,False,12
7154,validator_28,69205482430,True,547000000,20129590,567129590,False,2
7155,validator_10,80211835950,True,820620000,11678100,832298100,True,2
7156,validator_21,151499177802,True,672404003,16436970,688840973,True,4
7157,validator_36,213095661370,True,545500000,6855140,552355140,False,6
7158,validator_17,429051630111,True,721099998,16292700,737392698,True,13
7159,validator_19,158534989806,True,453240005,11207940,464447945,True,4
7160,validator_34,646695085630,True,585900000,24389060,610289060,False,20
7161,validator_34,647450679300,True,754000000,1593670,755593670,False,20
7162,validator_20,74008704559,True,631159997,36036060,667196057,True,2
7163,validator_11,62428903590,True,697239998,14306530,711546528,True,1
7164,validator_34,648025871120,True,571400000,3791820,575191820,False,20
7165,validator_34,648870889620,True,806100000,38918500,845018500,False,20
7166,validator_14,277016536865,True,689820000,18690500,708510500,True,8
7167,validator_17,429665525181,True,585656000,28239070,613895070,True,13
7168,validator_30,135485926660,True,561000000,8799410,569799410,False,4
7169,validator_14,277568669576,True,534440001,17692710,552132711,True,8
7170,validator_27,221956829570,True,442800000,26117220,468917220,False,6
7171,validator_34,649716597800,True,843600000,2108180,845708180,False,20
7172,validator_9,73535844748,True,500900000,25229000,526129000,True,2
7173,validator_21,152264797825,True,718960003,46660020,765620023,True,4
7174,validator_20,74883187638,True,848979999,25503080,874483079,True,2
7175,validator_39,69313462720,True,626000000,2895110,628895110,False,2
7176,validator_12,242149899830,True,868506004,35477210,903983214,True,7
7177,validator_17,430343346328,True,622139997,55681150,677821147,True,13
7178,validator_15,704529470947,True,594639995,10993730,605633725,True,22
7179,validator_15,705498669357,True,963440010,5758400,969198410,True,22
7180,validator_49,167914369680,True,549700000,15421780,565121780,False,5
7181,validator_7,161622171441,True,770940006,6685040,777625046,True,5
7182,validator_1,162401470877,True,713820000,37928680,751748680,True,5
7183,validator_12,242739400725,True,577519995,11980900,589500895,True,7
7184,validator_36,213539450870,True,442790000,999500,443789500,False,6
7185,validator_35,199188977610,True,481200000,1513020,482713020,False,6
7186,validator_14,278399671172,True,820399996,10601600,831001596,True,8
7187,validator_46,241349913500,True,703800000,1279640,705079640,False,7
7188,validator_39,69912935510,True,598100000,1372790,599472790,False,2
7189,validator_45,61460340390,True,695600000,4297560,699897560,False,1
7190,validator_17,431098306212,True,724540004,30419880,754959884,True,13
7191,validator_38,67141493450,True,462800000,1964090,464764090,False,2
7192,validator_27,222524348690,True,564500000,3019120,567519120,False,6
7193,validator_12,243519924763,True,772299998,8224040,780524038,True,7
7194,validator_48,410541173900,True,595000000,9957830,604957830,False,12
7195,validator_31,385705453530,True,797800000,20787900,818587900,False,12
7196,validator_44,218125580710,True,486500000,25257990,511757990,False,6
7197,validator_30,136356242860,True,867400000,2916200,870316200,False,4
7198,validator_19,159533166143,True,959739997,38436340,998176337,True,4
7199,validator_37,153062794760,True,417900000,4349200,422249200,False,4
7200,validator_46,241851175000,True,499200000,2061500,501261500,False,7
7201,validator_14,278938323811,True,524639999,14012640,538652639,True,8
7202,validator_7,162259485424,True,627220003,10093980,637313983,True,5
7203,validator_22,168433337748,True,807219996,8539580,815759576,True,5
7204,validator_26,62306355990,True,346000000,5752750,351752750,False,1
7205,validator_18,257600896402,True,501007998,7631920,508639918,True,8
7206,validator_2,63413674859,True,660380005,36434940,696814945,True,1
7207,validator_15,706104885303,True,595520006,10695940,606215946,True,22
7208,validator_46,242400352730,True,545400000,3777730,549177730,False,7
7209,validator_29,61016345040,True,573900000,2838700,576738700,False,1
7210,validator_31,386248032290,True,540400000,2178760,542578760,False,12
7211,validator_12,244338804442,True,814619999,4259680,818879679,True,7
7212,validator_35,199595218510,True,378700000,27540900,406240900,False,6
7213,validator_17,431867019017,True,759640005,9072800,768712805,True,13
7214,validator_34,650439578820,True,717400000,5581020,722981020,False,20
7215,validator_24,82057558099,True,801019997,24836830,825856827,True,2
7216,validator_5,156791528325,True,512000004,20033530,532033534,True,4
7217,validator_35,200145179210,True,530000000,19960700,549960700,False,6
7218,validator_3,72184074149,True,894800001,5468620,900268621,True,2
7219,validator_49,168434716950,True,513300000,7047270,520347270,False,5
7220,validator_49,169048561360,True,607100000,6744410,613844410,False,5
7221,validator_18,258184083398,True,552396006,30790990,583186996,True,8
7222,validator_17,432668524555,True,782219998,19285540,801505538,True,13
7223,validator_3,72766519611,True,560240002,22205460,582445462,True,2
7224,validator_10,80886935432,True,609158002,65941480,675099482,True,2
7225,validator_22,169381111269,True,942440001,5333520,947773521,True,5
7226,validator_35,200741841710,True,594200000,2462500,596662500,False,6
7227,validator_31,386679420270,True,429540000,1847980,431387980,False,12
7228,validator_15,706906973303,True,800100000,1988000,802088000,True,22
7229,validator_14,279701371976,True,725300005,37748160,763048165,True,8
7230,validator_8,65998924179,True,955299994,21503630,976803624,True,2
7231,validator_36,214186857290,True,640600000,6806420,647406420,False,6
7232,validator_41,158005888930,True,493000000,1765800,494765800,False,4
7233,validator_7,162984629520,True,716119996,9024100,725144096,True,5
7234,validator_36,214798945490,True,592700000,19388200,612088200,False,6
7235,validator_45,62148568520,True,681400000,6828130,688228130,False,1
7236,validator_24,82837252015,True,741199996,38493920,779693916,True,2
7237,validator_15,707839330803,True,886620000,45737500,932357500,True,22
7238,validator_1,163056007885,True,652499998,2037010,654537008,True,5
7239,validator_15,708613467144,True,736040001,38096340,774136341,True,22
7240,validator_38,67888599830,True,736900000,10206380,747106380,False,2
7241,validator_12,244967512059,True,602699997,26007620,628707617,True,7
7242,validator_6,75302851665,True,814719992,3868240,818588232,True,2
7243,validator_7,163736851360,True,746040000,6181840,752221840,True,5
7244,validator_45,62923083580,True,772200000,2315060,774515060,False,1
7245,validator_48,411138992900,True,590700000,7119000,597819000,False,12
7246,validator_47,151331489130,True,747900000,1902460,749802460,False,4
7247,validator_12,245716022496,True,721819997,26690440,748510437,True,7
7248,validator_34,651144132150,True,702000000,2553330,704553330,False,20
7249,validator_15,709399017642,True,765599998,19950500,785550498,True,22
7250,validator_22,170053299374,True,633940005,38248100,672188105,True,5
7251,validator_15,710033218453,True,590260011,43940800,634200811,True,22
7252,validator_18,258726908637,True,535499999,7325240,542825239,True,8
7253,validator_40,74673093420,True,575500000,3911100,579411100,False,2
7254,validator_40,75092807700,True,411300000,8414280,419714280,False,2
7255,validator_22,170636501408,True,582200004,1002030,583202034,True,5
7256,validator_15,710788140848,True,734119995,20802400,754922395,True,22
7257,validator_18,259449387537,True,687239990,35238910,722478900,True,8
7258,validator_9,74261726382,True,714839994,11041640,725881634,True,2
7259,validator_12,246284679027,True,558720001,9936530,568656531,True,7
7260,validator_15,711641401473,True,851700005,1560620,853260625,True,22
7261,validator_35,201580101710,True,828900000,9360000,838260000,False,6
7262,validator_49,169703049200,True,651700000,2787840,654487840,False,5
7263,validator_49,170371948820,True,666800000,2099620,668899620,False,5
7264,validator_34,651720688340,True,565500000,11056190,576556190,False,20
7265,validator_7,164377124463,True,623520003,16753100,640273103,True,5
7266,validator_29,61532125300,True,513500000,2280260,515780260,False,1
7267,validator_9,75046497969,True,727673997,57097590,784771587,True,2
7268,validator_13,70343009483,True,584399996,13469880,597869876,True,2
7269,validator_9,75742827166,True,691160007,5169190,696329197,True,2
7270,validator_43,142685489490,True,758400000,6295000,764695000,False,4
7271,validator_14,280183721313,True,460859997,21489340,482349337,True,8
7272,validator_14,280898158848,True,669816005,44621530,714437535,True,8
7273,validator_35,202067701100,True,480670000,6929390,487599390,False,6
7274,validator_38,68463561950,True,568100000,6862120,574962120,False,2
7275,validator_17,433164089997,True,468600002,26965440,495565442,True,13
7276,validator_46,243107717660,True,698300000,9064930,707364930,False,7
7277,validator_48,411796076170,True,654500000,2583270,657083270,False,12
7278,validator_34,652204276170,True,481400000,2187830,483587830,False,20
7279,validator_33,65893027920,True,683400000,9396600,692796600,False,2
7280,validator_39,70533328470,True,619800000,592960,620392960,False,2
7281,validator_15,712398853900,True,729239997,28212430,757452427,True,22
7282,validator_37,153722223060,True,655900000,3528300,659428300,False,4
7283,validator_15,712969016421,True,558160001,12002520,570162521,True,22
7284,validator_43,143296636880,True,591100000,20047390,611147390,False,4
7285,validator_9,76323154293,True,558959997,21367130,580327127,True,2
7286,validator_21,153113509245,True,807120000,41591420,848711420,True,4
7287,validator_34,652833601490,True,627600000,1725320,629325320,False,20
7288,validator_34,653446700420,True,610600000,2498930,613098930,False,20
7289,validator_22,171194076283,True,534659995,22914880,557574875,True,5
7290,validator_3,73402933210,True,620639999,15773600,636413599,True,2
7291,validator_46,243762285340,True,607300000,47267680,654567680,False,7
7292,validator_16,75735875902,True,589400004,6315800,595715804,True,2
7293,validator_14,281442738985,True,536299997,8280140,544580137,True,8
7294,validator_13,70911047881,True,557399998,10638400,568038398,True,2
7295,validator_15,713796826120,True,819399999,8409700,827809699,True,22
7296,validator_37,154238196370,True,511400000,4573310,515973310,False,4
7297,validator_31,387376009400,True,694800000,1789130,696589130,False,12
7298,validator_46,244424906780,True,625800000,36821440,662621440,False,7
7299,validator_31,388218362940,True,832800000,9553540,842353540,False,12
7300,validator_27,223120728610,True,576200000,20179920,596379920,False,6
7301,validator_47,151945026860,True,611100000,2437730,613537730,False,4
7302,validator_44,218683038620,True,554600000,2857910,557457910,False,6
7303,validator_22,172017479481,True,798039998,25363200,823403198,True,5
7304,validator_34,654039068880,True,589400000,2968460,592368460,False,20
7305,validator_43,144007200400,True,709100000,1463520,710563520,False,4
7306,validator_34,654524267080,True,481900000,3298200,485198200,False,20
7307,validator_15,714551792303,True,745120003,9846180,754966183,True,22
7308,validator_31,388942496970,True,720600000,3534030,724134030,False,12
7309,validator_17,433622508738,True,456700001,1718740,458418741,True,13
7310,validator_17,434172019730,True,502629992,46881000,549510992,True,13
7311,validator_17,434807737268,True,615499998,20217540,635717538,True,13
7312,validator_15,715136521369,True,546199996,38529070,584729066,True,22
7313,validator_34,655150919610,True,619200000,7452530,626652530,False,20
7314,validator_18,260050747298,True,577700001,23659760,601359761,True,8
7315,validator_48,412428114720,True,609200000,22838550,632038550,False,12
7316,validator_18,260814250639,True,735240001,28263340,763503341,True,8
7317,validator_27,223721514010,True,593800000,6985400,600785400,False,6
7318,validator_34,655852118500,True,681600000,19598890,701198890,False,20
7319,validator_35,202605080730,True,535200000,2179630,537379630,False,6
7320,validator_15,715808876721,True,653020002,19335350,672355352,True,22
7321,validator_35,203314572930,True,707500000,1992200,709492200,False,6
7322,validator_27,224399637570,True,647900000,30223560,678123560,False,7
7323,validator_12,247081952002,True,782600005,14672970,797272975,True,7
7324,validator_46,244969473910,True,541900000,2667130,544567130,False,7
7325,validator_30,136960143990,True,593000000,10901130,603901130,False,4
7326,validator_34,656425242100,True,568400000,4723600,573123600,False,20
7327,validator_43,144720357340,True,711100000,2056940,713156940,False,4
7328,validator_34,657003746190,True,551700000,26804090,578504090,False,20
7329,validator_18,261761874367,True,931497998,16125730,947623728,True,8
7330,validator_34,657463688890,True,457900000,2042700,459942700,False,20
7331,validator_15,716496818100,True,649099999,38841380,687941379,True,22
7332,validator_35,203902148270,True,584400000,3175340,587575340,False,6
7333,validator_46,245698893680,True,701800000,27619770,729419770,False,7
7334,validator_7,165251852406,True,858268003,16459940,874727943,True,5
7335,validator_17,435778424288,True,955000000,15687020,970687020,True,13
7336,validator_32,59420797650,True,547400000,3048200,550448200,False,1
7337,validator_32,59997818030,True,574900000,2120380,577020380,False,1
7338,validator_15,717431579380,True,922260000,12501280,934761280,True,22
7339,validator_37,154846211510,True,601900000,6115140,608015140,False,4
7340,validator_12,247780817596,True,667059994,31805600,698865594,True,7
7341,validator_22,172705618078,True,667579997,20558600,688138597,True,5
7342,validator_3,74221860228,True,806099998,12827020,818927018,True,2
7343,validator_36,215399407590,True,586300000,14162100,600462100,False,6
7344,validator_27,225109286170,True,705700000,3948600,709648600,False,7
7345,validator_18,262488822064,True,705999997,20947700,726947697,True,8
7346,validator_18,263130052298,True,640300004,930230,641230234,True,8
7347,validator_49,170787079900,True,411500000,3631080,415131080,False,5
7348,validator_18,263733729299,True,589540001,14137000,603677001,True,8
7349,validator_13,71789918317,True,862746006,16124430,878870436,True,2
7350,validator_36,215946077280,True,537300000,9369690,546669690,False,6
7351,validator_43,145502009140,True,780800000,851800,781651800,False,4
7352,validator_10,81465162732,True,543940000,34287300,578227300,True,2
7353,validator_39,71239236370,True,703400000,2507900,705907900,False,2
7354,validator_48,413015778620,True,566600000,21063900,587663900,False,12
7355,validator_15,718137080232,True,686400002,19100850,705500852,True,22
7356,validator_15,719020774314,True,850020002,33674080,883694082,True,22
7357,validator_15,719573444978,True,540500004,12170660,552670664,True,22
7358,validator_48,413402842650,True,384400000,2664030,387064030,False,12
7359,validator_44,219204056950,True,517800000,3218330,521018330,False,6
7360,validator_49,171350212650,True,550600000,12532750,563132750,False,5
7361,validator_44,219783638370,True,563700000,15881420,579581420,False,6
7362,validator_25,76598840350,True,572800000,6870680,579670680,False,2
7363,validator_38,69023994840,True,551500000,8932890,560432890,False,2
7364,validator_15,720129777780,True,538694002,17638800,556332802,True,22
7365,validator_49,171872041180,True,502700000,19128530,521828530,False,5
7366,validator_10,82043202756,True,542459994,35580030,578040024,True,2
7367,validator_6,76065514294,True,734859999,27802630,762662629,True,2
7368,validator_5,157410087622,True,607739997,10819300,618559297,True,4
7369,validator_18,264466892933,True,713170004,19993630,733163634,True,8
7370,validator_34,658089710520,True,605000000,21021630,626021630,False,20
7371,validator_30,137702189650,True,740200000,1845660,742045660,False,4
7372,validator_12,248510400898,True,704998002,24585300,729583302,True,7
7373,validator_5,158042114354,True,621360002,10666730,632026732,True,4
7374,validator_18,265214352066,True,723050003,24409130,747459133,True,8
7375,validator_34,658752914170,True,653800000,9403650,663203650,False,20
7376,validator_27,225516175470,True,393600000,13289300,406889300,False,7
7377,validator_9,77037357490,True,711999997,2203200,714203197,True,2
7378,validator_21,153711757179,True,556880004,41367930,598247934,True,4
7379,validator_48,413974733850,True,570090000,1801200,571891200,False,12
7380,validator_29,62154367130,True,619740000,2501830,622241830,False,1
7381,validator_12,249321633131,True,785700003,25532230,811232233,True,7
7382,validator_17,436493480790,True,704540002,10516500,715056502,True,13
7383,validator_35,204489032600,True,585900000,984330,586884330,False,6
7384,validator_48,414687576770,True,686100000,26742920,712842920,False,12
7385,validator_15,720735072186,True,594639996,10654410,605294406,True,22
7386,validator_27,226058625200,True,541500000,949730,542449730,False,7
7387,validator_34,659296727710,True,543100000,713540,543813540,False,20
7388,validator_12,250012275074,True,628060003,62581940,690641943,True,7
7389,validator_17,437135323872,True,640300002,1543080,641843082,True,13
7390,validator_47,152352815660,True,396900000,10888800,407788800,False,4
7391,validator_31,389584738530,True,640100000,2141560,642241560,False,12
7392,validator_15,721182020113,True,371327997,75619930,446947927,True,22
7393,validator_31,390331458790,True,724700000,22020260,746720260,False,12
7394,validator_34,659997864930,True,700500000,637220,701137220,False,20
7395,validator_48,415181150470,True,489200000,4373700,493573700,False,12
7396,validator_34,660563246700,True,563600000,1781770,565381770,False,20
7397,validator_27,226703205030,True,642700000,1879830,644579830,False,7
7398,validator_22,173481245363,True,749040005,26587280,775627285,True,5
7399,validator_14,281914197283,True,448145998,23312300,471458298,True,8
7400,validator_21,154497210979,True,771140000,14313800,785453800,True,4
7401,validator_15,721953810121,True,743940008,27850000,771790008,True,22
7402,validator_17,437928568074,True,757860002,35384200,793244202,True,13
7403,validator_21,155044218769,True,525220000,21787790,547007790,True,4
7404,validator_19,160423316941,True,873863998,16286800,890150798,True,5
7405,validator_29,62709077080,True,537300000,17409950,554709950,False,1
7406,validator_15,722530754975,True,569399994,7544860,576944854,True,22
7407,validator_34,661256229820,True,690400000,2583120,692983120,False,20
7408,validator_42,59727792970,True,631600000,2859530,634459530,False,1
7409,validator_48,415635760770,True,442600000,12010300,454610300,False,12
7410,validator_12,250838202211,True,823199997,2727140,825927137,True,7
7411,validator_7,165974816111,True,694566005,28397700,722963705,True,5
7412,validator_26,62844927670,True,537300000,1271680,538571680,False,1
7413,validator_35,205313749930,True,804100000,20617330,824717330,False,6
7414,validator_17,438632937216,True,674300002,30069140,704369142,True,13
7415,validator_35,206019285270,True,699800000,5735340,705535340,False,6
7416,validator_30,138269140290,True,564800000,2150640,566950640,False,4
7417,validator_47,153131862870,True,751000000,28047210,779047210,False,4
7418,validator_30,139059370720,True,781300000,8930430,790230430,False,4
7419,validator_18,266302911042,True,1083300006,5258970,1088558976,True,8
7420,validator_34,661956577920,True,699200000,1148100,700348100,False,20
7421,validator_14,282576610473,True,636940010,25473180,662413190,True,8
7422,validator_17,439199708698,True,541184002,25587480,566771482,True,13
7423,validator_15,723427946372,True,894199997,2991400,897191397,True,22
7424,validator_44,220305974370,True,519200000,3136000,522336000,False,6
7425,validator_38,69615894010,True,589000000,2899170,591899170,False,2
7426,validator_15,724045763001,True,596739999,21076630,617816629,True,22
7427,validator_35,206586020510,True,557210000,9525240,566735240,False,6
7428,validator_13,72500721138,True,622525991,88276830,710802821,True,2
7429,validator_37,155658326010,True,790600000,21514500,812114500,False,4
7430,validator_34,662644977650,True,682200000,6199730,688399730,False,20
7431,validator_41,158714652050,True,702500000,6263120,708763120,False,4
7432,validator_36,216635573380,True,685900000,3596100,689496100,False,6
7433,validator_14,283280195602,True,663753999,39831130,703585129,True,8
7434,validator_15,724720321878,True,655979997,18578880,674558877,True,22
7435,validator_15,725346953663,True,593763995,32867790,626631785,True,22
7436,validator_17,440077491095,True,869159997,8622400,877782397,True,13
7437,validator_31,391005419480,True,670900000,3060690,673960690,False,12
7438,validator_46,246241576140,True,533050000,9632460,542682460,False,7
7439,validator_15,726001938402,True,625899999,29084740,654984739,True,22
7440,validator_34,663106147750,True,457300000,3870100,461170100,False,20
7441,validator_36,217166690410,True,528700000,2417030,531117030,False,6
7442,validator_14,284252829489,True,934639997,37993890,972633887,True,8
7443,validator_41,159328387950,True,609900000,3835900,613735900,False,4
7444,validator_44,221019625400,True,704100000,9551030,713651030,False,6
7445,validator_48,416383112310,True,746100000,1251540,747351540,False,13
7446,validator_45,63593417780,True,664900000,5434200,670334200,False,1
7447,validator_5,158489790551,True,445699997,1976200,447676197,True,4
7448,validator_18,266882306480,True,542499998,36895440,579395438,True,8
7449,validator_10,82584775652,True,538000006,3572890,541572896,True,2
7450,validator_44,221450153570,True,418800000,11728170,430528170,False,6
7451,validator_12,251632710913,True,783000002,11508700,794508702,True,7
7452,validator_18,267562728887,True,647756007,32666400,680422407,True,8
7453,validator_40,75846296440,True,750700000,2788740,753488740,False,2
7454,validator_31,391569354970,True,542500000,21435490,563935490,False,12
7455,validator_22,174270674959,True,781040006,8389590,789429596,True,5
7456,validator_35,207112086530,True,523400000,2666020,526066020,False,6
7457,validator_28,69688833230,True,480700000,2650800,483350800,False,2
7458,validator_36,217780358150,True,588700000,24967740,613667740,False,6
7459,validator_37,156317465130,True,652400000,6739120,659139120,False,4
7460,validator_47,153820917940,True,683140000,5915070,689055070,False,4
7461,validator_35,207863179430,True,731600000,19492900,751092900,False,6
7462,validator_14,285047772891,True,780880002,14063400,794943402,True,8
7463,validator_36,218304827380,True,522500000,1969230,524469230,False,6
7464,validator_36,218786046780,True,479000000,2219400,481219400,False,6
7465,validator_39,71904309350,True,627700000,37372980,665072980,False,2
7466,validator_34,663624278480,True,510100000,8030730,518130730,False,20
7467,validator_15,726513255203,True,510300001,1016800,511316801,True,22
7468,validator_15,727195991588,True,672100005,10636380,682736385,True,22
7469,validator_19,161188587239,True,763099998,2170300,765270298,True,5
7470,validator_25,77156361290,True,543900000,13620940,557520940,False,2
7471,validator_15,727675393592,True,441620004,37782000,479402004,True,22
7472,validator_15,728315090058,True,616319996,23376470,639696466,True,22
7473,validator_34,664287876310,True,653900000,9697830,663597830,False,20
7474,validator_47,154268211360,True,444710000,2583420,447293420,False,4
7475,validator_46,246894095260,True,631700000,20819120,652519120,False,7
7476,validator_17,440834390128,True,752040003,4859030,756899033,True,13
7477,validator_0,65983638942,True,638954008,23782500,662736508,True,2
7478,validator_34,664823941150,True,534400000,1664840,536064840,False,20
7479,validator_28,70041009120,True,344600000,7575890,352175890,False,2
7480,validator_14,285618152647,True,539399996,30979760,570379756,True,8
7481,validator_34,665117519650,True,289860000,3718500,293578500,False,20
7482,validator_44,222022469600,True,569000000,3316030,572316030,False,6
7483,validator_46,247527563660,True,613700000,19768400,633468400,False,7
7484,validator_3,74837703560,True,612940002,2903330,615843332,True,2
7485,validator_12,252364741210,True,712979997,19050300,732030297,True,7
7486,validator_15,729068131889,True,741460001,11581830,753041831,True,22
7487,validator_31,392035070010,True,463500000,2215040,465715040,False,12
7488,validator_12,252887161234,True,508299994,14120030,522420024,True,7
7489,validator_46,248133077160,True,594600000,10913500,605513500,False,7
7490,validator_19,161843943170,True,651700001,3655930,655355931,True,5
7491,validator_17,441513504112,True,653900004,25213980,679113984,True,13
7492,validator_7,166541353108,True,528819997,37717000,566536997,True,5
7493,validator_14,286436749677,True,799200000,19397030,818597030,True,8
7494,validator_22,174854787160,True,546008001,38104200,584112201,True,5
7495,validator_24,83498520055,True,645534000,15734040,661268040,True,2
7496,validator_21,155829749266,True,777659997,7870500,785530497,True,4
7497,validator_48,416989371980,True,605400000,859670,606259670,False,13
7498,validator_27,227283531530,True,571000000,9326500,580326500,False,7
7499,validator_17,442280797347,True,746165995,21127240,767293235,True,13
7500,validator_22,175432567015,True,569399995,8379860,577779855,True,5
7501,validator_7,167080360913,True,510640005,28367800,539007805,True,5
7502,validator_14,287002302755,True,562699998,2853080,565553078,True,8
7503,validator_27,228106270780,True,819400000,3339250,822739250,False,7
7504,validator_16,76541221649,True,778440007,26905740,805345747,True,2
7505,validator_40,76572981270,True,694500000,32184830,726684830,False,2
7506,validator_34,665824838550,True,704200000,3118900,707318900,False,20
7507,validator_6,76870746608,True,794439994,10792320,805232314,True,2
7508,validator_31,392542845560,True,505900000,1875550,507775550,False,12
7509,validator_47,154781482500,True,504600000,8671140,513271140,False,4
7510,validator_34,666531449060,True,703900000,2710510,706610510,False,20
7511,validator_14,287678251869,True,664839994,11109120,675949114,True,8
7512,validator_17,442966216404,True,684399997,1019060,685419057,True,13
7513,validator_15,729891386744,True,783145995,40108860,823254855,True,22
7514,validator_25,77868188800,True,708600000,3227510,711827510,False,2
7515,validator_30,139600486310,True,540000000,1115590,541115590,False,4
7516,validator_41,159968341930,True,624800000,15153980,639953980,False,4
7517,validator_15,730578559110,True,657000006,30172360,687172366,True,22
7518,validator_15,731051215549,True,421065999,51590440,472656439,True,22
7519,validator_21,156667625680,True,834999994,2876420,837876414,True,4
7520,validator_27,228855943080,True,729700000,19972300,749672300,False,7
7521,validator_43,146063601440,True,554200000,7392300,561592300,False,4
7522,validator_34,667094742080,True,540700000,22593020,563293020,False,20
7523,validator_13,73278953535,True,751639997,26592400,778232397,True,2
7524,validator_1,163670520507,True,600620002,13892620,614512622,True,5
7525,validator_24,84351047392,True,816620007,35907330,852527337,True,2
7526,validator_14,288357899316,True,642179997,37467450,679647447,True,9
7527,validator_34,667651462580,True,554100000,2620500,556720500,False,20
7528,validator_34,668240500400,True,585400000,3637820,589037820,False,20
7529,validator_34,669118587690,True,876200000,1887290,878087290,False,20
7530,validator_48,417938065610,True,927400000,21293630,948693630,False,13
7531,validator_29,63210093460,True,480800000,20216380,501016380,False,1
7532,validator_48,418500510790,True,561100000,1345180,562445180,False,13
7533,validator_30,140356590330,True,729500000,26604020,756104020,False,4
7534,validator_15,731655896346,True,573543997,31136800,604680797,True,22
7535,validator_40,77074800470,True,482100000,19719200,501819200,False,2
7536,validator_49,172504812250,True,630700000,2071070,632771070,False,5
7537,validator_17,443708008768,True,716720004,25072360,741792364,True,13
7538,validator_19,162525655716,True,649880006,31832540,681712546,True,5
7539,validator_22,176276038713,True,809879998,33591700,843471698,True,5
7540,validator_18,268229330312,True,641579995,25021430,666601425,True,8
7541,validator_27,229418637790,True,559900000,2794710,562694710,False,7
7542,validator_12,253653479435,True,763700001,2618200,766318201,True,7
7543,validator_44,222798398630,True,772000000,3929030,775929030,False,6
7544,validator_15,732212996959,True,533460003,23640610,557100613,True,22
7545,validator_3,75506919373,True,666999993,2215820,669215813,True,2
7546,validator_35,208497206390,True,631300000,2726960,634026960,False,6
7547,validator_36,219544873710,True,738600000,20226930,758826930,False,6
7548,validator_33,66642632400,True,747700000,1904480,749604480,False,2
7549,validator_15,733034002287,True,806939998,14065330,821005328,True,22
7550,validator_36,220142963210,True,594000000,4089500,598089500,False,6
7551,validator_12,254338697581,True,675040006,10178140,685218146,True,7
7552,validator_35,209182301690,True,683300000,1795300,685095300,False,6
7553,validator_7,167800351421,True,708120008,11870500,719990508,True,5
7554,validator_17,444350922600,True,614780002,28133830,642913832,True,13
7555,validator_33,67292285950,True,627100000,22553550,649653550,False,2
7556,validator_37,156914465750,True,589000000,8000620,597000620,False,4
7557,validator_23,69358857206,True,547320008,29215230,576535238,True,2
7558,validator_27,230165159330,True,743500000,3021540,746521540,False,7
7559,validator_15,733787100667,True,714520000,38578380,753098380,True,22
7560,validator_18,268920316453,True,668600001,22386140,690986141,True,8
7561,validator_15,734561320404,True,761840007,12379730,774219737,True,22
7562,validator_35,209798709650,True,613800000,2607960,616407960,False,6
7563,validator_15,735367146728,True,785800004,20026320,805826324,True,22
7564,validator_21,157192443000,True,500720000,24097320,524817320,True,4
7565,validator_22,176980665762,True,687689999,16937050,704627049,True,5
7566,validator_46,248747224870,True,611900000,2247710,614147710,False,7
7567,validator_27,230801527670,True,634200000,2168340,636368340,False,7
7568,validator_48,419086240190,True,570400000,15329400,585729400,False,13
7569,validator_14,289126534607,True,730560001,38075290,768635291,True,9
7570,validator_35,210596280730,True,795100000,2471080,797571080,False,6
7571,validator_17,444773177995,True,416239995,6015400,422255395,True,13
7572,validator_41,160507987570,True,535500000,4145640,539645640,False,5
7573,validator_34,669808869590,True,680300000,9981900,690281900,False,20
7574,validator_15,736287929529,True,908860001,11922800,920782801,True,23
7575,validator_35,211186710320,True,587800000,2629590,590429590,False,6
7576,validator_44,223399984430,True,593400000,8185800,601585800,False,6
7577,validator_34,670243623310,True,428100000,6653720,434753720,False,20
7578,validator_48,419691621360,True,602700000,2681170,605381170,False,13
7579,validator_0,66663856674,True,677400002,2817730,680217732,True,2
7580,validator_15,737251834726,True,912899997,51005200,963905197,True,23
7581,validator_22,177627626569,True,622880007,24080800,646960807,True,5
7582,validator_27,231438899190,True,634400000,2971520,637371520,False,7
7583,validator_22,178612816371,True,977660002,7529800,985189802,True,5
7584,validator_6,77636789803,True,743799995,22243200,766043195,True,2
7585,validator_19,163167711197,True,580520001,61535480,642055481,True,5
7586,validator_27,232011292270,True,552880000,19513080,572393080,False,7
7587,validator_31,393213815880,True,669600000,1370320,670970320,False,12
7588,validator_27,232534586210,True,504090000,19203940,523293940,False,7
7589,validator_19,164066707163,True,890069996,8925970,898995966,True,5
7590,validator_15,737912555528,True,647346002,13374800,660720802,True,23
7591,validator_17,445702381840,True,904720005,24483840,929203845,True,13
7592,validator_49,173026198150,True,489240000,32145900,521385900,False,5
7593,validator_6,78444320891,True,779719998,27811090,807531088,True,2
7594,validator_47,155458990300,True,667300000,10207800,677507800,False,4
7595,validator_12,254927317491,True,577454000,11165910,588619910,True,7
7596,validator_45,64087318090,True,491600000,2300310,493900310,False,2
7597,validator_17,446423244121,True,703980001,16882280,720862281,True,13
7598,validator_5,159416466450,True,894727999,31947900,926675899,True,4
7599,validator_36,220797568010,True,632400000,22204800,654604800,False,6
7600,validator_14,289775017407,True,636620000,11862800,648482800,True,9
7601,validator_14,290471424506,True,659179999,37227100,696407099,True,9
7602,validator_38,70200699770,True,578000000,6805760,584805760,False,2
7603,validator_33,67967382490,True,669000000,6096540,675096540,False,2
7604,validator_3,76169277341,True,653899998,8457970,662357968,True,2
7605,validator_47,156044373040,True,580500000,4882740,585382740,False,4
7606,validator_46,249217785770,True,457500000,13060900,470560900,False,7
7607,validator_48,420207736240,True,508700000,7414880,516114880,False,13
7608,validator_11,63237991197,True,733400007,75687600,809087607,True,1
7609,validator_46,249975130130,True,712200000,45144360,757344360,False,7
7610,validator_15,738641913550,True,685258002,44100020,729358022,True,23
7611,validator_23,70299175097,True,918399991,21917900,940317891,True,2
7612,validator_18,269723855092,True,782599999,20938640,803538639,True,8
7613,validator_30,140967078330,True,607600000,2888000,610488000,False,4
7614,validator_27,233197551950,True,661400000,1565740,662965740,False,7
7615,validator_17,447153736085,True,692254004,38237960,730491964,True,13
7616,validator_7,168627912526,True,806600005,20961100,827561105,True,5
7617,validator_44,224102748550,True,683800000,18964120,702764120,False,7
7618,validator_49,173800028150,True,747000000,26830000,773830000,False,5
7619,validator_17,448088540590,True,897200005,37604500,934804505,True,14
7620,validator_12,255670422393,True,741400002,1704900,743104902,True,7
7621,validator_35,211646767760,True,449400000,10657440,460057440,False,6
7622,validator_31,393907822420,True,691400000,2606540,694006540,False,12
7623,validator_25,78467196630,True,593900000,5107830,599007830,False,2
7624,validator_15,739316665281,True,673500001,1251730,674751731,True,23
7625,validator_17,448783297430,True,688820000,5936840,694756840,True,14
7626,validator_34,670743269000,True,490200000,9445690,499645690,False,20
7627,validator_12,256257552273,True,566240000,20889880,587129880,True,8
7628,validator_7,169221565565,True,591099999,2553040,593653039,True,5
7629,validator_46,250641914710,True,645800000,20984580,666784580,False,7
7630,validator_30,141552494030,True,583100000,2315700,585415700,False,4
7631,validator_21,158070087428,True,875399998,2244430,877644428,True,4
7632,validator_33,68509372500,True,539000000,2990010,541990010,False,2
7633,validator_31,394482428320,True,568700000,5905900,574605900,False,12
7634,validator_15,739950343416,True,613319995,20358140,633678135,True,23
7635,validator_15,740529429001,True,549594005,29491580,579085585,True,23
7636,validator_31,395064249140,True,579800000,2020820,581820820,False,12
7637,validator_48,420832893180,True,622000000,3156940,625156940,False,13
7638,validator_34,671313140990,True,559900000,9971990,569871990,False,20
7639,validator_25,78999749140,True,525900000,6652510,532552510,False,2
7640,validator_19,164651921662,True,564619999,20594500,585214499,True,5
7641,validator_2,64012114852,True,587099993,11340000,598439993,True,2
7642,validator_34,671920320190,True,587700000,19479200,607179200,False,20
7643,validator_48,421349350080,True,513400000,3056900,516456900,False,13
7644,validator_28,70792841880,True,742600000,9232760,751832760,False,2
7645,validator_18,270502884096,True,768400004,10629000,779029004,True,8
7646,validator_48,422134182040,True,783000000,1831960,784831960,False,13
7647,validator_41,161165715440,True,655800000,1927870,657727870,False,5
7648,validator_2,64739118347,True,718639995,8363500,727003495,True,2
7649,validator_37,157561417500,True,626100000,20851750,646951750,False,4
7650,validator_49,174392991770,True,590700000,2263620,592963620,False,5
7651,validator_18,271330002024,True,772519998,54597930,827117928,True,8
7652,validator_7,169795939884,True,570019999,4354320,574374319,True,5
7653,validator_48,422670689230,True,516300000,20207190,536507190,False,13
7654,validator_44,224619967590,True,514200000,3019040,517219040,False,7
7655,validator_36,221351403450,True,545800000,8035440,553835440,False,6
7656,validator_12,256856465053,True,579000000,19912780,598912780,True,8
7657,validator_14,290988589332,True,472440006,44724820,517164826,True,9
7658,validator_7,170611761798,True,770399994,45421920,815821914,True,5
7659,validator_42,60319138550,True,590700000,645580,591345580,False,1
7660,validator_47,156893334780,True,840500000,8461740,848961740,False,4
7661,validator_15,741146384703,True,571198002,45757700,616955702,True,23
7662,validator_31,395654723820,True,587900000,2574680,590474680,False,12
7663,validator_18,272054404789,True,695240005,29162760,724402765,True,8
7664,validator_18,272909640588,True,823459999,31775800,855235799,True,8
7665,validator_2,65457424234,True,703139997,15165890,718305887,True,2
7666,validator_12,257625191076,True,735260003,33466020,768726023,True,8
7667,validator_21,158691023530,True,590600002,30336100,620936102,True,4
7668,validator_14,291662647133,True,660040001,14017800,674057801,True,9
7669,validator_15,741971372995,True,769180002,55808290,824988292,True,23
7670,validator_27,233792065710,True,575200000,19313760,594513760,False,7
7671,validator_34,672504702740,True,581000000,3382550,584382550,False,21
7672,validator_44,225198623590,True,571900000,6756000,578656000,False,7
7673,validator_34,673041738140,True,514500000,22535400,537035400,False,21
7674,validator_37,158059762300,True,476900000,21444800,498344800,False,4
7675,validator_17,449443753465,True,640357995,20098040,660456035,True,14
7676,validator_14,292214101325,True,504719992,46734200,551454192,True,9
7677,validator_0,67410540330,True,722919996,23763660,746683656,True,2
7678,validator_12,258138952641,True,488699995,25061570,513761565,True,8
7679,validator_3,77126475700,True,912079999,45118360,957198359,True,2
7680,validator_21,159401587311,True,694520001,16043780,710563781,True,4
7681,validator_15,742574723449,True,577699994,25650460,603350454,True,23
7682,validator_46,251178162750,True,534100000,2148040,536248040,False,7
7683,validator_11,63949394994,True,701339997,10063800,711403797,True,1
7684,validator_17,450382551912,True,914040007,24758440,938798447,True,14
7685,validator_34,673679914470,True,636100000,2076330,638176330,False,21
7686,validator_31,396165160400,True,498900000,11536580,510436580,False,12
7687,validator_17,451022922992,True,617000000,23371080,640371080,True,14
7688,validator_10,83301491320,True,710259998,6455670,716715668,True,2
7689,validator_17,451812668895,True,747114003,42631900,789745903,True,14
7690,validator_14,293119551606,True,879400001,26050280,905450281,True,9
7691,validator_37,158750815480,True,667800000,23253180,691053180,False,4
7692,validator_22,179174306940,True,516659999,44830570,561490569,True,5
7693,validator_31,396558370850,True,391600000,1610450,393210450,False,12
7694,validator_49,175061175200,True,665900000,2283430,668183430,False,5
7695,validator_35,212162343030,True,508000000,7575270,515575270,False,6
7696,validator_36,221925577190,True,564100000,10073740,574173740,False,6
7697,validator_41,161705391570,True,537400000,2276130,539676130,False,5
7698,validator_49,175872102030,True,797500000,13426830,810926830,False,5
7699,validator_22,179797082110,True,589740000,33035170,622775170,True,5
7700,validator_31,397310491200,True,741900000,10220350,752120350,False,12
7701,validator_15,743181193479,True,592196000,14274030,606470030,True,23
7702,validator_30,142129549600,True,568140000,8915570,577055570,False,4
7703,validator_34,674207275550,True,508400000,18961080,527361080,False,21
7704,validator_35,212810232870,True,637400000,10489840,647889840,False,6
7705,validator_27,234317960910,True,523800000,2095200,525895200,False,7
7706,validator_48,423167023370,True,487700000,8634140,496334140,False,13
7707,validator_2,66163134617,True,698600003,7110380,705710383,True,2
7708,validator_34,674800614720,True,591400000,1939170,593339170,False,21
7709,validator_6,79164397820,True,703739999,16336930,720076929,True,2
7710,validator_34,675412387840,True,610500000,1273120,611773120,False,21
7711,validator_3,77618968550,True,485640000,6852850,492492850,True,2
7712,validator_40,77666088240,True,580200000,11087770,591287770,False,2
7713,validator_17,452603970325,True,770100000,21201430,791301430,True,14
7714,validator_17,453329463173,True,707059998,18432850,725492848,True,14
7715,validator_14,293754478035,True,629719999,5206430,634926429,True,9
7716,validator_15,744134913577,True,949899998,3820100,953720098,True,23
7717,validator_40,78253715840,True,585200000,2427600,587627600,False,2
7718,validator_31,397909683600,True,572700000,26492400,599192400,False,12
7719,validator_27,235160998640,True,840400000,2637730,843037730,False,7
7720,validator_2,66857417492,True,687999995,6282880,694282875,True,2
7721,validator_20,75490858562,True,588180004,19490920,607670924,True,2
7722,validator_22,180265042754,True,457700004,10260640,467960644,True,5
7723,validator_10,83924347533,True,602760003,20096210,622856213,True,2
7724,validator_41,162388129990,True,681300000,1438420,682738420,False,5
7725,validator_45,64796976890,True,707400000,2258800,709658800,False,2
7726,validator_27,235693247040,True,529600000,2648400,532248400,False,7
7727,validator_47,157577380020,True,674100000,9945240,684045240,False,4
7728,validator_43,146526003520,True,443500000,18902080,462402080,False,4
7729,validator_44,225737737330,True,511500000,27613740,539113740,False,7
7730,validator_14,294391323860,True,626619995,10225830,636845825,True,9
7731,validator_12,258745966828,True,569177997,37836190,607014187,True,8
7732,validator_35,213427600870,True,615300000,2068000,617368000,False,6
7733,validator_17,453838749798,True,498323995,10962630,509286625,True,14
7734,validator_31,398539147860,True,627000000,2464260,629464260,False,12
7735,validator_32,60591400550,True,569100000,24482520,593582520,False,1
7736,validator_1,164302679925,True,599579998,32579420,632159418,True,5
7737,validator_17,454230509482,True,358020004,33739680,391759684,True,14
7738,validator_31,399131279180,True,591400000,731320,592131320,False,12
7739,validator_9,77744720124,True,675779994,31582640,707362634,True,2
7740,validator_27,236350235780,True,652800000,4188740,656988740,False,7
7741,validator_24,84988957858,True,623540006,14370460,637910466,True,2
7742,validator_14,295072947759,True,675479999,6143900,681623899,True,9
7743,validator_25,79705965140,True,698600000,7616000,706216000,False,2
7744,validator_48,423638361390,True,469100000,2238020,471338020,False,13
7745,validator_34,676048228730,True,634800000,1040890,635840890,False,21
7746,validator_48,424289631690,True,647500000,3770300,651270300,False,13
7747,validator_41,163269286980,True,854900000,26256990,881156990,False,5
7748,validator_17,455141955379,True,907399997,4045900,911445897,True,14
7749,validator_14,295535184655,True,455279996,6956900,462236896,True,9
7750,validator_34,676604839370,True,536700000,19910640,556610640,False,21
7751,validator_34,677154200080,True,528800000,20560710,549360710,False,21
7752,validator_39,72602057800,True,694800000,2948450,697748450,False,2
7753,validator_31,399799991180,True,665900000,2812000,668712000,False,12
7754,validator_17,455706688311,True,543000002,21732930,564732932,True,14
7755,validator_22,181004873389,True,698559995,41270640,739830635,True,5
7756,validator_15,745278822678,True,1116640001,27269100,1143909101,True,23
7757,validator_5,160066074059,True,622635999,26971610,649607609,True,5
7758,validator_46,251938658790,True,753500000,6996040,760496040,False,7
7759,validator_44,226235482070,True,493900000,3844740,497744740,False,7
7760,validator_31,400274514320,True,472600000,1923140,474523140,False,12
7761,validator_12,259393245201,True,639600003,7678370,647278373,True,8
7762,validator_17,456406150018,True,696400007,3061700,699461707,True,14
7763,validator_35,214068463170,True,637500000,3362300,640862300,False,6
7764,validator_36,222583975510,True,657500000,898320,658398320,False,6
7765,validator_18,273665342021,True,737620003,18081430,755701433,True,8
7766,validator_27,236987844400,True,635500000,2108620,637608620,False,7
7767,validator_48,425006444520,True,704600000,12212830,716812830,False,13
7768,validator_36,223299803350,True,712700000,3127840,715827840,False,6
7769,validator_34,677673679260,True,512100000,7379180,519479180,False,21
7770,validator_20,76177467738,True,671739996,14869180,686609176,True,2
7771,validator_31,400901782860,True,624600000,2668540,627268540,False,12
7772,validator_17,456989569524,True,567780006,15639500,583419506,True,14
7773,validator_12,260181648434,True,757059993,31343240,788403233,True,8
7774,validator_34,678195107320,True,511800000,9628060,521428060,False,21
7775,validator_48,425699077000,True,690900000,1732480,692632480,False,13
7776,validator_12,260870366517,True,677580003,11138080,688718083,True,8
7777,validator_17,457422502464,True,428440000,4492940,432932940,True,14
7778,validator_34,678899559610,True,684500000,19952290,704452290,False,21
7779,validator_34,679523835410,True,604200000,20075800,624275800,False,21
7780,validator_41,163800894150,True,528800000,2807170,531607170,False,5
7781,validator_41,164399071150,True,594900000,3277000,598177000,False,5
7782,validator_31,401469005320,True,565600000,1622460,567222460,False,12
7783,validator_48,426454212520,True,750800000,4335520,755135520,False,13
7784,validator_18,274291379914,True,623800003,2237890,626037893,True,8
7785,validator_36,223966438010,True,647530000,19104660,666634660,False,6
7786,validator_31,401960762180,True,471840000,19916860,491756860,False,12
7787,validator_44,227032589870,True,791900000,5207800,797107800,False,7
7788,validator_44,227665145540,True,611900000,20655670,632555670,False,7
7789,validator_3,78374820472,True,753100002,2751920,755851922,True,2
7790,validator_41,165083021160,True,682400000,1550010,683950010,False,5
7791,validator_15,745876268172,True,572279994,25165500,597445494,True,23
7792,validator_14,296030231282,True,473539997,21506630,495046627,True,9
7793,validator_45,65358702940,True,555570000,6156050,561726050,False,2
7794,validator_3,79175575645,True,780100003,20655170,800755173,True,2
7795,validator_25,80345352080,True,636900000,2486940,639386940,False,2
7796,validator_48,426878004820,True,421300000,2492300,423792300,False,13
7797,validator_30,142864279440,True,724900000,9829840,734729840,False,4
7798,validator_47,158046540820,True,460000000,9160800,469160800,False,4
7799,validator_34,680101962440,True,558500000,19627030,578127030,False,21
7800,validator_14,296835687878,True,778119996,27336600,805456596,True,9
7801,validator_22,181611059429,True,588860000,17326040,606186040,True,5
7802,validator_18,275018766276,True,724800002,2586360,727386362,True,8
7803,validator_34,680566297980,True,462200000,2135540,464335540,False,21
7804,validator_27,237603884050,True,613000000,3039650,616039650,False,7
7805,validator_14,297660140978,True,821400000,3053100,824453100,True,9
7806,validator_35,214766196770,True,695300000,2433600,697733600,False,6
7807,validator_37,159337469300,True,582000000,4653820,586653820,False,4
7808,validator_31,402468038730,True,495900000,11376550,507276550,False,12
7809,validator_17,458133334802,True,684799998,26032340,710832338,True,14
7810,validator_17,458907301362,True,770800000,3166560,773966560,True,14
7811,validator_1,165142372016,True,836200001,3492090,839692091,True,5
7812,validator_48,427522130740,True,623500000,20625920,644125920,False,13
7813,validator_20,77143144949,True,949440001,16237210,965677211,True,2
7814,validator_49,176731421030,True,848300000,11019000,859319000,False,5
7815,validator_33,69174273360,True,660000000,4900860,664900860,False,2
7816,validator_34,681124322380,True,538500000,19524400,558024400,False,21
7817,validator_27,238438747050,True,832000000,2863000,834863000,False,7
7818,validator_30,143425359460,True,541300000,19780020,561080020,False,4
7819,validator_12,261548849720,True,668840003,9643200,678483203,True,8
7820,validator_30,144081310620,True,618400000,37551160,655951160,False,4
7821,validator_26,63655082990,True,789600000,20555320,810155320,False,1
7822,validator_31,403176938110,True,704300000,4599380,708899380,False,12
7823,validator_13,74045669117,True,740220002,26495580,766715582,True,2
7824,validator_47,158622499330,True,574100000,1858510,575958510,False,4
7825,validator_18,275970834100,True,936559994,15507830,952067824,True,8
7826,validator_17,459668104866,True,722180004,38623500,760803504,True,14
7827,validator_17,460358684889,True,665340003,25240020,690580023,True,14
7828,validator_8,66823037618,True,799780009,24333430,824113439,True,2
7829,validator_15,746828926876,True,925160004,27498700,952658704,True,23
7830,validator_47,159226071320,True,601200000,2371990,603571990,False,4
7831,validator_49,177499724770,True,748900000,19403740,768303740,False,5
7832,validator_22,182273141839,True,588140010,73942400,662082410,True,5
7833,validator_34,681736391040,True,610000000,2068660,612068660,False,21
7834,validator_38,71019219940,True,814400000,4120170,818520170,False,2
7835,validator_44,228397500960,True,712500000,19855420,732355420,False,7
7836,validator_43,147141898940,True,613700000,2195420,615895420,False,4
7837,validator_15,747295063621,True,418286005,47850740,466136745,True,23
7838,validator_1,165888464897,True,738300001,7792880,746092881,True,5
7839,validator_15,747765254540,True,452099999,18090920,470190919,True,23
7840,validator_14,298398815776,True,677379998,61294800,738674798,True,9
7841,validator_34,682345244670,True,605800000,3053630,608853630,False,21
7842,validator_49,178203558150,True,699700000,4133380,703833380,False,5
7843,validator_35,215309931370,True,542800000,934600,543734600,False,6
7844,validator_5,160476878598,True,401699999,9104540,410804539,True,5
7845,validator_35,216091003600,True,778600000,2472230,781072230,False,6
7846,validator_17,461181213314,True,807635995,14892430,822528425,True,14
7847,validator_34,682907935900,True,523700000,38991230,562691230,False,21
7848,validator_34,683548068100,True,638070000,2062200,640132200,False,21
7849,validator_43,147776742050,True,624100000,10743110,634843110,False,4
7850,validator_15,748487330778,True,694599998,27476240,722076238,True,23
7851,validator_15,749115535017,True,600360009,27844230,628204239,True,23
7852,validator_15,749743368783,True,618099996,9733770,627833766,True,23
7853,validator_39,73221009340,True,616100000,2851540,618951540,False,2
7854,validator_21,160179556269,True,775100008,2868950,777968958,True,5
7855,validator_15,750368912123,True,616060000,9483340,625543340,True,23
7856,validator_15,751053230167,True,682800004,1518040,684318044,True,23
7857,validator_34,684295065300,True,737900000,9097200,746997200,False,21
7858,validator_44,229035609290,True,635900000,2208330,638108330,False,7
7859,validator_17,461705482644,True,514600000,9669330,524269330,True,14
7860,validator_9,78502415653,True,725939999,31755530,757695529,True,2
7861,validator_48,428199410060,True,675500000,1779320,677279320,False,13
7862,validator_41,165739472960,True,636000000,20451800,656451800,False,5
7863,validator_17,462286191439,True,571499995,9208800,580708795,True,14
7864,validator_48,428696794470,True,495800000,1584410,497384410,False,13
7865,validator_35,216660960930,True,567900000,2057330,569957330,False,6
7866,validator_15,751703430943,True,625109996,25090780,650200776,True,23
7867,validator_25,81032317250,True,683900000,3065170,686965170,False,2
7868,validator_27,239134784880,True,694100000,1937830,696037830,False,7
7869,validator_30,144701304660,True,618400000,1594040,619994040,False,4
7870,validator_34,684936859870,True,622200000,19594570,641794570,False,21
7871,validator_31,403945186550,True,766000000,2248440,768248440,False,12
7872,validator_41,166393996490,True,648200000,6323530,654523530,False,5
7873,validator_49,178965068620,True,734500000,27010470,761510470,False,5
7874,validator_41,166911755090,True,511500000,6258600,517758600,False,5
7875,validator_27,239715537280,True,560700000,20052400,580752400,False,7
7876,validator_36,224604077580,True,634300000,3339570,637639570,False,7
7877,validator_43,148328401660,True,548400000,3259610,551659610,False,4
7878,validator_18,276703849205,True,707100005,25915100,733015105,True,8
7879,validator_46,252589010890,True,627100000,23252100,650352100,False,7
7880,validator_31,404523465580,True,576200000,2079030,578279030,False,12
7881,validator_13,74639952789,True,547320002,46963670,594283672,True,2
7882,validator_10,84642865229,True,696639996,21877700,718517696,True,2
7883,validator_18,277496628944,True,778699999,14079740,792779739,True,8
7884,validator_48,429150854000,True,434470000,19589530,454059530,False,13
7885,validator_39,73712059920,True,489100000,1950580,491050580,False,2
7886,validator_43,149019419910,True,671700000,19318250,691018250,False,4
7887,validator_8,67443551514,True,593539996,26973900,620513896,True,2
7888,validator_48,429728970900,True,575800000,2316900,578116900,False,13
7889,validator_34,685670485160,True,723300000,10325290,733625290,False,21
7890,validator_34,686239005960,True,543000000,25520800,568520800,False,21
7891,validator_6,79726193052,True,529180002,32615230,561795232,True,2
7892,validator_45,65934916840,True,574700000,1513900,576213900,False,2
7893,validator_48,430497084660,True,761400000,6713760,768113760,False,13
7894,validator_19,165335202888,True,636399996,46881230,683281226,True,5
7895,validator_36,225326537600,True,720300000,2160020,722460020,False,7
7896,validator_15,752341714046,True,592258003,46025100,638283103,True,23
7897,validator_18,278276930843,True,760499999,19801900,780301899,True,8
7898,validator_34,687036918420,True,795900000,2012460,797912460,False,21
7899,validator_5,161277281672,True,773339994,27063080,800403074,True,5
7900,validator_40,79062187280,True,802200000,6271440,808471440,False,2
7901,validator_12,262158968924,True,603499994,6619210,610119204,True,8
7902,validator_27,240490176210,True,767100000,7538930,774638930,False,7
7903,validator_15,752883052020,True,538099994,3237980,541337974,True,23
7904,validator_15,753679610224,True,770140004,26418200,796558204,True,23
7905,validator_34,687690721550,True,652400000,1403130,653803130,False,21
7906,validator_9,79079794861,True,575000008,2379200,577379208,True,2
7907,validator_48,431009718840,True,486900000,25734180,512634180,False,13
7908,validator_1,166554129228,True,654840001,10824330,665664331,True,5
7909,validator_34,688261940640,True,555600000,15619090,571219090,False,21
7910,validator_34,688766001210,True,477400000,26660570,504060570,False,21
7911,validator_21,160941274866,True,738139997,23578600,761718597,True,5
7912,validator_13,75545661957,True,888739998,16969170,905709168,True,2
7913,validator_37,159842252520,True,504000000,783220,504783220,False,4
7914,validator_30,145392902680,True,689800000,1798020,691598020,False,4
7915,validator_34,689408608750,True,636400000,6207540,642607540,False,21
7916,validator_12,262962749126,True,772740002,31040200,803780202,True,8
7917,validator_15,754249899293,True,531399989,38889080,570289069,True,23
7918,validator_34,690060557380,True,648700000,3248630,651948630,False,21
7919,validator_33,69707772380,True,531600000,1899020,533499020,False,2
7920,validator_30,145995775890,True,596000000,6873210,602873210,False,4
7921,validator_40,79413038390,True,348800000,2051110,350851110,False,2
7922,validator_49,179500667390,True,532800000,2798770,535598770,False,5
7923,validator_31,405117840630,True,573400000,20975050,594375050,False,12
7924,validator_34,690748255500,True,685800000,1898120,687698120,False,21
7925,validator_17,462915453367,True,612619998,16641930,629261928,True,14
7926,validator_34,691497017830,True,728000000,20762330,748762330,False,21
7927,validator_34,692150797130,True,645500000,8279300,653779300,False,21
7928,validator_46,253170050970,True,580700000,340080,581040080,False,7
7929,validator_26,64291259790,True,628200000,7976800,636176800,False,2
7930,validator_22,182906819271,True,624940002,8737430,633677432,True,5
7931,validator_5,161930398910,True,646399998,6717240,653117238,True,5
7932,validator_15,754938908593,True,649460000,39549300,689009300,True,23
7933,validator_14,298940888154,True,536439998,5632380,542072378,True,9
7934,validator_48,431611592570,True,601100000,773730,601873730,False,13
7935,validator_36,225898201420,True,565300000,6363820,571663820,False,7
7936,validator_17,463893985369,True,935320002,43212000,978532002,True,14
7937,validator_17,464915479710,True,998960001,22534340,1021494341,True,14
7938,validator_17,465492441137,True,567999997,8961430,576961427,True,14
7939,validator_46,253664625700,True,492600000,1974730,494574730,False,7
7940,validator_19,166130987193,True,783000005,12784300,795784305,True,5
7941,validator_37,160458502350,True,613100000,3149830,616249830,False,5
7942,validator_19,166840728880,True,663600007,46141680,709741687,True,5
7943,validator_34,692860581210,True,708900000,884080,709784080,False,21
7944,validator_14,299529369998,True,577870004,10611840,588481844,True,9
7945,validator_4,61047523328,True,585300009,47842500,633142509,True,1
7946,validator_15,755794563806,True,809860003,45795210,855655213,True,23
7947,validator_35,217105981580,True,420200000,24820650,445020650,False,6
7948,validator_40,79970617030,True,547900000,9678640,557578640,False,2
7949,validator_27,241094845110,True,576580000,28088900,604668900,False,7
7950,validator_49,180196747590,True,694100000,1980200,696080200,False,5
7951,validator_36,226475502420,True,556100000,21201000,577301000,False,7
7952,validator_11,64825314397,True,865800003,10119400,875919403,True,2
7953,validator_31,405851758760,True,706600000,27318130,733918130,False,12
7954,validator_15,756627998003,True,814199997,19234200,833434197,True,23
7955,validator_15,757213812300,True,547759997,38054300,585814297,True,23
7956,validator_0,68061862121,True,644520001,6801790,651321791,True,2
7957,validator_1,167215453028,True,650666000,10657800,661323800,True,5
7958,validator_14,300116615035,True,549900007,37345030,587245037,True,9
7959,validator_27,241675545830,True,561100000,19600720,580700720,False,7
7960,validator_16,77409221218,True,855486009,12513560,867999569,True,2
7961,validator_18,278950465753,True,660580000,12954910,673534910,True,8
7962,validator_39,74326523850,True,608200000,6263930,614463930,False,2
7963,validator_31,406629533820,True,775000000,2775060,777775060,False,12
7964,validator_43,149532601910,True,503100000,10082000,513182000,False,4
7965,validator_49,180793562670,True,593100000,3715080,596815080,False,5
7966,validator_17,466098506095,True,595059988,11004970,606064958,True,14
7967,validator_17,466954459197,True,815280002,40673100,855953102,True,14
7968,validator_42,60981958430,True,661000000,1819880,662819880,False,1
7969,validator_48,432369026830,True,755600000,1834260,757434260,False,13
7970,validator_42,61598197320,True,612500000,3738890,616238890,False,1
7971,validator_12,263333872529,True,366940003,4183400,371123403,True,8
7972,validator_21,161550862529,True,601300003,8287660,609587663,True,5
7973,validator_7,171397878017,True,775099999,11016220,786116219,True,5
7974,validator_34,693340391910,True,478900000,910700,479810700,False,21
7975,validator_48,433025891670,True,653800000,3064840,656864840,False,13
7976,validator_31,407206040310,True,567400000,9106490,576506490,False,12
7977,validator_27,242485838730,True,799900000,10392900,810292900,False,7
7978,validator_15,757944363731,True,729400001,1151430,730551431,True,23
7979,validator_15,758807724639,True,848939998,14420910,863360908,True,23
7980,validator_49,181486050670,True,690200000,2288000,692488000,False,5
7981,validator_48,433518661260,True,470600000,22169590,492769590,False,13
7982,validator_21,162110190872,True,543570003,15758340,559328343,True,5
7983,validator_44,229646709970,True,601900000,9200680,611100680,False,7
7984,validator_49,182067001710,True,578600000,2351040,580951040,False,5
7985,validator_3,79826775238,True,642519993,8679600,651199593,True,2
7986,validator_5,162483582513,True,520900003,32283600,553183603,True,5
7987,validator_21,162575090573,True,456940001,7959700,464899701,True,5
7988,validator_31,407939732610,True,730400000,3292300,733692300,False,12
7989,validator_48,434007934080,True,486400000,2872820,489272820,False,13
7990,validator_15,759511041584,True,701100005,2216940,703316945,True,23
7991,validator_48,434625782780,True,615200000,2648700,617848700,False,13
7992,validator_17,467535810800,True,561546003,19805600,581351603,True,14
7993,validator_35,217792993880,True,684700000,2312300,687012300,False,6
7994,validator_34,693863777970,True,504200000,19186060,523386060,False,21
7995,validator_39,74711379770,True,342880000,41975920,384855920,False,2
7996,validator_48,435274498060,True,646600000,2115280,648715280,False,13
7997,validator_40,80449221360,True,467600000,11004330,478604330,False,2
7998,validator_48,435967978060,True,683600000,9880000,693480000,False,13
7999,validator_14,300592368458,True,458520003,17233420,475753423,True,9
8000,validator_3,80508217100,True,654720002,26721860,681441862,True,2
8001,validator_21,163166876217,True,586420004,5365640,591785644,True,5
8002,validator_41,167587438020,True,671500000,4182930,675682930,False,5
8003,validator_36,227097997360,True,602000000,20494940,622494940,False,7
8004,validator_18,279704794420,True,727659997,26668670,754328667,True,8
8005,validator_46,254220292720,True,552500000,3167020,555667020,False,7
8006,validator_18,280444438548,True,686161998,53482130,739644128,True,8
8007,validator_36,227675814750,True,568800000,9017390,577817390,False,7
8008,validator_42,62113667930,True,511600000,3870610,515470610,False,1
8009,validator_15,760279528947,True,766200003,2287360,768487363,True,23
8010,validator_27,242917514310,True,421800000,9875580,431675580,False,7
8011,validator_47,159854868430,True,627300000,1497110,628797110,False,4
8012,validator_29,63865939290,True,653700000,2145830,655845830,False,1
8013,validator_14,301115748656,True,514463998,8916200,523380198,True,9
8014,validator_44,230341888590,True,691900000,3278620,695178620,False,7
8015,validator_40,80962382040,True,511000000,2160680,513160680,False,2
8016,validator_36,228203905430,True,527200000,890680,528090680,False,7
8017,validator_34,694836655620,True,971500000,1377650,972877650,False,21
8018,validator_30,146618806710,True,604100000,18930820,623030820,False,4
8019,validator_31,408526540310,True,584100000,2707700,586807700,False,12
8020,validator_9,79653152641,True,571000000,2357780,573357780,True,2
8021,validator_17,468233077798,True,676459998,20807000,697266998,True,14
8022,validator_7,172081862890,True,672959993,11024880,683984873,True,5
8023,validator_30,147281814340,True,643200000,19807630,663007630,False,4
8024,validator_34,695338736180,True,482040000,20040560,502080560,False,21
8025,validator_7,172734962409,True,639859999,13239520,653099519,True,5
8026,validator_15,760997773443,True,716299996,1944500,718244496,True,23
8027,validator_46,255096025520,True,847100000,28632800,875732800,False,7
8028,validator_12,264219499416,True,851917997,33708890,885626887,True,8
8029,validator_37,161074904210,True,613500000,2901860,616401860,False,5
8030,validator_15,761568919813,True,555608000,15538370,571146370,True,23
8031,validator_48,436430283560,True,460700000,1605500,462305500,False,13
8032,validator_34,696011054560,True,670600000,1718380,672318380,False,21
8033,validator_2,67687455769,True,799800007,30238270,830038277,True,2
8034,validator_15,762293460407,True,720699994,3840600,724540594,True,23
8035,validator_5,163256534712,True,725960009,46992190,772952199,True,5
8036,validator_29,64475344350,True,600600000,8805060,609405060,False,2
8037,validator_48,437119891500,True,669100000,20507940,689607940,False,13
8038,validator_44,231160964770,True,815600000,3476180,819076180,False,7
8039,validator_15,763176973309,True,841360002,42152900,883512902,True,23
8040,validator_12,264745194679,True,522899993,2795270,525695263,True,8
8041,validator_15,763933372946,True,717593997,38805640,756399637,True,23
8042,validator_15,764594749333,True,639939997,21436390,661376387,True,23
8043,validator_35,218390185030,True,595900000,1291150,597191150,False,6
8044,validator_48,437896658120,True,753300000,23466620,776766620,False,13
8045,validator_17,468920666080,True,676800002,10788280,687588282,True,14
8046,validator_36,228867595730,True,661100000,2590300,663690300,False,7
8047,validator_34,696768575790,True,754600000,2921230,757521230,False,21
8048,validator_35,219032148560,True,640000000,1963530,641963530,False,6
8049,validator_17,469757192639,True,832499999,4026560,836526559,True,14
8050,validator_8,68168497562,True,698220008,26726040,724946048,True,2
8051,validator_14,301718636960,True,578080004,24808300,602888304,True,9
8052,validator_48,438618425110,True,719300000,2466990,721766990,False,13
8053,validator_18,281077759580,True,626720002,6601030,633321032,True,8
8054,validator_41,168307490630,True,713300000,6752610,720052610,False,5
8055,validator_35,219721658700,True,688700000,810140,689510140,False,6
8056,validator_6,80351401664,True,621600002,3608610,625208612,True,2
8057,validator_31,409172465340,True,624300000,21625030,645925030,False,12
8058,validator_15,765207298910,True,594540007,18009570,612549577,True,23
8059,validator_41,169065101630,True,756000000,1611000,757611000,False,5
8060,validator_43,150137912590,True,602600000,2710680,605310680,False,4
8061,validator_27,243666318530,True,742500000,6304220,748804220,False,7
8062,validator_14,302600179376,True,859899996,21642420,881542416,True,9
8063,validator_6,81195794865,True,824400001,19993200,844393201,True,2
8064,validator_47,160396811130,True,539500000,2442700,541942700,False,5
8065,validator_45,66397445440,True,461200000,1328600,462528600,False,2
8066,validator_19,167574827709,True,689619999,44478830,734098829,True,5
8067,validator_25,81586372780,True,531700000,22355530,554055530,False,2
8068,validator_46,255678811040,True,579800000,2985520,582785520,False,7
8069,validator_44,231827077960,True,655700000,10413190,666113190,False,7
8070,validator_15,765997481980,True,787000000,3183070,790183070,True,23
8071,validator_13,76079907865,True,513100008,21145900,534245908,True,2
8072,validator_48,439059540730,True,438500000,2615620,441115620,False,13
8073,validator_17,470355829428,True,570119999,28516790,598636789,True,14
8074,validator_23,71040652837,True,721258000,20219740,741477740,True,2
8075,validator_35,220201727440,True,477900000,2168740,480068740,False,6
8076,validator_44,232379866510,True,550800000,1988550,552788550,False,7
8077,validator_34,697497283460,True,719200000,9507670,728707670,False,21
8078,validator_15,766804133168,True,743923998,62727190,806651188,True,23
8079,validator_7,173294346894,True,550900005,8484480,559384485,True,5
8080,validator_34,697932094260,True,433100000,1710800,434810800,False,21
8081,validator_31,409821026970,True,646300000,2261630,648561630,False,12
8082,validator_36,229370250460,True,500600000,2054730,502654730,False,7
8083,validator_7,173893279974,True,585710000,13223080,598933080,True,5
8084,validator_15,767673100209,True,855354001,13613040,868967041,True,23
8085,validator_14,303320727343,True,665139997,55407970,720547967,True,9
8086,validator_12,265543593424,True,776400005,21998740,798398745,True,8
8087,validator_47,161214120200,True,776700000,40609070,817309070,False,5
8088,validator_34,698532175370,True,598300000,1781110,600081110,False,21
8089,validator_4,61473029506,True,417539998,7966180,425506178,True,1
8090,validator_48,439640376870,True,570100000,10736140,580836140,False,13
8091,validator_47,162123217410,True,871300000,37797210,909097210,False,5
8092,validator_35,220850344140,True,645800000,2816700,648616700,False,6
8093,validator_21,164074864206,True,887379999,20607990,907987989,True,5
8094,validator_6,82080433008,True,865100003,19538140,884638143,True,2
8095,validator_12,266373753394,True,827220000,2939970,830159970,True,8
8096,validator_31,410537610680,True,709000000,7583710,716583710,False,12
8097,validator_47,162643143410,True,518470000,1456000,519926000,False,5
8098,validator_17,471031881115,True,662940007,13111680,676051687,True,14
8099,validator_17,471643622547,True,607400002,4341430,611741432,True,14
8100,validator_21,164552784433,True,475339997,2580230,477920227,True,5
8101,validator_19,168123407038,True,545499999,3079330,548579329,True,5
8102,validator_15,768342294203,True,629020004,40173990,669193994,True,24
8103,validator_26,64931473600,True,638000000,2213810,640213810,False,2
8104,validator_48,440204365080,True,562600000,1388210,563988210,False,13
8105,validator_30,147667254490,True,384140000,1300150,385440150,False,4
8106,validator_48,440722585250,True,512200000,6020170,518220170,False,13
8107,validator_48,441225165050,True,500500000,2079800,502579800,False,13
8108,validator_17,472394030986,True,739499999,10908440,750408439,True,14
8109,validator_0,68673944591,True,587900000,24182470,612082470,True,2
8110,validator_44,233095457110,True,712000000,3590600,715590600,False,7
8111,validator_35,221256850140,True,404000000,2506000,406506000,False,6
8112,validator_15,769088834703,True,740500000,6040500,746540500,True,24
8113,validator_27,244322452330,True,627900000,28233800,656133800,False,7
8114,validator_15,769637030281,True,514859998,33335580,548195578,True,24
8115,validator_48,441776010970,True,542700000,8145920,550845920,False,13
8116,validator_19,168830156155,True,695839997,10909120,706749117,True,5
8117,validator_35,222028320360,True,750600000,20870220,771470220,False,6
8118,validator_15,770328612479,True,666065998,25516200,691582198,True,24
8119,validator_38,71632657720,True,591300000,22137780,613437780,False,2
8120,validator_35,222588601630,True,534000000,26281270,560281270,False,6
8121,validator_18,281696584675,True,572779995,46045100,618825095,True,8
8122,validator_18,282190807798,True,479279993,14943130,494223123,True,8
8123,validator_44,233725186240,True,627700000,2029130,629729130,False,7
8124,validator_34,699239185270,True,703900000,3109900,707009900,False,21
8125,validator_24,85750491865,True,718840007,42694000,761534007,True,2
8126,validator_14,304150046046,True,803160003,26158700,829318703,True,9
8127,validator_12,267068156275,True,674699991,19702890,694402881,True,8
8128,validator_31,411157194340,True,617400000,2183660,619583660,False,12
8129,validator_21,165289557724,True,704736001,32037290,736773291,True,5
8130,validator_34,699939344520,True,691700000,8459250,700159250,False,21
8131,validator_49,182673962310,True,603800000,3160600,606960600,False,5
8132,validator_17,473229991099,True,814540003,21420110,835960113,True,14
8133,validator_12,267778331677,True,700400002,9775400,710175402,True,8
8134,validator_17,473803083792,True,565199993,7892700,573092693,True,14
8135,validator_15,771125276284,True,769600005,27063800,796663805,True,24
8136,validator_13,76776784563,True,670419998,26456700,696876698,True,2
8137,validator_34,700260810610,True,320230000,1236090,321466090,False,21
8138,validator_47,163418431090,True,773000000,2287680,775287680,False,5
8139,validator_14,304829023581,True,663880005,15097530,678977535,True,9
8140,validator_12,268443353809,True,661800002,3222130,665022132,True,8
8141,validator_3,81024431793,True,479825993,36388700,516214693,True,2
8142,validator_43,150710742790,True,552600000,20230200,572830200,False,4
8143,validator_31,411824422470,True,659400000,7828130,667228130,False,12
8144,validator_36,229999858860,True,609000000,20608400,629608400,False,7
8145,validator_0,69243986191,True,545200000,24841600,570041600,True,2
8146,validator_7,174439980718,True,537520004,9180740,546700744,True,5
8147,validator_17,474774629238,True,935969996,35575450,971545446,True,14
8148,validator_19,169620547193,True,771199998,19191040,790391038,True,5
8149,validator_31,412500655440,True,662600000,13632970,676232970,False,12
8150,validator_44,234156629820,True,423600000,7843580,431443580,False,7
8151,validator_17,475783046995,True,987683997,20733760,1008417757,True,14
8152,validator_39,75360965960,True,646200000,3386190,649586190,False,2
8153,validator_34,700852761980,True,588900000,3051370,591951370,False,21
8154,validator_35,223096076730,True,506000000,1475100,507475100,False,6
8155,validator_5,163859226109,True,585979997,16711400,602691397,True,5
8156,validator_29,65018331290,True,541300000,1686940,542986940,False,2
8157,validator_35,223617669410,True,497900000,23692680,521592680,False,6
8158,validator_35,224416423390,True,792000000,6753980,798753980,False,7
8159,validator_48,442558449600,True,773100000,9338630,782438630,False,13
8160,validator_17,476501366854,True,698039999,20279860,718319859,True,14
8161,validator_15,771657073786,True,521680002,10117500,531797502,True,24
8162,validator_25,82128166100,True,534300000,7493320,541793320,False,2
8163,validator_14,305595255793,True,730990002,35242210,766232212,True,9
8164,validator_22,183762210649,True,832699998,22691380,855391378,True,5
8165,validator_5,164661815912,True,798300003,4289800,802589803,True,5
8166,validator_15,772547556134,True,845000008,45482340,890482348,True,24
8167,validator_5,165320682025,True,644520003,14346110,658866113,True,5
8168,validator_12,269226006310,True,762940001,19712500,782652501,True,8
8169,validator_17,477402829372,True,848118008,53344510,901462518,True,14
8170,validator_37,161621313390,True,540100000,6309180,546409180,False,5
8171,validator_30,148337452290,True,668000000,2197800,670197800,False,4
8172,validator_47,163983705090,True,562270000,3004000,565274000,False,5
8173,validator_1,167787067670,True,568400002,3214640,571614642,True,5
8174,validator_48,443117181700,True,549900000,8832100,558732100,False,13
8175,validator_17,477877600302,True,465000000,9770930,474770930,True,14
8176,validator_31,413032033870,True,526000000,5378430,531378430,False,12
8177,validator_27,244959831670,True,633100000,4279340,637379340,False,7
8178,validator_44,234643449420,True,481000000,5819600,486819600,False,7
8179,validator_27,245430555480,True,468600000,2123810,470723810,False,7
8180,validator_34,701426880180,True,560900000,13218200,574118200,False,21
8181,validator_31,413555340790,True,513700000,9606920,523306920,False,12
8182,validator_41,169587665390,True,515900000,6663760,522563760,False,5
8183,validator_3,81620694155,True,565040002,31222360,596262362,True,2
8184,validator_41,170149889040,True,536100000,26123650,562223650,False,5
8185,validator_17,478445958091,True,554259999,14097790,568357789,True,14
8186,validator_5,166057015021,True,716199996,20133000,736332996,True,5
8187,validator_22,184559368745,True,758079996,39078100,797158096,True,5
8188,validator_48,443737822630,True,601400000,19240930,620640930,False,13
8189,validator_17,479011814819,True,560519998,5336730,565856728,True,14
8190,validator_14,306285270027,True,683000004,7014230,690014234,True,9
8191,validator_49,183366331710,True,683400000,8969400,692369400,False,5
8192,validator_0,69800193712,True,553900001,2307520,556207521,True,2
8193,validator_3,82263834258,True,623840003,19300100,643140103,True,2
8194,validator_2,68425590769,True,729240000,8895000,738135000,True,2
8195,validator_17,479814859693,True,782399994,20644880,803044874,True,14
8196,validator_7,175095718654,True,650120006,5617930,655737936,True,5
8197,validator_12,269858964014,True,613300004,19657700,632957704,True,8
8198,validator_14,306936003163,True,645200006,5533130,650733136,True,9
8199,validator_15,773242443042,True,692999998,1886910,694886908,True,24
8200,validator_48,444321551530,True,554400000,29328900,583728900,False,13
8201,validator_40,81542985590,True,578400000,2203550,580603550,False,2
8202,validator_15,773930647348,True,656440006,31764300,688204306,True,24
8203,validator_48,445142281450,True,819900000,829920,820729920,False,13
8204,validator_5,166596151524,True,531540003,7596500,539136503,True,5
8205,validator_31,414246927190,True,689300000,2286400,691586400,False,12
8206,validator_10,85358866755,True,674067996,41933530,716001526,True,2
8207,validator_8,68755849260,True,563799998,23551700,587351698,True,2
8208,validator_48,445808856720,True,663700000,2875270,666575270,False,13
8209,validator_15,774592882519,True,642040001,20195170,662235171,True,24
8210,validator_34,702080555880,True,650300000,3375700,653675700,False,21
8211,validator_1,168434943905,True,626279995,21596240,647876235,True,5
8212,validator_34,702674270740,True,590600000,3114860,593714860,False,21
8213,validator_34,703196307360,True,520000000,2036620,522036620,False,21
8214,validator_4,62013490275,True,536999999,3460770,540460769,True,1
8215,validator_44,235012229220,True,366900000,1879800,368779800,False,7
8216,validator_5,167260856723,True,643139999,21565200,664705199,True,5
8217,validator_20,77805110883,True,630619994,31345940,661965934,True,2
8218,validator_15,775119178675,True,488370006,37926150,526296156,True,24
8219,validator_35,225086979730,True,664200000,6356340,670556340,False,7
8220,validator_14,307457159796,True,507560003,13596630,521156633,True,9
8221,validator_12,270444216843,True,568879999,16372830,585252829,True,8
8222,validator_41,171092586810,True,900100000,42597770,942697770,False,5
8223,validator_31,414752004590,True,500200000,4877400,505077400,False,12
8224,validator_41,171666171300,True,571500000,2084490,573584490,False,5
8225,validator_31,415430569210,True,659500000,19064620,678564620,False,12
8226,validator_41,172246614620,True,577900000,2543320,580443320,False,5
8227,validator_30,149110525850,True,751900000,21173560,773073560,False,4
8228,validator_9,80324294872,True,664506001,6636230,671142231,True,2
8229,validator_15,775824880875,True,673328000,32374200,705702200,True,24
8230,validator_21,165844183414,True,548100000,6525690,554625690,True,5
8231,validator_7,175732026051,True,629339997,6967400,636307397,True,5
8232,validator_36,230608160460,True,604800000,3501600,608301600,False,7
8233,validator_48,446365013620,True,554200000,1956900,556156900,False,13
8234,validator_1,169189353932,True,711279997,43130030,754410027,True,5
8235,validator_34,703755355050,True,554940000,4107690,559047690,False,21
8236,validator_7,176438953549,True,665463998,41463500,706927498,True,5
8237,validator_10,85984369157,True,616660002,8842400,625502402,True,2
8238,validator_44,235718478180,True,686700000,19548960,706248960,False,7
8239,validator_2,69281515063,True,790979994,64944300,855924294,True,2
8240,validator_20,78470421262,True,657199999,8110380,665310379,True,2
8241,validator_48,447093212160,True,720900000,7298540,728198540,False,13
8242,validator_19,170391765193,True,735660000,35558000,771218000,True,5
8243,validator_15,776491252972,True,579703997,86668100,666372097,True,24
8244,validator_4,62872196275,True,834560000,24146000,858706000,True,1
8245,validator_22,185210898508,True,623480003,28049760,651529763,True,5
8246,validator_48,447773562960,True,677200000,3150800,680350800,False,13
8247,validator_28,71182525920,True,387600000,2084040,389684040,False,2
8248,validator_31,416026406210,True,590600000,5237000,595837000,False,13
8249,validator_11,65498416061,True,670800004,2301660,673101664,True,2
8250,validator_34,704337561850,True,579700000,2506800,582206800,False,22
8251,validator_6,82862026469,True,757140001,24453460,781593461,True,2
8252,validator_37,162158662520,True,514800000,22549130,537349130,False,5
8253,validator_35,225579431990,True,490600000,1852260,492452260,False,7
8254,validator_34,704951845150,True,610200000,4083300,614283300,False,22
8255,validator_22,185969941154,True,758100006,942640,759042646,True,5
8256,validator_26,65526366530,True,591300000,3592930,594892930,False,2
8257,validator_17,480708390412,True,822389999,71140720,893530719,True,15
8258,validator_26,66133256130,True,585300000,21589600,606889600,False,2
8259,validator_15,776987084122,True,489440000,6391150,495831150,True,24
8260,validator_10,86590083548,True,603400001,2314390,605714391,True,2
8261,validator_48,448453506050,True,675500000,4443090,679943090,False,14
8262,validator_17,481358941443,True,647800001,2751030,650551031,True,15
8263,validator_17,482196199274,True,836300001,957830,837257831,True,15
8264,validator_47,164722957250,True,731200000,8052160,739252160,False,5
8265,validator_37,162773039190,True,599200000,15176670,614376670,False,5
8266,validator_14,308169640230,True,695160004,17320430,712480434,True,9
8267,validator_45,66978697240,True,580300000,951800,581251800,False,2
8268,validator_14,308894735353,True,701665993,23429130,725095123,True,9
8269,validator_15,777556698338,True,555519996,14094220,569614216,True,24
8270,validator_21,166453447158,True,554440004,54823740,609263744,True,5
8271,validator_44,236501746920,True,779300000,3968740,783268740,False,7
8272,validator_46,256332626580,True,640600000,13215540,653815540,False,8
8273,validator_31,416594465880,True,561100000,6959670,568059670,False,13
8274,validator_35,226191605720,True,610500000,1673730,612173730,False,7
8275,validator_24,86299696268,True,546200003,3004400,549204403,True,2
8276,validator_3,82839430717,True,574239999,1356460,575596459,True,2
8277,validator_49,183901245410,True,533300000,1613700,534913700,False,5
8278,validator_37,163381220040,True,605400000,2780850,608180850,False,5
8279,validator_46,256929884710,True,595600000,1658130,597258130,False,8
8280,validator_5,168066165398,True,778119995,27188680,805308675,True,5
8281,validator_19,171049789893,True,629400000,28624700,658024700,True,5
8282,validator_1,169829691331,True,625759999,14577400,640337399,True,5
8283,validator_1,170576082546,True,715400005,30991210,746391215,True,5
8284,validator_7,177188650232,True,724339993,25356690,749696683,True,5
8285,validator_25,82693210260,True,562300000,2744160,565044160,False,2
8286,validator_14,309643555372,True,725403989,23416030,748820019,True,9
8287,validator_11,66092032372,True,540480001,53136310,593616311,True,2
8288,validator_29,65535077690,True,515700000,1046400,516746400,False,2
8289,validator_34,705689156670,True,732900000,4411520,737311520,False,22
8290,validator_7,178027213499,True,812359997,26203270,838563267,True,5
8291,validator_34,706194234870,True,503500000,1578200,505078200,False,22
8292,validator_45,67603379270,True,623600000,1082030,624682030,False,2
8293,validator_48,449103862350,True,629900000,20456300,650356300,False,14
8294,validator_46,257636974360,True,704800000,2289650,707089650,False,8
8295,validator_46,258308782280,True,661700000,10107920,671807920,False,8
8296,validator_17,482988948177,True,749020003,43728900,792748903,True,15
8297,validator_41,172856650450,True,590900000,19135830,610035830,False,5
8298,validator_45,68317147610,True,712400000,1368340,713768340,False,2
8299,validator_39,76191329480,True,825600000,4763520,830363520,False,2
8300,validator_21,167061769721,True,595900003,12422560,608322563,True,5
8301,validator_36,231160395990,True,548500000,3735530,552235530,False,7
8302,validator_15,778472463663,True,907200005,8565320,915765325,True,24
8303,validator_27,246071879720,True,634800000,6524240,641324240,False,7
8304,validator_31,417172921520,True,568800000,9655640,578455640,False,13
8305,validator_23,72160178455,True,1073080008,46445610,1119525618,True,2
8306,validator_5,168664493295,True,596999997,1327900,598327897,True,5
8307,validator_35,227016795050,True,812200000,12989330,825189330,False,7
8308,validator_33,70448422450,True,734600000,6050070,740650070,False,2
8309,validator_37,163939251480,True,549200000,8831440,558031440,False,5
8310,validator_34,706896695410,True,700300000,2160540,702460540,False,22
8311,validator_46,258922639340,True,610000000,3857060,613857060,False,8
8312,validator_48,449789728420,True,681700000,4166070,685866070,False,14
8313,validator_48,450519038540,True,726100000,3210120,729310120,False,14
8314,validator_18,282871638812,True,651280004,29551010,680831014,True,8
8315,validator_15,779137087497,True,655099994,9523840,664623834,True,24
8316,validator_22,186563725053,True,546515999,47267900,593783899,True,5
8317,validator_31,417719357360,True,539100000,7335840,546435840,False,13
8318,validator_11,66616161771,True,521619999,2509400,524129399,True,2
8319,validator_17,483723313276,True,720539999,13825100,734365099,True,15
8320,validator_48,451103066760,True,575000000,9028220,584028220,False,14
8321,validator_17,484365968200,True,632019994,10634930,642654924,True,15
8322,validator_19,171549160588,True,466239995,33130700,499370695,True,5
8323,validator_36,231890714430,True,729300000,1018440,730318440,False,7
8324,validator_7,178644532196,True,567945997,49372700,617318697,True,5
8325,validator_0,70727081656,True,896439994,30447950,926887944,True,2
8326,validator_18,283744021212,True,865300000,7082400,872382400,True,8
8327,validator_15,779981205567,True,841200000,2918070,844118070,True,24
8328,validator_17,485188914495,True,794974005,27972290,822946295,True,15
8329,validator_13,77597233303,True,811100000,9348740,820448740,True,2
8330,validator_34,707543896470,True,643400000,3801060,647201060,False,22
8331,validator_9,81156162486,True,813039994,18827620,831867614,True,2
8332,validator_17,486096899469,True,905200004,2784970,907984974,True,15
8333,validator_36,232471956870,True,571500000,9742440,581242440,False,7
8334,validator_48,451577925780,True,474100000,759020,474859020,False,14
8335,validator_5,169308613395,True,600540000,43580100,644120100,True,5
8336,validator_49,184608387390,True,699100000,8041980,707141980,False,5
8337,validator_14,310274515872,True,587060000,43900500,630960500,True,9
8338,validator_18,284338217213,True,593800001,396000,594196001,True,8
8339,validator_24,86842065371,True,507040003,35329100,542369103,True,2
8340,validator_21,168150251325,True,1059860004,28621600,1088481604,True,5
8341,validator_5,170057335627,True,723040002,25682230,748722232,True,5
8342,validator_15,780619142658,True,623720001,14217090,637937091,True,24
8343,validator_5,170911509856,True,835219999,18954230,854174229,True,5
8344,validator_46,259613230370,True,688600000,1991030,690591030,False,8
8345,validator_30,149634188870,True,519000000,4663020,523663020,False,4
8346,validator_7,179389511095,True,702419999,42558900,744978899,True,5
8347,validator_31,418282412350,True,553500000,9554990,563054990,False,13
8348,validator_37,164448586810,True,507200000,2135330,509335330,False,5
8349,validator_12,270977176882,True,520620009,12340030,532960039,True,8
8350,validator_45,68889462950,True,563000000,9315340,572315340,False,2
8351,validator_15,781313447727,True,675999999,18305070,694305069,True,24
8352,validator_34,708000280450,True,454340000,2043980,456383980,False,22
8353,validator_48,452349789310,True,751500000,20363530,771863530,False,14
8354,validator_17,486649051470,True,523360001,28792000,552152001,True,15
8355,validator_3,83426361458,True,573520001,13410740,586930741,True,2
8356,validator_14,311005942511,True,700659999,30766640,731426639,True,9
8357,validator_24,87607613674,True,742800003,22748300,765548303,True,2
8358,validator_8,69629689678,True,843196008,30644410,873840418,True,2
8359,validator_37,165000264510,True,549400000,2277700,551677700,False,5
8360,validator_10,87332259565,True,709439997,32736020,742176017,True,2
8361,validator_15,781917071332,True,582600005,21023600,603623605,True,24
8362,validator_3,84034680623,True,588799995,19519170,608319165,True,2
8363,validator_1,171172870621,True,573020005,23768070,596788075,True,5
8364,validator_21,168849594645,True,672560000,26783320,699343320,True,5
8365,validator_48,453088283250,True,727700000,10793940,738493940,False,14
8366,validator_33,71227004200,True,772800000,5781750,778581750,False,2
8367,validator_48,453770814530,True,677400000,5131280,682531280,False,14
8368,validator_20,79016641482,True,521480000,24740220,546220220,True,2
8369,validator_30,150399436890,True,729400000,35848020,765248020,False,4
8370,validator_46,260172984400,True,539400000,20354030,559754030,False,8
8371,validator_12,271773623410,True,786460008,9986520,796446528,True,8
8372,validator_12,272690582897,True,911199997,5759490,916959487,True,8
8373,validator_21,169668748158,True,818100003,1053510,819153513,True,5
8374,validator_1,171870442825,True,671240004,26332200,697572204,True,5
8375,validator_8,70487109297,True,853899999,3519620,857419619,True,2
8376,validator_18,285003824312,True,646439999,19167100,665607099,True,8
8377,validator_29,66126353710,True,584500000,6776020,591276020,False,2
8378,validator_48,454500538470,True,703400000,26323940,729723940,False,14
8379,validator_23,73225652365,True,1058799990,6673920,1065473910,True,2
8380,validator_15,782582749531,True,642459999,23218200,665678199,True,24
8381,validator_0,71343250280,True,579978004,36190620,616168624,True,2
8382,validator_12,273281739093,True,562779996,28376200,591156196,True,8
8383,validator_36,233235640630,True,760400000,3283760,763683760,False,7
8384,validator_5,171522467475,True,608799999,2157620,610957619,True,5
8385,validator_40,82159916020,True,609100000,7830430,616930430,False,2
8386,validator_31,418816530070,True,532400000,1717720,534117720,False,13
8387,validator_4,63472438655,True,585099990,15142390,600242380,True,1
8388,validator_15,783156379231,True,572000000,1629700,573629700,True,24
8389,validator_43,151195617510,True,476600000,8274720,484874720,False,4
8390,validator_27,246648794670,True,557300000,19614950,576914950,False,7
8391,validator_5,172072625174,True,533419999,16737700,550157699,True,5
8392,validator_27,247279675840,True,627700000,3181170,630881170,False,7
8393,validator_34,708496449040,True,477400000,18768590,496168590,False,22
8394,validator_21,170482535543,True,771599995,42187390,813787385,True,5
8395,validator_10,88020775893,True,663667998,24848330,688516328,True,2
8396,validator_0,72114461377,True,715339997,55871100,771211097,True,2
8397,validator_1,172471332548,True,572040003,28849720,600889723,True,5
8398,validator_49,185203718650,True,595000000,331260,595331260,False,5
8399,validator_36,233855192680,True,617700000,1852050,619552050,False,7
8400,validator_29,66847384970,True,718100000,2931260,721031260,False,2
8401,validator_27,247859116780,True,572600000,6840940,579440940,False,7
8402,validator_27,248445661620,True,582800000,3744840,586544840,False,7
8403,validator_47,165349150950,True,601400000,24793700,626193700,False,5
8404,validator_46,260872782470,True,680000000,19798070,699798070,False,8
8405,validator_36,234502876170,True,643500000,4183490,647683490,False,7
8406,validator_31,419212674080,True,393500000,2644010,396144010,False,13
8407,validator_35,227481838230,True,449700000,15343180,465043180,False,7
8408,validator_41,173498547380,True,641000000,896930,641896930,False,5
8409,validator_17,487242312673,True,589100003,4161200,593261203,True,15
8410,validator_15,783735391253,True,559500002,19512020,579012022,True,24
8411,validator_37,165765868650,True,708700000,56904140,765604140,False,5
8412,validator_1,172961240843,True,470999995,18908300,489908295,True,5
8413,validator_17,487936605288,True,645439995,48852620,694292615,True,15
8414,validator_15,784430302993,True,686000010,8911730,694911740,True,24
8415,validator_34,708933979130,True,430600000,6930090,437530090,False,22
8416,validator_30,151055983290,True,635750000,20796400,656546400,False,4
8417,validator_41,174154692560,True,649800000,6345180,656145180,False,5
8418,validator_38,72325629160,True,667200000,25771440,692971440,False,2
8419,validator_49,185947061640,True,737400000,5942990,743342990,False,5
8420,validator_5,172573233272,True,478660008,21948090,500608098,True,5
8421,validator_24,88185908125,True,529400001,48894450,578294451,True,2
8422,validator_16,77914231396,True,459779998,45230180,505010178,True,2
8423,validator_34,709514890440,True,565100000,15811310,580911310,False,22
8424,validator_18,285895097609,True,874139997,17133300,891273297,True,8
8425,validator_17,488566151391,True,623320003,6226100,629546103,True,15
8426,validator_15,785284794310,True,827300007,27191310,854491317,True,24
8427,validator_27,249048802720,True,601500000,1641100,603141100,False,7
8428,validator_34,710204085540,True,688000000,1195100,689195100,False,22
8429,validator_48,455019211600,True,515700000,2973130,518673130,False,14
8430,validator_19,172228172418,True,623212010,55799820,679011830,True,5
8431,validator_12,273924896996,True,605140003,38017900,643157903,True,8
8432,validator_17,489338547891,True,739820000,32576500,772396500,True,15
8433,validator_15,785671886308,True,366939998,20152000,387091998,True,24
8434,validator_27,249586688500,True,531300000,6585780,537885780,False,7
8435,validator_18,286477044548,True,560059999,21886940,581946939,True,8
8436,validator_27,250355521360,True,758000000,10832860,768832860,False,7
8437,validator_35,228170611910,True,675500000,13273680,688773680,False,7
8438,validator_17,489834554079,True,458363998,37642190,496006188,True,15
8439,validator_48,455465550300,True,442500000,3838700,446338700,False,14
8440,validator_48,456227546300,True,731000000,30996000,761996000,False,14
8441,validator_32,61307988450,True,713800000,2787900,716587900,False,1
8442,validator_5,173302676369,True,698964007,30479090,729443097,True,5
8443,validator_33,71932976220,True,695100000,10872020,705972020,False,2
8444,validator_47,166038071250,True,683700000,5220300,688920300,False,5
8445,validator_2,70038971238,True,726839995,30616180,757456175,True,2
8446,validator_34,710783217640,True,576100000,3032100,579132100,False,22
8447,validator_17,490383642384,True,511000005,38088300,549088305,True,15
8448,validator_46,261374834610,True,501100000,952140,502052140,False,8
8449,validator_40,82670914950,True,508300000,2698930,510998930,False,2
8450,validator_31,419762500500,True,524500000,25326420,549826420,False,13
8451,validator_17,491103078973,True,692940009,26496580,719436589,True,15
8452,validator_15,786435821729,True,751460001,12475420,763935421,True,24
8453,validator_47,166623930680,True,585000000,859430,585859430,False,5
8454,validator_30,151650485580,True,588200000,6302290,594502290,False,4
8455,validator_31,420095845200,True,324100000,9244700,333344700,False,13
8456,validator_48,456969105120,True,738400000,3158820,741558820,False,14
8457,validator_15,787223723044,True,736899995,51001320,787901315,True,24
8458,validator_14,311565361102,True,539099991,20318600,559418591,True,9
8459,validator_40,83331950990,True,656400000,4636040,661036040,False,2
8460,validator_17,491903274259,True,798199996,1995290,800195286,True,15
8461,validator_5,173966898393,True,640840004,23382020,664222024,True,5
8462,validator_47,167324869780,True,680800000,20139100,700939100,False,5
8463,validator_19,172920419667,True,667619999,24627250,692247249,True,5
8464,validator_22,187534197054,True,949460001,21012000,970472001,True,5
8465,validator_27,250897544060,True,539800000,2222700,542022700,False,7
8466,validator_44,237177517720,True,675000000,770800,675770800,False,7
8467,validator_31,420546758000,True,448500000,2412800,450912800,False,13
8468,validator_44,237867199110,True,688100000,1581390,689681390,False,7
8469,validator_36,235044054770,True,533100000,8078600,541178600,False,7
8470,validator_7,180251167076,True,851700001,9955980,861655981,True,5
8471,validator_22,188222411985,True,660706001,27508930,688214931,True,5
8472,validator_11,67237935551,True,620400000,1373780,621773780,True,2
8473,validator_34,711274722040,True,489400000,2104400,491504400,False,22
8474,validator_14,312352477408,True,776240006,10876300,787116306,True,9
8475,validator_17,492693130361,True,779080002,10776100,789856102,True,15
8476,validator_12,274543728826,True,614500000,4331830,618831830,True,8
8477,validator_12,275145873431,True,569540005,32604600,602144605,True,8
8478,validator_17,493257476359,True,543657998,20688000,564345998,True,15
8479,validator_34,711878425460,True,595000000,8703420,603703420,False,22
8480,validator_3,84694297913,True,651500000,8117290,659617290,True,2
8481,validator_12,275732511728,True,561660007,24978290,586638297,True,8
8482,validator_36,235756853370,True,706900000,5898600,712798600,False,7
8483,validator_5,174658056727,True,685740004,5418330,691158334,True,5
8484,validator_34,712721643260,True,832300000,10917800,843217800,False,22
8485,validator_15,787965216042,True,716759998,24733000,741492998,True,24
8486,validator_38,72970703260,True,624900000,20174100,645074100,False,2
8487,validator_15,788759241507,True,745243995,48781470,794025465,True,24
8488,validator_27,251513480260,True,615100000,836200,615936200,False,7
8489,validator_49,186406157800,True,437200000,21896160,459096160,False,5
8490,validator_15,789487400470,True,719319993,8838970,728158963,True,24
8491,validator_18,287017303090,True,503760002,36498540,540258542,True,8
8492,validator_44,238455640010,True,584400000,4040900,588440900,False,7
8493,validator_14,313148663395,True,769139997,27045990,796185987,True,9
8494,validator_15,790429054166,True,916699996,24953700,941653696,True,24
8495,validator_37,166310572290,True,542710000,1993640,544703640,False,5
8496,validator_28,71810784910,True,624400000,3858990,628258990,False,2
8497,validator_17,493838329494,True,566600005,14253130,580853135,True,15
8498,validator_44,239048917410,True,568800000,24477400,593277400,False,7
8499,validator_19,173504049623,True,563500006,20129950,583629956,True,5
8500,validator_5,175417186922,True,741139995,17990200,759130195,True,5
8501,validator_15,791018014370,True,582899994,6060210,588960204,True,24
8502,validator_12,276147573933,True,389800005,25262200,415062205,True,8
8503,validator_34,713334589920,True,611200000,1746660,612946660,False,22
8504,validator_21,171210048423,True,715540000,11972880,727512880,True,5
8505,validator_21,171987205911,True,763739998,13417490,777157488,True,5
8506,validator_15,791549753857,True,520400007,11339480,531739487,True,24
8507,validator_38,73582673120,True,600800000,11169860,611969860,False,2
8508,validator_18,287521821686,True,497239996,7278600,504518596,True,8
8509,validator_34,713875944620,True,537600000,3754700,541354700,False,22
8510,validator_34,714445702760,True,566500000,3258140,569758140,False,22
8511,validator_3,85685889346,True,959994003,31597430,991591433,True,2
8512,validator_8,71225122712,True,726619995,11393420,738013415,True,2
8513,validator_48,457553780820,True,575500000,9175700,584675700,False,14
8514,validator_22,188854544187,True,608860002,23272200,632132202,True,5
8515,validator_15,792020897890,True,459060003,12084030,471144033,True,24
8516,validator_15,792726933819,True,672700009,33335920,706035929,True,24
8517,validator_41,174746352600,True,590400000,1260040,591660040,False,5
8518,validator_39,76667408610,True,474200000,1879130,476079130,False,2
8519,validator_41,175227100140,True,466600000,14147540,480747540,False,5
8520,validator_48,458018235950,True,436000000,28455130,464455130,False,14
8521,validator_0,72727712907,True,589820010,23431520,613251530,True,2
8522,validator_46,261934905120,True,553100000,6970510,560070510,False,8
8523,validator_34,714930505140,True,478000000,6802380,484802380,False,22
8524,validator_15,793404450163,True,658800004,18716340,677516344,True,24
8525,validator_34,715487999720,True,553700000,3794580,557494580,False,22
8526,validator_31,421104939300,True,538200000,19981300,558181300,False,13
8527,validator_24,89097894268,True,908800003,3186140,911986143,True,2
8528,validator_5,176150930089,True,713660007,20083160,733743167,True,5
8529,validator_44,239923607140,True,865600000,9089730,874689730,False,7
8530,validator_43,151868557010,True,669300000,3639500,672939500,False,4
8531,validator_34,716139756850,True,650400000,1357130,651757130,False,22
8532,validator_49,186896411440,True,487500000,2753640,490253640,False,5
8533,validator_18,288253533794,True,722260008,9452100,731712108,True,9
8534,validator_31,421827174830,True,702000000,20235530,722235530,False,13
8535,validator_43,152392388940,True,519800000,4031930,523831930,False,4
8536,validator_48,458759987600,True,740300000,1451650,741751650,False,14
8537,validator_36,236453740920,True,693600000,3287550,696887550,False,7
8538,validator_45,69498590590,True,582100000,27027640,609127640,False,2
8539,validator_25,83295907960,True,582200000,20497700,602697700,False,2
8540,validator_32,62028545530,True,693100000,27457080,720557080,False,1
8541,validator_1,173625361543,True,633100000,31020700,664120700,True,5
8542,validator_20,79662605543,True,643300001,2664060,645964061,True,2
8543,validator_10,88740624058,True,696804005,23044160,719848165,True,2
8544,validator_27,252196371700,True,679900000,2991440,682891440,False,7
8545,validator_34,716659353150,True,514000000,5596300,519596300,False,22
8546,validator_31,422416991630,True,587300000,2516800,589816800,False,13
8547,validator_5,177097374016,True,911296007,35147920,946443927,True,5
8548,validator_31,423058108860,True,630900000,10217230,641117230,False,13
8549,validator_14,313708604861,True,535149996,24791470,559941466,True,9
8550,validator_49,187547086210,True,644400000,6274770,650674770,False,5
8551,validator_34,717433920650,True,772800000,1767500,774567500,False,22
8552,validator_44,240512785410,True,585800000,3378270,589178270,False,7
8553,validator_15,794069950684,True,624520001,40980520,665500521,True,24
8554,validator_48,459396227040,True,632800000,3439440,636239440,False,14
8555,validator_34,718066076210,True,611200000,20955560,632155560,False,22
8556,validator_34,718705281210,True,631200000,8005000,639205000,False,22
8557,validator_49,188154325360,True,604100000,3139150,607239150,False,5
8558,validator_43,153016778890,True,621000000,3389950,624389950,False,4
8559,validator_14,314458974063,True,723160002,27209200,750369202,True,9
8560,validator_10,89344713491,True,553260003,50829430,604089433,True,2
8561,validator_37,166940595240,True,618900000,11122950,630022950,False,5
8562,validator_36,237049130650,True,593900000,1489730,595389730,False,7
8563,validator_34,719232457730,True,525300000,1876520,527176520,False,22
8564,validator_35,228813637810,True,635500000,7525900,643025900,False,7
8565,validator_14,315359676686,True,891840003,8862620,900702623,True,9
8566,validator_38,74209259140,True,606700000,19886020,626586020,False,2
8567,validator_26,66775418220,True,637900000,4262090,642162090,False,2
8568,validator_34,719783542250,True,545900000,5184520,551084520,False,22
8569,validator_31,423893200770,True,815500000,19591910,835091910,False,13
8570,validator_27,252815165600,True,599000000,19793900,618793900,False,7
8571,validator_17,494590179628,True,736747994,15102140,751850134,True,15
8572,validator_27,253635300690,True,798900000,21235090,820135090,False,7
8573,validator_47,168024647980,True,670700000,29078200,699778200,False,5
8574,validator_7,180831028507,True,570500001,9361430,579861431,True,5
8575,validator_21,172872062444,True,840180003,44676530,884856533,True,5
8576,validator_3,86347588745,True,642239999,19459400,661699399,True,2
8577,validator_46,262528773380,True,582200000,11668260,593868260,False,8
8578,validator_37,167494048160,True,551900000,1552920,553452920,False,5
8579,validator_35,229459822470,True,636200000,9984660,646184660,False,7
8580,validator_13,78496990342,True,878439999,21317040,899757039,True,2
8581,validator_34,720509300350,True,706500000,19258100,725758100,False,22
8582,validator_15,794736261889,True,644900005,21411200,666311205,True,24
8583,validator_33,72636651420,True,683500000,20175200,703675200,False,2
8584,validator_18,288914451543,True,658039989,2877760,660917749,True,9
8585,validator_49,188815084990,True,659600000,1159630,660759630,False,5
8586,validator_48,459986349570,True,570100000,20022530,590122530,False,14
8587,validator_35,229908765610,True,439500000,9443140,448943140,False,7
8588,validator_15,795288896390,True,528440001,24194500,552634501,True,24
8589,validator_48,460586817330,True,598400000,2067760,600467760,False,14
8590,validator_48,461056706170,True,466900000,2988840,469888840,False,14
8591,validator_37,168290364030,True,769700000,26615870,796315870,False,5
8592,validator_15,795862202822,True,542540002,30766430,573306432,True,24
8593,validator_34,721127159720,True,609800000,8059370,617859370,False,22
8594,validator_48,461687816350,True,629300000,1810180,631110180,False,14
8595,validator_27,254262144150,True,624000000,2843460,626843460,False,7
8596,validator_48,462210020280,True,494900000,27303930,522203930,False,14
8597,validator_23,73821063706,True,593000001,2411340,595411341,True,2
8598,validator_34,721779422840,True,645000000,7263120,652263120,False,22
8599,validator_18,289505181937,True,588100004,2630390,590730394,True,9
8600,validator_46,263185271580,True,648000000,8498200,656498200,False,8
8601,validator_12,276990381775,True,817960002,24847840,842807842,True,8
8602,validator_18,290266920046,True,740470009,21268100,761738109,True,9
8603,validator_47,168450316570,True,424400000,1268590,425668590,False,5
8604,validator_4,64119772103,True,636839998,10493450,647333448,True,2
8605,validator_34,722360123850,True,557200000,23501010,580701010,False,22
8606,validator_47,169057947970,True,579900000,27731400,607631400,False,5
8607,validator_34,722849902070,True,480980000,8798220,489778220,False,22
8608,validator_17,495243321469,True,641640001,11501840,653141841,True,15
8609,validator_15,796654414478,True,761080006,31131650,792211656,True,24
8610,validator_48,462802867480,True,589300000,3547200,592847200,False,14
8611,validator_43,153570826980,True,533700000,20348090,554048090,False,4
8612,validator_13,79107699368,True,582759996,27949030,610709026,True,2
8613,validator_38,74657546570,True,444700000,3587430,448287430,False,2
8614,validator_18,291061182815,True,772819999,21442770,794262769,True,9
8615,validator_15,797302224695,True,603155997,44654220,647810217,True,24
8616,validator_22,189579118619,True,721900002,2674430,724574432,True,5
8617,validator_49,189319488180,True,503000000,1403190,504403190,False,5
8618,validator_15,797918002734,True,588999999,26778040,615778039,True,24
8619,validator_41,175733046860,True,502870000,3076720,505946720,False,5
8620,validator_18,291824884301,True,715119996,48581490,763701486,True,9
8621,validator_1,174272570939,True,609859996,37349400,647209396,True,5
8622,validator_36,237541283350,True,490170000,1982700,492152700,False,7
8623,validator_30,152388430680,True,725400000,12545100,737945100,False,4
8624,validator_26,67502980080,True,709400000,18161860,727561860,False,2
8625,validator_47,169628036970,True,569100000,989000,570089000,False,5
8626,validator_23,74476485710,True,653940004,1482000,655422004,True,2
8627,validator_15,798508809731,True,575259997,15547000,590806997,True,24
8628,validator_40,84152479690,True,818000000,2528700,820528700,False,2
8629,validator_44,241049113940,True,526200000,10128530,536328530,False,7
8630,validator_27,254949238680,True,685400000,1694530,687094530,False,7
8631,validator_34,723369797810,True,518270000,1625740,519895740,False,22
8632,validator_44,241663281380,True,609800000,4367440,614167440,False,7
8633,validator_9,81971032933,True,801766007,13104440,814870447,True,2
8634,validator_34,723978025610,True,592400000,15827800,608227800,False,22
8635,validator_21,173436500686,True,554800002,9638240,564438242,True,5
8636,validator_34,724551721490,True,560200000,13495880,573695880,False,22
8637,validator_34,725124830340,True,562400000,10708850,573108850,False,22
8638,validator_19,174476598713,True,929813990,42735100,972549090,True,5
8639,validator_18,292489213823,True,661819992,2509530,664329522,True,9
8640,validator_47,170281925370,True,652200000,1688400,653888400,False,5
8641,validator_7,181517541923,True,649080006,37433410,686513416,True,5
8642,validator_40,85075838700,True,896200000,27159010,923359010,False,2
8643,validator_15,799159582735,True,647169994,3603010,650773004,True,24
8644,validator_38,75300902370,True,634500000,8855800,643355800,False,2
8645,validator_2,70785624473,True,742300005,4353230,746653235,True,2
8646,validator_31,424376218360,True,474500000,8517590,483017590,False,13
8647,validator_34,725647221170,True,517100000,5290830,522390830,False,22
8648,validator_34,726261484170,True,612300000,1963000,614263000,False,22
8649,validator_48,463523162630,True,718000000,2295150,720295150,False,14
8650,validator_48,463955249750,True,429700000,2387120,432087120,False,14
8651,validator_34,726980401170,True,704800000,14117000,718917000,False,22
8652,validator_34,727664489710,True,682300000,1788540,684088540,False,22
8653,validator_41,176348645560,True,587700000,27898700,615598700,False,5
8654,validator_12,277751960160,True,746360005,15218380,761578385,True,8
8655,validator_40,85632947820,True,554600000,2509120,557109120,False,2
8656,validator_34,728121504410,True,450500000,6514700,457014700,False,22
8657,validator_35,230435537400,True,517200000,9571790,526771790,False,7
8658,validator_34,728665842010,True,538500000,5837600,544337600,False,22
8659,validator_1,174967599044,True,691900005,3128100,695028105,True,5
8660,validator_22,190508230275,True,909719996,19391660,929111656,True,5
8661,validator_11,68003892179,True,762619998,3336630,765956628,True,2
8662,validator_15,799692715059,True,518674004,14458320,533132324,True,24
8663,validator_18,293056435563,True,521140000,46081740,567221740,True,9
8664,validator_4,64784372399,True,631519996,33080300,664600296,True,2
8665,validator_17,495996031277,True,724420008,28289800,752709808,True,15
8666,validator_20,80380500943,True,688440000,29455400,717895400,True,2
8667,validator_21,174140763148,True,677100002,27162460,704262462,True,5
8668,validator_3,87035010459,True,666100004,21321710,687421714,True,2
8669,validator_31,425041557240,True,664100000,1238880,665338880,False,13
8670,validator_41,176848537850,True,480500000,19392290,499892290,False,5
8671,validator_15,800290194362,True,497460003,100019300,597479303,True,25
8672,validator_45,70066644890,True,565000000,3054300,568054300,False,2
8673,validator_41,177604948510,True,753900000,2510660,756410660,False,5
8674,validator_15,800781671644,True,468460002,23017280,491477282,True,25
8675,validator_18,293663462395,True,572780002,34246830,607026832,True,9
8676,validator_23,74988864848,True,456680008,55699130,512379138,True,2
8677,validator_36,238056663810,True,512000000,3380460,515380460,False,7
8678,validator_12,278619526751,True,844140001,23426590,867566591,True,8
8679,validator_22,191490936397,True,958485992,24220130,982706122,True,5
8680,validator_48,464529195750,True,553000000,20946000,573946000,False,14
8681,validator_18,294482807301,True,809940006,9404900,819344906,True,9
8682,validator_34,729423473810,True,748100000,9531800,757631800,False,22
8683,validator_48,465274663450,True,703700000,41767700,745467700,False,14
8684,validator_36,238659818860,True,595000000,8155050,603155050,False,7
8685,validator_39,77225018400,True,553400000,4209790,557609790,False,2
8686,validator_45,70763796030,True,695200000,1951140,697151140,False,2
8687,validator_36,239270344680,True,604400000,6125820,610525820,False,7
8688,validator_1,175624451926,True,651760002,5092880,656852882,True,5
8689,validator_45,71253783460,True,488570000,1417430,489987430,False,2
8690,validator_21,174786020474,True,625260006,19997320,645257326,True,5
8691,validator_31,425615009080,True,552500000,20951840,573451840,False,13
8692,validator_41,178327655770,True,684700000,38007260,722707260,False,5
8693,validator_48,465877954670,True,584900000,18391220,603291220,False,14
8694,validator_15,801411306236,True,608600002,21034590,629634592,True,25
8695,validator_47,170906087900,True,587500000,36662530,624162530,False,5
8696,validator_17,496686093392,True,681340005,8722110,690062115,True,15
8697,validator_34,729955064680,True,511900000,19690870,531590870,False,22
8698,validator_48,466271854940,True,383400000,10500270,393900270,False,14
8699,validator_17,497383173420,True,650718008,46362020,697080028,True,15
8700,validator_33,73338590150,True,682700000,19238730,701938730,False,2
8701,validator_3,87556900896,True,518199997,3690440,521890437,True,2
8702,validator_27,255532645080,True,579100000,4306400,583406400,False,7
8703,validator_18,295137717117,True,652399996,2509820,654909816,True,9
8704,validator_17,498144045981,True,749168001,11704560,760872561,True,15
8705,validator_14,316226026864,True,853219998,13130180,866350178,True,9
8706,validator_18,295919278348,True,778200001,3361230,781561231,True,9
8707,validator_34,730627456500,True,661300000,11091820,672391820,False,22
8708,validator_47,171564256120,True,626900000,31268220,658168220,False,5
8709,validator_34,731237989000,True,607660000,2872500,610532500,False,22
8710,validator_44,242276383390,True,609800000,3302010,613102010,False,7
8711,validator_17,498716508459,True,500959998,71502480,572462478,True,15
8712,validator_35,231156455000,True,718600000,2317600,720917600,False,7
8713,validator_19,175303148651,True,823399998,3149940,826549938,True,5
8714,validator_1,176298532190,True,640960004,33120260,674080264,True,5
8715,validator_19,175912580419,True,572399998,37031770,609431768,True,5
8716,validator_15,802120271330,True,661779994,47185100,708965094,True,25
8717,validator_9,82610882458,True,629639995,10209530,639849525,True,2
8718,validator_36,239950305490,True,677400000,2560810,679960810,False,7
8719,validator_11,68751816131,True,710600002,37323950,747923952,True,2
8720,validator_22,192114404301,True,613440004,10027900,623467904,True,6
8721,validator_44,243062249190,True,762600000,23265800,785865800,False,7
8722,validator_49,189977221780,True,655700000,2033600,657733600,False,5
8723,validator_27,256072526980,True,534900000,4981900,539881900,False,8
8724,validator_48,466952729280,True,637200000,43674340,680874340,False,14
8725,validator_26,68055628140,True,550500000,2148060,552648060,False,2
8726,validator_11,69516378928,True,757939997,6622800,764562797,True,2
8727,validator_34,731868278080,True,622900000,7389080,630289080,False,22
8728,validator_24,89549730573,True,442199995,9636310,451836305,True,2
8729,validator_15,802818553550,True,668160000,30122220,698282220,True,25
8730,validator_10,90014238600,True,652020009,17505100,669525109,True,2
8731,validator_18,296455960805,True,522364007,14318450,536682457,True,9
8732,validator_47,172250399670,True,665900000,20243550,686143550,False,5
8733,validator_1,176989822918,True,685900008,5390720,691290728,True,5
8734,validator_34,732232105500,True,360800000,3027420,363827420,False,22
8735,validator_36,240699319310,True,742300000,6713820,749013820,False,7
8736,validator_6,83632344666,True,736659997,33658200,770318197,True,2
8737,validator_48,467669255340,True,714700000,1826060,716526060,False,14
8738,validator_13,79806529569,True,685074001,13756200,698830201,True,2
8739,validator_15,803608212350,True,752900000,36758800,789658800,True,25
8740,validator_49,191063252570,True,1076500000,9530790,1086030790,False,5
8741,validator_1,177660464366,True,664700008,5941440,670641448,True,5
8742,validator_7,182152741975,True,614640002,20560050,635200052,True,5
8743,validator_19,176658015055,True,736420006,9014630,745434636,True,5
8744,validator_31,426350946460,True,721900000,14037380,735937380,False,13
8745,validator_48,468293278080,True,622000000,2022740,624022740,False,14
8746,validator_15,804388223308,True,776739998,3270960,780010958,True,25
8747,validator_15,805049386170,True,634320002,26842860,661162862,True,25
8748,validator_6,84478561546,True,816270000,29946880,846216880,True,2
8749,validator_27,256559831370,True,483900000,3404390,487304390,False,8
8750,validator_15,805744390968,True,693499998,1504800,695004798,True,25
8751,validator_13,80590192867,True,773153998,10509300,783663298,True,2
8752,validator_39,77886994200,True,659100000,2875800,661975800,False,2
8753,validator_17,499479024426,True,760100007,2415960,762515967,True,15
8754,validator_2,71462538206,True,655357993,21555740,676913733,True,2
8755,validator_46,263796517220,True,603100000,8145640,611245640,False,8
8756,validator_31,426977072440,True,616000000,10125980,626125980,False,13
8757,validator_15,806342095461,True,585979993,11724500,597704493,True,25
8758,validator_18,297146129407,True,679240002,10928600,690168602,True,9
8759,validator_4,65507635855,True,672040006,51223450,723263456,True,2
8760,validator_34,732682457210,True,447600000,2751710,450351710,False,22
8761,validator_34,733227929810,True,537100000,8372600,545472600,False,22
8762,validator_27,257071254220,True,509100000,2322850,511422850,False,8
8763,validator_5,177643080424,True,531594008,14112400,545706408,True,5
8764,validator_15,807161948427,True,784385996,35466970,819852966,True,25
8765,validator_34,733841959940,True,608000000,6030130,614030130,False,22
8766,validator_49,191637741800,True,573300000,1189230,574489230,False,5
8767,validator_26,68791468920,True,731100000,4740780,735840780,False,2
8768,validator_22,192866413700,True,724199999,27809400,752009399,True,6
8769,validator_22,193451243772,True,550600002,34230070,584830072,True,6
8770,validator_43,154175153690,True,602100000,2226710,604326710,False,4
8771,validator_15,807875544397,True,706958010,6637960,713595970,True,25
8772,validator_23,75871727483,True,880199995,2662640,882862635,True,2
8773,validator_15,808750469232,True,861139995,13784840,874924835,True,25
8774,validator_48,468896822380,True,602000000,1544300,603544300,False,14
8775,validator_36,241292656520,True,573500000,19837210,593337210,False,7
8776,validator_34,734524355950,True,663200000,19196010,682396010,False,22
8777,validator_48,469482249180,True,573000000,12426800,585426800,False,14
8778,validator_27,257757328820,True,672000000,14074600,686074600,False,8
8779,validator_46,264390152180,True,565400000,28234960,593634960,False,8
8780,validator_24,90244999970,True,668659997,26609400,695269397,True,2
8781,validator_14,317050301780,True,793065996,31208920,824274916,True,9
8782,validator_27,258581436910,True,821400000,2708090,824108090,False,8
8783,validator_41,178904336800,True,574700000,1981030,576681030,False,5
8784,validator_11,70219020774,True,671613996,31027850,702641846,True,2
8785,validator_36,241992800780,True,691400000,8744260,700144260,False,7
8786,validator_43,154923838220,True,728300000,20384530,748684530,False,4
8787,validator_14,317833178014,True,744485994,38390240,782876234,True,9
8788,validator_20,81104103650,True,715840007,7762700,723602707,True,2
8789,validator_44,243566404950,True,501980000,2175760,504155760,False,7
8790,validator_21,175438507376,True,650100002,2386900,652486902,True,5
8791,validator_27,259185719950,True,594400000,9883040,604283040,False,8
8792,validator_17,500122285623,True,627799997,15461200,643261197,True,15
8793,validator_18,298039066704,True,860339997,32597300,892937297,True,9
8794,validator_34,735155607990,True,628200000,3052040,631252040,False,22
8795,validator_15,809546622531,True,789319999,6833300,796153299,True,25
8796,validator_31,427665267750,True,686300000,1895310,688195310,False,13
8797,validator_7,182741749439,True,555506004,33501460,589007464,True,5
8798,validator_1,178300495289,True,628340003,11690920,640030923,True,5
8799,validator_37,169016187920,True,723300000,2523890,725823890,False,5
8800,validator_35,231841329020,True,660500000,24374020,684874020,False,7
8801,validator_19,177392814780,True,719360005,15439720,734799725,True,5
8802,validator_30,153107777780,True,717200000,2147100,719347100,False,4
8803,validator_7,183333433295,True,588199996,3483860,591683856,True,5
8804,validator_34,735744335690,True,583700000,5027700,588727700,False,22
8805,validator_40,86133840540,True,479600000,21292720,500892720,False,2
8806,validator_27,259856305770,True,649600000,20985820,670585820,False,8
8807,validator_47,172962830230,True,690800000,21630560,712430560,False,5
8808,validator_41,179592453470,True,680300000,7816670,688116670,False,5
8809,validator_15,810234067273,True,645740002,41704740,687444742,True,25
8810,validator_34,736355000290,True,607700000,2964600,610664600,False,23
8811,validator_23,76503135591,True,608419998,22988110,631408108,True,2
8812,validator_44,244025178230,True,435000000,23773280,458773280,False,7
8813,validator_49,192425124990,True,784800000,2583190,787383190,False,6
8814,validator_13,81253969663,True,652499996,11276800,663776796,True,2
8815,validator_36,242491697880,True,496300000,2597100,498897100,False,7
8816,validator_47,173376894220,True,412300000,1763990,414063990,False,5
8817,validator_31,428183184650,True,516000000,1916900,517916900,False,13
8818,validator_38,75818464590,True,515100000,2462220,517562220,False,2
8819,validator_21,175894886504,True,446879998,9499130,456379128,True,5
8820,validator_48,470204267410,True,719500000,2518230,722018230,False,14
8821,validator_15,810865680954,True,580720001,50893680,631613681,True,25
8822,validator_28,72305815700,True,475200000,19830790,495030790,False,2
8823,validator_14,318600908517,True,765099993,2630510,767730503,True,9
8824,validator_18,298715298082,True,641899998,34331380,676231378,True,9
8825,validator_34,736785529980,True,429000000,1529690,430529690,False,23
8826,validator_26,69258773640,True,457800000,9504720,467304720,False,2
8827,validator_34,737274710250,True,483200000,5980270,489180270,False,23
8828,validator_31,428849529150,True,656300000,10044500,666344500,False,13
8829,validator_35,232447669450,True,599500000,6840430,606340430,False,7
8830,validator_48,470902517410,True,695200000,3050000,698250000,False,14
8831,validator_35,232863949710,True,409600000,6680260,416280260,False,7
8832,validator_31,429433798780,True,560100000,24169630,584269630,False,13
8833,validator_48,471585672920,True,674700000,8455510,683155510,False,14
8834,validator_33,73854522340,True,515400000,532190,515932190,False,2
8835,validator_44,244674796910,True,642000000,7618680,649618680,False,7
8836,validator_31,429986131860,True,549200000,3133080,552333080,False,13
8837,validator_17,500789456344,True,639960001,27210720,667170721,True,15
8838,validator_44,245265318410,True,586500000,4021500,590521500,False,7
8839,validator_14,319254887840,True,644040003,9939320,653979323,True,9
8840,validator_15,811393004689,True,449800005,77523730,527323735,True,25
8841,validator_7,184031610571,True,673299996,24877280,698177276,True,5
8842,validator_10,90584019985,True,556459995,13321390,569781385,True,2
8843,validator_0,73266815587,True,531280000,7822680,539102680,True,2
8844,validator_31,430479820720,True,470700000,22988860,493688860,False,13
8845,validator_7,184846798353,True,807539992,7647790,815187782,True,5
8846,validator_17,501594195067,True,784899993,19838730,804738723,True,15
8847,validator_5,178473774797,True,799719993,30974380,830694373,True,5
8848,validator_1,178914283791,True,610760002,3028500,613788502,True,5
8849,validator_35,233549627360,True,683200000,2477650,685677650,False,7
8850,validator_27,260471338970,True,595800000,19233200,615033200,False,8
8851,validator_41,180031100670,True,437100000,1547200,438647200,False,5
8852,validator_17,502239942787,True,636400000,9347720,645747720,True,15
8853,validator_17,502855486383,True,606945996,8597600,615543596,True,15
8854,validator_34,737855276070,True,577600000,2965820,580565820,False,23
8855,validator_27,261071151470,True,597500000,2312500,599812500,False,8
8856,validator_13,81964740668,True,697100005,13671000,710771005,True,2
8857,validator_41,180775479390,True,735600000,8778720,744378720,False,5
8858,validator_34,738544773390,True,674900000,14597320,689497320,False,23
8859,validator_17,503723574385,True,784894002,83194000,868088002,True,15
8860,validator_7,185608819891,True,747039998,14981540,762021538,True,5
8861,validator_15,811829692426,True,412239997,24447740,436687737,True,25
8862,validator_5,178985552745,True,466239988,45537960,511777948,True,5
8863,validator_36,243102766980,True,602000000,9069100,611069100,False,7
8864,validator_36,243901693500,True,795100000,3826520,798926520,False,7
8865,validator_14,320193272620,True,937200000,1184780,938384780,True,10
8866,validator_46,264859275580,True,453700000,15423400,469123400,False,8
8867,validator_23,77288009331,True,781000000,3873740,784873740,True,2
8868,validator_35,234072198040,True,520400000,2170680,522570680,False,7
8869,validator_37,169637094320,True,620000000,906400,620906400,False,5
8870,validator_5,179718776268,True,705599993,27623530,733223523,True,5
8871,validator_5,180458673926,True,715200008,24697650,739897658,True,5
8872,validator_37,170234792640,True,587200000,10498320,597698320,False,5
8873,validator_32,62677233770,True,639500000,9188240,648688240,False,1
8874,validator_48,472232847660,True,634800000,12374740,647174740,False,14
8875,validator_34,739129978530,True,583000000,2205140,585205140,False,23
8876,validator_19,178119880965,True,703020005,24046180,727066185,True,5
8877,validator_13,82887752034,True,918900006,4111360,923011366,True,2
8878,validator_31,431063660840,True,573800000,10040120,583840120,False,13
8879,validator_48,472800142770,True,565200000,2095110,567295110,False,14
8880,validator_44,245790367550,True,514300000,10749140,525049140,False,7
8881,validator_48,473373647870,True,571300000,2205100,573505100,False,14
8882,validator_47,174110209420,True,729200000,4115200,733315200,False,5
8883,validator_6,85089352295,True,607499999,3290750,610790749,True,2
8884,validator_46,265387895560,True,524200000,4419980,528619980,False,8
8885,validator_36,244438333220,True,533900000,2739720,536639720,False,7
8886,validator_42,62796199250,True,679400000,3131320,682531320,False,1
8887,validator_27,261507961210,True,433400000,3409740,436809740,False,8
8888,validator_27,262280574650,True,752500000,20113440,772613440,False,8
8889,validator_46,266074495640,True,680100000,6500080,686600080,False,8
8890,validator_24,90823266373,True,531024003,47242400,578266403,True,2
8891,validator_7,186073043224,True,459800003,4423330,464223333,True,5
8892,validator_34,739939187160,True,803600000,5608630,809208630,False,23
8893,validator_49,192971955600,True,541300000,5530610,546830610,False,6
8894,validator_21,176568002109,True,640660005,32455600,673115605,True,5
8895,validator_49,193671948030,True,697400000,2592430,699992430,False,6
8896,validator_21,177695307390,True,1052096001,75209280,1127305281,True,5
8897,validator_15,812638537651,True,747310005,61535220,808845225,True,25
8898,validator_18,299654381787,True,935300005,3783700,939083705,True,9
8899,validator_34,740445413960,True,503800000,2426800,506226800,False,23
8900,validator_18,300461556529,True,792900002,14274740,807174742,True,9
8901,validator_2,72096814397,True,621999991,12276200,634276191,True,2
8902,validator_9,83185890677,True,556139999,18868220,575008219,True,2
8903,validator_34,740959070700,True,510600000,3056740,513656740,False,23
8904,validator_34,741527513960,True,544800000,23643260,568443260,False,23
8905,validator_7,186685229304,True,609300000,2886080,612186080,True,5
8906,validator_6,85813726793,True,697579998,26794500,724374498,True,2
8907,validator_37,170744645260,True,506100000,3752620,509852620,False,5
8908,validator_15,813332603596,True,651780005,42285940,694065945,True,25
8909,validator_15,814214824097,True,839020001,43200500,882220501,True,25
8910,validator_25,83804895470,True,506900000,2087510,508987510,False,2
8911,validator_34,742110391110,True,580000000,2877150,582877150,False,23
8912,validator_21,178349858560,True,644420000,10131170,654551170,True,5
8913,validator_4,66082931600,True,553500005,21795740,575295745,True,2
8914,validator_41,181388964990,True,610800000,2685600,613485600,False,5
8915,validator_27,262926052680,True,637400000,8078030,645478030,False,8
8916,validator_1,179738859318,True,810899997,13675530,824575527,True,5
8917,validator_15,814921118272,True,684120005,22174170,706294175,True,25
8918,validator_31,431705855960,True,605000000,37195120,642195120,False,13
8919,validator_13,83493444219,True,579366005,26326180,605692185,True,2
8920,validator_10,91198327834,True,600439999,13867850,614307849,True,2
8921,validator_31,432417907440,True,693800000,18251480,712051480,False,13
8922,validator_35,234616077120,True,539700000,4179080,543879080,False,7
8923,validator_35,235068079540,True,448440000,3562420,452002420,False,7
8924,validator_26,69972361560,True,705500000,8087920,713587920,False,2
8925,validator_12,279309571191,True,674340000,15704440,690044440,True,8
8926,validator_14,320780050920,True,585500000,1278300,586778300,True,10
8927,validator_46,266824977280,True,741000000,9481640,750481640,False,8
8928,validator_18,301512223387,True,1026259998,24406860,1050666858,True,9
8929,validator_17,504509197381,True,758800006,26822990,785622996,True,15
8930,validator_17,505436044382,True,909580001,17267000,926847001,True,15
8931,validator_43,155596929600,True,669700000,3391380,673091380,False,4
8932,validator_46,267415386100,True,581700000,8708820,590408820,False,8
8933,validator_20,81629877192,True,523600002,2173540,525773542,True,2
8934,validator_15,815823831052,True,899200000,3512780,902712780,True,25
8935,validator_41,182104516840,True,698400000,17151850,715551850,False,5
8936,validator_39,78452771320,True,564300000,1477120,565777120,False,2
8937,validator_5,181092202628,True,543360002,90168700,633528702,True,5
8938,validator_21,179090208141,True,737320001,3029580,740349581,True,5
8939,validator_17,506297288337,True,839540005,21703950,861243955,True,15
8940,validator_49,194273216730,True,598000000,3268700,601268700,False,6
8941,validator_45,71778119360,True,521300000,3035900,524335900,False,2
8942,validator_7,187390101435,True,641900001,62972130,704872131,True,5
8943,validator_27,263545951960,True,617900000,1999280,619899280,False,8
8944,validator_1,180404819022,True,652496004,13463700,665959704,True,5
8945,validator_17,507024230133,True,717295996,9645800,726941796,True,15
8946,validator_28,72935393820,True,613500000,16078120,629578120,False,2
8947,validator_34,742895879230,True,782700000,2788120,785488120,False,23
8948,validator_15,816427950474,True,587180002,16939420,604119422,True,25
8949,validator_32,63344493470,True,662000000,5259700,667259700,False,1
8950,validator_48,473914921770,True,540100000,1173900,541273900,False,14
8951,validator_43,156188718440,True,572800000,18988840,591788840,False,4
8952,validator_17,507617677531,True,573699998,19747400,593447398,True,15
8953,validator_48,474498398170,True,575610000,7866400,583476400,False,14
8954,validator_27,264192680160,True,632600000,14128200,646728200,False,8
8955,validator_17,508328351834,True,659460003,51214300,710674303,True,15
8956,validator_48,475157928090,True,651200000,8329920,659529920,False,14
8957,validator_17,509029377867,True,670240003,30786030,701026033,True,15
8958,validator_47,174683907450,True,571100000,2598030,573698030,False,5
8959,validator_48,475651580330,True,490300000,3352240,493652240,False,14
8960,validator_31,433003654640,True,555100000,30647200,585747200,False,13
8961,validator_32,63982488760,True,632500000,5495290,637995290,False,1
8962,validator_17,509753806602,True,658264005,66164730,724428735,True,15
8963,validator_25,84483924540,True,670000000,9029070,679029070,False,2
8964,validator_5,181858695620,True,749240002,17252990,766492992,True,5
8965,validator_49,194806917440,True,530600000,3100710,533700710,False,6
8966,validator_19,178764750211,True,633120006,11749240,644869246,True,5
8967,validator_3,88291178293,True,699899997,34377400,734277397,True,2
8968,validator_35,235577892660,True,499400000,10413120,509813120,False,7
8969,validator_17,510503951007,True,724900005,25244400,750144405,True,15
8970,validator_36,244957004180,True,515400000,3270960,518670960,False,7
8971,validator_7,188111668859,True,719200004,2367420,721567424,True,5
8972,validator_46,267999400630,True,580400000,3614530,584014530,False,8
8973,validator_15,817112119153,True,678599999,5568680,684168679,True,25
8974,validator_36,245628615610,True,664800000,6811430,671611430,False,7
8975,validator_15,817801675383,True,668459990,21096240,689556230,True,25
8976,validator_6,86533140295,True,690378002,29035500,719413502,True,2
8977,validator_13,84325608719,True,821158000,11006500,832164500,True,2
8978,validator_12,279877767096,True,548970005,19225900,568195905,True,8
8979,validator_14,321616027973,True,829519993,6457060,835977053,True,10
8980,validator_38,76470598790,True,650100000,2034200,652134200,False,2
8981,validator_6,87321042221,True,770719996,17181930,787901926,True,2
8982,validator_14,322529860187,True,905900004,7932210,913832214,True,10
8983,validator_31,433567298110,True,555800000,7843470,563643470,False,13
8984,validator_39,79025211280,True,555800000,16639960,572439960,False,2
8985,validator_14,323240522280,True,690339993,20322100,710662093,True,10
8986,validator_12,280550437299,True,627520003,45150200,672670203,True,8
8987,validator_48,476297572100,True,625400000,20591770,645991770,False,14
8988,validator_2,72892544363,True,788673996,7055970,795729966,True,2
8989,validator_46,268510941820,True,503800000,7741190,511541190,False,8
8990,validator_33,74284879370,True,426900000,3457030,430357030,False,2
8991,validator_21,179691357241,True,594960000,6189100,601149100,True,5
8992,validator_11,70990277276,True,744618002,26638500,771256502,True,2
8993,validator_17,511345191622,True,823699995,17540620,841240615,True,15
8994,validator_37,171223545400,True,470000000,8900140,478900140,False,5
8995,validator_17,511922230023,True,549520001,27518400,577038401,True,15
8996,validator_46,268852919200,True,338800000,3177380,341977380,False,8
8997,validator_49,195391128710,True,583100000,1111270,584211270,False,6
8998,validator_47,175142488680,True,457500000,1081230,458581230,False,5
8999,validator_17,512525056220,True,592765997,10060200,602826197,True,16
9000,validator_15,818343647634,True,510060001,31912250,541972251,True,25
9001,validator_18,302114978188,True,598480001,4274800,602754801,True,9
9002,validator_32,64438545050,True,454300000,1756290,456056290,False,2
9003,validator_8,71757241515,True,505500003,26618800,532118803,True,2
9004,validator_0,74051710246,True,758399999,26494660,784894659,True,2
9005,validator_34,743433452470,True,535600000,1973240,537573240,False,23
9006,validator_21,180622702340,True,922599999,8745100,931345099,True,5
9007,validator_36,246127908830,True,497800000,1493220,499293220,False,7
9008,validator_44,246570419380,True,778800000,1251830,780051830,False,7
9009,validator_15,818857683779,True,510440005,3596140,514036145,True,25
9010,validator_29,67482465210,True,633400000,1680240,635080240,False,2
9011,validator_43,156703028240,True,511500000,2809800,514309800,False,4
9012,validator_49,195856554750,True,460200000,5226040,465426040,False,6
9013,validator_12,281399745897,True,829199998,20108600,849308598,True,8
9014,validator_18,302987589078,True,862800000,9810890,872610890,True,9
9015,validator_41,182752307560,True,636700000,11090720,647790720,False,5
9016,validator_36,246756933930,True,626800000,2225100,629025100,False,7
9017,validator_15,819558077618,True,680599999,19793840,700393839,True,25
9018,validator_15,820447596713,True,887800005,1719090,889519095,True,25
9019,validator_7,188987841377,True,851499998,24672520,876172518,True,5
9020,validator_15,821082965812,True,617359999,18009100,635369099,True,25
9021,validator_44,247121445470,True,548900000,2126090,551026090,False,7
9022,validator_31,434044780870,True,475400000,2082760,477482760,False,13
9023,validator_37,171722598090,True,496800000,2252690,499052690,False,5
9024,validator_16,78689823234,True,772599998,2991840,775591838,True,2
9025,validator_17,513386544052,True,854174002,7313830,861487832,True,16
9026,validator_31,434568825270,True,504800000,19244400,524044400,False,13
9027,validator_36,247416016110,True,656800000,2282180,659082180,False,7
9028,validator_13,85338961421,True,968440002,44912700,1013352702,True,2
9029,validator_32,64961908810,True,513200000,10163760,523363760,False,2
9030,validator_31,435092183590,True,520600000,2758320,523358320,False,13
9031,validator_21,181358009435,True,733799995,1507100,735307095,True,5
9032,validator_27,264740116760,True,544800000,2636600,547436600,False,8
9033,validator_35,236128300870,True,536200000,14208210,550408210,False,7
9034,validator_13,86167173005,True,803600004,24611580,828211584,True,2
9035,validator_36,248175472330,True,757600000,1856220,759456220,False,7
9036,validator_34,744024249520,True,588900000,1897050,590797050,False,23
9037,validator_14,323902376979,True,655199999,6654700,661854699,True,10
9038,validator_48,476797843540,True,497900000,2371440,500271440,False,14
9039,validator_14,324603147973,True,684180004,16590990,700770994,True,10
9040,validator_48,477373354440,True,573400000,2110900,575510900,False,14
9041,validator_27,265321915650,True,574900000,6898890,581798890,False,8
9042,validator_35,236764988670,True,630500000,6187800,636687800,False,7
9043,validator_48,477887873860,True,493600000,20919420,514519420,False,14
9044,validator_18,303750299573,True,756239995,6470500,762710495,True,9
9045,validator_22,194171071790,True,691899998,27928020,719828018,True,6
9046,validator_15,821644851230,True,555239998,6645420,561885418,True,25
9047,validator_17,514011457017,True,622419995,2492970,624912965,True,16
9048,validator_23,78166943241,True,871640000,7293910,878933910,True,2
9049,validator_43,157194275780,True,470500000,20747540,491247540,False,4
9050,validator_1,181383655429,True,940200007,38636400,978836407,True,5
9051,validator_14,325341736404,True,705100001,33488430,738588431,True,10
9052,validator_15,822378636669,True,706620009,27165430,733785439,True,25
9053,validator_46,269429527060,True,575300000,1307860,576607860,False,8
9054,validator_5,182476995025,True,611120005,7179400,618299405,True,5
9055,validator_2,73621405656,True,720299993,8561300,728861293,True,2
9056,validator_17,514523672846,True,497017999,15197830,512215829,True,16
9057,validator_14,326043528613,True,624699999,77092210,701792209,True,10
9058,validator_27,265981422890,True,657100000,2407240,659507240,False,8
9059,validator_15,822920263168,True,535799999,5826500,541626499,True,25
9060,validator_18,304384794325,True,626040002,8454750,634494752,True,9
9061,validator_15,823458610521,True,515999993,22347360,538347353,True,25
9062,validator_37,172341410530,True,615500000,3312440,618812440,False,5
9063,validator_33,74846790910,True,559100000,2811540,561911540,False,2
9064,validator_27,266732762220,True,731700000,19639330,751339330,False,8
9065,validator_48,478536349960,True,636400000,12076100,648476100,False,14
9066,validator_19,179486904893,True,695400002,26754680,722154682,True,5
9067,validator_17,515376118047,True,822700001,29745200,852445201,True,16
9068,validator_34,744467896080,True,440200000,3446560,443646560,False,23
9069,validator_9,83804722116,True,598899999,19931440,618831439,True,2
9070,validator_23,78854702961,True,684800000,2959720,687759720,True,2
9071,validator_34,745022868410,True,552100000,2872330,554972330,False,23
9072,validator_31,435685792830,True,578900000,14709240,593609240,False,13
9073,validator_34,745580390010,True,555100000,2421600,557521600,False,23
9074,validator_40,86873434280,True,736800000,2793740,739593740,False,2
9075,validator_17,516072086319,True,692499992,3468280,695968272,True,16
9076,validator_18,304933289767,True,524300002,24195440,548495442,True,9
9077,validator_44,247804522090,True,681000000,2076620,683076620,False,7
9078,validator_30,153700773470,True,553500000,39495690,592995690,False,4
9079,validator_36,248844436520,True,649800000,19164190,668964190,False,7
9080,validator_14,326748270043,True,688140000,16601430,704741430,True,10
9081,validator_19,180167484955,True,638599992,41980070,680580062,True,5
9082,validator_21,182219117250,True,828805995,32301820,861107815,True,5
9083,validator_47,175683300970,True,537800000,3012290,540812290,False,5
9084,validator_46,270186041190,True,742600000,13914130,756514130,False,8
9085,validator_4,66654622178,True,562359998,9330580,571690578,True,2
9086,validator_35,237414402300,True,645700000,3713630,649413630,False,7
9087,validator_1,181969820559,True,580000000,6165130,586165130,True,5
9088,validator_12,282141120924,True,733299997,8075030,741375027,True,8
9089,validator_18,305731537940,True,774578003,23670170,798248173,True,9
9090,validator_34,746306101770,True,716200000,9511760,725711760,False,23
9091,validator_19,180917464655,True,744200000,5779700,749979700,True,5
9092,validator_45,72549761200,True,768400000,3241840,771641840,False,2
9093,validator_41,183345909910,True,569000000,24602350,593602350,False,5
9094,validator_34,746935763110,True,628800000,861340,629661340,False,23
9095,validator_44,248370536620,True,565100000,914530,566014530,False,7
9096,validator_31,436164439930,True,477300000,1347100,478647100,False,13
9097,validator_27,267318820820,True,548200000,37858600,586058600,False,8
9098,validator_15,824300913518,True,802699997,39603000,842302997,True,25
9099,validator_15,824996772651,True,664973993,30885140,695859133,True,25
9100,validator_17,516740926418,True,636957999,31882100,668840099,True,16
9101,validator_44,248990619520,True,616900000,3182900,620082900,False,7
9102,validator_41,183823795640,True,473800000,4085730,477885730,False,5
9103,validator_35,238054731120,True,638300000,2028820,640328820,False,7
9104,validator_48,479234606760,True,653900000,44356800,698256800,False,14
9105,validator_34,747531969710,True,593700000,2506600,596206600,False,23
9106,validator_30,154353653750,True,642100000,10780280,652880280,False,4
9107,validator_18,306415507003,True,674600003,9369060,683969063,True,9
9108,validator_47,176125298520,True,440230000,1767550,441997550,False,5
9109,validator_14,327445743633,True,685840000,11633590,697473590,True,10
9110,validator_34,747969763230,True,436300000,1493520,437793520,False,23
9111,validator_7,189631202800,True,584520003,58841420,643361423,True,5
9112,validator_18,307239772471,True,798539998,25725470,824265468,True,9
9113,validator_17,517363167445,True,603545997,18695030,622241027,True,16
9114,validator_6,88057270490,True,698109999,38118270,736228269,True,2
9115,validator_46,270912949950,True,717200000,9708760,726908760,False,8
9116,validator_35,238666539950,True,591000000,20808830,611808830,False,7
9117,validator_36,249234173660,True,385300000,4437140,389737140,False,7
9118,validator_48,479796800480,True,559100000,3093720,562193720,False,14
9119,validator_27,267949626360,True,611700000,19105540,630805540,False,8
9120,validator_35,239293668740,True,607300000,19828790,627128790,False,7
9121,validator_37,173087564970,True,743500000,2654440,746154440,False,5
9122,validator_34,748566673810,True,594600000,2310580,596910580,False,23
9123,validator_48,480275916580,True,467500000,11616100,479116100,False,15
9124,validator_13,86776738817,True,585600002,23965810,609565812,True,2
9125,validator_44,249539130130,True,544300000,4210610,548510610,False,7
9126,validator_35,239923223680,True,610500000,19054940,629554940,False,7
9127,validator_34,748987697600,True,397530000,23493790,421023790,False,23
9128,validator_44,250079079610,True,536300000,3649480,539949480,False,7
9129,validator_45,73186911400,True,635600000,1550200,637150200,False,2
9130,validator_8,72360348384,True,578819999,24286870,603106869,True,2
9131,validator_17,517880626364,True,515000009,2458910,517458919,True,16
9132,validator_34,749803080080,True,812200000,3182480,815382480,False,23
9133,validator_47,176736907840,True,607100000,4509320,611609320,False,5
9134,validator_15,825786063032,True,709160001,80130380,789290381,True,25
9135,validator_31,436717130530,True,551000000,1690600,552690600,False,13
9136,validator_6,88655120773,True,596300003,1550280,597850283,True,2
9137,validator_21,183026153044,True,785939994,21095800,807035794,True,5
9138,validator_10,91809340932,True,603699998,7313100,611013098,True,2
9139,validator_31,437175471680,True,448900000,9441150,458341150,False,13
9140,validator_2,74493497875,True,843699999,28392220,872092219,True,2
9141,validator_30,155022863880,True,665300000,3910130,669210130,False,4
9142,validator_15,826613244556,True,824899994,2281530,827181524,True,25
9143,validator_34,750412496780,True,607200000,2216700,609416700,False,23
9144,validator_11,71860236341,True,846320005,23639060,869959065,True,2
9145,validator_31,437748276610,True,571900000,904930,572804930,False,13
9146,validator_3,88930525092,True,607919999,31426800,639346799,True,2
9147,validator_16,79220849596,True,510540002,20486360,531026362,True,2
9148,validator_44,250620718140,True,529000000,12638530,541638530,False,7
9149,validator_34,750983314500,True,568200000,2617720,570817720,False,23
9150,validator_31,438328782810,True,571700000,8806200,580506200,False,13
9151,validator_1,182592170090,True,583600001,38749530,622349531,True,5
9152,validator_15,827184879039,True,559100003,12534480,571634483,True,25
9153,validator_48,480897115060,True,596670000,24528480,621198480,False,15
9154,validator_30,155649141410,True,624500000,1777530,626277530,False,4
9155,validator_6,89168169073,True,509510000,3538300,513048300,True,2
9156,validator_17,518564788591,True,636239997,47922230,684162227,True,16
9157,validator_44,251114961440,True,492300000,1943300,494243300,False,7
9158,validator_2,75089950079,True,538460004,57992200,596452204,True,2
9159,validator_46,271435981690,True,513900000,9131740,523031740,False,8
9160,validator_14,328229316939,True,754567996,29005310,783573306,True,10
9161,validator_32,65673953960,True,690200000,21845150,712045150,False,2
9162,validator_27,268458696360,True,506300000,2770000,509070000,False,8
9163,validator_1,183279137108,True,673139998,13827020,686967018,True,5
9164,validator_6,89982086367,True,808120004,5797290,813917294,True,2
9165,validator_17,519377179600,True,764519999,47871010,812391009,True,16
9166,validator_18,307964143904,True,718499993,5871440,724371433,True,9
9167,validator_46,272048163830,True,598800000,13382140,612182140,False,8
9168,validator_35,240783054060,True,855500000,4330380,859830380,False,7
9169,validator_0,74795967518,True,718173992,26083280,744257272,True,2
9170,validator_48,481408380610,True,510200000,1065550,511265550,False,15
9171,validator_17,519820911499,True,399539999,44191900,443731899,True,16
9172,validator_15,827841628623,True,655500004,1249580,656749584,True,25
9173,validator_17,520620542583,True,779300004,20331080,799631084,True,16
9174,validator_44,251561607020,True,442100000,4545580,446645580,False,7
9175,validator_15,828434742922,True,562399999,30714300,593114299,True,25
9176,validator_22,194870443951,True,680840001,18532160,699372161,True,6
9177,validator_36,249814991460,True,578600000,2217800,580817800,False,7
9178,validator_34,751514032010,True,528260000,2457510,530717510,False,23
9179,validator_8,73188860178,True,803619994,24891800,828511794,True,2
9180,validator_13,87361800396,True,568779999,16281580,585061579,True,2
9181,validator_44,252237138820,True,669900000,5631800,675531800,False,7
9182,validator_22,195764028092,True,869020001,24564140,893584141,True,6
9183,validator_34,752170725810,True,655300000,1393800,656693800,False,23
9184,validator_22,196469003097,True,684680005,20295000,704975005,True,6
9185,validator_18,308909949108,True,925500004,20305200,945805204,True,9
9186,validator_16,79972378675,True,740499999,11029080,751529079,True,2
9187,validator_5,183254841899,True,757257994,20588880,777846874,True,5
9188,validator_15,828976619317,True,535099995,6776400,541876395,True,25
9189,validator_18,309511834622,True,576474004,25411510,601885514,True,9
9190,validator_46,272905264170,True,854100000,3000340,857100340,False,8
9191,validator_34,752724618250,True,546500000,7392440,553892440,False,23
9192,validator_17,521215955541,True,593119998,2292960,595412958,True,16
9193,validator_18,310336818320,True,803499998,21483700,824983698,True,9
9194,validator_18,310876572841,True,519340001,20414520,539754521,True,9
9195,validator_22,197007113870,True,530940003,7170770,538110773,True,6
9196,validator_41,184294951890,True,468600000,2556250,471156250,False,5
9197,validator_28,73601293260,True,650900000,14999440,665899440,False,2
9198,validator_31,438786575780,True,444900000,12892970,457792970,False,13
9199,validator_30,156311022720,True,660200000,1681310,661881310,False,4
9200,validator_12,282771508759,True,585120005,45267830,630387835,True,8
9201,validator_7,190245522372,True,598340002,15979570,614319572,True,5
9202,validator_17,522164291455,True,940520004,7815910,948335914,True,16
9203,validator_18,311669268675,True,746356004,46339830,792695834,True,9
9204,validator_37,173508241850,True,414200000,6476880,420676880,False,5
9205,validator_49,196423717150,True,564200000,2962400,567162400,False,6
9206,validator_12,283475720661,True,689100002,15111900,704211902,True,8
9207,validator_36,250453986780,True,636200000,2795320,638995320,False,7
9208,validator_48,482123878540,True,691200000,24297930,715497930,False,15
9209,validator_14,328886034731,True,647440012,9277780,656717792,True,10
9210,validator_49,196793396680,True,349800000,19879530,369679530,False,6
9211,validator_24,91402978416,True,566700003,13012040,579712043,True,2
9212,validator_40,87573507360,True,692400000,7673080,700073080,False,2
9213,validator_34,753423488930,True,677900000,20970680,698870680,False,23
9214,validator_37,174085205840,True,568100000,8863990,576963990,False,5
9215,validator_18,312323081153,True,627139998,26672480,653812478,True,9
9216,validator_27,269166274340,True,698400000,9177980,707577980,False,8
9217,validator_36,250974153580,True,500650000,19516800,520166800,False,7
9218,validator_39,79631548210,True,603300000,3036930,606336930,False,2
9219,validator_34,754078170430,True,650900000,3781500,654681500,False,23
9220,validator_34,754681228940,True,602100000,958510,603058510,False,23
9221,validator_37,174871420060,True,784100000,2114220,786214220,False,5
9222,validator_15,829678516682,True,677196005,24701360,701897365,True,25
9223,validator_49,197328148980,True,528000000,6752300,534752300,False,6
9224,validator_41,184776980310,True,479200000,2828420,482028420,False,5
9225,validator_2,75742284677,True,626059998,26274600,652334598,True,2
9226,validator_18,312997650048,True,665320005,9248890,674568895,True,9
9227,validator_34,755280663880,True,595300000,4134940,599434940,False,23
9228,validator_9,84461601609,True,647060003,9819490,656879493,True,2
9229,validator_21,183817538662,True,727219998,64165620,791385618,True,5
9230,validator_18,313427507173,True,415900005,13957120,429857125,True,9
9231,validator_18,314158794576,True,725100003,6187400,731287403,True,9
9232,validator_18,314909733072,True,727199996,23738500,750938496,True,9
9233,validator_35,241371520920,True,579700000,8766860,588466860,False,7
9234,validator_48,482741779370,True,592100000,25800830,617900830,False,15
9235,validator_33,75370134200,True,503100000,20243290,523343290,False,2
9236,validator_46,273508539280,True,601900000,1375110,603275110,False,8
9237,validator_17,523102404096,True,883500001,54612640,938112641,True,16
9238,validator_31,439566514480,True,771900000,8038700,779938700,False,13
9239,validator_17,523593046136,True,436560000,54082040,490642040,True,16
9240,validator_34,755807461780,True,525300000,1497900,526797900,False,23
9241,validator_31,440137545980,True,568500000,2531500,571031500,False,13
9242,validator_15,830523826120,True,823139998,22169440,845309438,True,25
9243,validator_3,89741969757,True,793260005,18184660,811444665,True,2
9244,validator_17,524179262434,True,579999998,6216300,586216298,True,16
9245,validator_46,273891714030,True,379000000,4174750,383174750,False,8
9246,validator_48,483523747730,True,761200000,20768360,781968360,False,15
9247,validator_4,67359527783,True,697960005,6945600,704905605,True,2
9248,validator_43,157776486660,True,580800000,1410880,582210880,False,4
9249,validator_36,251452979040,True,475800000,3025460,478825460,False,7
9250,validator_2,76275685171,True,524173994,9226500,533400494,True,2
9251,validator_1,184068700398,True,764600000,24963290,789563290,True,5
9252,validator_44,252935322850,True,695200000,2984030,698184030,False,7
9253,validator_48,484156940920,True,605500000,27693190,633193190,False,15
9254,validator_31,440711328940,True,571000000,2782960,573782960,False,13
9255,validator_4,68109302914,True,738080001,11695130,749775131,True,2
9256,validator_33,75957417500,True,567200000,20083300,587283300,False,2
9257,validator_15,831139129524,True,587740004,27563400,615303404,True,25
9258,validator_39,80331703250,True,698700000,1455040,700155040,False,2
9259,validator_7,190946096987,True,697999995,2574620,700574615,True,5
9260,validator_12,284113778009,True,617159998,20897350,638057348,True,8
9261,validator_21,184494686127,True,643273995,33873470,677147465,True,5
9262,validator_36,251964913440,True,503700000,8234400,511934400,False,7
9263,validator_7,191597027962,True,607840005,43090970,650930975,True,5
9264,validator_47,177222102430,True,482900000,2294590,485194590,False,5
9265,validator_45,73709105470,True,508300000,13894070,522194070,False,2
9266,validator_12,284629723410,True,509300001,6645400,515945401,True,8
9267,validator_15,831766367226,True,605246002,21991700,627237702,True,25
9268,validator_47,177872157340,True,647900000,2154910,650054910,False,5
9269,validator_25,84978755540,True,472500000,22331000,494831000,False,2
9270,validator_1,184858941295,True,786999997,3240900,790240897,True,5
9271,validator_43,158371935160,True,593200000,2248500,595448500,False,4
9272,validator_15,832464236423,True,672855997,25013200,697869197,True,26
9273,validator_34,756400043070,True,585000000,7581290,592581290,False,23
9274,validator_26,70651389950,True,675100000,3928390,679028390,False,2
9275,validator_48,484860340640,True,701000000,2399720,703399720,False,15
9276,validator_49,197996438290,True,652200000,16089310,668289310,False,6
9277,validator_34,756968796330,True,564900000,3853260,568753260,False,23
9278,validator_26,71199096390,True,531800000,15906440,547706440,False,2
9279,validator_34,757468846760,True,478600000,21450430,500050430,False,23
9280,validator_31,441372316030,True,657300000,3687090,660987090,False,13
9281,validator_34,757822979160,True,353000000,1132400,354132400,False,23
9282,validator_17,525022431973,True,841199999,1969540,843169539,True,16
9283,validator_23,79506166189,True,635519998,15943230,651463228,True,2
9284,validator_27,269830913740,True,661100000,3539400,664639400,False,8
9285,validator_45,74369684330,True,633100000,27478860,660578860,False,2
9286,validator_7,192284381819,True,620867997,66485860,687353857,True,6
9287,validator_31,442002130120,True,611000000,18814090,629814090,False,13
9288,validator_1,185505230616,True,640460001,5829320,646289321,True,5
9289,validator_9,85157799939,True,662900000,33298330,696198330,True,2
9290,validator_29,68088077120,True,596400000,9211910,605611910,False,2
9291,validator_38,77058890020,True,585400000,2891230,588291230,False,2
9292,validator_49,198491898610,True,494100000,1360320,495460320,False,6
9293,validator_12,285432300769,True,776720009,25857350,802577359,True,8
9294,validator_15,833108406528,True,619764005,24406100,644170105,True,26
9295,validator_5,183878093266,True,603899997,19351370,623251367,True,5
9296,validator_17,525632150764,True,603980001,5738790,609718791,True,16
9297,validator_46,274513805930,True,616300000,5791900,622091900,False,8
9298,validator_31,442674435460,True,665600000,6705340,672305340,False,13
9299,validator_34,758334814620,True,510900000,935460,511835460,False,23
9300,validator_21,185337873759,True,834300002,8887630,843187632,True,5
9301,validator_6,90867709347,True,864954000,20668980,885622980,True,2
9302,validator_22,197805809113,True,777400003,21295240,798695243,True,6
9303,validator_43,158971711290,True,581800000,17976130,599776130,False,4
9304,validator_16,80624567774,True,620867999,31321100,652189099,True,2
9305,validator_15,833642283452,True,527820004,6056920,533876924,True,26
9306,validator_44,253432417280,True,489000000,8094430,497094430,False,7
9307,validator_46,274996104180,True,462700000,19598250,482298250,False,8
9308,validator_44,254373011650,True,920900000,19694370,940594370,False,7
9309,validator_7,192923689620,True,630170001,9137800,639307801,True,6
9310,validator_49,198927238310,True,429110000,6229700,435339700,False,6
9311,validator_13,87900700627,True,529370001,9530230,538900231,True,2
9312,validator_27,270399195630,True,564900000,3381890,568281890,False,8
9313,validator_48,485354942440,True,490200000,4401800,494601800,False,15
9314,validator_7,194003481258,True,1037559998,42231640,1079791638,True,6
9315,validator_24,92118407072,True,701299996,14128660,715428656,True,2
9316,validator_18,315583447207,True,662000005,11714130,673714135,True,9
9317,validator_31,443194175960,True,517200000,2540500,519740500,False,13
9318,validator_30,157058665100,True,740400000,7242380,747642380,False,4
9319,validator_41,185257625040,True,478570000,2074730,480644730,False,5
9320,validator_48,486010404880,True,628000000,27462440,655462440,False,15
9321,validator_49,199635717770,True,701100000,7379460,708479460,False,6
9322,validator_48,486497390280,True,486240000,745400,486985400,False,15
9323,validator_27,271164797750,True,740700000,24902120,765602120,False,8
9324,validator_31,443685051630,True,483500000,7375670,490875670,False,13
9325,validator_36,252755498240,True,770500000,20084800,790584800,False,7
9326,validator_1,186156718816,True,625914000,25574200,651488200,True,5
9327,validator_34,759002481460,True,665300000,2366840,667666840,False,23
9328,validator_35,241869436790,True,495900000,2015870,497915870,False,7
9329,validator_14,329570825520,True,664939999,19850790,684790789,True,10
9330,validator_17,526218294565,True,583500001,2643800,586143801,True,16
9331,validator_19,181479982815,True,491228000,71290160,562518160,True,5
9332,validator_19,182165950756,True,654180001,31787940,685967941,True,5
9333,validator_24,93030196904,True,892000002,19789830,911789832,True,2
9334,validator_10,92447793073,True,601560001,36892140,638452141,True,2
9335,validator_15,834351434462,True,681540000,27611010,709151010,True,26
9336,validator_1,186778677254,True,588340008,33618430,621958438,True,5
9337,validator_44,255106996160,True,731200000,2784510,733984510,False,7
9338,validator_1,187548448258,True,746000004,23771000,769771004,True,5
9339,validator_5,184654871031,True,751820005,24957760,776777765,True,5
9340,validator_41,185802616380,True,542900000,2091340,544991340,False,5
9341,validator_17,526964998701,True,725859996,20844140,746704136,True,16
9342,validator_21,185991713695,True,608049996,45789940,653839936,True,5
9343,validator_14,330376634919,True,782999999,22809400,805809399,True,10
9344,validator_17,527644621498,True,670419997,9202800,679622797,True,16
9345,validator_27,271730256720,True,561900000,3558970,565458970,False,8
9346,validator_48,486977372890,True,474100000,5882610,479982610,False,15
9347,validator_47,178556980500,True,676200000,8623160,684823160,False,5
9348,validator_19,182811127650,True,610976004,34200890,645176894,True,5
9349,validator_24,93793377783,True,698253999,64926880,763180879,True,2
9350,validator_1,188454374785,True,877693997,28232530,905926527,True,5
9351,validator_27,272220240180,True,469400000,20583460,489983460,False,8
9352,validator_35,242432377830,True,553100000,9841040,562941040,False,7
9353,validator_17,528233248654,True,561980006,26647150,588627156,True,16
9354,validator_15,835191102634,True,834800002,4868170,839668172,True,26
9355,validator_17,528823308153,True,565059999,24999500,590059499,True,16
9356,validator_40,88154433860,True,578600000,2326500,580926500,False,2
9357,validator_34,759645297430,True,621600000,21215970,642815970,False,23
9358,validator_0,75563490267,True,739494009,28028740,767522749,True,2
9359,validator_36,253374974230,True,581600000,37875990,619475990,False,7
9360,validator_49,200247665060,True,610400000,1547290,611947290,False,6
9361,validator_36,253985829430,True,608100000,2755200,610855200,False,7
9362,validator_37,175418041190,True,525700000,20921130,546621130,False,5
9363,validator_48,487747527690,True,767500000,2654800,770154800,False,15
9364,validator_15,835697890705,True,479164001,27624070,506788071,True,26
9365,validator_15,836369914027,True,647600002,24423320,672023322,True,26
9366,validator_14,331316035123,True,916658004,22742200,939400204,True,10
9367,validator_44,255900738300,True,783900000,9842140,793742140,False,7
9368,validator_34,760379592350,True,726600000,7694920,734294920,False,23
9369,validator_48,488501883290,True,748200000,6155600,754355600,False,15
9370,validator_15,837146209142,True,767439995,8855120,776295115,True,26
9371,validator_36,254680247630,True,673500000,20918200,694418200,False,7
9372,validator_19,183390407786,True,573199996,6080140,579280136,True,5
9373,validator_14,332282849550,True,936499997,30314430,966814427,True,10
9374,validator_29,68719934450,True,594320000,37537330,631857330,False,2
9375,validator_27,272914737280,True,674600000,19897100,694497100,False,8
9376,validator_40,88861169810,True,705200000,1535950,706735950,False,2
9377,validator_19,183862425687,True,449140011,22877890,472017901,True,5
9378,validator_12,286158733571,True,714640002,11792800,726432802,True,8
9379,validator_17,529583732294,True,750440001,9984140,760424141,True,16
9380,validator_29,69484034750,True,754000000,10100300,764100300,False,2
9381,validator_19,184448138832,True,579319995,6393150,585713145,True,5
9382,validator_7,194831420999,True,820500001,7439740,827939741,True,6
9383,validator_44,256583803820,True,682500000,565520,683065520,False,8
9384,validator_12,287060270798,True,897199997,4337230,901537227,True,8
9385,validator_34,760902787330,True,519900000,3294980,523194980,False,23
9386,validator_15,837830777013,True,659440001,25127870,684567871,True,26
9387,validator_35,242907426230,True,453700000,21348400,475048400,False,7
9388,validator_49,201000018280,True,751300000,1053220,752353220,False,6
9389,validator_0,76129760764,True,557539997,8730500,566270497,True,2
9390,validator_11,72651282561,True,738674000,52372220,791046220,True,2
9391,validator_45,75036415470,True,665600000,1131140,666731140,False,2
9392,validator_30,157710604300,True,646500000,5439200,651939200,False,4
9393,validator_15,838373029259,True,514448006,27804240,542252246,True,26
9394,validator_7,195376082837,True,539119998,5541840,544661838,True,6
9395,validator_15,839178426513,True,777819994,27577260,805397254,True,26
9396,validator_31,444383760430,True,693100000,5608800,698708800,False,13
9397,validator_18,316457049608,True,856540001,17062400,873602401,True,9
9398,validator_48,489222794830,True,713800000,7111540,720911540,False,15
9399,validator_34,761473523720,True,554500000,16236390,570736390,False,23
9400,validator_31,445012453830,True,619800000,8893400,628693400,False,13
9401,validator_33,76355064720,True,395320000,2327220,397647220,False,2
9402,validator_44,257231054900,True,645300000,1951080,647251080,False,8
9403,validator_31,445657003950,True,641800000,2750120,644550120,False,13
9404,validator_2,77159716787,True,862239996,21791620,884031616,True,2
9405,validator_34,762090995830,True,596500000,20972110,617472110,False,23
9406,validator_14,332930921750,True,641100000,6972200,648072200,True,10
9407,validator_34,762651806510,True,551500000,9310680,560810680,False,23
9408,validator_44,257786806290,True,553900000,1851390,555751390,False,8
9409,validator_47,179227792270,True,645100000,25711770,670811770,False,5
9410,validator_37,176039041620,True,601400000,19600430,621000430,False,5
9411,validator_31,446171586880,True,486100000,28482930,514582930,False,13
9412,validator_44,258362966990,True,573500000,2660700,576160700,False,8
9413,validator_18,317233121960,True,774700002,1372350,776072352,True,9
9414,validator_48,489660853240,True,436000000,2058410,438058410,False,15
9415,validator_11,73340838498,True,664019997,25535940,689555937,True,2
9416,validator_17,530155657192,True,557219998,14704900,571924898,True,16
9417,validator_27,273500923460,True,566800000,19386180,586186180,False,8
9418,validator_49,201645983420,True,636300000,9665140,645965140,False,6
9419,validator_46,275645018270,True,647900000,1014090,648914090,False,8
9420,validator_34,763143045700,True,490000000,1239190,491239190,False,23
9421,validator_48,490171015260,True,508900000,1262020,510162020,False,15
9422,validator_1,189119816661,True,618779996,46661880,665441876,True,5
9423,validator_48,490823338860,True,649800000,2523600,652323600,False,15
9424,validator_45,75585487200,True,545400000,3671730,549071730,False,2
9425,validator_14,333519393783,True,567670003,20802030,588472033,True,10
9426,validator_31,446793122860,True,620400000,1135980,621535980,False,13
9427,validator_34,763787710600,True,623900000,20764900,644664900,False,23
9428,validator_16,81258173764,True,591339990,42266000,633605990,True,2
9429,validator_5,185322227427,True,639759996,27596400,667356396,True,5
9430,validator_29,70107898970,True,594900000,28964220,623864220,False,2
9431,validator_17,530933511454,True,773700002,4154260,777854262,True,16
9432,validator_13,88777697432,True,851660005,25336800,876996805,True,2
9433,validator_44,258929264540,True,557700000,8597550,566297550,False,8
9434,validator_30,158323044300,True,610900000,1540000,612440000,False,4
9435,validator_23,80116929143,True,575099994,35662960,610762954,True,2
9436,validator_12,287676500903,True,557880005,58350100,616230105,True,8
9437,validator_46,276107417250,True,458700000,3698980,462398980,False,8
9438,validator_48,491488833340,True,646600000,18894480,665494480,False,15
9439,validator_7,195988404874,True,601699997,10622040,612322037,True,6
9440,validator_15,839853670413,True,626960000,48283900,675243900,True,26
9441,validator_49,202351592100,True,703100000,2508680,705608680,False,6
9442,validator_34,764577897300,True,781400000,8786700,790186700,False,23
9443,validator_12,288445848503,True,757854000,11493600,769347600,True,9
9444,validator_43,159505065150,True,524400000,8953860,533353860,False,4
9445,validator_17,531567691179,True,573839995,60339730,634179725,True,16
9446,validator_48,492053437570,True,561200000,3404230,564604230,False,15
9447,validator_15,840562191841,True,700599998,7921430,708521428,True,26
9448,validator_30,158928038700,True,603550000,1444400,604994400,False,4
9449,validator_17,532086250778,True,515999999,2559600,518559599,True,16
9450,validator_48,492582296800,True,528000000,859230,528859230,False,15
9451,validator_26,71830945610,True,622900000,8949220,631849220,False,2
9452,validator_22,198499116124,True,641140001,52167010,693307011,True,6
9453,validator_11,73982508001,True,616920003,24749500,641669503,True,2
9454,validator_21,186730532122,True,714589997,24228430,738818427,True,5
9455,validator_34,765440361350,True,841800000,20664050,862464050,False,23
9456,validator_49,202873349730,True,518400000,3357630,521757630,False,6
9457,validator_17,532765312522,True,668519994,10541750,679061744,True,16
9458,validator_1,189916098098,True,754196007,42085430,796281437,True,5
9459,validator_0,76670672011,True,503799997,37111250,540911247,True,2
9460,validator_7,196563706175,True,542800001,32501300,575301301,True,6
9461,validator_17,533278868322,True,506540000,7015800,513555800,True,16
9462,validator_3,90480162241,True,719021994,19170490,738192484,True,2
9463,validator_34,766084093400,True,634700000,9032050,643732050,False,23
9464,validator_40,89386981010,True,511800000,14011200,525811200,False,2
9465,validator_15,841163573416,True,598600005,2781570,601381575,True,26
9466,validator_15,841815852059,True,649300003,2978640,652278643,True,26
9467,validator_23,80741768847,True,598580004,26259700,624839704,True,2
9468,validator_0,77425053697,True,706499996,47881690,754381686,True,2
9469,validator_12,289325322407,True,854660004,24813900,879473904,True,9
9470,validator_37,176577973120,True,532000000,6931500,538931500,False,5
9471,validator_41,186382071020,True,577700000,1754640,579454640,False,5
9472,validator_12,290184380822,True,851639995,7418420,859058415,True,9
9473,validator_26,72508055530,True,658400000,18709920,677109920,False,2
9474,validator_27,274126703600,True,614800000,10980140,625780140,False,8
9475,validator_14,334263949523,True,734500000,10055740,744555740,True,10
9476,validator_34,766628389100,True,539400000,4895700,544295700,False,23
9477,validator_44,259508090570,True,572400000,6426030,578826030,False,8
9478,validator_27,274648674600,True,518500000,3471000,521971000,False,8
9479,validator_17,533800497566,True,515000004,6629240,521629244,True,16
9480,validator_27,275526458990,True,870500000,7284390,877784390,False,8
9481,validator_27,276213669720,True,671000000,16210730,687210730,False,8
9482,validator_18,317969567549,True,711393999,25051590,736445589,True,9
9483,validator_49,203501823270,True,627100000,1373540,628473540,False,6
9484,validator_21,187496045047,True,733540005,31972920,765512925,True,5
9485,validator_46,276672873510,True,534100000,31356260,565456260,False,8
9486,validator_0,78133238181,True,699820004,8364480,708184484,True,2
9487,validator_16,82050677462,True,743721998,48781700,792503698,True,2
9488,validator_21,188143004378,True,632640001,14319330,646959331,True,5
9489,validator_29,70875424370,True,751500000,16025400,767525400,False,2
9490,validator_17,534206359497,True,380940001,24921930,405861931,True,16
9491,validator_15,842462500987,True,640119998,6528930,646648928,True,26
9492,validator_14,334971560330,True,659050007,48560800,707610807,True,10
9493,validator_31,447391187500,True,596700000,1364640,598064640,False,13
9494,validator_7,197087015518,True,495960003,27349340,523309343,True,6
9495,validator_15,843305404280,True,797979993,44923300,842903293,True,26
9496,validator_36,255358939690,True,667300000,11392060,678692060,False,7
9497,validator_19,185101586926,True,625639994,27808100,653448094,True,5
9498,validator_15,844030879744,True,722499994,2975470,725475464,True,26
9499,validator_34,767388992940,True,741200000,19403840,760603840,False,23
9500,validator_35,243280218930,True,363100000,9692700,372792700,False,7
9501,validator_47,179934248500,True,687500000,18956230,706456230,False,5
9502,validator_47,180671321620,True,731200000,5873120,737073120,False,5
9503,validator_0,78899144249,True,713499998,52406070,765906068,True,2
9504,validator_18,318637742160,True,648570001,19604610,668174611,True,9
9505,validator_14,335569896130,True,572286000,26049800,598335800,True,10
9506,validator_5,185980915373,True,647600006,11087940,658687946,True,5
9507,validator_28,74406075030,True,803000000,1781770,804781770,False,2
9508,validator_28,74894470830,True,462500000,25895800,488395800,False,2
9509,validator_19,185847259627,True,734700001,10972700,745672701,True,5
9510,validator_48,493036809790,True,451490000,3022990,454512990,False,15
9511,validator_27,276668084910,True,451500000,2915190,454415190,False,8
9512,validator_15,844559440381,True,509719997,18840640,528560637,True,26
9513,validator_19,186463103928,True,591888001,23956300,615844301,True,5
9514,validator_49,203954002770,True,450600000,1579500,452179500,False,6
9515,validator_27,277235721010,True,565000000,2636100,567636100,False,8
9516,validator_13,89469388372,True,638640000,53050940,691690940,True,2
9517,validator_28,75487182130,True,584000000,8711300,592711300,False,2
9518,validator_47,181289179650,True,608000000,9858030,617858030,False,5
9519,validator_47,181806699180,True,516300000,1219530,517519530,False,5
9520,validator_31,448033570800,True,633700000,8683300,642383300,False,14
9521,validator_7,197791350396,True,687046008,17288870,704334878,True,6
9522,validator_14,336084057067,True,483256007,30904930,514160937,True,10
9523,validator_31,448507564180,True,473200000,793380,473993380,False,14
9524,validator_35,243920487760,True,636600000,3668830,640268830,False,7
9525,validator_22,199107505254,True,568740000,39649130,608389130,True,6
9526,validator_14,336672211949,True,585260002,2894880,588154882,True,10
9527,validator_49,204598939900,True,641900000,3037130,644937130,False,6
9528,validator_48,493513676630,True,473700000,3166840,476866840,False,15
9529,validator_47,182241966150,True,434100000,1166970,435266970,False,5
9530,validator_33,77179654960,True,821800000,2790240,824590240,False,2
9531,validator_31,449277226560,True,759600000,10062380,769662380,False,14
9532,validator_45,76246664640,True,640100000,21077440,661177440,False,2
9533,validator_26,73081026400,True,561900000,11070870,572970870,False,2
9534,validator_48,494240455940,True,715300000,11479310,726779310,False,15
9535,validator_15,845131263045,True,526340004,45482660,571822664,True,26
9536,validator_31,449862710840,True,583900000,1584280,585484280,False,14
9537,validator_15,845913232389,True,761900004,20069340,781969344,True,26
9538,validator_28,76189906630,True,699700000,3024500,702724500,False,2
9539,validator_36,256103465230,True,735900000,8625540,744525540,False,8
9540,validator_12,290931699466,True,730800004,16518640,747318644,True,9
9541,validator_44,260148536630,True,637900000,2546060,640446060,False,8
9542,validator_34,768007581040,True,616300000,2288100,618588100,False,24
9543,validator_31,450505727940,True,615800000,27217100,643017100,False,14
9544,validator_48,494938973180,True,690900000,7617240,698517240,False,15
9545,validator_31,451168510270,True,642900000,19882330,662782330,False,14
9546,validator_36,256691778590,True,581100000,7213360,588313360,False,8
9547,validator_35,244719143510,True,779000000,19655750,798655750,False,7
9548,validator_22,200062294351,True,926799997,27989100,954789097,True,6
9549,validator_36,257262419630,True,559300000,11341040,570641040,False,8
9550,validator_41,186927335760,True,543800000,1464740,545264740,False,5
9551,validator_14,337290551536,True,604419997,13919590,618339587,True,10
9552,validator_27,277961032340,True,723600000,1711330,725311330,False,8
9553,validator_31,451807149900,True,636000000,2639630,638639630,False,14
9554,validator_17,534933217127,True,697820000,29037630,726857630,True,16
9555,validator_18,319451207834,True,787280004,26185670,813465674,True,9
9556,validator_43,160152027930,True,645600000,1362780,646962780,False,5
9557,validator_27,278548470240,True,554300000,33137900,587437900,False,8
9558,validator_18,320094422439,True,593680005,49534600,643214605,True,10
9559,validator_43,160845903970,True,673900000,19976040,693876040,False,5
9560,validator_12,291811648124,True,863519998,16428660,879948658,True,9
9561,validator_43,161640112870,True,792600000,1608900,794208900,False,5
9562,validator_19,187208049210,True,742700002,2245280,744945282,True,5
9563,validator_32,66144970740,True,467400000,3616780,471016780,False,2
9564,validator_34,768639417470,True,629600000,2236430,631836430,False,24
9565,validator_11,74592382043,True,575406002,34468040,609874042,True,2
9566,validator_17,535665162680,True,707839993,24105560,731945553,True,16
9567,validator_48,495601440350,True,659700000,2767170,662467170,False,15
9568,validator_48,496406485680,True,796700000,8345330,805045330,False,15
9569,validator_23,81405988144,True,642979997,21239300,664219297,True,2
9570,validator_42,63357032750,True,559600000,1233500,560833500,False,1
9571,validator_44,260973635770,True,822200000,2899140,825099140,False,8
9572,validator_30,159640279700,True,675400000,36841000,712241000,False,4
9573,validator_48,496941691280,True,533500000,1705600,535205600,False,15
9574,validator_4,68647823988,True,535239994,3281080,538521074,True,2
9575,validator_47,182890066210,True,645300000,2800060,648100060,False,5
9576,validator_7,198700187720,True,898364004,10473320,908837324,True,6
9577,validator_37,177162766320,True,582100000,2693200,584793200,False,5
9578,validator_49,205390131060,True,771200000,19991160,791191160,False,6
9579,validator_43,162242918910,True,592800000,10006040,602806040,False,5
9580,validator_22,200744431658,True,680499997,1637310,682137307,True,6
9581,validator_19,187980361394,True,770000004,2312180,772312184,True,5
9582,validator_34,769388708090,True,727300000,21990620,749290620,False,24
9583,validator_3,91330303829,True,818100008,32041580,850141588,True,2
9584,validator_23,82017065555,True,602200001,8877410,611077411,True,2
9585,validator_27,279194935240,True,633600000,12865000,646465000,False,8
9586,validator_37,178015821950,True,846800000,6255630,853055630,False,5
9587,validator_5,186646950104,True,654400001,11634730,666034731,True,5
9588,validator_9,85770387379,True,576560000,36027440,612587440,True,2
9589,validator_31,452437462320,True,626900000,3412420,630312420,False,14
9590,validator_1,190536913970,True,601500002,19315870,620815872,True,5
9591,validator_10,93097708362,True,622659999,27255290,649915289,True,2
9592,validator_44,261597480740,True,601920000,21924970,623844970,False,8
9593,validator_17,536265672484,True,589000004,11509800,600509804,True,16
9594,validator_14,338005052439,True,705140003,9360900,714500903,True,10
9595,validator_15,846610513090,True,662420001,34860700,697280701,True,26
9596,validator_48,497652565410,True,707100000,3774130,710874130,False,15
9597,validator_45,76804876140,True,556000000,2211500,558211500,False,2
9598,validator_11,75451266449,True,855100006,3784400,858884406,True,2
9599,validator_44,262126673970,True,521600000,7593230,529193230,False,8
9600,validator_10,93938316853,True,825399991,15208500,840608491,True,2
9601,validator_34,770165378130,True,767900000,8770040,776670040,False,24
9602,validator_31,453085481480,True,646100000,1919160,648019160,False,14
9603,validator_28,76715987530,True,520950000,5130900,526080900,False,2
9604,validator_34,770806905450,True,630400000,11127320,641527320,False,24
9605,validator_30,160132696940,True,472300000,20117240,492417240,False,5
9606,validator_3,92101636828,True,753239999,18093000,771332999,True,2
9607,validator_17,536693695327,True,400120003,27902840,428022843,True,16
9608,validator_37,178463494880,True,444700000,2972930,447672930,False,5
9609,validator_31,453565992780,True,472900000,7611300,480511300,False,14
9610,validator_15,847310053527,True,668464007,31076430,699540437,True,26
9611,validator_2,77838817924,True,655205997,23895140,679101137,True,2
9612,validator_15,847852431088,True,532660001,9717560,542377561,True,26
9613,validator_15,848360614391,True,499100003,9083300,508183303,True,26
9614,validator_22,201417267797,True,655813999,17022140,672836139,True,6
9615,validator_44,262709869490,True,581600000,1595520,583195520,False,8
9616,validator_3,92546570566,True,421385998,23547740,444933738,True,2
9617,validator_4,69194622974,True,538140006,8658980,546798986,True,2
9618,validator_14,338619516668,True,591639999,22824230,614464229,True,10
9619,validator_14,339365783725,True,725740007,20527050,746267057,True,10
9620,validator_31,454088603210,True,519900000,2710430,522610430,False,14
9621,validator_2,78608641308,True,739299994,30523390,769823384,True,2
9622,validator_15,848987693833,True,604940002,22139440,627079442,True,26
9623,validator_45,77332051320,True,525000000,2175180,527175180,False,2
9624,validator_47,183489207920,True,594400000,4741710,599141710,False,5
9625,validator_44,263244595230,True,513770000,20955740,534725740,False,8
9626,validator_44,264000564850,True,733100000,22869620,755969620,False,8
9627,validator_38,77617541760,True,555900000,2751740,558651740,False,2
9628,validator_47,183919835980,True,423800000,6828060,430628060,False,5
9629,validator_11,75897988732,True,408539993,38182290,446722283,True,2
9630,validator_15,849520012951,True,525939998,6379120,532319118,True,26
9631,validator_45,78121427260,True,787600000,1775940,789375940,False,2
9632,validator_38,78397093960,True,778300000,1252200,779552200,False,2
9633,validator_15,850176828820,True,648019999,8795870,656815869,True,26
9634,validator_9,86472285652,True,672460003,29438270,701898273,True,2
9635,validator_17,537377505565,True,673100008,10710230,683810238,True,16
9636,validator_3,93241423794,True,691900008,2953220,694853228,True,2
9637,validator_30,160805414740,True,670000000,2717800,672717800,False,5
9638,validator_18,320851193763,True,740160004,16611320,756771324,True,10
9639,validator_27,279969494380,True,770800000,3759140,774559140,False,8
9640,validator_35,245217324560,True,480400000,17781050,498181050,False,7
9641,validator_48,498294640430,True,639800000,2275020,642075020,False,15
9642,validator_48,498770828810,True,474600000,1588380,476188380,False,15
9643,validator_17,538121587704,True,694249999,49832140,744082139,True,16
9644,validator_44,264572092510,True,569100000,2427660,571527660,False,8
9645,validator_20,82387811906,True,753400004,4534710,757934714,True,2
9646,validator_27,280636829380,True,647800000,19535000,667335000,False,8
9647,validator_8,73835630717,True,623639999,23130540,646770539,True,2
9648,validator_43,162885953550,True,640000000,3034640,643034640,False,5
9649,validator_34,771524859530,True,715300000,2654080,717954080,False,24
9650,validator_1,191162359464,True,622899994,2545500,625445494,True,5
9651,validator_15,850907403427,True,692460007,38114600,730574607,True,26
9652,validator_15,851549780895,True,640699998,1677470,642377468,True,26
9653,validator_12,292592382122,True,773839998,6894000,780733998,True,9
9654,validator_46,277308576190,True,632700000,3002680,635702680,False,8
9655,validator_21,189192861213,True,1023984005,25872830,1049856835,True,5
9656,validator_18,321517112636,True,643679993,22238880,665918873,True,10
9657,validator_28,77402903730,True,667100000,19816200,686916200,False,2
9658,validator_12,293292722254,True,679366002,20974130,700340132,True,9
9659,validator_9,87239419880,True,729179998,37954230,767134228,True,2
9660,validator_25,85613555780,True,630300000,4500240,634800240,False,2
9661,validator_48,499226437690,True,450200000,5408880,455608880,False,15
9662,validator_11,76575531635,True,639560003,37982900,677542903,True,2
9663,validator_45,78873560000,True,732200000,19932740,752132740,False,2
9664,validator_31,454539694730,True,447900000,3191520,451091520,False,14
9665,validator_27,281098619530,True,452000000,9790150,461790150,False,8
9666,validator_15,852215016091,True,637199996,28035200,665235196,True,26
9667,validator_37,179049769880,True,575900000,10375000,586275000,False,5
9668,validator_17,538723215464,True,572780000,28847760,601627760,True,16
9669,validator_27,281622548380,True,523000000,928850,523928850,False,8
9670,validator_15,853041212214,True,820300003,5896120,826196123,True,26
9671,validator_12,294002831551,True,670899997,39209300,710109297,True,9
9672,validator_32,66671735030,True,524400000,2364290,526764290,False,2
9673,validator_30,161416118640,True,604110000,6593900,610703900,False,5
9674,validator_34,772196157840,True,668900000,2398310,671298310,False,24
9675,validator_31,455041621030,True,495300000,6626300,501926300,False,14
9676,validator_18,322132976487,True,599900001,15963850,615863851,True,10
9677,validator_34,772810517740,True,605900000,8459900,614359900,False,24
9678,validator_14,340409384804,True,1005719999,37881080,1043601079,True,10
9679,validator_48,500047731730,True,800500000,20794040,821294040,False,15
9680,validator_48,500653613610,True,604200000,1681880,605881880,False,15
9681,validator_15,853832716717,True,784280003,7224500,791504503,True,26
9682,validator_15,854482725422,True,590380005,59628700,650008705,True,26
9683,validator_43,163483274990,True,588800000,8521440,597321440,False,5
9684,validator_37,179516555080,True,463900000,2885200,466785200,False,5
9685,validator_34,773422420520,True,609900000,2002780,611902780,False,24
9686,validator_44,265238709410,True,662800000,3816900,666616900,False,8
9687,validator_49,205988565050,True,597000000,1433990,598433990,False,6
9688,validator_38,78965950620,True,549100000,19756660,568856660,False,2
9689,validator_13,90064791872,True,588300000,7103500,595403500,True,2
9690,validator_15,855385233887,True,881219995,21288470,902508465,True,26
9691,validator_14,341111383497,True,674519993,27478700,701998693,True,10
9692,validator_26,73685364980,True,593400000,10938580,604338580,False,2
9693,validator_34,773930184800,True,505300000,2464280,507764280,False,24
9694,validator_25,86035626870,True,413300000,8771090,422071090,False,2
9695,validator_14,341916877189,True,756659992,48833700,805493692,True,10
9696,validator_15,856172254085,True,766639998,20380200,787020198,True,26
9697,validator_18,322716498386,True,573493999,10027900,583521899,True,10
9698,validator_17,539244609238,True,508899994,12493780,521393774,True,16
9699,validator_49,206551801050,True,561800000,1436000,563236000,False,6
9700,validator_19,188562584816,True,579700002,2523420,582223422,True,5
9701,validator_27,282352567110,True,710100000,19918730,730018730,False,8
9702,validator_15,856896480966,True,719399991,4826890,724226881,True,26
9703,validator_22,202129272596,True,687719999,24284800,712004799,True,6
9704,validator_36,257876071630,True,612000000,1652000,613652000,False,8
9705,validator_33,77958817400,True,777300000,1862440,779162440,False,2
9706,validator_14,342539764081,True,619599992,3286900,622886892,True,10
9707,validator_17,540026601240,True,757440002,24552000,781992002,True,16
9708,validator_43,163920976990,True,435200000,2502000,437702000,False,5
9709,validator_15,857708503579,True,785399993,26622620,812022613,True,26
9710,validator_5,187339816214,True,690800000,2066110,692866110,True,5
9711,validator_27,282943412290,True,588600000,2245180,590845180,False,8
9712,validator_35,245686336940,True,465300000,3712380,469012380,False,7
9713,validator_48,501322554140,True,665000000,3940530,668940530,False,15
9714,validator_14,343212868376,True,664640005,8464290,673104295,True,10
9715,validator_34,774583889300,True,650300000,3404500,653704500,False,24
9716,validator_23,82683733982,True,657499997,9168430,666668427,True,2
9717,validator_15,858479220177,True,748139998,22576600,770716598,True,26
9718,validator_17,540659226817,True,610239997,22385580,632625577,True,16
9719,validator_24,94502732888,True,697643995,11711110,709355105,True,2
9720,validator_48,501849824950,True,525600000,1670810,527270810,False,15
9721,validator_27,283679371910,True,716300000,19659620,735959620,False,8
9722,validator_46,277905262720,True,594100000,2586530,596686530,False,8
9723,validator_49,207136602490,True,565500000,19301440,584801440,False,6
9724,validator_34,775219288170,True,608700000,26698870,635398870,False,24
9725,validator_5,188231575710,True,870279996,21479500,891759496,True,5
9726,validator_28,77859483150,True,454300000,2279420,456579420,False,2
9727,validator_15,859090391557,True,549740000,61431380,611171380,True,26
9728,validator_48,502653615420,True,799700000,4090470,803790470,False,15
9729,validator_37,180132936940,True,614300000,2081860,616381860,False,5
9730,validator_16,82984239957,True,871084005,62478490,933562495,True,2
9731,validator_34,775709278270,True,463000000,26990100,489990100,False,24
9732,validator_2,79401329844,True,761080006,31608530,792688536,True,2
9733,validator_45,79522267720,True,645200000,3507720,648707720,False,2
9734,validator_41,187537357060,True,605300000,4721300,610021300,False,5
9735,validator_31,455800925350,True,752100000,7204320,759304320,False,14
9736,validator_12,294896017569,True,877468008,15718010,893186018,True,9
9737,validator_35,246248719750,True,523700000,38682810,562382810,False,7
9738,validator_20,83186265537,True,771139991,27313640,798453631,True,2
9739,validator_25,86692712610,True,642200000,14885740,657085740,False,2
9740,validator_18,323229080389,True,498200003,14382000,512582003,True,10
9741,validator_17,541087480611,True,422739994,5513800,428253794,True,16
9742,validator_30,161947144080,True,528700000,2325440,531025440,False,5
9743,validator_14,343695993595,True,470169999,12955220,483125219,True,10
9744,validator_15,859605363678,True,510300011,4672110,514972121,True,26
9745,validator_2,80146450438,True,713169994,31950600,745120594,True,2
9746,validator_17,541609068354,True,510740003,10847740,521587743,True,16
9747,validator_34,776379257250,True,664300000,5678980,669978980,False,24
9748,validator_49,207897272270,True,758300000,2369780,760669780,False,6
9749,validator_4,69956078338,True,733299994,28155370,761455364,True,2
9750,validator_43,164529307250,True,602800000,5530260,608330260,False,5
9751,validator_24,95215484188,True,708500000,4251300,712751300,True,2
9752,validator_48,503251716120,True,594300000,3800700,598100700,False,15
9753,validator_48,503971587010,True,718400000,1470890,719870890,False,15
9754,validator_8,74369520513,True,496595996,37293800,533889796,True,2
9755,validator_46,278447874730,True,540100000,2512010,542612010,False,8
9756,validator_7,199137495880,True,435300000,2008160,437308160,True,6
9757,validator_20,84061173193,True,865699996,9207660,874907656,True,2
9758,validator_43,165183787670,True,645500000,8980420,654480420,False,5
9759,validator_46,278850978630,True,400900000,2203900,403103900,False,8
9760,validator_1,191800243642,True,610139998,27744180,637884178,True,5
9761,validator_15,860429208227,True,814080009,9764540,823844549,True,26
9762,validator_48,504517352800,True,542900000,2865790,545765790,False,15
9763,validator_17,542169366372,True,521620008,38678010,560298018,True,16
9764,validator_44,265733375630,True,491400000,3266220,494666220,False,8
9765,validator_40,89956335500,True,566200000,3154490,569354490,False,2
9766,validator_17,543282117467,True,1046919995,65831100,1112751095,True,16
9767,validator_19,189328333945,True,735419999,30329130,765749129,True,5
9768,validator_43,165826531220,True,616600000,26143550,642743550,False,5
9769,validator_9,87910997139,True,643423999,28153260,671577259,True,2
9770,validator_35,246787454470,True,536040000,2694720,538734720,False,7
9771,validator_18,323877001531,True,645560002,2361140,647921142,True,10
9772,validator_35,247521731710,True,732000000,2277240,734277240,False,7
9773,validator_21,190067052930,True,847519997,26671720,874191717,True,5
9774,validator_37,180667210520,True,530800000,3473580,534273580,False,5
9775,validator_1,192578637584,True,754420002,23973940,778393942,True,6
9776,validator_2,80856185958,True,708800000,935520,709735520,True,2
9777,validator_34,777058541150,True,677400000,1883900,679283900,False,24
9778,validator_46,279306395470,True,454150000,1266840,455416840,False,8
9779,validator_30,162630623380,True,681800000,1679300,683479300,False,5
9780,validator_34,777787587560,True,722700000,6346410,729046410,False,24
9781,validator_34,778321629590,True,514180000,19862030,534042030,False,24
9782,validator_40,90536063880,True,574600000,5128380,579728380,False,2
9783,validator_40,90944834210,True,406400000,2370330,408770330,False,2
9784,validator_15,861136158363,True,680399996,26550140,706950136,True,26
9785,validator_36,258733209770,True,854600000,2538140,857138140,False,8
9786,validator_35,247948475500,True,424200000,2543790,426743790,False,7
9787,validator_17,544042022992,True,736479995,23425530,759905525,True,17
9788,validator_34,778757021700,True,433100000,2292110,435392110,False,24
9789,validator_43,166422581120,True,592100000,3949900,596049900,False,5
9790,validator_7,199920794264,True,769420004,13878380,783298384,True,6
9791,validator_15,861903550151,True,723839998,43551790,767391788,True,26
9792,validator_49,208529128670,True,610500000,21356400,631856400,False,6
9793,validator_37,181244835850,True,574200000,3425330,577625330,False,5
9794,validator_27,284330382580,True,644800000,6210670,651010670,False,8
9795,validator_31,456301227450,True,498900000,1402100,500302100,False,14
9796,validator_14,344392720577,True,678884002,17842980,696726982,True,10
9797,validator_41,188352737300,True,813300000,2080240,815380240,False,5
9798,validator_48,505112901550,True,585700000,9848750,595548750,False,15
9799,validator_46,279820517870,True,505800000,8322400,514122400,False,8
9800,validator_43,167009284450,True,584400000,2303330,586703330,False,5
9801,validator_14,345163182376,True,768699999,1761800,770461799,True,10
9802,validator_17,544768948271,True,713519999,13405280,726925279,True,17
9803,validator_41,188981220830,True,624300000,4183530,628483530,False,5
9804,validator_22,203070129034,True,903257998,37598440,940856438,True,6
9805,validator_34,779330325660,True,566800000,6503960,573303960,False,24
9806,validator_49,209131579400,True,587200000,15250730,602450730,False,6
9807,validator_4,70651148969,True,631540001,63530630,695070631,True,2
9808,validator_14,346013630895,True,841699999,8748520,850448519,True,10
9809,validator_18,324709857132,True,809440001,23415600,832855601,True,10
9810,validator_18,325455464333,True,722160001,23447200,745607201,True,10
9811,validator_12,295729369005,True,771320006,62031430,833351436,True,9
9812,validator_11,77095206937,True,503840002,15835300,519675302,True,2
9813,validator_31,457012402530,True,694900000,16275080,711175080,False,14
9814,validator_10,94522172590,True,563379997,20475740,583855737,True,2
9815,validator_15,862824523567,True,880179996,40793420,920973416,True,26
9816,validator_34,779912418060,True,577600000,4492400,582092400,False,24
9817,validator_28,78329582490,True,467500000,2599340,470099340,False,2
9818,validator_31,457823471930,True,808900000,2169400,811069400,False,14
9819,validator_44,266348013260,True,610700000,3937630,614637630,False,8
9820,validator_47,184495929140,True,572400000,3693160,576093160,False,5
9821,validator_19,189837986521,True,478779996,30872580,509652576,True,5
9822,validator_34,780375419290,True,461000000,2001230,463001230,False,24
9823,validator_5,188957514164,True,715620004,10318450,725938454,True,5
9824,validator_27,284998861890,True,666400000,2079310,668479310,False,8
9825,validator_7,200545230606,True,591200002,33236340,624436342,True,6
9826,validator_48,505709733230,True,594700000,2131680,596831680,False,15
9827,validator_44,267048181290,True,697600000,2568030,700168030,False,8
9828,validator_35,248692165080,True,728200000,15489580,743689580,False,7
9829,validator_15,863301711763,True,462099996,15088200,477188196,True,26
9830,validator_35,249175334520,True,481000000,2169440,483169440,False,7
9831,validator_14,346913172186,True,875600001,23941290,899541291,True,10
9832,validator_49,209701944100,True,560500000,9864700,570364700,False,6
9833,validator_40,91751230550,True,799300000,7096340,806396340,False,2
9834,validator_2,81656969286,True,759639998,41143330,800783328,True,2
9835,validator_16,83746956036,True,742573999,20142080,762716079,True,2
9836,validator_37,182052325720,True,793200000,14289870,807489870,False,5
9837,validator_45,80154844220,True,629900000,2676500,632576500,False,2
9838,validator_28,78776488430,True,427400000,19505940,446905940,False,2
9839,validator_15,864428635886,True,1090440003,36484120,1126924123,True,27
9840,validator_17,545226511777,True,445736006,11827500,457563506,True,17
9841,validator_31,458179010620,True,354300000,1238690,355538690,False,14
9842,validator_27,285541282590,True,521200000,21220700,542420700,False,8
9843,validator_48,506209896210,True,498200000,1962980,500162980,False,15
9844,validator_28,79280604550,True,485000000,19116120,504116120,False,2
9845,validator_17,546025853048,True,779340001,20001270,799341271,True,17
9846,validator_8,74942788745,True,564268002,9000230,573268232,True,2
9847,validator_46,280448772500,True,624000000,4254630,628254630,False,8
9848,validator_18,326219619272,True,749219999,14934940,764154939,True,10
9849,validator_44,267758195520,True,683500000,26514230,710014230,False,8
9850,validator_18,327097492911,True,853239999,24633640,877873639,True,10
9851,validator_15,865043469277,True,613499991,1333400,614833391,True,27
9852,validator_5,189722400393,True,741244009,23642220,764886229,True,5
9853,validator_34,781034766000,True,657100000,2246710,659346710,False,24
9854,validator_48,506745134480,True,527100000,8138270,535238270,False,15
9855,validator_10,95140363765,True,598279995,19911180,618191175,True,2
9856,validator_36,259259607470,True,518500000,7897700,526397700,False,8
9857,validator_15,865756604478,True,678320001,34815200,713135201,True,27
9858,validator_34,781632683660,True,589100000,8817660,597917660,False,24
9859,validator_42,64000357680,True,623500000,19824930,643324930,False,2
9860,validator_49,210237421590,True,526300000,9177490,535477490,False,6
9861,validator_15,866453896379,True,694900001,2391900,697291901,True,27
9862,validator_27,286087863030,True,545200000,1380440,546580440,False,8
9863,validator_41,189557142360,True,570600000,5321530,575921530,False,5
9864,validator_19,190359548916,True,504143995,17418400,521562395,True,5
9865,validator_18,327684419603,True,574796002,12130690,586926692,True,10
9866,validator_15,867281112759,True,801858000,25358380,827216380,True,27
9867,validator_21,190640986133,True,569270003,4663200,573933203,True,5
9868,validator_46,281054077200,True,602000000,3304700,605304700,False,8
9869,validator_48,507350475110,True,603600000,1740630,605340630,False,15
9870,validator_15,867864062898,True,559439999,23510140,582950139,True,27
9871,validator_27,286632139610,True,535800000,8476580,544276580,False,8
9872,validator_34,782192685460,True,558800000,1201800,560001800,False,24
9873,validator_19,190977553711,True,612939995,5064800,618004795,True,5
9874,validator_15,868467705701,True,599500003,4142800,603642803,True,27
9875,validator_33,78496575930,True,534400000,3358530,537758530,False,2
9876,validator_33,79115956850,True,610500000,8880920,619380920,False,2
9877,validator_17,546592869975,True,538159997,28856930,567016927,True,17
9878,validator_17,547326313904,True,692539999,40903930,733443929,True,17
9879,validator_34,782674716800,True,478200000,3831340,482031340,False,24
9880,validator_18,328391076495,True,651007992,55648900,706656892,True,10
9881,validator_42,64456587610,True,453100000,3129930,456229930,False,2
9882,validator_17,548112159402,True,759999998,25845500,785845498,True,17
9883,validator_41,190083529380,True,523470000,2917020,526387020,False,5
9884,validator_18,329170575495,True,736000000,43499000,779499000,True,10
9885,validator_1,193225421984,True,642460000,4324400,646784400,True,6
9886,validator_12,296421502111,True,636699996,55433110,692133106,True,9
9887,validator_48,507993482790,True,639800000,3207680,643007680,False,15
9888,validator_14,347760299879,True,834199993,12927700,847127693,True,10
9889,validator_15,869068950637,True,583139996,18104940,601244936,True,27
9890,validator_27,287304521420,True,669600000,2781810,672381810,False,8
9891,validator_48,508551025340,True,547800000,9742550,557542550,False,15
9892,validator_20,84582132790,True,492039997,28919600,520959597,True,2
9893,validator_10,95790152308,True,589540003,60248540,649788543,True,2
9894,validator_46,281559318230,True,502300000,2941030,505241030,False,8
9895,validator_5,190595013191,True,851179998,21432800,872612798,True,5
9896,validator_15,869579164331,True,500079994,10133700,510213694,True,27
9897,validator_47,185059749280,True,561500000,2320140,563820140,False,5
9898,validator_34,783266322520,True,589500000,2105720,591605720,False,24
9899,validator_18,329759988003,True,552200008,37212500,589412508,True,10
9900,validator_48,509180169480,True,621400000,7744140,629144140,False,15
9901,validator_46,282056553110,True,493180000,4054880,497234880,False,8
9902,validator_48,509804203180,True,621300000,2733700,624033700,False,15
9903,validator_47,185723187300,True,652700000,10738020,663438020,False,5
9904,validator_12,297230731110,True,785745999,23483000,809228999,True,9
9905,validator_31,458833898960,True,654100000,788340,654888340,False,14
9906,validator_15,870152086280,True,566697999,6223950,572921949,True,27
9907,validator_15,870747952973,True,552140003,43726690,595866693,True,27
9908,validator_15,871764083748,True,977140005,38990770,1016130775,True,27
9909,validator_27,287857171210,True,549400000,3249790,552649790,False,8
9910,validator_31,459337569360,True,501600000,2070400,503670400,False,14
9911,validator_18,330386326398,True,575959995,50378400,626338395,True,10
9912,validator_15,872267197652,True,494100004,9013900,503113904,True,27
9913,validator_11,77842765443,True,745200006,2358500,747558506,True,2
9914,validator_46,282813706410,True,755600000,1553300,757153300,False,8
9915,validator_3,93833890837,True,561300003,31167040,592467043,True,2
9916,validator_12,298006531867,True,773599997,2200760,775800757,True,9
9917,validator_15,872901596195,True,592400003,41998540,634398543,True,27
9918,validator_30,163109279760,True,477350000,1306380,478656380,False,5
9919,validator_37,182678621040,True,615400000,10895320,626295320,False,5
9920,validator_3,94726322634,True,870919997,21511800,892431797,True,2
9921,validator_34,783848743580,True,571600000,10821060,582421060,False,24
9922,validator_37,183229383280,True,548300000,2462240,550762240,False,5
9923,validator_15,873689820068,True,778360003,9863870,788223873,True,27
9924,validator_40,92461204170,True,706300000,3673620,709973620,False,2
9925,validator_0,79559562154,True,638599995,21817910,660417905,True,2
9926,validator_27,288425620270,True,551000000,17449060,568449060,False,9
9927,validator_17,548874947637,True,747360005,15428230,762788235,True,17
9928,validator_30,163539477840,True,428070000,2128080,430198080,False,5
9929,validator_48,510351529740,True,545800000,1526560,547326560,False,15
9930,validator_47,186295884760,True,568400000,4297460,572697460,False,5
9931,validator_34,784396515430,True,526770000,21001850,547771850,False,24
9932,validator_34,784989288590,True,589600000,3173160,592773160,False,24
9933,validator_26,74349384810,True,653000000,11019830,664019830,False,2
9934,validator_31,459905132300,True,565700000,1862940,567562940,False,14
9935,validator_31,460594541750,True,670300000,19109450,689409450,False,14
9936,validator_14,348441647779,True,619040000,62307900,681347900,True,10
9937,validator_27,289090050260,True,643100000,21329990,664429990,False,9
9938,validator_7,201392788971,True,814419995,33138370,847558365,True,6
9939,validator_44,268222364050,True,444400000,19768530,464168530,False,8
9940,validator_31,461108373670,True,510730000,3101920,513831920,False,14
9941,validator_13,90761300149,True,682359997,14148280,696508277,True,2
9942,validator_20,85186281979,True,585899999,18249190,604149189,True,2
9943,validator_40,93298977880,True,834700000,3073710,837773710,False,2
9944,validator_42,65122326910,True,664500000,1239300,665739300,False,2
9945,validator_41,190682491880,True,590700000,8262500,598962500,False,5
9946,validator_5,191408822023,True,810399992,3408840,813808832,True,5
9947,validator_32,67189765270,True,504200000,13830240,518030240,False,2
9948,validator_21,191594442005,True,950300002,3155870,953455872,True,5
9949,validator_22,203687082730,True,603519996,13433700,616953696,True,6
9950,validator_15,874249771646,True,536479998,23471580,559951578,True,27
9951,validator_30,164238241860,True,695600000,3164020,698764020,False,5
9952,validator_30,164924172330,True,670500000,15430470,685930470,False,5
9953,validator_34,785544894450,True,551800000,3805860,555605860,False,24
9954,validator_43,167498020740,True,487100000,1636290,488736290,False,5
9955,validator_44,268877403150,True,649800000,5239100,655039100,False,8
9956,validator_46,283413877500,True,597000000,3171090,600171090,False,8
9957,validator_19,191543538301,True,559000000,6984590,565984590,True,5
9958,validator_17,549475851768,True,577340001,23564130,600904131,True,17
9959,validator_15,875008368439,True,734499993,24096800,758596793,True,27
9960,validator_15,875672217542,True,635660003,28189100,663849103,True,27
9961,validator_27,289650113060,True,552300000,7762800,560062800,False,9
9962,validator_36,259682759100,True,420500000,2651630,423151630,False,8
9963,validator_46,283936475700,True,521200000,1398200,522598200,False,8
9964,validator_38,79536384320,True,542500000,27933700,570433700,False,2
9965,validator_48,511090990370,True,735900000,3560630,739460630,False,15
9966,validator_31,461772816770,True,654400000,10043100,664443100,False,14
9967,validator_34,786300885380,True,754000000,1990930,755990930,False,24
9968,validator_5,192030503261,True,603819998,17861240,621681238,True,6
9969,validator_30,165810521070,True,867000000,19348740,886348740,False,5
9970,validator_20,86034059548,True,823045999,24731570,847777569,True,2
9971,validator_48,511846489340,True,746300000,9198970,755498970,False,15
9972,validator_21,192372069835,True,768440000,9187830,777627830,True,6
9973,validator_15,876180935838,True,499899996,8818300,508718296,True,27
9974,validator_27,290298762340,True,646900000,1749280,648649280,False,9
9975,validator_49,210850899690,True,599400000,14078100,613478100,False,6
9976,validator_46,284587064000,True,647500000,3088300,650588300,False,8
9977,validator_21,193152822868,True,777500003,3253030,780753033,True,6
9978,validator_12,298519639155,True,503299988,9807300,513107288,True,9
9979,validator_31,462338527080,True,563000000,2710310,565710310,False,14
9980,validator_17,550266951867,True,746679999,44420100,791100099,True,17
9981,validator_1,193709926388,True,448240004,36264400,484504404,True,6
9982,validator_7,202028738772,True,614300001,21649800,635949801,True,6
9983,validator_14,349120449460,True,670220001,8581680,678801681,True,10
9984,validator_44,269440451250,True,550300000,12748100,563048100,False,8
9985,validator_12,299178081915,True,604139990,54302770,658442760,True,9
9986,validator_17,550955169408,True,679700001,8517540,688217541,True,17
9987,validator_46,285032764980,True,426510000,19190980,445700980,False,8
9988,validator_10,96693673015,True,881720007,21800700,903520707,True,3
9989,validator_30,166331123710,True,519000000,1602640,520602640,False,5
9990,validator_48,512462344570,True,613400000,2455230,615855230,False,16
9991,validator_48,513170769870,True,703500000,4925300,708425300,False,16
9992,validator_34,787006748770,True,701200000,4663390,705863390,False,24
9993,validator_15,876883298938,True,677520000,24843100,702363100,True,27
9994,validator_35,249722505850,True,546400000,771330,547171330,False,7
9995,validator_29,71534680740,True,656400000,2856370,659256370,False,2
9996,validator_14,349632458657,True,504879997,7129200,512009197,True,10
9997,validator_48,513832608110,True,644100000,17738240,661838240,False,16
9998,validator_43,168146683940,True,624500000,24163200,648663200,False,5
9999,validator_47,186933666790,True,635700000,2082030,637782030,False,5
