block_num,validator_id,validator_capital,validator_restaking_factor,total_gas_fee,total_mev_available,block_reward,is_attacker
0,validator_11,32179811494,True,172774994,7036500,179811494,True
1,validator_40,32065710500,True,65032000,678500,65710500,False
2,validator_39,32174110500,True,173562000,548500,174110500,False
3,validator_12,96131287702,True,126176002,5111700,131287702,True
4,validator_12,96233095032,True,101316000,491330,101807330,True
5,validator_27,96173720900,True,171039000,2681900,173720900,False
6,validator_19,64050814740,True,50307000,507740,50814740,True
7,validator_26,32140242200,True,139656000,586200,140242200,False
8,validator_30,64148303400,True,147812000,491400,148303400,False
9,validator_40,32129893200,True,62701000,1481700,64182700,False
10,validator_30,64265158700,True,116499000,356300,116855300,False
11,validator_37,64105306300,True,104535000,771300,105306300,False
12,validator_17,160290178086,True,288726996,1451090,290178086,True
13,validator_47,64088681500,True,87048000,1633500,88681500,False
14,validator_2,32120553403,True,118274003,2279400,120553403,True
15,validator_41,64143446600,True,141393000,2053600,143446600,False
16,validator_42,32099717000,True,99103000,614000,99717000,False
17,validator_27,96312017270,True,128752000,9544370,138296370,False
18,validator_12,96296206956,True,61800994,1310930,63111924,True
19,validator_15,256166614389,True,165819999,794390,166614389,True
20,validator_6,32197749800,True,195612000,2137800,197749800,True
21,validator_12,96441917831,True,145038995,671880,145710875,True
22,validator_33,32131853840,True,112066000,19787840,131853840,False
23,validator_20,32058749102,True,56965002,1784100,58749102,True
24,validator_19,64187428641,True,136352001,261900,136613901,True
25,validator_24,32213758518,True,211183998,2574520,213758518,True
26,validator_18,96281222943,True,278767003,2455940,281222943,True
27,validator_36,96075040500,True,73834000,1206500,75040500,False
28,validator_7,64229271104,True,209079004,20192100,229271104,True
29,validator_38,32132663120,True,130463000,2200120,132663120,False
30,validator_14,96142041102,True,140885002,1156100,142041102,True
31,validator_18,96476533389,True,192833006,2477440,195310446,True
32,validator_5,64099552326,True,98106996,1445330,99552326,True
33,validator_30,64319227790,True,53443000,626090,54069090,False
34,validator_45,32084985200,True,83074000,1911200,84985200,False
35,validator_35,96115279390,True,115042000,237390,115279390,False
36,validator_10,32112124995,True,110042995,2082000,112124995,True
37,validator_39,32301379300,True,121578000,5690800,127268800,False
38,validator_17,160452758715,True,160632999,1947630,162580629,True
39,validator_2,32347004506,True,226174003,277100,226451103,True
40,validator_38,32243455320,True,110212000,580200,110792200,False
41,validator_30,64500119210,True,175922000,4969420,180891420,False
42,validator_44,96162784700,True,162215000,569700,162784700,False
43,validator_0,32137997337,True,119320997,18676340,137997337,True
44,validator_44,96324738570,True,160523000,1430870,161953870,False
45,validator_31,160219281290,True,218517000,764290,219281290,False
46,validator_13,32058726265,True,57452995,1273270,58726265,True
47,validator_1,64123163404,True,120929004,2234400,123163404,True
48,validator_1,64341362105,True,216890001,1308700,218198701,True
49,validator_14,96339693288,True,196174006,1478180,197652186,True
50,validator_35,96242491790,True,125902000,1310400,127212400,False
51,validator_39,32425600200,True,123299000,921900,124220900,False
52,validator_34,256133016200,True,131992000,1024200,133016200,False
53,validator_40,32256156500,True,124626000,1637300,126263300,False
54,validator_22,64271439138,True,268437998,3001140,271439138,True
55,validator_18,96620397187,True,142229998,1633800,143863798,True
56,validator_34,256231222100,True,93347000,4858900,98205900,False
57,validator_21,64073275603,True,70894003,2381600,73275603,True
58,validator_38,32417663820,True,155607000,18601500,174208500,False
59,validator_31,160335274890,True,114613000,1380600,115993600,False
60,validator_8,32146073503,True,144421003,1652500,146073503,True
61,validator_46,96067471420,True,65838000,1633420,67471420,False
62,validator_24,32350054465,True,135482997,812950,136295947,True
63,validator_1,64406393427,True,63666002,1365320,65031322,True
64,validator_27,96363110670,True,50113000,980400,51093400,False
65,validator_30,64612757810,True,107669000,4969600,112638600,False
66,validator_13,32149670787,True,71937992,19006530,90944522,True
67,validator_31,160510910890,True,172556000,3080000,175636000,False
68,validator_18,96826247589,True,204824002,1026400,205850402,True
69,validator_15,256286515428,True,112177999,7723040,119901039,True
70,validator_11,32614932409,True,434139995,980920,435120915,True
71,validator_36,96184624400,True,101347000,8236900,109583900,False
72,validator_9,32099173802,True,97701002,1472800,99173802,True
73,validator_28,32148403700,True,147187000,1216700,148403700,False
74,validator_23,32094008730,True,91563000,2445730,94008730,True
75,validator_22,64390246168,True,118127000,680030,118807030,True
76,validator_10,32202414298,True,82596003,7693300,90289303,True
77,validator_34,256363561800,True,130568000,1771700,132339700,False
78,validator_26,32250419840,True,109110000,1067640,110177640,False
79,validator_3,32072918101,True,63547001,9371100,72918101,True
80,validator_9,32385794200,True,267916998,18703400,286620398,True
81,validator_4,32158647992,True,158234002,413990,158647992,True
82,validator_46,96137311160,True,68170000,1669740,69839740,False
83,validator_24,32571020610,True,216484005,4482140,220966145,True
84,validator_19,64346750463,True,158572002,749820,159321822,True
85,validator_24,32672463440,True,100205000,1237830,101442830,True
86,validator_48,160045890700,True,44784000,1106700,45890700,False
87,validator_16,32125189547,True,123679007,1510540,125189547,True
88,validator_11,32830816409,True,195826000,20058000,215884000,True
89,validator_34,256470011300,True,105677000,772500,106449500,False
90,validator_11,32986377026,True,154197997,1362620,155560617,True
91,validator_1,64617958228,True,205124001,6440800,211564801,True
92,validator_17,160565236118,True,111933003,544400,112477403,True
93,validator_24,32922989545,True,247072005,3454100,250526105,True
94,validator_39,32480911500,True,55231000,80300,55311300,False
95,validator_8,32315997507,True,169541004,383000,169924004,True
96,validator_44,96484246870,True,158240000,1268300,159508300,False
97,validator_11,33115503842,True,126685996,2440820,129126816,True
98,validator_24,33102306609,True,160529994,18787070,179317064,True
99,validator_46,96325589660,True,185838000,2440500,188278500,False
100,validator_14,96486266747,True,144424999,2148460,146573459,True
101,validator_4,32319285789,True,158434997,2202800,160637797,True
102,validator_2,32394503204,True,47111998,386700,47498698,True
103,validator_31,160633205990,True,107674000,14621100,122295100,False
104,validator_31,160793332590,True,146448000,13678600,160126600,False
105,validator_44,96733340570,True,248759000,334700,249093700,False
106,validator_14,96548890945,True,61887998,736200,62624198,True
107,validator_25,32163952640,True,158731000,5221640,163952640,False
108,validator_47,64201995120,True,108535000,4778620,113313620,False
109,validator_34,256633471860,True,163323000,137560,163460560,False
110,validator_34,256777180950,True,125339000,18370090,143709090,False
111,validator_23,32158865632,True,63703002,1153900,64856902,True
112,validator_2,32563209441,True,166852997,1853240,168706237,True
113,validator_1,64719814163,True,99584995,2270940,101855935,True
114,validator_43,64067061900,True,62185000,4876900,67061900,False
115,validator_12,96586834430,True,144059999,856600,144916599,True
116,validator_40,32388486700,True,130994000,1336200,132330200,False
117,validator_30,64802689340,True,189693000,238530,189931530,False
118,validator_35,96416684130,True,174041000,151340,174192340,False
119,validator_21,64216427207,True,141288004,1863600,143151604,True
120,validator_5,64176466929,True,76628003,286600,76914603,True
121,validator_0,32238040941,True,97079004,2964600,100043604,True
122,validator_48,160108454840,True,60817000,1747140,62564140,False
123,validator_36,96253893200,True,51019000,18249800,69268800,False
124,validator_13,32324420271,True,169478994,5270490,174749484,True
125,validator_45,32182016100,True,95273000,1757900,97030900,False
126,validator_17,160646035060,True,80514002,284940,80798942,True
127,validator_20,32240466901,True,160521999,21195800,181717799,True
128,validator_17,160689395800,True,43285000,75740,43360740,True
129,validator_5,64401527654,True,224136005,924720,225060725,True
130,validator_28,32206611300,True,57919000,288600,58207600,False
131,validator_11,33206409741,True,88831999,2073900,90905899,True
132,validator_23,32329838214,True,170547002,425580,170972582,True
133,validator_45,32260120300,True,77006000,1098200,78104200,False
134,validator_18,96951054787,True,123785998,1021200,124807198,True
135,validator_30,64876650440,True,72520000,1441100,73961100,False
136,validator_3,32232009003,True,154331002,4759900,159090902,True
137,validator_15,256395809770,True,108010002,1284340,109294342,True
138,validator_7,64399345724,True,169287000,787620,170074620,True
139,validator_32,32163368000,True,154079000,9289000,163368000,False
140,validator_1,64828416363,True,108130000,472200,108602200,True
141,validator_19,64466754698,True,118847005,1157230,120004235,True
142,validator_4,32527162986,True,206797997,1079200,207877197,True
143,validator_45,32411913100,True,145564000,6228800,151792800,False
144,validator_37,64212232560,True,103727000,3199260,106926260,False
145,validator_48,160223478820,True,113460000,1563980,115023980,False
146,validator_21,64310475203,True,91106996,2941000,94047996,True
147,validator_16,32188231228,True,61048001,1993680,63041681,True
148,validator_22,64469552067,True,78716999,588900,79305899,True
149,validator_10,32271159594,True,66961996,1783300,68745296,True
150,validator_22,64509893270,True,39214003,1127200,40341203,True
151,validator_32,32217450230,True,52143000,1939230,54082230,False
152,validator_20,32387288602,True,144120001,2701700,146821701,True
153,validator_8,32406191745,True,82433998,7760240,90194238,True
154,validator_1,64996170463,True,166845000,909100,167754100,True
155,validator_37,64286389490,True,73666000,490930,74156930,False
156,validator_34,256857734830,True,79817000,736880,80553880,False
157,validator_13,32489729702,True,162073001,3236430,165309431,True
158,validator_8,32488389038,True,81061003,1136290,82197293,True
159,validator_4,32635728886,True,88854000,19711900,108565900,True
160,validator_28,32327705320,True,120687000,407020,121094020,False
161,validator_46,96414620980,True,88304000,727320,89031320,False
162,validator_9,32469718535,True,81366005,2558330,83924335,True
163,validator_37,64475036790,True,179663000,8984300,188647300,False
164,validator_0,32377787173,True,137795002,1951230,139746232,True
165,validator_19,64583373296,True,111512998,5105600,116618598,True
166,validator_0,32503571295,True,124853002,931120,125784122,True
167,validator_32,32330530930,True,105194000,7886700,113080700,False
168,validator_32,32506518050,True,170270000,5717120,175987120,False
169,validator_23,32430675314,True,96151000,4686100,100837100,True
170,validator_24,33209079912,True,105694003,1079300,106773303,True
171,validator_30,64957682240,True,71390000,9641800,81031800,False
172,validator_45,32551542330,True,131597000,8032230,139629230,False
173,validator_27,96519645670,True,137163000,19372000,156535000,False
174,validator_13,32579906403,True,89169001,1007700,90176701,True
175,validator_43,64157932180,True,85860000,5010280,90870280,False
176,validator_13,32671706680,True,89497007,2303270,91800277,True
177,validator_3,32431318104,True,197951001,1358100,199309101,True
178,validator_14,96620829669,True,68897004,3041720,71938724,True
179,validator_11,33384998581,True,173305000,5283840,178588840,True
180,validator_42,32233503890,True,118589000,15197890,133786890,False
181,validator_36,96393078280,True,137758000,1427080,139185080,False
182,validator_17,160810238419,True,119438999,1403620,120842619,True
183,validator_26,32367226840,True,114783000,2024000,116807000,False
184,validator_10,32368022570,True,78446006,18416970,96862976,True
185,validator_13,32839951402,True,166813002,1431720,168244722,True
186,validator_32,32653004920,True,144916000,1570870,146486870,False
187,validator_27,96619539040,True,99513000,380370,99893370,False
188,validator_44,96874458470,True,140305000,812900,141117900,False
189,validator_19,64684441690,True,81603994,19464400,101068394,True
190,validator_31,160888157990,True,93465000,1360400,94825400,False
191,validator_43,64209994860,True,33261000,18801680,52062680,False
192,validator_49,64089545600,True,88046000,1499600,89545600,False
193,validator_31,161117279890,True,217797000,11324900,229121900,False
194,validator_47,64481954920,True,270274000,9685800,279959800,False
195,validator_20,32556733501,True,168347999,1096900,169444899,True
196,validator_22,64785845349,True,252814999,23137080,275952079,True
197,validator_34,256974434750,True,114330000,2369920,116699920,False
198,validator_25,32304040270,True,139161000,926630,140087630,False
199,validator_31,161184771690,True,66358000,1133800,67491800,False
200,validator_38,32549076720,True,129734000,1678900,131412900,False
201,validator_33,32220580740,True,76670000,12056900,88726900,False
202,validator_28,32457550050,True,122241000,7603730,129844730,False
203,validator_46,96524824180,True,91997000,18206200,110203200,False
204,validator_30,65092748340,True,133134000,1932100,135066100,False
205,validator_41,64250072900,True,105455000,1171300,106626300,False
206,validator_48,160253754620,True,29632000,643800,30275800,False
207,validator_18,97145578013,True,192324996,2198230,194523226,True
208,validator_7,64606260022,True,197406998,9507300,206914298,True
209,validator_45,32687247860,True,134489000,1216530,135705530,False
210,validator_2,32695934140,True,131397999,1326700,132724699,True
211,validator_40,32616000330,True,226068000,1445630,227513630,False
212,validator_39,32622744330,True,139536000,2296830,141832830,False
213,validator_45,32812528960,True,124803000,478100,125281100,False
214,validator_45,32900173280,True,68922000,18722320,87644320,False
215,validator_5,64455657009,True,51887995,2241360,54129355,True
216,validator_10,32616718175,True,236692005,12003600,248695605,True
217,validator_12,96708791000,True,120448000,1508570,121956570,True
218,validator_47,64546052720,True,59400000,4697800,64097800,False
219,validator_5,64598726010,True,142585001,484000,143069001,True
220,validator_11,33520666581,True,133855000,1813000,135668000,True
221,validator_40,32766852560,True,148064000,2788230,150852230,False
222,validator_41,64314463290,True,63591000,799390,64390390,False
223,validator_36,96457601420,True,64342000,181140,64523140,False
224,validator_30,65209946360,True,115219000,1979020,117198020,False
225,validator_16,32243441607,True,54849999,360380,55210379,True
226,validator_5,64728417394,True,129200004,491380,129691384,True
227,validator_1,65152922360,True,155844997,906900,156751897,True
228,validator_25,32406548850,True,83692000,18816580,102508580,False
229,validator_19,64882804268,True,193597998,4764580,198362578,True
230,validator_37,64651748770,True,175494000,1217980,176711980,False
231,validator_3,32577479234,True,145802000,359130,146161130,True
232,validator_31,161258784070,True,73824000,188380,74012380,False
233,validator_44,96985861350,True,110183000,1219880,111402880,False
234,validator_27,96692932670,True,72233000,1160630,73393630,False
235,validator_0,32633046898,True,127263003,2212600,129475603,True
236,validator_7,64795275167,True,186133005,2882140,189015145,True
237,validator_29,32093762200,True,92475000,1287200,93762200,False
238,validator_3,32706811753,True,129099999,232520,129332519,True
239,validator_37,64774970210,True,115485000,7736440,123221440,False
240,validator_4,32709328582,True,70943006,2656690,73599696,True
241,validator_44,97138850170,True,150888000,2100820,152988820,False
242,validator_30,65314104500,True,103836000,322140,104158140,False
243,validator_14,96687504610,True,58841001,7833940,66674941,True
244,validator_43,64311074760,True,100022000,1057900,101079900,False
245,validator_2,32939305467,True,220396997,22974330,243371327,True
246,validator_39,32722957530,True,99061000,1152200,100213200,False
247,validator_49,64177223800,True,69611000,18067200,87678200,False
248,validator_15,256697637617,True,299467007,2360840,301827847,True
249,validator_47,64710872620,True,162138000,2681900,164819900,False
250,validator_6,32359102106,True,159499006,1853300,161352306,True
251,validator_11,33690372819,True,161193998,8512240,169706238,True
252,validator_9,32540267627,True,68907002,1642090,70549092,True
253,validator_8,32648884873,True,158988995,1506840,160495835,True
254,validator_40,32892175160,True,103082000,22240600,125322600,False
255,validator_7,64933661367,True,120387000,17999200,138386200,True
256,validator_6,32464525590,True,97617004,7806480,105423484,True
257,validator_2,33055041465,True,114993998,742000,115735998,True
258,validator_31,161375494800,True,116009000,701730,116710730,False
259,validator_47,64891568220,True,171960000,8735600,180695600,False
260,validator_3,32837701148,True,112170995,18718400,130889395,True
261,validator_49,64384507600,True,206470000,813800,207283800,False
262,validator_37,64998711310,True,217820000,5921100,223741100,False
263,validator_7,65027279868,True,92817001,801500,93618501,True
264,validator_0,32782136900,True,147197002,1893000,149090002,True
265,validator_32,32769302820,True,116106000,191900,116297900,False
266,validator_2,33168677885,True,113181000,455420,113636420,True
267,validator_49,64514156840,True,128805000,844240,129649240,False
268,validator_29,32215558030,True,120456000,1339830,121795830,False
269,validator_22,65000665485,True,213524996,1295140,214820136,True
270,validator_35,96559882160,True,141648000,1550030,143198030,False
271,validator_27,96774297870,True,80714000,651200,81365200,False
272,validator_9,32681061027,True,135185000,5608400,140793400,True
273,validator_46,96603833880,True,77666000,1343700,79009700,False
274,validator_43,64388835780,True,58815000,18946020,77761020,False
275,validator_32,32873099660,True,102507000,1289840,103796840,False
276,validator_4,32822288900,True,107801998,5158320,112960318,True
277,validator_27,97031186200,True,248787000,8101330,256888330,False
278,validator_46,96681773580,True,72570000,5369700,77939700,False
279,validator_24,33302467513,True,92693001,694600,93387601,True
280,validator_10,32669911576,True,51065001,2128400,53193401,True
281,validator_46,96775094620,True,91652000,1669040,93321040,False
282,validator_46,96882384860,True,105507000,1783240,107290240,False
283,validator_45,33047422650,True,146354000,895370,147249370,False
284,validator_23,32475973014,True,43244000,2053700,45297700,True
285,validator_12,96826391118,True,116504998,1095120,117600118,True
286,validator_17,161002030220,True,183436001,8355800,191791801,True
287,validator_11,33991165615,True,293426996,7365800,300792796,True
288,validator_40,32989629070,True,97109000,344910,97453910,False
289,validator_28,32574814350,True,98966000,18298300,117264300,False
290,validator_4,32989073915,True,166589005,196010,166785015,True
291,validator_25,32483279790,True,75983000,747940,76730940,False
292,validator_15,256776938408,True,78984001,316790,79300791,True
293,validator_45,33232266770,True,183545000,1299120,184844120,False
294,validator_19,65059197148,True,157812000,18580880,176392880,True
295,validator_38,32651049850,True,92304000,9669130,101973130,False
296,validator_45,33401887270,True,167699000,1921500,169620500,False
297,validator_44,97266310360,True,108367000,19093190,127460190,False
298,validator_12,96900875088,True,66275000,8208970,74483970,True
299,validator_21,64591799769,True,275962996,5361570,281324566,True
300,validator_17,161112298520,True,109320000,948300,110268300,True
301,validator_39,32863557230,True,136828000,3771700,140599700,False
302,validator_4,33055326569,True,65169994,1082660,66252654,True
303,validator_30,65492470100,True,159517000,18848600,178365600,False
304,validator_0,32850632533,True,67938003,557630,68495633,True
305,validator_12,97002898251,True,100760003,1263160,102023163,True
306,validator_39,33027499140,True,160456000,3485910,163941910,False
307,validator_46,97007843100,True,119503000,5955240,125458240,False
308,validator_29,32337970330,True,120384000,2028300,122412300,False
309,validator_31,161487693080,True,111600000,598280,112198280,False
310,validator_43,64456752620,True,62964000,4952840,67916840,False
311,validator_22,65148325482,True,147057997,602000,147659997,True
312,validator_42,32319629810,True,77585000,8540920,86125920,False
313,validator_11,34142059342,True,149715997,1177730,150893727,True
314,validator_28,32674759690,True,92570000,7375340,99945340,False
315,validator_4,33166804367,True,111074998,402800,111477798,True
316,validator_22,65241347621,True,92812999,209140,93022139,True
317,validator_44,97410070160,True,142677000,1082800,143759800,False
318,validator_35,96686811980,True,126009000,920820,126929820,False
319,validator_44,97448453160,True,37805000,578000,38383000,False
320,validator_1,65325612801,True,170362001,2328440,172690441,True
321,validator_9,32759019833,True,76220006,1738800,77958806,True
322,validator_7,65322889537,True,294065999,1543670,295609669,True
323,validator_35,96757104060,True,68678000,1614080,70292080,False
324,validator_38,32741477780,True,71336000,19091930,90427930,False
325,validator_10,32877540823,True,205012997,2616250,207629247,True
326,validator_23,32644570953,True,167135999,1461940,168597939,True
327,validator_44,97522540560,True,71347000,2740400,74087400,False
328,validator_19,65183159031,True,118856003,5105880,123961883,True
329,validator_44,97572753260,True,49619000,593700,50212700,False
330,validator_46,97088437420,True,80143000,451320,80594320,False
331,validator_40,33184913470,True,193990000,1294400,195284400,False
332,validator_41,64529520690,True,214197000,860400,215057400,False
333,validator_15,256972766844,True,186630996,9197440,195828436,True
334,validator_23,32805998796,True,159904003,1523840,161427843,True
335,validator_12,97269066054,True,264101003,2066800,266167803,True
336,validator_17,161181025410,True,49629000,19097890,68726890,True
337,validator_39,33113437580,True,84458000,1480440,85938440,False
338,validator_41,64726470990,True,194170000,2780300,196950300,False
339,validator_29,32427107630,True,87990000,1147300,89137300,False
340,validator_41,64847506490,True,119422000,1613500,121035500,False
341,validator_35,96883731170,True,126037000,590110,126627110,False
342,validator_46,97204089230,True,96919000,18732810,115651810,False
343,validator_1,65428407921,True,101902000,893120,102795120,True
344,validator_43,64552627740,True,94896000,979120,95875120,False
345,validator_12,97431648221,True,161281997,1300170,162582167,True
346,validator_48,160380773480,True,124229000,2789860,127018860,False
347,validator_46,97302094110,True,79836000,18168880,98004880,False
348,validator_33,32385474870,True,163818000,1076130,164894130,False
349,validator_40,33329107130,True,138935000,5258660,144193660,False
350,validator_13,33071296505,True,212864003,18481100,231345103,True
351,validator_11,34309907339,True,161252997,6595000,167847997,True
352,validator_33,32553568670,True,167439000,654800,168093800,False
353,validator_46,97441058180,True,137064000,1900070,138964070,False
354,validator_43,64715547340,True,155048000,7871600,162919600,False
355,validator_39,33216644920,True,97135000,6072340,103207340,False
356,validator_45,33580188170,True,177245000,1055900,178300900,False
357,validator_7,65540112576,True,197625999,19597040,217223039,True
358,validator_35,97067705070,True,165943000,18030900,183973900,False
359,validator_36,96580024220,True,121887000,535800,122422800,False
360,validator_41,65009993130,True,160766000,1720640,162486640,False
361,validator_40,33503644360,True,168831000,5706230,174537230,False
362,validator_21,64728198951,True,135302002,1097180,136399182,True
363,validator_30,65537509530,True,44725000,314430,45039430,False
364,validator_41,65107402030,True,96991000,417900,97408900,False
365,validator_18,97245026350,True,96915997,2532340,99448337,True
366,validator_19,65349892547,True,147663996,19069520,166733516,True
367,validator_49,64708601970,True,182355000,12090130,194445130,False
368,validator_40,33619441280,True,114979000,817920,115796920,False
369,validator_5,64848980697,True,100249003,20314300,120563303,True
370,validator_44,97652480060,True,78418000,1308800,79726800,False
371,validator_49,64878802990,True,149808000,20393020,170201020,False
372,validator_13,33164121107,True,84654002,8170600,92824602,True
373,validator_11,34398214641,True,86670002,1637300,88307302,True
374,validator_14,96896363411,True,207663001,1195800,208858801,True
375,validator_33,32638271870,True,79218000,5485200,84703200,False
376,validator_1,65542948121,True,112601000,1939200,114540200,True
377,validator_48,160494198900,True,111606000,1819420,113425420,False
378,validator_35,97129066290,True,59367000,1994220,61361220,False
379,validator_34,257133758250,True,157338000,1985500,159323500,False
380,validator_15,257271172239,True,297735995,669400,298405395,True
381,validator_26,32520370160,True,151360000,1783320,153143320,False
382,validator_27,97177583000,True,144643000,1753800,146396800,False
383,validator_37,65105557330,True,104638000,2208020,106846020,False
384,validator_11,34518169975,True,117082994,2872340,119955334,True
385,validator_38,32900252350,True,155814000,2960570,158774570,False
386,validator_32,32985263060,True,111617000,546400,112163400,False
387,validator_1,65582729519,True,39429998,351400,39781398,True
388,validator_32,33113712260,True,125294000,3155200,128449200,False
389,validator_26,32718566260,True,197757000,439100,198196100,False
390,validator_19,65453552377,True,102505000,1154830,103659830,True
391,validator_15,257384120939,True,111419000,1529700,112948700,True
392,validator_11,34593273764,True,67908999,7194790,75103789,True
393,validator_14,96973898441,True,76791000,744030,77535030,True
394,validator_7,65727246016,True,184755000,2378440,187133440,True
395,validator_15,257440558137,True,56251998,185200,56437198,True
396,validator_25,32626076030,True,140077000,2719240,142796240,False
397,validator_3,32987469350,True,147494002,2274200,149768202,True
398,validator_3,33106710351,True,118361001,880000,119241001,True
399,validator_7,65903774853,True,152192997,24335840,176528837,True
400,validator_2,33343959390,True,174161005,1120500,175281505,True
401,validator_41,65145599920,True,35438000,2759890,38197890,False
402,validator_15,257536396439,True,94252002,1586300,95838302,True
403,validator_27,97314868420,True,135619000,1666420,137285420,False
404,validator_45,33721331710,True,139186000,1957540,141143540,False
405,validator_41,65302256020,True,146120000,10536100,156656100,False
406,validator_16,32295895507,True,51001000,1452900,52453900,True
407,validator_3,33267845940,True,141364999,19770590,161135589,True
408,validator_20,32660094830,True,93943999,9417330,103361329,True
409,validator_48,160700378930,True,205242000,938030,206180030,False
410,validator_9,32882090093,True,119345000,3725260,123070260,True
411,validator_28,32914594980,True,185106000,54729290,239835290,False
412,validator_3,33304363672,True,34633002,1884730,36517732,True
413,validator_35,97222507490,True,91272000,2169200,93441200,False
414,validator_11,34650318164,True,54061000,2983400,57044400,True
415,validator_30,65593437350,True,52698000,3229820,55927820,False
416,validator_34,257267314050,True,128309000,5246800,133555800,False
417,validator_36,96744332750,True,163321000,987530,164308530,False
418,validator_43,64771648440,True,55093000,1008100,56101100,False
419,validator_17,161353603368,True,171107998,1469960,172577958,True
420,validator_26,32748744400,True,29624000,554140,30178140,False
421,validator_49,64971054390,True,74044000,18207400,92251400,False
422,validator_8,32767233778,True,117204005,1144900,118348905,True
423,validator_0,32919808833,True,64361000,4815300,69176300,True
424,validator_38,32997336850,True,95865000,1219500,97084500,False
425,validator_33,32706258570,True,67315000,671700,67986700,False
426,validator_2,33566764532,True,214270002,8535140,222805142,True
427,validator_12,97777095823,True,344018002,1429600,345447602,True
428,validator_27,97524123460,True,207547000,1708040,209255040,False
429,validator_42,32452822410,True,132210000,982600,133192600,False
430,validator_11,34744042664,True,85437000,8287500,93724500,True
431,validator_17,161443886361,True,88661993,1621000,90282993,True
432,validator_5,64981866495,True,130951998,1933800,132885798,True
433,validator_10,33063848752,True,184645009,1662920,186307929,True
434,validator_47,65014481550,True,121554000,1359330,122913330,False
435,validator_16,32421395094,True,124053997,1445590,125499587,True
436,validator_47,65263697640,True,230923000,18293090,249216090,False
437,validator_23,32926860402,True,119161006,1700600,120861606,True
438,validator_38,33182117550,True,168238000,16542700,184780700,False
439,validator_5,65156456812,True,173550997,1039320,174590317,True
440,validator_24,33383018344,True,78253001,2297830,80550831,True
441,validator_17,161531773509,True,87561998,325150,87887148,True
442,validator_42,32515023550,True,61376000,825140,62201140,False
443,validator_34,257504282670,True,218398000,18570620,236968620,False
444,validator_42,32715929350,True,199786000,1119800,200905800,False
445,validator_4,33261657885,True,93811998,1041520,94853518,True
446,validator_16,32692348317,True,269511003,1442220,270953223,True
447,validator_30,65724758440,True,108121000,23200090,131321090,False
448,validator_12,98032396639,True,246711996,8588820,255300816,True
449,validator_2,33703702954,True,136560002,378420,136938422,True
450,validator_32,33212189490,True,79277000,19200230,98477230,False
451,validator_6,32668670392,True,199009002,5135800,204144802,True
452,validator_14,97066196270,True,73583999,18713830,92297829,True
453,validator_45,33755783910,True,33972000,480200,34452200,False
454,validator_32,33355847770,True,143156000,502280,143658280,False
455,validator_47,65351695740,True,86029000,1969100,87998100,False
456,validator_31,161581503970,True,92154000,1656890,93810890,False
457,validator_39,33341966350,True,123848000,1473430,125321430,False
458,validator_46,97561395280,True,119969000,368100,120337100,False
459,validator_48,160839826230,True,138899000,548300,139447300,False
460,validator_3,33465555172,True,159699000,1492500,161191500,True
461,validator_40,33701779010,True,81807000,530730,82337730,False
462,validator_39,33512935760,True,170301000,668410,170969410,False
463,validator_7,66045856070,True,141679997,401220,142081217,True
464,validator_18,97296875177,True,50929997,918830,51848827,True
465,validator_30,65789409540,True,64248000,403100,64651100,False
466,validator_3,33702847501,True,236846999,445330,237292329,True
467,validator_35,97349696670,True,125799000,1390180,127189180,False
468,validator_12,98157532241,True,124470002,665600,125135602,True
469,validator_37,65289225530,True,182275000,1393200,183668200,False
470,validator_13,33305262052,True,140108005,1032940,141140945,True
471,validator_43,64951075340,True,177031000,2395900,179426900,False
472,validator_6,32836548001,True,166581999,1295610,167877609,True
473,validator_37,65382075650,True,92231000,619120,92850120,False
474,validator_6,32935878937,True,98058006,1272930,99330936,True
475,validator_0,33055386856,True,115830003,19748020,135578023,True
476,validator_10,33202970742,True,138013000,1108990,139121990,True
477,validator_23,33146322697,True,199869995,19592300,219462295,True
478,validator_17,161649118100,True,116439001,905590,117344591,True
479,validator_29,32475959730,True,48243000,609100,48852100,False
480,validator_26,32922736400,True,149503000,24489000,173992000,False
481,validator_20,32786784064,True,125289004,1400230,126689234,True
482,validator_18,97396257155,True,98727998,653980,99381978,True
483,validator_44,97765011560,True,111219000,1312500,112531500,False
484,validator_11,34820977347,True,76545003,389680,76934683,True
485,validator_31,161743924270,True,155989000,6431300,162420300,False
486,validator_47,65465821740,True,112073000,2053000,114126000,False
487,validator_31,161836230270,True,91066000,1240000,92306000,False
488,validator_15,257621965638,True,63129999,22439200,85569199,True
489,validator_14,97309837780,True,242062000,1579510,243641510,True
490,validator_46,97692413800,True,130089000,929520,131018520,False
491,validator_23,33271930894,True,125144997,463200,125608197,True
492,validator_12,98221989877,True,59216996,5240640,64457636,True
493,validator_28,32980484290,True,65238000,651310,65889310,False
494,validator_42,32923317360,True,201729000,5659010,207388010,False
495,validator_39,33626113460,True,111495000,1682700,113177700,False
496,validator_5,65227356106,True,63002994,7896300,70899294,True
497,validator_34,257569836300,True,60337000,5216630,65553630,False
498,validator_15,257791796037,True,151356999,18473400,169830399,True
499,validator_36,96795489770,True,50934000,223020,51157020,False
500,validator_20,32865551562,True,78216998,550500,78767498,True
501,validator_47,65604761860,True,137690000,1250120,138940120,False
502,validator_18,97491334150,True,94516995,560000,95076995,True
503,validator_25,32688269030,True,51280000,10913000,62193000,False
504,validator_11,34899272545,True,77868998,426200,78295198,True
505,validator_43,65061272620,True,101765000,8432280,110197280,False
506,validator_25,32781808800,True,91553000,1986770,93539770,False
507,validator_16,32851898546,True,158216999,1333230,159550229,True
508,validator_14,97524493806,True,211691006,2965020,214656026,True
509,validator_48,160880624270,True,39184000,1614040,40798040,False
510,validator_18,97567337744,True,75494994,508600,76003594,True
511,validator_35,97518734070,True,161456000,7581400,169037400,False
512,validator_2,33858979653,True,147506999,7769700,155276699,True
513,validator_8,33011260480,True,241760002,2266700,244026702,True
514,validator_23,33345509825,True,73279001,299930,73578931,True
515,validator_15,257921878714,True,112247997,17834680,130082677,True
516,validator_40,33803415110,True,99015000,2621100,101636100,False
517,validator_13,33473080424,True,166496002,1322370,167818372,True
518,validator_10,33253378044,True,48862002,1545300,50407302,True
519,validator_29,32566290730,True,67688000,22643000,90331000,False
520,validator_26,33001274600,True,75978000,2560200,78538200,False
521,validator_31,161932889300,True,95518000,1141030,96659030,False
522,validator_47,65675783620,True,69935000,1086760,71021760,False
523,validator_8,33067232519,True,54285999,1686040,55972039,True
524,validator_15,258043205191,True,101683997,19642480,121326477,True
525,validator_21,64918996954,True,188892003,1906000,190798003,True
526,validator_36,96962613170,True,164924000,2199400,167123400,False
527,validator_22,65451918302,True,210180001,390680,210570681,True
528,validator_44,97889165720,True,123103000,1051160,124154160,False
529,validator_43,65128722520,True,57026000,10423900,67449900,False
530,validator_29,32790511020,True,222074000,2146290,224220290,False
531,validator_25,32850563740,True,68170000,584940,68754940,False
532,validator_0,33166407558,True,87857002,23163700,111020702,True
533,validator_46,97797892000,True,86898000,18580200,105478200,False
534,validator_5,65357058508,True,128482002,1220400,129702402,True
535,validator_37,65644389250,True,261617000,696600,262313600,False
536,validator_39,33724690290,True,90993000,7583830,98576830,False
537,validator_14,97605683735,True,80443999,745930,81189929,True
538,validator_26,33042221430,True,40404000,542830,40946830,False
539,validator_36,96999504670,True,29460000,7431500,36891500,False
540,validator_9,33031523925,True,141538002,7895830,149433832,True
541,validator_14,97794590033,True,179527998,9378300,188906298,True
542,validator_23,33539106025,True,192000000,1596200,193596200,True
543,validator_49,65089711620,True,113726000,4931230,118657230,False
544,validator_34,257689308140,True,115922000,3549840,119471840,False
545,validator_15,258186025851,True,140501000,2319660,142820660,True
546,validator_36,97079657270,True,67641000,12511600,80152600,False
547,validator_42,32976874700,True,48481000,5076340,53557340,False
548,validator_2,33977182726,True,99820003,18383070,118203073,True
549,validator_37,65769125850,True,116272000,8464600,124736600,False
550,validator_5,65440932611,True,83096003,778100,83874103,True
551,validator_28,33053807870,True,72609000,714580,73323580,False
552,validator_15,258353207588,True,130905997,36275740,167181737,True
553,validator_15,258456134888,True,102182000,745300,102927300,True
554,validator_32,33447247370,True,88894000,2505600,91399600,False
555,validator_25,32974422640,True,118135000,5723900,123858900,False
556,validator_11,34991587318,True,90993003,1321770,92314773,True
557,validator_16,33104834057,True,252067001,868510,252935511,True
558,validator_3,33789659098,True,85983997,827600,86811597,True
559,validator_5,65540754508,True,97864997,1956900,99821897,True
560,validator_7,66347392573,True,282732003,18804500,301536503,True
561,validator_10,33419116756,True,164144002,1594710,165738712,True
562,validator_0,33271708489,True,104390001,910930,105300931,True
563,validator_24,33504579943,True,102548999,19012600,121561599,True
564,validator_32,33520851670,True,61543000,12061300,73604300,False
565,validator_24,33640450943,True,135423000,448000,135871000,True
566,validator_44,98038837060,True,141248000,8423340,149671340,False
567,validator_34,257789098740,True,97909000,1881600,99790600,False
568,validator_31,162020421000,True,86701000,830700,87531700,False
569,validator_39,33823512180,True,96540000,2281890,98821890,False
570,validator_45,33839834410,True,83372000,678500,84050500,False
571,validator_31,162172537080,True,149690000,2426080,152116080,False
572,validator_20,32959711043,True,92849001,1310480,94159481,True
573,validator_9,33166306513,True,133449998,1332590,134782588,True
574,validator_20,33121810442,True,161544999,554400,162099399,True
575,validator_7,66475238405,True,96495002,31350830,127845832,True
576,validator_47,65766531960,True,75833000,14915340,90748340,False
577,validator_4,33445127481,True,164262996,19206600,183469596,True
578,validator_44,98198836160,True,158243000,1756100,159999100,False
579,validator_31,162277545200,True,85584000,19424120,105008120,False
580,validator_32,33582654500,True,54824000,6978830,61802830,False
581,validator_46,97899169700,True,100694000,583700,101277700,False
582,validator_48,161031155570,True,149436000,1095300,150531300,False
583,validator_38,33300704880,True,117365000,1222330,118587330,False
584,validator_25,33084058040,True,109060000,575400,109635400,False
585,validator_41,65458257750,True,154946000,1055730,156001730,False
586,validator_34,257951787730,True,156073000,6615990,162688990,False
587,validator_5,65671006267,True,111116999,19134760,130251759,True
588,validator_5,65834002966,True,160377999,2618700,162996699,True
589,validator_41,65528864800,True,69172000,1435050,70607050,False
590,validator_13,33627783819,True,153170995,1532400,154703395,True
591,validator_37,65979423750,True,208477000,1820900,210297900,False
592,validator_48,161147440970,True,108014000,8271400,116285400,False
593,validator_49,65180356020,True,89620000,1024400,90644400,False
594,validator_6,33041341941,True,104658004,805000,105463004,True
595,validator_46,98069172800,True,169075000,928100,170003100,False
596,validator_7,66537511803,True,61875998,397400,62273398,True
597,validator_8,33273810839,True,205834000,744320,206578320,True
598,validator_43,65230120620,True,95900000,5498100,101398100,False
599,validator_7,66654463201,True,116265998,685400,116951398,True
600,validator_18,97650061043,True,75121999,7601300,82723299,True
601,validator_3,33884241792,True,93155004,1427690,94582694,True
602,validator_1,65667448717,True,64855998,19863200,84719198,True
603,validator_48,161255681210,True,99364000,8876240,108240240,False
604,validator_38,33447955380,True,144432000,2818500,147250500,False
605,validator_39,33964364880,True,139781000,1071700,140852700,False
606,validator_3,34102877883,True,193146001,25490090,218636091,True
607,validator_40,33883865210,True,80077000,373100,80450100,False
608,validator_31,162403177200,True,124347000,1285000,125632000,False
609,validator_34,258139096810,True,161051000,26258080,187309080,False
610,validator_18,97866207844,True,213117001,3029800,216146801,True
611,validator_15,258618954096,True,158317998,4501210,162819208,True
612,validator_17,161700379101,True,50219001,1042000,51261001,True
613,validator_7,66832417772,True,176114001,1840570,177954571,True
614,validator_15,258768233496,True,148123000,1156400,149279400,True
615,validator_44,98302474560,True,101117000,2521400,103638400,False
616,validator_2,34059171922,True,76865996,5123200,81989196,True
617,validator_23,33654250724,True,113088999,2055700,115144699,True
618,validator_20,33302591548,True,178635006,2146100,180781106,True
619,validator_46,98140359800,True,70435000,752000,71187000,False
620,validator_3,34344322989,True,236572006,4873100,241445106,True
621,validator_15,259007652122,True,221217006,18201620,239418626,True
622,validator_44,98379124260,True,73651000,2998700,76649700,False
623,validator_21,65063118388,True,134893004,9228430,144121434,True
624,validator_11,35113431714,True,119805996,2038400,121844396,True
625,validator_32,33743567680,True,159649000,1264180,160913180,False
626,validator_29,32861510520,True,70470000,529500,70999500,False
627,validator_12,98338032375,True,114768998,1273500,116042498,True
628,validator_3,34387886387,True,41231998,2331400,43563398,True
629,validator_21,65201704488,True,138502000,84100,138586100,True
630,validator_16,33202255986,True,95880999,1540930,97421929,True
631,validator_4,33549264223,True,102970002,1166740,104136742,True
632,validator_25,33176558640,True,66971000,25529600,92500600,False
633,validator_33,32943913310,True,235784000,1870740,237654740,False
634,validator_18,97998507579,True,131972005,327730,132299735,True
635,validator_16,33349476411,True,141611005,5609420,147220425,True
636,validator_43,65448922410,True,217661000,1140790,218801790,False
637,validator_41,65577239870,True,47086000,1289070,48375070,False
638,validator_30,65948697340,True,158151000,1136800,159287800,False
639,validator_9,33323256564,True,155684001,1266050,156950051,True
640,validator_27,97640487160,True,102984000,13379700,116363700,False
641,validator_35,97707224970,True,182872000,5618900,188490900,False
642,validator_14,97931055264,True,135014001,1451230,136465231,True
643,validator_33,33088047730,True,142864000,1270420,144134420,False
644,validator_3,34454987682,True,65048995,2052300,67101295,True
645,validator_8,33410719340,True,135966001,942500,136908501,True
646,validator_34,258362249910,True,222378000,775100,223153100,False
647,validator_10,33551464876,True,129923000,2425120,132348120,True
648,validator_12,98438499573,True,99236998,1230200,100467198,True
649,validator_20,33375710341,True,72310993,807800,73118793,True
650,validator_10,33690745965,True,130277989,9003100,139281089,True
651,validator_14,98203962287,True,271367003,1540020,272907023,True
652,validator_32,33850104680,True,105900000,637000,106537000,False
653,validator_33,33201337530,True,111628000,1661800,113289800,False
654,validator_8,33507728871,True,94178001,2831530,97009531,True
655,validator_22,65612869060,True,155857998,5092760,160950758,True
656,validator_15,259171589327,True,141687005,22250200,163937205,True
657,validator_26,33197222530,True,153287000,1714100,155001100,False
658,validator_3,34550172685,True,93532003,1653000,95185003,True
659,validator_19,65590864477,True,113838000,23474100,137312100,True
660,validator_26,33361496950,True,161771000,2503420,164274420,False
661,validator_1,65918981118,True,251244001,288400,251532401,True
662,validator_15,259272844027,True,93590000,7664700,101254700,True
663,validator_30,66035201140,True,81677000,4826800,86503800,False
664,validator_15,259389101631,True,114246004,2011600,116257604,True
665,validator_31,162528536240,True,124424000,935040,125359040,False
666,validator_46,98242186900,True,101011000,816100,101827100,False
667,validator_33,33349736760,True,147971000,428230,148399230,False
668,validator_10,33791005557,True,99574002,685590,100259592,True
669,validator_6,33136735962,True,94448001,946020,95394021,True
670,validator_0,33379731188,True,107329999,692700,108022699,True
671,validator_27,97730507170,True,71369000,18651010,90020010,False
672,validator_16,33473222513,True,122096002,1650100,123746102,True
673,validator_25,33279542780,True,102263000,721140,102984140,False
674,validator_23,33887909256,True,225309002,8349530,233658532,True
675,validator_27,97805046970,True,73596000,943800,74539800,False
676,validator_11,35239556017,True,123683003,2441300,126124303,True
677,validator_31,162582725740,True,53207000,982500,54189500,False
678,validator_31,162758564240,True,173878000,1960500,175838500,False
679,validator_11,35346179832,True,105791005,832810,106623815,True
680,validator_30,66273750730,True,236946000,1603590,238549590,False
681,validator_32,34021342580,True,169836000,1401900,171237900,False
682,validator_34,258395803710,True,31669000,1884800,33553800,False
683,validator_45,33966675910,True,118892000,7949500,126841500,False
684,validator_14,98332818090,True,122766003,6089800,128855803,True
685,validator_26,33502697410,True,139678000,1522460,141200460,False
686,validator_0,33647077189,True,266668001,678000,267346001,True
687,validator_45,34089980810,True,120922000,2382900,123304900,False
688,validator_10,33858229306,True,66345999,877750,67223749,True
689,validator_15,259569614330,True,174404999,6107700,180512699,True
690,validator_46,98306656640,True,63371000,1098740,64469740,False
691,validator_17,161968970798,True,267303997,1287700,268591697,True
692,validator_41,65669274470,True,91396000,638600,92034600,False
693,validator_1,65989731823,True,65702005,5048700,70750705,True
694,validator_45,34158970410,True,50049000,18940600,68989600,False
695,validator_18,98254824378,True,256171999,144800,256316799,True
696,validator_21,65324055088,True,121172000,1178600,122350600,True
697,validator_40,33958700210,True,66025000,8810000,74835000,False
698,validator_34,258705024250,True,307699000,1521540,309220540,False
699,validator_39,34068774880,True,95257000,9153000,104410000,False
700,validator_9,33435738096,True,111633002,848530,112481532,True
701,validator_10,34021201335,True,162542999,429030,162972029,True
702,validator_12,98522947774,True,79456001,4992200,84448201,True
703,validator_13,33711216821,True,82500002,933000,83433002,True
704,validator_28,33139402510,True,84141000,1453640,85594640,False
705,validator_20,33551422345,True,175004004,708000,175712004,True
706,validator_3,34696928789,True,144769004,1987100,146756104,True
707,validator_9,33522669597,True,85662001,1269500,86931501,True
708,validator_32,34171475330,True,148453000,1679750,150132750,False
709,validator_9,33610477768,True,87596001,212170,87808171,True
710,validator_7,67034878114,True,182751002,19709340,202460342,True
711,validator_37,66075928380,True,94649000,1855630,96504630,False
712,validator_41,65782350070,True,112706000,369600,113075600,False
713,validator_35,97852889410,True,140152000,5512440,145664440,False
714,validator_15,259738831432,True,167979002,1238100,169217102,True
715,validator_9,33754438823,True,143071005,890050,143961055,True
716,validator_20,33734914465,True,183125000,367120,183492120,True
717,validator_13,33804585053,True,92141002,1227230,93368232,True
718,validator_0,33840906194,True,190593005,3236000,193829005,True
719,validator_16,33580217415,True,106554002,440900,106994902,True
720,validator_22,65710732063,True,95150003,2713000,97863003,True
721,validator_2,34334777019,True,265286997,10318100,275605097,True
722,validator_17,162182459996,True,212833998,655200,213489198,True
723,validator_22,65810664562,True,91971999,7960500,99932499,True
724,validator_44,98484499060,True,104667000,707800,105374800,False
725,validator_34,258865072090,True,157537000,2510840,160047840,False
726,validator_15,259894990073,True,154678001,1480640,156158641,True
727,validator_8,33713271237,True,202368006,3174360,205542366,True
728,validator_37,66235469560,True,157720000,1821180,159541180,False
729,validator_42,33175706890,True,198268000,564190,198832190,False
730,validator_27,97882644670,True,76832000,765700,77597700,False
731,validator_42,33254952410,True,78987000,258520,79245520,False
732,validator_44,98646462660,True,160976000,987600,161963600,False
733,validator_33,33483836190,True,116100000,17999430,134099430,False
734,validator_44,98738726650,True,91552000,711990,92263990,False
735,validator_30,66415575530,True,135019000,6805800,141824800,False
736,validator_39,34157762580,True,88043000,944700,88987700,False
737,validator_17,162318477571,True,117368005,18649570,136017575,True
738,validator_22,65882663358,True,70495996,1502800,71998796,True
739,validator_41,65937032870,True,149011000,5671800,154682800,False
740,validator_42,33472134040,True,216225000,956630,217181630,False
741,validator_28,33372215950,True,231315000,1498440,232813440,False
742,validator_41,66042870100,True,105663000,174230,105837230,False
743,validator_18,98319748879,True,59833001,5091500,64924501,True
744,validator_33,33561468490,True,69647000,7985300,77632300,False
745,validator_9,34018646564,True,244726001,19481740,264207741,True
746,validator_13,33879054188,True,73887005,582130,74469135,True
747,validator_7,67172719409,True,129706995,8134300,137841295,True
748,validator_35,97924420110,True,70204000,1326700,71530700,False
749,validator_10,34137394938,True,111377003,4816600,116193603,True
750,validator_6,33333273686,True,186499004,10038720,196537724,True
751,validator_5,65892886794,True,56430998,2452830,58883828,True
752,validator_43,65527397540,True,76976000,1499130,78475130,False
753,validator_17,162487561174,True,167300003,1783600,169083603,True
754,validator_12,98798343502,True,273916998,1478730,275395728,True
755,validator_39,34348924480,True,182395000,8766900,191161900,False
756,validator_48,161516585610,True,260035000,869400,260904400,False
757,validator_26,33624372040,True,120993000,681630,121674630,False
758,validator_44,98842297880,True,102468000,1103230,103571230,False
759,validator_44,98983031670,True,122591000,18142790,140733790,False
760,validator_0,34076890166,True,215917002,20066970,235983972,True
761,validator_9,34142954196,True,123709002,598630,124307632,True
762,validator_18,98390006213,True,69121994,1135340,70257334,True
763,validator_49,65328090470,True,146219000,1515450,147734450,False
764,validator_45,34215247110,True,56245000,31700,56276700,False
765,validator_29,33054908410,True,149262000,44135890,193397890,False
766,validator_9,34268500990,True,122311994,3234800,125546794,True
767,validator_14,98473754992,True,140208002,728900,140936902,True
768,validator_20,33840045666,True,103848001,1283200,105131201,True
769,validator_1,66126332224,True,128610001,7990400,136600401,True
770,validator_32,34368683050,True,195471000,1736720,197207720,False
771,validator_12,98908959082,True,109634000,981580,110615580,True
772,validator_3,34807717155,True,109367006,1421360,110788366,True
773,validator_47,65903872060,True,137095000,245100,137340100,False
774,validator_5,65949683817,True,48769003,8028020,56797023,True
775,validator_19,65758268179,True,166704002,699700,167403702,True
776,validator_22,66017214987,True,126729999,7821630,134551629,True
777,validator_41,66148248360,True,104065000,1313260,105378260,False
778,validator_21,65423750676,True,81852998,17842590,99695588,True
779,validator_16,33713663414,True,132503999,942000,133445999,True
780,validator_5,66071307518,True,119752001,1871700,121623701,True
781,validator_24,33806997343,True,166336000,210400,166546400,True
782,validator_19,65901085781,True,141754002,1063600,142817602,True
783,validator_8,33912936334,True,191728997,7936100,199665097,True
784,validator_2,34502432861,True,162971002,4684840,167655842,True
785,validator_38,33538897480,True,89690000,1252100,90942100,False
786,validator_31,162963435640,True,202889000,1982400,204871400,False
787,validator_39,34435291910,True,85536000,831430,86367430,False
788,validator_26,33790813840,True,158141000,8300800,166441800,False
789,validator_1,66226682628,True,94741004,5609400,100350404,True
790,validator_5,66283030517,True,209981999,1741000,211722999,True
791,validator_2,34741600562,True,219914001,19253700,239167701,True
792,validator_4,33729869324,True,161874001,18731100,180605101,True
793,validator_18,98520357744,True,129802001,549530,130351531,True
794,validator_23,34095497955,True,205846999,1741700,207588699,True
795,validator_47,66036014960,True,130107000,2035900,132142900,False
796,validator_1,66402890230,True,158064002,18143600,176207602,True
797,validator_12,98978283276,True,68150004,1174190,69324194,True
798,validator_1,66546399123,True,122948993,20559900,143508893,True
799,validator_26,33872022370,True,76323000,4885530,81208530,False
800,validator_4,33820816326,True,89033002,1914000,90947002,True
801,validator_37,66335715160,True,99078000,1167600,100245600,False
802,validator_36,97214421970,True,133929000,835700,134764700,False
803,validator_11,35451403330,True,104311998,911500,105223498,True
804,validator_35,98019101090,True,92869000,1811980,94680980,False
805,validator_44,99092384570,True,100654000,8698900,109352900,False
806,validator_29,33117551810,True,61967000,676400,62643400,False
807,validator_47,66157142680,True,120576000,551720,121127720,False
808,validator_30,66488925000,True,54580000,18769470,73349470,False
809,validator_15,260011082202,True,111629999,4462130,116092129,True
810,validator_10,34289126240,True,149318002,2413300,151731302,True
811,validator_14,98699143795,True,224747003,641800,225388803,True
812,validator_34,258948111290,True,78219000,4820200,83039200,False
813,validator_42,33610984440,True,135800000,3050400,138850400,False
814,validator_43,65601805340,True,73452000,955800,74407800,False
815,validator_19,66055430985,True,153218004,1127200,154345204,True
816,validator_32,34426205050,True,56225000,1297000,57522000,False
817,validator_37,66477923980,True,121515000,20693820,142208820,False
818,validator_39,34559879310,True,116296000,8291400,124587400,False
819,validator_23,34357032157,True,259703002,1831200,261534202,True
820,validator_22,66171181072,True,152925995,1040090,153966085,True
821,validator_28,33430066450,True,55413000,2437500,57850500,False
822,validator_4,33883237458,True,61087002,1334130,62421132,True
823,validator_35,98258479090,True,231547000,7831000,239378000,False
824,validator_18,98649110945,True,123356001,5397200,128753201,True
825,validator_40,34123627180,True,156846000,8080970,164926970,False
826,validator_47,66229890580,True,72405000,342900,72747900,False
827,validator_10,34415557786,True,125662996,768550,126431546,True
828,validator_15,260086095900,True,74072998,940700,75013698,True
829,validator_28,33530121750,True,98627000,1428300,100055300,False
830,validator_15,260250210503,True,161607003,2507600,164114603,True
831,validator_34,259023688720,True,74099000,1478430,75577430,False
832,validator_29,33294430050,True,175942000,936240,176878240,False
833,validator_35,98420092810,True,160213000,1400720,161613720,False
834,validator_20,33938304524,True,97652998,605860,98258858,True
835,validator_16,33845893436,True,129479002,2751020,132230022,True
836,validator_48,161662833880,True,144077000,2171270,146248270,False
837,validator_22,66329372124,True,156598002,1593050,158191052,True
838,validator_6,33453546114,True,117579998,2692430,120272428,True
839,validator_41,66195685780,True,44779000,2658420,47437420,False
840,validator_7,67238618227,True,65532998,365820,65898818,True
841,validator_35,98549648910,True,103717000,25839100,129556100,False
842,validator_35,98654719880,True,103817000,1253970,105070970,False
843,validator_42,33721895680,True,109579000,1332240,110911240,False
844,validator_21,65545882178,True,119880002,2251500,122131502,True
845,validator_12,99049821904,True,71303998,234630,71538628,True
846,validator_20,34024011829,True,78838005,6869300,85707305,True
847,validator_17,162606428270,True,117739996,1127100,118867096,True
848,validator_10,34513307781,True,95728995,2021000,97749995,True
849,validator_19,66272778284,True,212010999,5336300,217347299,True
850,validator_8,33955887911,True,41337997,1613580,42951577,True
851,validator_1,66686245086,True,139737003,108960,139845963,True
852,validator_1,66921324078,True,229549992,5529000,235078992,True
853,validator_15,260328150005,True,77108002,831500,77939502,True
854,validator_14,98787743300,True,87146005,1453500,88599505,True
855,validator_0,34150622008,True,71242002,2489840,73731842,True
856,validator_26,33958873640,True,86369000,482270,86851270,False
857,validator_35,98805966620,True,146777000,4469740,151246740,False
858,validator_45,34258031710,True,36848000,5936600,42784600,False
859,validator_41,66306628220,True,109353000,1589440,110942440,False
860,validator_34,259101839620,True,76223000,1927900,78150900,False
861,validator_2,34871039790,True,129129998,309230,129439228,True
862,validator_28,33662448950,True,131653000,674200,132327200,False
863,validator_0,34216929927,True,65938999,368920,66307919,True
864,validator_2,35037870228,True,164154998,2675440,166830438,True
865,validator_7,67293147604,True,53436997,1092380,54529377,True
866,validator_39,34737199810,True,175642000,1678500,177320500,False
867,validator_17,162755023766,True,147474996,1120500,148595496,True
868,validator_6,33608252289,True,153809995,896180,154706175,True
869,validator_22,66467505913,True,137615999,517790,138133789,True
870,validator_23,34441134462,True,65039005,19063300,84102305,True
871,validator_32,34497117650,True,69174000,1738600,70912600,False
872,validator_48,161895282080,True,231034000,1414200,232448200,False
873,validator_44,99219013270,True,123596000,3032700,126628700,False
874,validator_28,33759841010,True,88149000,9243060,97392060,False
875,validator_48,162034839300,True,121028000,18529220,139557220,False
876,validator_31,163076061960,True,112280000,346320,112626320,False
877,validator_20,34139237127,True,113946998,1278300,115225298,True
878,validator_34,259279179270,True,175754000,1585650,177339650,False
879,validator_24,33858548839,True,50448996,1102500,51551496,True
880,validator_17,162860290555,True,81205999,24060790,105266789,True
881,validator_17,162996905974,True,130844999,5770420,136615419,True
882,validator_43,65833300040,True,230873000,621700,231494700,False
883,validator_23,34596448260,True,145053998,10259800,155313798,True
884,validator_31,163186129590,True,107512000,2555630,110067630,False
885,validator_41,66461454520,True,135539000,19287300,154826300,False
886,validator_27,98000941370,True,116715000,1581700,118296700,False
887,validator_23,34724318357,True,125212997,2657100,127870097,True
888,validator_19,66494491386,True,202513002,19200100,221713102,True
889,validator_37,66599825470,True,104066000,17835490,121901490,False
890,validator_31,163326059520,True,139698000,231930,139929930,False
891,validator_23,34970356997,True,245808000,230640,246038640,True
892,validator_22,66736713041,True,267001008,2206120,269207128,True
893,validator_5,66334246447,True,49826000,1389930,51215930,True
894,validator_9,34443795284,True,156009994,19284300,175294294,True
895,validator_47,66333061720,True,84487000,18684140,103171140,False
896,validator_32,34646030150,True,147027000,1885500,148912500,False
897,validator_18,98833456732,True,183173997,1171790,184345787,True
898,validator_35,98933931420,True,125909000,2055800,127964800,False
899,validator_48,162138766030,True,96145000,7781730,103926730,False
900,validator_37,66681784770,True,79907000,2052300,81959300,False
901,validator_18,98912244232,True,76473000,2314500,78787500,True
902,validator_47,66521398050,True,186445000,1891330,188336330,False
903,validator_8,34074081039,True,117330998,862130,118193128,True
904,validator_34,259401298730,True,121925000,194460,122119460,False
905,validator_9,34569432484,True,125538000,99200,125637200,True
906,validator_25,33364464580,True,77065000,7856800,84921800,False
907,validator_25,33401980660,True,37427000,89080,37516080,False
908,validator_44,99299159270,True,79662000,484000,80146000,False
909,validator_34,259495260210,True,91209000,2752480,93961480,False
910,validator_41,66600069710,True,137544000,1071190,138615190,False
911,validator_11,35525797029,True,73478999,914700,74393699,True
912,validator_41,66726465510,True,125537000,858800,126395800,False
913,validator_10,34628739368,True,113673997,1757590,115431587,True
914,validator_30,66643315040,True,153389000,1001040,154390040,False
915,validator_12,99182577926,True,129693002,3063020,132756022,True
916,validator_35,98985745320,True,51070000,743900,51813900,False
917,validator_23,35130887598,True,154875001,5655600,160530601,True
918,validator_13,34025658718,True,145897000,707530,146604530,True
919,validator_38,33632433380,True,91433000,2102900,93535900,False
920,validator_45,34379713780,True,121138000,544070,121682070,False
921,validator_47,66605786580,True,82411000,1977530,84388530,False
922,validator_8,34321294021,True,245604002,1608980,247212982,True
923,validator_41,66914050460,True,185780000,1804950,187584950,False
924,validator_37,66800407490,True,116661000,1961720,118622720,False
925,validator_45,34452666920,True,71950000,1003140,72953140,False
926,validator_39,34804198380,True,65360000,1638570,66998570,False
927,validator_2,35198663746,True,160119998,673520,160793518,True
928,validator_23,35241793689,True,110457001,449090,110906091,True
929,validator_48,162247789930,True,108786000,237900,109023900,False
930,validator_42,33871614780,True,125142000,24577100,149719100,False
931,validator_42,34013115260,True,132671000,8829480,141500480,False
932,validator_14,98854696876,True,65735006,1218570,66953576,True
933,validator_6,33713594831,True,104120002,1222540,105342542,True
934,validator_49,65397537270,True,63633000,5813800,69446800,False
935,validator_12,99387486542,True,203846996,1061620,204908616,True
936,validator_34,259658492410,True,160302000,2930200,163232200,False
937,validator_11,35768512326,True,233455997,9259300,242715297,True
938,validator_15,260396010403,True,66905998,954400,67860398,True
939,validator_18,99016490033,True,96431001,7814800,104245801,True
940,validator_9,34642067490,True,71810006,825000,72635006,True
941,validator_35,99050665440,True,61996000,2924120,64920120,False
942,validator_26,34032920640,True,72409000,1638000,74047000,False
943,validator_37,66883570710,True,70509000,12654220,83163220,False
944,validator_15,260577221689,True,179414996,1796290,181211286,True
945,validator_31,163398766200,True,52268000,20438680,72706680,False
946,validator_41,67066932360,True,133649000,19232900,152881900,False
947,validator_0,34361512748,True,143930001,652820,144582821,True
948,validator_4,34121384999,True,211383001,26764540,238147541,True
949,validator_9,34812209221,True,168511001,1630730,170141731,True
950,validator_49,65497608070,True,99802000,268800,100070800,False
951,validator_48,162327648610,True,79297000,561680,79858680,False
952,validator_14,98997685036,True,142444000,544160,142988160,True
953,validator_37,66976234640,True,91517000,1146930,92663930,False
954,validator_47,66805634980,True,189828000,10020400,199848400,False
955,validator_34,259768279950,True,108785000,1002540,109787540,False
956,validator_0,34601301348,True,239616000,172600,239788600,True
957,validator_33,33635415680,True,68646000,5301190,73947190,False
958,validator_25,33554410360,True,151905000,524700,152429700,False
959,validator_23,35347337891,True,105198002,346200,105544202,True
960,validator_34,259837712250,True,68940000,492300,69432300,False
961,validator_41,67225533900,True,158371000,230540,158601540,False
962,validator_8,34479798920,True,157917999,586900,158504899,True
963,validator_2,35405746322,True,201736996,5345580,207082576,True
964,validator_9,34922254222,True,107875001,2170000,110045001,True
965,validator_10,34758550864,True,129140006,671490,129811496,True
966,validator_17,163158132858,True,160129004,1097880,161226884,True
967,validator_27,98071253570,True,69264000,1048200,70312200,False
968,validator_37,67164841520,True,188386000,220880,188606880,False
969,validator_21,65796710282,True,230350004,20478100,250828104,True
970,validator_14,99150703733,True,151900997,1117700,153018697,True
971,validator_38,33727502280,True,76917000,18151900,95068900,False
972,validator_5,66430914248,True,86393001,10274800,96667801,True
973,validator_17,163253545256,True,93792998,1619400,95412398,True
974,validator_28,33855316550,True,94562000,913540,95475540,False
975,validator_17,163399808337,True,137815001,8448080,146263081,True
976,validator_22,66886974060,True,149864999,396020,150261019,True
977,validator_22,66982702623,True,94435003,1293560,95728563,True
978,validator_34,259879784180,True,41794000,277930,42071930,False
979,validator_35,99164313620,True,112812000,836180,113648180,False
980,validator_8,34526535911,True,44614001,2122990,46736991,True
981,validator_49,65559238870,True,61083000,547800,61630800,False
982,validator_12,99489727242,True,101949000,291700,102240700,True
983,validator_26,34179130040,True,144318000,1891400,146209400,False
984,validator_14,99333484153,True,181259000,1521420,182780420,True
985,validator_14,99562074769,True,227209996,1380620,228590616,True
986,validator_48,162618436970,True,289525000,1263360,290788360,False
987,validator_34,259966793580,True,86124000,885400,87009400,False
988,validator_28,33913791790,True,57673000,802240,58475240,False
989,validator_47,66952857880,True,146450000,772900,147222900,False
990,validator_13,34229644723,True,185584995,18401010,203986005,True
991,validator_3,34981152976,True,172691001,744820,173435821,True
992,validator_15,260707944197,True,128414998,2307510,130722508,True
993,validator_40,34231297480,True,99244000,8426300,107670300,False
994,validator_17,163507699338,True,99874001,8017000,107891001,True
995,validator_8,34703632349,True,175799998,1296440,177096438,True
996,validator_30,66738260840,True,94102000,843800,94945800,False
997,validator_24,33927749442,True,68934003,266600,69200603,True
998,validator_16,33926773638,True,80183002,697200,80880202,True
999,validator_29,33383464730,True,87119000,1915680,89034680,False
1000,validator_31,163554590500,True,137226000,18598300,155824300,False
1001,validator_7,67359059404,True,65362000,549800,65911800,True
1002,validator_44,99346794370,True,46888000,747100,47635100,False
1003,validator_15,260813515815,True,98049998,7521620,105571618,True
1004,validator_37,67286445520,True,102981000,18623000,121604000,False
1005,validator_49,65741041870,True,160128000,21675000,181803000,False
1006,validator_12,99643735762,True,135137000,18871520,154008520,True
1007,validator_43,65885741540,True,51375000,1066500,52441500,False
1008,validator_17,163599525264,True,83072006,8753920,91825926,True
1009,validator_37,67413648220,True,125012000,2190700,127202700,False
1010,validator_24,34112686737,True,182581995,2355300,184937295,True
1011,validator_32,34778508190,True,132353000,125040,132478040,False
1012,validator_27,98261113470,True,170359000,19500900,189859900,False
1013,validator_42,34181836240,True,168513000,207980,168720980,False
1014,validator_20,34386190078,True,245811001,1141950,246952951,True
1015,validator_27,98338762310,True,73847000,3801840,77648840,False
1016,validator_34,260029218280,True,53030000,9394700,62424700,False
1017,validator_30,66814784440,True,75489000,1034600,76523600,False
1018,validator_4,34316129201,True,175496002,19248200,194744202,True
1019,validator_25,33637237690,True,80258000,2569330,82827330,False
1020,validator_34,260151952330,True,120621000,2113050,122734050,False
1021,validator_17,163685523622,True,85392998,605360,85998358,True
1022,validator_34,260195735860,True,38875000,4908530,43783530,False
1023,validator_37,67593866220,True,179581000,637000,180218000,False
1024,validator_11,35914482828,True,144365002,1605500,145970502,True
1025,validator_35,99261338740,True,96428000,597120,97025120,False
1026,validator_34,260283873160,True,87500000,637300,88137300,False
1027,validator_47,67009140180,True,36642000,19640300,56282300,False
1028,validator_42,34267558040,True,84756000,965800,85721800,False
1029,validator_45,34524648120,True,71719000,262200,71981200,False
1030,validator_13,34372870142,True,142457999,767420,143225419,True
1031,validator_27,98400542510,True,60794000,986200,61780200,False
1032,validator_14,99652717510,True,89344001,1298740,90642741,True
1033,validator_28,33977966920,True,62153000,2022130,64175130,False
1034,validator_10,34933130968,True,173210004,1370100,174580104,True
1035,validator_14,99886432106,True,232525996,1188600,233714596,True
1036,validator_19,66603100325,True,105836999,2771940,108608939,True
1037,validator_27,98526045640,True,120435000,5068130,125503130,False
1038,validator_13,34455794350,True,82556998,367210,82924208,True
1039,validator_48,162683804980,True,59505000,5863010,65368010,False
1040,validator_1,67101375712,True,177864004,2187630,180051634,True
1041,validator_45,34620058770,True,94579000,831650,95410650,False
1042,validator_36,97324998090,True,108345000,2231120,110576120,False
1043,validator_10,34976926769,True,43659001,136800,43795801,True
1044,validator_30,66969410140,True,152099000,2526700,154625700,False
1045,validator_11,36069611806,True,155017998,110980,155128978,True
1046,validator_26,34293326440,True,95250000,18946400,114196400,False
1047,validator_39,34893311180,True,87976000,1136800,89112800,False
1048,validator_19,66774437514,True,169342999,1994190,171337189,True
1049,validator_1,67261155806,True,144987994,14792100,159780094,True
1050,validator_22,67113273821,True,120897998,9673200,130571198,True
1051,validator_6,33828564848,True,113584997,1385020,114970017,True
1052,validator_1,67338229163,True,69265997,7807360,77073357,True
1053,validator_48,162822243010,True,136437000,2001030,138438030,False
1054,validator_26,34418235340,True,120134000,4774900,124908900,False
1055,validator_22,67247129820,True,132851999,1004000,133855999,True
1056,validator_10,35092448654,True,110322995,5198890,115521885,True
1057,validator_37,67711152210,True,116683000,602990,117285990,False
1058,validator_2,35603705420,True,195704998,2254100,197959098,True
1059,validator_39,35009150980,True,115355000,484800,115839800,False
1060,validator_40,34327144680,True,93989000,1858200,95847200,False
1061,validator_44,99480071470,True,132013000,1264100,133277100,False
1062,validator_5,66572459720,True,140083002,1462470,141545472,True
1063,validator_7,67519693908,True,158833004,1801500,160634504,True
1064,validator_40,34427291180,True,88290000,11856500,100146500,False
1065,validator_21,65901646800,True,95790998,9145520,104936518,True
1066,validator_18,99120879640,True,103332007,1057600,104389607,True
1067,validator_3,35091410975,True,108968999,1289000,110257999,True
1068,validator_22,67404851714,True,149515994,8205900,157721894,True
1069,validator_16,34047518564,True,94769996,25974930,120744926,True
1070,validator_22,67480070288,True,73823004,1395570,75218574,True
1071,validator_30,67146342280,True,150786000,26146140,176932140,False
1072,validator_25,33876218690,True,236415000,2566000,238981000,False
1073,validator_8,34776770550,True,72910001,228200,73138201,True
1074,validator_8,34832663140,True,54341000,1551590,55892590,True
1075,validator_26,34568398960,True,148728000,1435620,150163620,False
1076,validator_48,162873905610,True,50693000,969600,51662600,False
1077,validator_21,65982611301,True,79990001,974500,80964501,True
1078,validator_14,99986715827,True,98836001,1447720,100283721,True
1079,validator_29,33501884410,True,117873000,546680,118419680,False
1080,validator_20,34563045550,True,175753002,1102470,176855472,True
1081,validator_37,67845106540,True,129254000,4700330,133954330,False
1082,validator_2,35939510557,True,333713997,2091140,335805137,True
1083,validator_14,100061608701,True,62048004,12844870,74892874,True
1084,validator_47,67059125780,True,48142000,1843600,49985600,False
1085,validator_48,162986290310,True,111636000,748700,112384700,False
1086,validator_32,34888075010,True,101139000,8427820,109566820,False
1087,validator_2,36218277848,True,259651001,19116290,278767291,True
1088,validator_30,67252712780,True,87922000,18448500,106370500,False
1089,validator_41,67277245620,True,47128000,4583720,51711720,False
1090,validator_1,67427693883,True,87868000,1596720,89464720,True
1091,validator_19,66954220814,True,159333000,20450300,179783300,True
1092,validator_41,67376353460,True,79903000,19204840,99107840,False
1093,validator_20,34644814449,True,80073999,1694900,81768899,True
1094,validator_18,99238965744,True,117335004,751100,118086104,True
1095,validator_13,34563458090,True,106958000,705740,107663740,True
1096,validator_33,33784417520,True,141024000,7977840,149001840,False
1097,validator_49,65822010370,True,79153000,1815500,80968500,False
1098,validator_29,33651339350,True,148264000,1190940,149454940,False
1099,validator_31,163719639420,True,164060000,988920,165048920,False
1100,validator_34,260405066060,True,118592000,2600900,121192900,False
1101,validator_33,33864896720,True,79725000,754200,80479200,False
1102,validator_19,67152451742,True,197127998,1102930,198230928,True
1103,validator_3,35239517217,True,142856002,5250240,148106242,True
1104,validator_25,33996653390,True,118740000,1694700,120434700,False
1105,validator_2,36298335846,True,74833998,5224000,80057998,True
1106,validator_44,99524738600,True,43613000,1054130,44667130,False
1107,validator_18,99329303242,True,88059998,2277500,90337498,True
1108,validator_14,100205834894,True,139158993,5067200,144226193,True
1109,validator_35,99452400040,True,190061000,1000300,191061300,False
1110,validator_5,66655170118,True,80836998,1873400,82710398,True
1111,validator_42,34361931740,True,93159000,1214700,94373700,False
1112,validator_8,34917625131,True,84045001,916990,84961991,True
1113,validator_17,163773248512,True,86114000,1610890,87724890,True
1114,validator_4,34510235404,True,189601003,4505200,194106203,True
1115,validator_48,163059072810,True,72453000,329500,72782500,False
1116,validator_45,34722309500,True,101178000,1072730,102250730,False
1117,validator_39,35168761680,True,158355000,1255700,159610700,False
1118,validator_12,99851641368,True,189735006,18170600,207905606,True
1119,validator_24,34205539537,True,92804000,48800,92852800,True
1120,validator_20,34773039814,True,122290995,5934370,128225365,True
1121,validator_43,65944709440,True,51034000,7933900,58967900,False
1122,validator_40,34566630210,True,133604000,5735030,139339030,False
1123,validator_43,66076367740,True,122134000,9524300,131658300,False
1124,validator_10,35249166155,True,156242001,475500,156717501,True
1125,validator_46,98379356540,True,72105000,594900,72699900,False
1126,validator_36,97485236690,True,159052000,1186600,160238600,False
1127,validator_19,67372556272,True,219956000,148530,220104530,True
1128,validator_1,67665577924,True,237811001,73040,237884041,True
1129,validator_27,98626747140,True,98963000,1738500,100701500,False
1130,validator_4,34596604806,True,74418002,11951400,86369402,True
1131,validator_44,99670229390,True,143395000,2095790,145490790,False
1132,validator_32,34934596600,True,45785000,736590,46521590,False
1133,validator_15,260963603015,True,149381000,706200,150087200,True
1134,validator_15,261092201882,True,120198997,8399870,128598867,True
1135,validator_28,34198582320,True,202440000,18175400,220615400,False
1136,validator_25,34065250570,True,65399000,3198180,68597180,False
1137,validator_39,35262216810,True,91885000,1570130,93455130,False
1138,validator_1,67750371102,True,84191998,601180,84793178,True
1139,validator_6,33946594746,True,115681998,2347900,118029898,True
1140,validator_25,34196365470,True,130987000,127900,131114900,False
1141,validator_30,67311096280,True,56930000,1453500,58383500,False
1142,validator_32,35083609030,True,147699000,1313430,149012430,False
1143,validator_34,260518746160,True,105019000,8661100,113680100,False
1144,validator_12,99957985567,True,105409999,934200,106344199,True
1145,validator_2,36396977435,True,97387999,1253590,98641589,True
1146,validator_7,67695644150,True,174022002,1928240,175950242,True
1147,validator_41,67436576580,True,58127000,2096120,60223120,False
1148,validator_18,99419146818,True,71005996,18837580,89843576,True
1149,validator_22,67610273810,True,129627002,576520,130203522,True
1150,validator_35,99644472870,True,191794000,278830,192072830,False
1151,validator_44,99854226560,True,182576000,1421170,183997170,False
1152,validator_9,35084739953,True,140474001,22011730,162485731,True
1153,validator_28,34257698550,True,52145000,6971230,59116230,False
1154,validator_19,67527093502,True,152975000,1562230,154537230,True
1155,validator_2,36566446733,True,169293998,175300,169469298,True
1156,validator_3,35298935405,True,53702998,5715190,59418188,True
1157,validator_15,261198134383,True,87119001,18813500,105932501,True
1158,validator_9,35231083629,True,144790996,1552680,146343676,True
1159,validator_0,34831871647,True,224656999,5913300,230570299,True
1160,validator_44,99947979420,True,86119000,7633860,93752860,False
1161,validator_13,34653010190,True,87476000,2076100,89552100,True
1162,validator_25,34327095710,True,126822000,3908240,130730240,False
1163,validator_38,33776664380,True,47046000,2116100,49162100,False
1164,validator_32,35155476630,True,71473000,394600,71867600,False
1165,validator_8,35021010531,True,102798000,587400,103385400,True
1166,validator_39,35372496210,True,109828000,451400,110279400,False
1167,validator_40,34702453710,True,130611000,5212500,135823500,False
1168,validator_7,67775325281,True,60967001,18714130,79681131,True
1169,validator_16,34165037462,True,109004998,8513900,117518898,True
1170,validator_49,65909315170,True,85036000,2268800,87304800,False
1171,validator_11,36273713128,True,203188002,913320,204101322,True
1172,validator_15,261309887610,True,86184007,25569220,111753227,True
1173,validator_8,35249451214,True,204212003,24228680,228440683,True
1174,validator_18,99605655817,True,185399999,1109000,186508999,True
1175,validator_5,66714876247,True,59054999,651130,59706129,True
1176,validator_19,67708064403,True,179301001,1669900,180970901,True
1177,validator_37,67930431720,True,83168000,2157180,85325180,False
1178,validator_27,98668478840,True,41031000,700700,41731700,False
1179,validator_23,35539194994,True,190836003,1021100,191857103,True
1180,validator_0,34887597743,True,55092996,633100,55726096,True
1181,validator_33,34001189640,True,117328000,18964920,136292920,False
1182,validator_37,68025987050,True,94304000,1251330,95555330,False
1183,validator_48,163161773950,True,100816000,1885140,102701140,False
1184,validator_1,67920341901,True,134012999,35957800,169970799,True
1185,validator_15,261385366235,True,74808995,669630,75478625,True
1186,validator_26,34648796840,True,79432000,965880,80397880,False
1187,validator_3,35486646631,True,186203006,1508220,187711226,True
1188,validator_47,67180055210,True,119533000,1396430,120929430,False
1189,validator_37,68161330450,True,133483000,1860400,135343400,False
1190,validator_16,34261049554,True,93124002,2888090,96012092,True
1191,validator_38,33924458310,True,144017000,3776930,147793930,False
1192,validator_47,67290701610,True,107214000,3432400,110646400,False
1193,validator_5,66823178479,True,106776002,1526230,108302232,True
1194,validator_20,35040331714,True,265375000,1916900,267291900,True
1195,validator_4,34838397644,True,236715998,5076840,241792838,True
1196,validator_6,34117712648,True,170712002,405900,171117902,True
1197,validator_0,35096223001,True,207608998,1016260,208625258,True
1198,validator_6,34247403052,True,111939004,17751400,129690404,True
1199,validator_5,66967218883,True,124152004,19888400,144040404,True
1200,validator_36,97555249440,True,69463000,549750,70012750,False
1201,validator_30,67472697180,True,151823000,9777900,161600900,False
1202,validator_26,34739346640,True,81509000,9040800,90549800,False
1203,validator_43,66250383880,True,168753000,5263140,174016140,False
1204,validator_35,99737434410,True,91677000,1284540,92961540,False
1205,validator_47,67474178810,True,181685000,1792200,183477200,False
1206,validator_35,99903741930,True,164881000,1426520,166307520,False
1207,validator_25,34350253110,True,22715000,442400,23157400,False
1208,validator_43,66339359170,True,87079000,1896290,88975290,False
1209,validator_8,35543536587,True,275520003,18565370,294085373,True
1210,validator_33,34083487410,True,81814000,483770,82297770,False
1211,validator_45,34883243200,True,158547000,2386700,160933700,False
1212,validator_5,67078903302,True,110035999,1648420,111684419,True
1213,validator_16,34646221754,True,379738000,5434200,385172200,True
1214,validator_8,35600591587,True,55876000,1179000,57055000,True
1215,validator_30,67587256920,True,108948000,5611740,114559740,False
1216,validator_37,68320700800,True,158255000,1115350,159370350,False
1217,validator_12,100041966466,True,83673999,306900,83980899,True
1218,validator_18,99706314920,True,100178003,481100,100659103,True
1219,validator_36,97652383300,True,95562000,1571860,97133860,False
1220,validator_25,34521230710,True,165792000,5185600,170977600,False
1221,validator_43,66449776470,True,108409000,2008300,110417300,False
1222,validator_6,34424805764,True,176984002,418710,177402712,True
1223,validator_43,66624749390,True,173600000,1372920,174972920,False
1224,validator_12,100302550763,True,259597997,986300,260584297,True
1225,validator_47,67618240810,True,140905000,3157000,144062000,False
1226,validator_34,260649297850,True,128771000,1780690,130551690,False
1227,validator_40,34851875200,True,148727000,694490,149421490,False
1228,validator_19,67835453103,True,126881000,507700,127388700,True
1229,validator_5,67230398780,True,148635998,2859480,151495478,True
1230,validator_28,34373719040,True,103313000,12707490,116020490,False
1231,validator_20,35178988837,True,137474003,1183120,138657123,True
1232,validator_4,34941142941,True,101571997,1173300,102745297,True
1233,validator_29,33799618050,True,147759000,519700,148278700,False
1234,validator_8,35828928491,True,227393004,943900,228336904,True
1235,validator_45,34949201700,True,65443000,515500,65958500,False
1236,validator_19,67957942288,True,122272005,217180,122489185,True
1237,validator_34,260813500680,True,162168000,2034830,164202830,False
1238,validator_40,34986347100,True,131145000,3326900,134471900,False
1239,validator_35,99937914830,True,33112000,1060900,34172900,False
1240,validator_37,68423726800,True,102756000,270000,103026000,False
1241,validator_13,34738772507,True,85038997,723320,85762317,True
1242,validator_43,66765644950,True,140568000,327560,140895560,False
1243,validator_21,66106436601,True,123130000,695300,123825300,True
1244,validator_15,261412921935,True,27309000,246700,27555700,True
1245,validator_42,34521565270,True,156782000,2851530,159633530,False
1246,validator_13,34894118286,True,154726999,618780,155345779,True
1247,validator_1,68022125700,True,101191999,591800,101783799,True
1248,validator_10,35413661718,True,163995993,499570,164495563,True
1249,validator_44,100043422060,True,94118000,1324640,95442640,False
1250,validator_25,34608044440,True,85650000,1163730,86813730,False
1251,validator_8,36057640493,True,210791002,17921000,228712002,True
1252,validator_35,100040821620,True,101780000,1126790,102906790,False
1253,validator_12,100448317505,True,143478002,2288740,145766742,True
1254,validator_17,163962537710,True,171732998,17556200,189289198,True
1255,validator_19,68117600581,True,159106993,551300,159658293,True
1256,validator_44,100100291860,True,55146000,1723800,56869800,False
1257,validator_2,36683113439,True,115811996,854710,116666706,True
1258,validator_2,36859670154,True,174546995,2009720,176556715,True
1259,validator_14,100347280114,True,123452000,17993220,141445220,True
1260,validator_35,100209890740,True,167424000,1645120,169069120,False
1261,validator_19,68297708995,True,162146004,17962410,180108414,True
1262,validator_26,34832946420,True,92766000,833780,93599780,False
1263,validator_25,34694966340,True,84711000,2210900,86921900,False
1264,validator_24,34445377535,True,239032998,805000,239837998,True
1265,validator_46,98476484140,True,95714000,1413600,97127600,False
1266,validator_36,97786094920,True,132070000,1641620,133711620,False
1267,validator_13,35042703154,True,147703008,881860,148584868,True
1268,validator_34,260879667410,True,65548000,618730,66166730,False
1269,validator_8,36197585908,True,121340995,18604420,139945415,True
1270,validator_0,35195367803,True,97055002,2089800,99144802,True
1271,validator_23,35818119724,True,278391000,533730,278924730,True
1272,validator_44,100134889920,True,33170000,1428060,34598060,False
1273,validator_27,98739668930,True,68643000,2547090,71190090,False
1274,validator_33,34197301410,True,113407000,407000,113814000,False
1275,validator_17,164125219350,True,161471000,1210640,162681640,True
1276,validator_3,35564257319,True,77023998,586690,77610688,True
1277,validator_34,260994155340,True,111296000,3191930,114487930,False
1278,validator_44,100236666600,True,100802000,974680,101776680,False
1279,validator_42,34573559750,True,51119000,875480,51994480,False
1280,validator_14,100443124210,True,94972996,871100,95844096,True
1281,validator_44,100328852900,True,91112000,1074300,92186300,False
1282,validator_12,100563949205,True,110509000,5122700,115631700,True
1283,validator_2,36967302172,True,105609998,2022020,107632018,True
1284,validator_20,35258361520,True,78214003,1158680,79372683,True
1285,validator_31,163866471620,True,142356000,4476200,146832200,False
1286,validator_10,35650425131,True,234863003,1900410,236763413,True
1287,validator_34,261128328840,True,108749000,25424500,134173500,False
1288,validator_41,67573016110,True,133572000,2867530,136439530,False
1289,validator_22,67824623106,True,190783996,23565300,214349296,True
1290,validator_12,100644315108,True,80164003,201900,80365903,True
1291,validator_17,164212753650,True,87170000,364300,87534300,True
1292,validator_26,34958794150,True,109892000,15955730,125847730,False
1293,validator_3,35757877620,True,192610001,1010300,193620301,True
1294,validator_32,35238304930,True,82455000,373300,82828300,False
1295,validator_32,35298970900,True,59497000,1168970,60665970,False
1296,validator_34,261254026020,True,123784000,1913180,125697180,False
1297,validator_48,163294163290,True,130859000,1530340,132389340,False
1298,validator_2,37144581208,True,174514996,2764040,177279036,True
1299,validator_31,163922350400,True,39917000,15961780,55878780,False
1300,validator_21,66203302201,True,95503000,1362600,96865600,True
1301,validator_45,35061054100,True,109821000,2031400,111852400,False
1302,validator_0,35329851609,True,132121006,2362800,134483806,True
1303,validator_12,100729019228,True,63916000,20788120,84704120,True
1304,validator_38,34016361410,True,73958000,17945100,91903100,False
1305,validator_29,33926664610,True,119053000,7993560,127046560,False
1306,validator_8,36291064435,True,91994997,1483530,93478527,True
1307,validator_12,100873708660,True,143894002,795430,144689432,True
1308,validator_22,67892637003,True,66918997,1094900,68013897,True
1309,validator_29,34089753810,True,157935000,5154200,163089200,False
1310,validator_18,99843392811,True,135443001,1634890,137077891,True
1311,validator_42,34647890150,True,73969000,361400,74330400,False
1312,validator_17,164470361308,True,257208998,398660,257607658,True
1313,validator_2,37357150325,True,211652997,916120,212569117,True
1314,validator_32,35496881750,True,192668000,5242850,197910850,False
1315,validator_23,35927259230,True,107267006,1872500,109139506,True
1316,validator_45,35193821930,True,131397000,1370830,132767830,False
1317,validator_42,34790285490,True,139265000,3130340,142395340,False
1318,validator_41,67751289480,True,176546000,1727370,178273370,False
1319,validator_2,37413058524,True,54835999,1072200,55908199,True
1320,validator_34,261327738160,True,55600000,18112140,73712140,False
1321,validator_19,68381129124,True,82411999,1008130,83420129,True
1322,validator_35,100314525370,True,82070000,22564630,104634630,False
1323,validator_3,36010610940,True,250706000,2027320,252733320,True
1324,validator_19,68516571246,True,132489002,2953120,135442122,True
1325,validator_9,35356689533,True,123200004,2405900,125605904,True
1326,validator_40,35206807420,True,220067000,393320,220460320,False
1327,validator_18,99996138408,True,151015997,1729600,152745597,True
1328,validator_6,34788215284,True,356977000,6432520,363409520,True
1329,validator_41,67858277780,True,106464000,524300,106988300,False
1330,validator_48,163366806310,True,71475000,1168020,72643020,False
1331,validator_29,34236822510,True,145570000,1498700,147068700,False
1332,validator_1,68150211016,True,127464006,621310,128085316,True
1333,validator_41,67956046820,True,90997000,6772040,97769040,False
1334,validator_25,34747143840,True,50735000,1442500,52177500,False
1335,validator_4,35063845923,True,103189002,19513980,122702982,True
1336,validator_40,35261762220,True,53674000,1280800,54954800,False
1337,validator_28,34473192610,True,97364000,2109570,99473570,False
1338,validator_2,37494157658,True,75212004,5887130,81099134,True
1339,validator_3,36151138977,True,118496997,22031040,140528037,True
1340,validator_32,35572502890,True,74483000,1138140,75621140,False
1341,validator_18,100136761106,True,139646998,975700,140622698,True
1342,validator_24,34590052134,True,143321999,1352600,144674599,True
1343,validator_8,36422480331,True,116417996,14997900,131415896,True
1344,validator_29,34338993210,True,101720000,450700,102170700,False
1345,validator_5,67428914182,True,195927002,2588400,198515402,True
1346,validator_10,35889332127,True,230115996,8791000,238906996,True
1347,validator_26,35068673450,True,108391000,1488300,109879300,False
1348,validator_27,98885930900,True,137035000,9226970,146261970,False
1349,validator_44,100502616900,True,173446000,318000,173764000,False
1350,validator_12,100969127059,True,94034999,1383400,95418399,True
1351,validator_28,34556313180,True,82433000,687570,83120570,False
1352,validator_22,67990554904,True,97514001,403900,97917901,True
1353,validator_39,35512054930,True,131330000,8228720,139558720,False
1354,validator_20,35405328362,True,144602012,2364830,146966842,True
1355,validator_9,35504122149,True,146172996,1259620,147432616,True
1356,validator_30,67734743720,True,145896000,1590800,147486800,False
1357,validator_18,100270090425,True,132357999,971320,133329319,True
1358,validator_38,34266232700,True,247985000,1886290,249871290,False
1359,validator_30,67802589520,True,65007000,2838800,67845800,False
1360,validator_25,34845332080,True,91467000,6721240,98188240,False
1361,validator_7,67817331841,True,40838000,1168560,42006560,True
1362,validator_24,34672791031,True,63713997,19024900,82738897,True
1363,validator_23,36181280926,True,251996006,2025690,254021696,True
1364,validator_20,35531512259,True,124863997,1319900,126183897,True
1365,validator_3,36310144313,True,157569996,1435340,159005336,True
1366,validator_32,35692734530,True,100229000,20002640,120231640,False
1367,validator_9,35769484180,True,263713001,1649030,265362031,True
1368,validator_49,66044319510,True,132929000,2075340,135004340,False
1369,validator_41,68134459020,True,159581000,18831200,178412200,False
1370,validator_10,36020958367,True,129362000,2264240,131626240,True
1371,validator_49,66136729040,True,91910000,499530,92409530,False
1372,validator_24,34789162013,True,114126002,2244980,116370982,True
1373,validator_46,98567657420,True,89980000,1193280,91173280,False
1374,validator_44,100701638790,True,197585000,1436890,199021890,False
1375,validator_15,261483871946,True,69466001,1484010,70950011,True
1376,validator_0,35439765112,True,109401003,512500,109913503,True
1377,validator_15,261694237287,True,209685001,680340,210365341,True
1378,validator_49,66360742760,True,216082000,7931720,224013720,False
1379,validator_32,35771577530,True,77395000,1448000,78843000,False
1380,validator_8,36630586130,True,202060999,6044800,208105799,True
1381,validator_27,98985532700,True,98666000,935800,99601800,False
1382,validator_4,35201855264,True,136274001,1735340,138009341,True
1383,validator_37,68524780740,True,100129000,924940,101053940,False
1384,validator_5,67656116797,True,224353995,2848620,227202615,True
1385,validator_19,68582655735,True,61560999,4523490,66084489,True
1386,validator_15,261747901505,True,52382998,1281220,53664218,True
1387,validator_34,261574491860,True,246332000,421700,246753700,False
1388,validator_19,68795852839,True,202841004,10356100,213197104,True
1389,validator_16,34794505555,True,147092001,1191800,148283801,True
1390,validator_36,97897169620,True,109026000,2048700,111074700,False
1391,validator_2,37659268551,True,163660003,1450890,165110893,True
1392,validator_34,261726340990,True,149159000,2690130,151849130,False
1393,validator_28,34611748350,True,47209000,8226170,55435170,False
1394,validator_9,35953544683,True,183279003,781500,184060503,True
1395,validator_8,36689239759,True,57390999,1262630,58653629,True
1396,validator_16,34883758454,True,86925999,2326900,89252899,True
1397,validator_23,36388999622,True,207492996,225700,207718696,True
1398,validator_31,164084767130,True,161710000,706730,162416730,False
1399,validator_21,66251345696,True,47294995,748500,48043495,True
1400,validator_43,66925867650,True,159743000,479700,160222700,False
1401,validator_12,101050813159,True,73056000,8630100,81686100,True
1402,validator_14,100657862756,True,193783006,20955540,214738546,True
1403,validator_11,36389525028,True,113917000,1894900,115811900,True
1404,validator_27,99168772700,True,182470000,770000,183240000,False
1405,validator_18,100394105165,True,123090000,924740,124014740,True
1406,validator_45,35256736270,True,61405000,1509340,62914340,False
1407,validator_24,34847141716,True,57897003,82700,57979703,True
1408,validator_15,261868945093,True,119443998,1599590,121043588,True
1409,validator_34,261863099180,True,129446000,7312190,136758190,False
1410,validator_4,35381245436,True,177140002,2250170,179390172,True
1411,validator_5,67843148137,True,185300010,1731330,187031340,True
1412,validator_22,68078204595,True,85903001,1746690,87649691,True
1413,validator_25,34994165200,True,147592000,1241120,148833120,False
1414,validator_21,66541306198,True,288698002,1262500,289960502,True
1415,validator_43,66998622150,True,60247000,12507500,72754500,False
1416,validator_41,68210273720,True,55690000,20124700,75814700,False
1417,validator_11,36508022894,True,117983996,513870,118497866,True
1418,validator_30,67930237220,True,125529000,2118700,127647700,False
1419,validator_1,68221928536,True,71022000,695520,71717520,True
1420,validator_44,100914096620,True,209548000,2909830,212457830,False
1421,validator_11,36609772094,True,100076000,1673200,101749200,True
1422,validator_38,34359558800,True,92090000,1236100,93326100,False
1423,validator_7,68051260633,True,233327002,601790,233928792,True
1424,validator_41,68342695920,True,131805000,617200,132422200,False
1425,validator_40,35407943990,True,136766000,9415770,146181770,False
1426,validator_23,36562669041,True,172343999,1325420,173669419,True
1427,validator_29,34414596240,True,64672000,10931030,75603030,False
1428,validator_37,68676671380,True,151158000,732640,151890640,False
1429,validator_18,100588372946,True,193598001,669780,194267781,True
1430,validator_21,66657766446,True,114846008,1614240,116460248,True
1431,validator_9,36055637277,True,97208004,4884590,102092594,True
1432,validator_49,66436886660,True,73832000,2311900,76143900,False
1433,validator_27,99261639400,True,92494000,372700,92866700,False
1434,validator_14,100814564558,True,155984002,717800,156701802,True
1435,validator_0,35597114617,True,156828995,520510,157349505,True
1436,validator_17,164678702742,True,207115004,1226430,208341434,True
1437,validator_46,98671218620,True,77980000,25581200,103561200,False
1438,validator_17,164928004339,True,243710997,5590600,249301597,True
1439,validator_26,35211233880,True,140692000,1868430,142560430,False
1440,validator_0,35682137355,True,58481998,26540740,85022738,True
1441,validator_17,165074326873,True,144257004,2065530,146322534,True
1442,validator_5,68092947540,True,249170003,629400,249799403,True
1443,validator_42,34851111390,True,60162000,663900,60825900,False
1444,validator_16,34925476954,True,41666000,52500,41718500,True
1445,validator_15,261976261481,True,105754998,1561390,107316388,True
1446,validator_47,67647838910,True,27655000,1943100,29598100,False
1447,validator_44,100950966420,True,36494000,375800,36869800,False
1448,validator_31,164147613450,True,62757000,89320,62846320,False
1449,validator_39,35665140630,True,151942000,1143700,153085700,False
1450,validator_23,36700055567,True,136900996,485530,137386526,True
1451,validator_40,35448010290,True,38311000,1755300,40066300,False
1452,validator_11,36819404394,True,209316000,316300,209632300,True
1453,validator_23,36821943469,True,121054002,833900,121887902,True
1454,validator_40,35559138630,True,109986000,1142340,111128340,False
1455,validator_1,68310417533,True,87423997,1065000,88488997,True
1456,validator_12,101193575798,True,141433999,1328640,142762639,True
1457,validator_14,100962925295,True,145953997,2406740,148360737,True
1458,validator_35,100437061970,True,120981000,1555600,122536600,False
1459,validator_34,261994074100,True,130158000,816920,130974920,False
1460,validator_30,68016605760,True,85097000,1271540,86368540,False
1461,validator_11,36923007594,True,102212000,1391200,103603200,True
1462,validator_27,99299599720,True,36872000,1088320,37960320,False
1463,validator_9,36099311077,True,42747000,926800,43673800,True
1464,validator_40,35724104350,True,163689000,1276720,164965720,False
1465,validator_27,99438228920,True,136789000,1840200,138629200,False
1466,validator_2,37762015258,True,100717007,2029700,102746707,True
1467,validator_20,35632140143,True,97360004,3267880,100627884,True
1468,validator_27,99536417160,True,96165000,2023240,98188240,False
1469,validator_35,100474765450,True,35892000,1811480,37703480,False
1470,validator_43,67186595350,True,179587000,8386200,187973200,False
1471,validator_3,36370912792,True,54830999,5937480,60768479,True
1472,validator_49,66528691700,True,89161000,2644040,91805040,False
1473,validator_21,66729054757,True,71019001,269310,71288311,True
1474,validator_15,262185052568,True,206274997,2516090,208791087,True
1475,validator_8,36971518456,True,262424997,19853700,282278697,True
1476,validator_41,68412846750,True,69526000,624830,70150830,False
1477,validator_32,35934560170,True,162554000,428640,162982640,False
1478,validator_46,98787449820,True,107818000,8413200,116231200,False
1479,validator_3,36500821594,True,122402002,7506800,129908802,True
1480,validator_45,35296871670,True,39060000,1075400,40135400,False
1481,validator_7,68183792832,True,131042999,1489200,132532199,True
1482,validator_19,68948485083,True,151495004,1137240,152632244,True
1483,validator_24,35047363715,True,199262999,959000,200221999,True
1484,validator_42,34941598510,True,88876000,1611120,90487120,False
1485,validator_27,99580328360,True,43240000,671200,43911200,False
1486,validator_6,34911446678,True,104924004,18307390,123231394,True
1487,validator_33,34335794310,True,137552000,940900,138492900,False
1488,validator_45,35466841710,True,168892000,1078040,169970040,False
1489,validator_20,35730676150,True,96953007,1583000,98536007,True
1490,validator_22,68160773630,True,81285005,1284030,82569035,True
1491,validator_34,262147569830,True,150966000,2529730,153495730,False
1492,validator_36,97968486920,True,68638000,2679300,71317300,False
1493,validator_20,35844416262,True,111149002,2591110,113740112,True
1494,validator_5,68253392310,True,159320000,1124770,160444770,True
1495,validator_48,163489882310,True,121497000,1579000,123076000,False
1496,validator_44,101074543720,True,122552000,1025300,123577300,False
1497,validator_17,165170761194,True,88612001,7822320,96434321,True
1498,validator_21,66824155632,True,94496005,604870,95100875,True
1499,validator_36,98090508650,True,113613000,8408730,122021730,False
1500,validator_14,101021321395,True,58280000,116100,58396100,True
1501,validator_29,34546394920,True,130291000,1507680,131798680,False
1502,validator_12,101395373226,True,201379998,417430,201797428,True
1503,validator_13,35163791750,True,115618996,5469600,121088596,True
1504,validator_48,163591521540,True,101247000,392230,101639230,False
1505,validator_36,98374051050,True,282538000,1004400,283542400,False
1506,validator_10,36104864569,True,81928002,1978200,83906202,True
1507,validator_47,67756174610,True,87473000,20862700,108335700,False
1508,validator_11,37042272917,True,105794003,13471320,119265323,True
1509,validator_14,101114513473,True,92199998,992080,93192078,True
1510,validator_15,262301549869,True,115957001,540300,116497301,True
1511,validator_39,35712302120,True,45770000,1391490,47161490,False
1512,validator_34,262242002230,True,93732000,700400,94432400,False
1513,validator_26,35287503510,True,75552000,717630,76269630,False
1514,validator_37,68717757870,True,39945000,1141490,41086490,False
1515,validator_44,101221580750,True,128025000,19012030,147037030,False
1516,validator_44,101342862550,True,118375000,2906800,121281800,False
1517,validator_31,164233140450,True,83329000,2198000,85527000,False
1518,validator_10,36248309341,True,142628002,816770,143444772,True
1519,validator_34,262298949130,True,56901000,45900,56946900,False
1520,validator_15,262377217171,True,56763002,18904300,75667302,True
1521,validator_2,37895200298,True,131395000,1790040,133185040,True
1522,validator_11,37152534119,True,110204002,57200,110261202,True
1523,validator_25,35220712340,True,219071000,7476140,226547140,False
1524,validator_2,37975505880,True,78847002,1458580,80305582,True
1525,validator_28,34652099780,True,40165000,186430,40351430,False
1526,validator_34,262394365760,True,93882000,1534630,95416630,False
1527,validator_37,68800022420,True,81701000,563550,82264550,False
1528,validator_12,101546572556,True,149698000,1501330,151199330,True
1529,validator_12,101792792084,True,244576998,1642530,246219528,True
1530,validator_11,37281962641,True,126564002,2864520,129428522,True
1531,validator_2,38163798904,True,170354994,17938030,188293024,True
1532,validator_11,37416601566,True,111714995,22923930,134638925,True
1533,validator_42,35069465110,True,95041000,32825600,127866600,False
1534,validator_36,98526656050,True,151830000,775000,152605000,False
1535,validator_21,67028430333,True,202613001,1661700,204274701,True
1536,validator_2,38454374853,True,290172999,402950,290575949,True
1537,validator_34,262459473140,True,60017000,5090380,65107380,False
1538,validator_24,35226944120,True,177740005,1840400,179580405,True
1539,validator_3,36704884633,True,203505999,557040,204063039,True
1540,validator_8,37070758154,True,96555998,2683700,99239698,True
1541,validator_34,262619786940,True,158397000,1916800,160313800,False
1542,validator_25,35290788670,True,68526000,1550330,70076330,False
1543,validator_10,36360151639,True,111198998,643300,111842298,True
1544,validator_17,165243793995,True,71522001,1510800,73032801,True
1545,validator_17,165372304876,True,127171001,1339880,128510881,True
1546,validator_41,68523059250,True,109942000,270500,110212500,False
1547,validator_10,36444990744,True,84407005,432100,84839105,True
1548,validator_5,68413178711,True,157199001,2587400,159786401,True
1549,validator_47,67891626040,True,134729000,722430,135451430,False
1550,validator_40,35865391450,True,140594000,693100,141287100,False
1551,validator_12,101950046782,True,156955998,298700,157254698,True
1552,validator_40,35931669450,True,65191000,1087000,66278000,False
1553,validator_0,35764759697,True,81612002,1010340,82622342,True
1554,validator_12,102117053301,True,166619999,386520,167006519,True
1555,validator_39,35789460120,True,54680000,22478000,77158000,False
1556,validator_7,68325004661,True,135700999,5510830,141211829,True
1557,validator_31,164301324350,True,68098000,85900,68183900,False
1558,validator_27,99649071760,True,66808000,1935400,68743400,False
1559,validator_32,36012646270,True,76591000,1495100,78086100,False
1560,validator_25,35406852560,True,90065000,25998890,116063890,False
1561,validator_49,66765826100,True,235899000,1235400,237134400,False
1562,validator_6,35098644839,True,186065001,1133160,187198161,True
1563,validator_0,35839034795,True,55657998,18617100,74275098,True
1564,validator_31,164467881030,True,165248000,1308680,166556680,False
1565,validator_16,35033317515,True,107129001,711560,107840561,True
1566,validator_17,165583118813,True,202433997,8379940,210813937,True
1567,validator_30,68161700200,True,143352000,1742440,145094440,False
1568,validator_19,69064447308,True,114094005,1868220,115962225,True
1569,validator_2,38631821151,True,152162998,25283300,177446298,True
1570,validator_27,99899738560,True,232668000,17998800,250666800,False
1571,validator_43,67231935850,True,44876000,464500,45340500,False
1572,validator_20,36044281763,True,198606001,1259500,199865501,True
1573,validator_48,163645671140,True,52996000,1153600,54149600,False
1574,validator_35,100621031830,True,143660000,2606380,146266380,False
1575,validator_38,34610301380,True,213582000,37160580,250742580,False
1576,validator_3,36898458656,True,191193003,2381020,193574023,True
1577,validator_39,35922385530,True,131702000,1223410,132925410,False
1578,validator_29,34654827520,True,102727000,5705600,108432600,False
1579,validator_24,35407956135,True,180020995,991020,181012015,True
1580,validator_27,100100376260,True,192366000,8271700,200637700,False
1581,validator_34,262799965340,True,179157000,1021400,180178400,False
1582,validator_23,37007896965,True,185133996,819500,185953496,True
1583,validator_4,35583999836,True,202124000,630400,202754400,True
1584,validator_16,35226236948,True,192236003,683430,192919433,True
1585,validator_40,36035585970,True,102397000,1519520,103916520,False
1586,validator_16,35436312149,True,204606001,5469200,210075201,True
1587,validator_38,34702757180,True,73920000,18535800,92455800,False
1588,validator_15,262591682553,True,199743002,14722380,214465382,True
1589,validator_14,101268703770,True,148200997,5989300,154190297,True
1590,validator_46,98892004670,True,103763000,791850,104554850,False
1591,validator_15,262678604465,True,85991002,930910,86921912,True
1592,validator_35,100785126530,True,158870000,5224700,164094700,False
1593,validator_41,68597584550,True,72734000,1791300,74525300,False
1594,validator_41,68750149580,True,151055000,1510030,152565030,False
1595,validator_8,37216152034,True,144534000,859880,145393880,True
1596,validator_47,67951717520,True,54431000,5660480,60091480,False
1597,validator_47,68032904160,True,79413000,1773640,81186640,False
1598,validator_31,164653589330,True,185469000,239300,185708300,False
1599,validator_15,263012154606,True,297340001,36210140,333550141,True
1600,validator_22,68358188447,True,178013997,19400820,197414817,True
1601,validator_6,35254424479,True,155404000,375640,155779640,True
1602,validator_43,67389105800,True,156373000,796950,157169950,False
1603,validator_18,100636077042,True,45852996,1851100,47704096,True
1604,validator_20,36181996170,True,118810007,18904400,137714407,True
1605,validator_26,35463555710,True,175011000,1041200,176052200,False
1606,validator_33,34410840010,True,74889000,156700,75045700,False
1607,validator_45,35522748130,True,54182000,1724420,55906420,False
1608,validator_30,68231316900,True,69128000,488700,69616700,False
1609,validator_7,68542691372,True,195533001,22153710,217686711,True
1610,validator_7,68645960483,True,95605001,7664110,103269111,True
1611,validator_20,36329921562,True,129256002,18669390,147925392,True
1612,validator_2,38742773129,True,110152998,798980,110951978,True
1613,validator_2,38898437919,True,120031000,35633790,155664790,True
1614,validator_8,37345613437,True,128329003,1132400,129461403,True
1615,validator_4,35700384238,True,111718002,4666400,116384402,True
1616,validator_36,98651965330,True,105465000,19844280,125309280,False
1617,validator_14,101402079064,True,115243994,18131300,133375294,True
1618,validator_15,263091107134,True,78801998,150530,78952528,True
1619,validator_46,98977521870,True,83810000,1707200,85517200,False
1620,validator_10,36569734062,True,124198998,544320,124743318,True
1621,validator_31,164723290330,True,69289000,412000,69701000,False
1622,validator_48,163739051590,True,92213000,1167450,93380450,False
1623,validator_26,35636519040,True,163312000,9651330,172963330,False
1624,validator_25,35499017960,True,91974000,191400,92165400,False
1625,validator_44,101439757950,True,88734000,8161400,96895400,False
1626,validator_12,102235483626,True,117558995,871330,118430325,True
1627,validator_41,68796424380,True,43817000,2457800,46274800,False
1628,validator_13,35247568393,True,75913003,7863640,83776643,True
1629,validator_29,34839193200,True,182934000,1431680,184365680,False
1630,validator_14,101495043566,True,91375002,1589500,92964502,True
1631,validator_30,68337391210,True,104932000,1142310,106074310,False
1632,validator_25,35561548440,True,54766000,7764480,62530480,False
1633,validator_13,35375929033,True,127576000,784640,128360640,True
1634,validator_18,100752283446,True,110711004,5495400,116206404,True
1635,validator_37,68905982420,True,98888000,7072000,105960000,False
1636,validator_29,34945483500,True,104395000,1895300,106290300,False
1637,validator_38,34799181180,True,95851000,573000,96424000,False
1638,validator_28,34732682780,True,79390000,1193000,80583000,False
1639,validator_5,68502853020,True,87437999,2236310,89674309,True
1640,validator_41,68930675250,True,133334000,916870,134250870,False
1641,validator_17,165832147123,True,230799000,18229310,249028310,True
1642,validator_13,35490944835,True,114385002,630800,115015802,True
1643,validator_33,34483938120,True,63935000,9163110,73098110,False
1644,validator_39,35994779520,True,71722000,671990,72393990,False
1645,validator_6,35421972580,True,159617001,7931100,167548101,True
1646,validator_21,67135689698,True,102005995,5253370,107259365,True
1647,validator_25,35635220880,True,72544000,1128440,73672440,False
1648,validator_43,67517996900,True,116736000,12155100,128891100,False
1649,validator_45,35722027730,True,198430000,849600,199279600,False
1650,validator_42,35190619230,True,101138000,20016120,121154120,False
1651,validator_35,100915837250,True,129597000,1113720,130710720,False
1652,validator_5,68650702185,True,147265005,584160,147849165,True
1653,validator_24,35477822940,True,69114005,752800,69866805,True
1654,validator_25,35786111880,True,149834000,1057000,150891000,False
1655,validator_6,35600969180,True,177140000,1856600,178996600,True
1656,validator_26,35857466640,True,202422000,18525600,220947600,False
1657,validator_44,101518055390,True,77957000,340440,78297440,False
1658,validator_42,35268027590,True,58665000,18743360,77408360,False
1659,validator_46,99111926360,True,133491000,913490,134404490,False
1660,validator_22,68455668072,True,96747995,731630,97479625,True
1661,validator_39,36139038150,True,143641000,617630,144258630,False
1662,validator_40,36152275650,True,114776000,1913680,116689680,False
1663,validator_14,101637622079,True,137972003,4606510,142578513,True
1664,validator_46,99263196480,True,149571000,1699120,151270120,False
1665,validator_13,35591972436,True,82123001,18904600,101027601,True
1666,validator_46,99367962480,True,96052000,8714000,104766000,False
1667,validator_42,35345930750,True,57707000,20196160,77903160,False
1668,validator_4,35861860952,True,160002994,1473720,161476714,True
1669,validator_28,34818806020,True,85278000,845240,86123240,False
1670,validator_12,102403804840,True,160208994,8112220,168321214,True
1671,validator_15,263445230733,True,335008999,19114600,354123599,True
1672,validator_14,101771438523,True,132788004,1028440,133816444,True
1673,validator_42,35426747610,True,79893000,923860,80816860,False
1674,validator_22,68540390710,True,65810998,18911640,84722638,True
1675,validator_16,35524696648,True,69338999,19045500,88384499,True
1676,validator_24,35561637735,True,83060995,753800,83814795,True
1677,validator_13,35728299036,True,136121000,205600,136326600,True
1678,validator_31,164799755370,True,75188000,1277040,76465040,False
1679,validator_15,263558060129,True,111887996,941400,112829396,True
1680,validator_15,263748128827,True,179813998,10254700,190068698,True
1681,validator_38,34964864770,True,164578000,1105590,165683590,False
1682,validator_33,34594724820,True,104738000,6048700,110786700,False
1683,validator_42,35586528210,True,157082000,2698600,159780600,False
1684,validator_39,36357284950,True,216974000,1272800,218246800,False
1685,validator_34,262991507940,True,190185000,1357600,191542600,False
1686,validator_49,66993292100,True,225213000,2253000,227466000,False
1687,validator_16,35604596635,True,57224997,22674990,79899987,True
1688,validator_7,68780006137,True,128665994,5379660,134045654,True
1689,validator_21,67254594233,True,89064005,29840530,118904535,True
1690,validator_27,100253805660,True,144188000,9241400,153429400,False
1691,validator_15,263987208155,True,238352998,726330,239079328,True
1692,validator_31,164896951270,True,96591000,604900,97195900,False
1693,validator_40,36318903150,True,164838000,1789500,166627500,False
1694,validator_18,100942970866,True,189427000,1260420,190687420,True
1695,validator_20,36450445664,True,119204002,1320100,120524102,True
1696,validator_34,263109399280,True,116984000,907340,117891340,False
1697,validator_32,36102981060,True,88244000,2090790,90334790,False
1698,validator_23,37256797005,True,238870000,10030040,248900040,True
1699,validator_15,264117432319,True,127352004,2872160,130224164,True
1700,validator_5,68914333783,True,261513998,2117600,263631598,True
1701,validator_32,36220245160,True,115911000,1353100,117264100,False
1702,validator_30,68454246910,True,80891000,35964700,116855700,False
1703,validator_7,68921194712,True,140070005,1118570,141188575,True
1704,validator_38,35064392310,True,98491000,1036540,99527540,False
1705,validator_12,102514964840,True,93414000,17746000,111160000,True
1706,validator_38,35310549660,True,244479000,1678350,246157350,False
1707,validator_48,163815176510,True,75510000,614920,76124920,False
1708,validator_7,68973557138,True,51406996,955430,52362426,True
1709,validator_48,163900436540,True,83911000,1349030,85260030,False
1710,validator_19,69243944835,True,178843997,653530,179497527,True
1711,validator_23,37382933800,True,125288995,847800,126136795,True
1712,validator_34,263184741410,True,70024000,5318130,75342130,False
1713,validator_7,69152712631,True,176268993,2886500,179155493,True
1714,validator_19,69332157638,True,86180003,2032800,88212803,True
1715,validator_49,67074471520,True,79312000,1867420,81179420,False
1716,validator_2,38979153746,True,80548997,166830,80715827,True
1717,validator_6,35818170411,True,214986001,2215230,217201231,True
1718,validator_1,68415957510,True,103554997,1984980,105539977,True
1719,validator_17,165883327714,True,50596001,584590,51180591,True
1720,validator_32,36351070600,True,128072000,2753440,130825440,False
1721,validator_29,35150068180,True,199648000,4936680,204584680,False
1722,validator_6,35937976714,True,119328003,478300,119806303,True
1723,validator_41,69010915550,True,80156000,84300,80240300,False
1724,validator_28,34907273720,True,69801000,18666700,88467700,False
1725,validator_39,36447335280,True,88895000,1155330,90050330,False
1726,validator_27,100369385550,True,114858000,721890,115579890,False
1727,validator_15,264330843413,True,211864994,1546100,213411094,True
1728,validator_14,101914408065,True,141806002,1163540,142969542,True
1729,validator_33,34704537160,True,109008000,804340,109812340,False
1730,validator_41,69056221050,True,44310000,995500,45305500,False
1731,validator_46,99477806580,True,109563000,281100,109844100,False
1732,validator_15,264460948213,True,125644000,4460800,130104800,True
1733,validator_32,36468852140,True,116198000,1583540,117781540,False
1734,validator_11,37586529999,True,168633993,1294440,169928433,True
1735,validator_3,36974740837,True,57294001,18988180,76282181,True
1736,validator_33,34839252320,True,134178000,537160,134715160,False
1737,validator_25,35864223070,True,76120000,1991190,78111190,False
1738,validator_45,35799206790,True,57826000,19353060,77179060,False
1739,validator_33,34919200600,True,79026000,922280,79948280,False
1740,validator_5,69072496589,True,157089996,1072810,158162806,True
1741,validator_37,69097942020,True,190394000,1565600,191959600,False
1742,validator_23,37507439165,True,121676005,2829360,124505365,True
1743,validator_44,101690314690,True,166077000,6182300,172259300,False
1744,validator_48,163985113840,True,84581000,96300,84677300,False
1745,validator_33,35007123400,True,87342000,580800,87922800,False
1746,validator_24,35679515226,True,110280001,7597490,117877491,True
1747,validator_44,101823063520,True,132017000,731830,132748830,False
1748,validator_27,100543214830,True,172475000,1354280,173829280,False
1749,validator_32,36587626810,True,109174000,9600670,118774670,False
1750,validator_22,68705228935,True,163060995,1777230,164838225,True
1751,validator_12,102605043240,True,89337000,741400,90078400,True
1752,validator_16,35639235537,True,34307002,331900,34638902,True
1753,validator_26,35925480640,True,62927000,5087000,68014000,False
1754,validator_30,68579701340,True,120545000,4909430,125454430,False
1755,validator_7,69324991062,True,170239001,2039430,172278431,True
1756,validator_22,68867580337,True,153290002,9061400,162351402,True
1757,validator_7,69560384062,True,232861000,2532000,235393000,True
1758,validator_35,101041744070,True,113090000,12816820,125906820,False
1759,validator_41,69141130850,True,83860000,1049800,84909800,False
1760,validator_40,36381516230,True,53789000,8824080,62613080,False
1761,validator_27,100596954100,True,52643000,1096270,53739270,False
1762,validator_19,69433413441,True,100157003,1098800,101255803,True
1763,validator_49,67136439350,True,60301000,1666830,61967830,False
1764,validator_1,68519831800,True,102668000,1206290,103874290,True
1765,validator_26,36057001850,True,95295000,36226210,131521210,False
1766,validator_31,165037684670,True,138858000,1875400,140733400,False
1767,validator_11,37736002029,True,139001000,10471030,149472030,True
1768,validator_45,35927314350,True,126052000,2055560,128107560,False
1769,validator_34,263366074640,True,175438000,5895230,181333230,False
1770,validator_23,37877274991,True,367318996,2516830,369835826,True
1771,validator_44,101885189060,True,61801000,324540,62125540,False
1772,validator_16,35908866038,True,250527001,19103500,269630501,True
1773,validator_23,38013576390,True,135907999,393400,136301399,True
1774,validator_5,69137577169,True,42673000,22407580,65080580,True
1775,validator_4,36039170957,True,169479005,7831000,177310005,True
1776,validator_35,101167792570,True,118376000,7672500,126048500,False
1777,validator_3,37213757598,True,237313001,1703760,239016761,True
1778,validator_14,102031067397,True,115453002,1206330,116659332,True
1779,validator_11,37852528931,True,115456002,1070900,116526902,True
1780,validator_36,98816794730,True,164203000,626400,164829400,False
1781,validator_33,35080537600,True,71936000,1478200,73414200,False
1782,validator_12,102750773940,True,144023000,1707700,145730700,True
1783,validator_49,67370541650,True,228504000,5598300,234102300,False
1784,validator_8,37573866279,True,228097002,155840,228252842,True
1785,validator_30,68660920390,True,79738000,1481050,81219050,False
1786,validator_46,99558971480,True,58916000,22248900,81164900,False
1787,validator_16,36053482530,True,142697002,1919490,144616492,True
1788,validator_24,35815064883,True,116655997,18893660,135549657,True
1789,validator_3,37380668328,True,165713000,1197730,166910730,True
1790,validator_9,36412094174,True,311376997,1406100,312783097,True
1791,validator_42,35687288310,True,100169000,591100,100760100,False
1792,validator_38,35395885160,True,84688000,647500,85335500,False
1793,validator_16,36260494255,True,181113995,25897730,207011725,True
1794,validator_19,69481852144,True,48016003,422700,48438703,True
1795,validator_7,69692111756,True,129736994,1990700,131727694,True
1796,validator_4,36211458859,True,170946002,1341900,172287902,True
1797,validator_13,35855376379,True,125281003,1796340,127077343,True
1798,validator_16,36326053986,True,63549001,2010730,65559731,True
1799,validator_32,36708176550,True,119890000,659740,120549740,False
1800,validator_47,68200670490,True,166601000,1165330,167766330,False
1801,validator_34,263517773710,True,150905000,794070,151699070,False
1802,validator_3,37531615635,True,147634007,3313300,150947307,True
1803,validator_40,36489584320,True,107629000,439090,108068090,False
1804,validator_46,99755592580,True,195543000,1078100,196621100,False
1805,validator_14,102150046032,True,118534005,444630,118978635,True
1806,validator_24,35878558301,True,61464998,2028420,63493418,True
1807,validator_27,100752898460,True,155109000,835360,155944360,False
1808,validator_45,36168680750,True,231084000,10282400,241366400,False
1809,validator_49,67477495650,True,106009000,945000,106954000,False
1810,validator_11,37930948660,True,78313999,105730,78419729,True
1811,validator_0,36057298829,True,216313004,1951030,218264034,True
1812,validator_7,69897777526,True,204155000,1510770,205665770,True
1813,validator_13,35986899305,True,111053996,20468930,131522926,True
1814,validator_20,36663098192,True,212372998,279530,212652528,True
1815,validator_25,35911704850,True,46045000,1436780,47481780,False
1816,validator_40,36575598300,True,80765000,5248980,86013980,False
1817,validator_9,36581692477,True,169272003,326300,169598303,True
1818,validator_12,102812275280,True,61108000,393340,61501340,True
1819,validator_32,36928988630,True,219023000,1789080,220812080,False
1820,validator_33,35202015800,True,120700000,778200,121478200,False
1821,validator_5,69196117209,True,48933000,9607040,58540040,True
1822,validator_37,69189640020,True,90635000,1063000,91698000,False
1823,validator_7,70015591024,True,102748998,15064500,117813498,True
1824,validator_7,70072058025,True,55276001,1191000,56467001,True
1825,validator_46,99899787370,True,143369000,825790,144194790,False
1826,validator_9,36736135561,True,153070994,1372090,154443084,True
1827,validator_21,67407665531,True,152203998,867300,153071298,True
1828,validator_41,69324479650,True,175771000,7577800,183348800,False
1829,validator_27,100911781900,True,157270000,1613440,158883440,False
1830,validator_49,67610046740,True,123798000,8753090,132551090,False
1831,validator_6,36070639614,True,132086000,576900,132662900,True
1832,validator_5,69454370105,True,257073996,1178900,258252896,True
1833,validator_27,101020102900,True,107477000,844000,108321000,False
1834,validator_0,36145544824,True,81180995,7065000,88245995,True
1835,validator_42,35778920610,True,89928000,1704300,91632300,False
1836,validator_25,36026647760,True,113509000,1433910,114942910,False
1837,validator_35,101222704470,True,53566000,1345900,54911900,False
1838,validator_0,36234082922,True,80748998,7789100,88538098,True
1839,validator_13,36130613908,True,117741003,25973600,143714603,True
1840,validator_0,36319487127,True,85067005,337200,85404205,True
1841,validator_22,69022570068,True,153300001,1689730,154989731,True
1842,validator_40,36679764280,True,102873000,1292980,104165980,False
1843,validator_38,35509206280,True,112458000,863120,113321120,False
1844,validator_21,67488313735,True,78508004,2140200,80648204,True
1845,validator_27,101099679510,True,79257000,319610,79576610,False
1846,validator_49,67803743280,True,190583000,3113540,193696540,False
1847,validator_5,69582302002,True,125611997,2319900,127931897,True
1848,validator_35,101370965190,True,139848000,8412720,148260720,False
1849,validator_28,35027745140,True,119106000,1365420,120471420,False
1850,validator_27,101249361950,True,142607000,7075440,149682440,False
1851,validator_30,68766734290,True,105033000,780900,105813900,False
1852,validator_10,36627252463,True,56037001,1481400,57518401,True
1853,validator_22,69129800094,True,106381996,848030,107230026,True
1854,validator_35,101443788960,True,70431000,2392770,72823770,False
1855,validator_28,35241253970,True,176225000,37283830,213508830,False
1856,validator_15,264515254216,True,52803003,1503000,54306003,True
1857,validator_28,35360622670,True,101051000,18317700,119368700,False
1858,validator_8,37855452778,True,279706999,1879500,281586499,True
1859,validator_35,101490392580,True,44867000,1736620,46603620,False
1860,validator_26,36177501250,True,114339000,6160400,120499400,False
1861,validator_39,36585194610,True,136595000,1264330,137859330,False
1862,validator_31,165101823770,True,63723000,416100,64139100,False
1863,validator_21,67734717733,True,245911998,492000,246403998,True
1864,validator_12,102944878857,True,132064997,538580,132603577,True
1865,validator_7,70201166927,True,128283002,825900,129108902,True
1866,validator_5,69725564809,True,142748007,514800,143262807,True
1867,validator_21,67823072808,True,87124995,1230080,88355075,True
1868,validator_18,101110071969,True,166213003,888100,167101103,True
1869,validator_34,263673838390,True,154715000,1349680,156064680,False
1870,validator_22,69236232597,True,101501003,4931500,106432503,True
1871,validator_43,67636888200,True,117764000,1127300,118891300,False
1872,validator_8,38015617896,True,159523998,641120,160165118,True
1873,validator_15,264727499754,True,211226998,1018540,212245538,True
1874,validator_14,102271978263,True,116368001,5564230,121932231,True
1875,validator_15,264943939682,True,180803998,35635930,216439928,True
1876,validator_17,166284665414,True,393440000,7897700,401337700,True
1877,validator_42,35889173540,True,109937000,315930,110252930,False
1878,validator_10,36695784261,True,49931998,18599800,68531798,True
1879,validator_48,164079355440,True,71088000,23153600,94241600,False
1880,validator_15,265140388283,True,195445001,1003600,196448601,True
1881,validator_8,38164828992,True,148654996,556100,149211096,True
1882,validator_11,38108610546,True,177067996,593890,177661886,True
1883,validator_46,100032895040,True,131869000,1238670,133107670,False
1884,validator_44,101950442290,True,64296000,957230,65253230,False
1885,validator_42,36017876130,True,128482000,220590,128702590,False
1886,validator_4,36358129857,True,145409998,1261000,146670998,True
1887,validator_2,39127075544,True,147434998,486800,147921798,True
1888,validator_36,98926551950,True,91201000,18556220,109757220,False
1889,validator_38,35628960280,True,118953000,801000,119754000,False
1890,validator_32,37050038530,True,119390000,1659900,121049900,False
1891,validator_44,102160618390,True,182856000,27320100,210176100,False
1892,validator_21,67884693338,True,60839000,781530,61620530,True
1893,validator_43,67738354120,True,100186000,1279920,101465920,False
1894,validator_21,68022902357,True,136735999,1473020,138209019,True
1895,validator_16,36406121446,True,78327000,1740460,80067460,True
1896,validator_13,36297924138,True,166656000,654230,167310230,True
1897,validator_30,68953985630,True,185898000,1353340,187251340,False
1898,validator_37,69276967820,True,86040000,1287800,87327800,False
1899,validator_7,70352044127,True,150199000,678200,150877200,True
1900,validator_17,166443254741,True,150321007,8268320,158589327,True
1901,validator_42,36156938070,True,137955000,1106940,139061940,False
1902,validator_2,39367363945,True,239213001,1075400,240288401,True
1903,validator_39,36706916950,True,116261000,5461340,121722340,False
1904,validator_18,101324032471,True,213114002,846500,213960502,True
1905,validator_10,36792005101,True,95709000,511840,96220840,True
1906,validator_42,36247501900,True,89798000,765830,90563830,False
1907,validator_47,68362677330,True,160463000,1543840,162006840,False
1908,validator_13,36470227804,True,170132996,2170670,172303666,True
1909,validator_25,36193588660,True,165668000,1272900,166940900,False
1910,validator_44,102243367190,True,81167000,1581800,82748800,False
1911,validator_24,36009122033,True,128404002,2159730,130563732,True
1912,validator_48,164212578160,True,131667000,1555720,133222720,False
1913,validator_42,36400166520,True,148744000,3920620,152664620,False
1914,validator_0,36436458307,True,98613000,18358180,116971180,True
1915,validator_0,36629017503,True,176939006,15620190,192559196,True
1916,validator_5,69811479940,True,84736001,1179130,85915131,True
1917,validator_0,36920577145,True,291033992,525650,291559642,True
1918,validator_45,36292069250,True,120896000,2492500,123388500,False
1919,validator_41,69506739090,True,176200000,6059440,182259440,False
1920,validator_39,36863739490,True,145084000,11738540,156822540,False
1921,validator_42,36562676420,True,159759000,2750900,162509900,False
1922,validator_3,37710510130,True,160607995,18286500,178894495,True
1923,validator_33,35313272420,True,93261000,17995620,111256620,False
1924,validator_22,69319839530,True,77460003,6146930,83606933,True
1925,validator_25,36278189860,True,83763000,838200,84601200,False
1926,validator_11,38177860422,True,69018996,230880,69249876,True
1927,validator_20,36867284891,True,202622999,1563700,204186699,True
1928,validator_41,69618120020,True,109954000,1426930,111380930,False
1929,validator_44,102345988110,True,101260000,1360920,102620920,False
1930,validator_26,36282916550,True,104216000,1199300,105415300,False
1931,validator_35,101596192980,True,104367000,1433400,105800400,False
1932,validator_21,68267349888,True,243341001,1106530,244447531,True
1933,validator_13,36616983536,True,144911002,1844730,146755732,True
1934,validator_31,165194732810,True,92290000,619040,92909040,False
1935,validator_34,263790370170,True,114816000,1715780,116531780,False
1936,validator_32,37192224300,True,139490000,2695770,142185770,False
1937,validator_1,68751481129,True,227362999,4286330,231649329,True
1938,validator_40,36792653390,True,112379000,510110,112889110,False
1939,validator_41,69750788150,True,130931000,1737130,132668130,False
1940,validator_33,35392973500,True,78899000,802080,79701080,False
1941,validator_47,68415317950,True,47421000,5219620,52640620,False
1942,validator_38,35721996120,True,91539000,1496840,93035840,False
1943,validator_6,36198537812,True,125673998,2224200,127898198,True
1944,validator_30,69053377030,True,96973000,2418400,99391400,False
1945,validator_34,263865209090,True,74743000,95920,74838920,False
1946,validator_4,36479367659,True,120945002,292800,121237802,True
1947,validator_23,38121844588,True,103231998,5036200,108268198,True
1948,validator_15,265308950723,True,166980000,1582440,168562440,True
1949,validator_3,37822771058,True,111893998,366930,112260928,True
1950,validator_25,36392291560,True,94648000,19453700,114101700,False
1951,validator_0,36970034895,True,47706000,1751750,49457750,True
1952,validator_34,263987240990,True,101244000,20787900,122031900,False
1953,validator_18,101521757568,True,187412997,10312100,197725097,True
1954,validator_37,69397581220,True,119774000,839400,120613400,False
1955,validator_42,36665312560,True,100690000,1946140,102636140,False
1956,validator_36,99057403380,True,127726000,3125430,130851430,False
1957,validator_49,67909595750,True,105055000,797470,105852470,False
1958,validator_23,38185461634,True,62260006,1357040,63617046,True
1959,validator_32,37351118060,True,157783000,1110760,158893760,False
1960,validator_37,69546900320,True,148811000,508100,149319100,False
1961,validator_33,35555383340,True,161897000,512840,162409840,False
1962,validator_15,265374780824,True,62611001,3219100,65830101,True
1963,validator_18,101684382768,True,144266000,18359200,162625200,True
1964,validator_16,36601035042,True,179671996,15241600,194913596,True
1965,validator_7,70571907869,True,211583002,8280740,219863742,True
1966,validator_6,36306202928,True,98652996,9012120,107665116,True
1967,validator_35,101772625320,True,173160000,3272340,176432340,False
1968,validator_26,36527000450,True,235131000,8952900,244083900,False
1969,validator_9,36987157561,True,249667000,1355000,251022000,True
1970,validator_49,68121270490,True,193558000,18116740,211674740,False
1971,validator_14,102321922212,True,48127999,1815950,49943949,True
1972,validator_33,35711420170,True,154831000,1205830,156036830,False
1973,validator_11,38360990527,True,174793995,8336110,183130105,True
1974,validator_2,39498032848,True,125451003,5217900,130668903,True
1975,validator_34,264099690690,True,104565000,7884700,112449700,False
1976,validator_45,36400437240,True,106751000,1616990,108367990,False
1977,validator_18,101797040886,True,111407998,1250120,112658118,True
1978,validator_8,38310007791,True,142703999,2474800,145178799,True
1979,validator_23,38336191127,True,149998003,731490,150729493,True
1980,validator_44,102556014600,True,207440000,2586490,210026490,False
1981,validator_27,101331380070,True,81264000,754120,82018120,False
1982,validator_16,36655202972,True,53472000,695930,54167930,True
1983,validator_0,37064274398,True,75170003,19069500,94239503,True
1984,validator_16,36766304175,True,110666003,435200,111101203,True
1985,validator_3,37893511024,True,68596996,2142970,70739966,True
1986,validator_36,99299437210,True,233336000,8697830,242033830,False
1987,validator_24,36102384552,True,92825999,436520,93262519,True
1988,validator_47,68476884750,True,60538000,1028800,61566800,False
1989,validator_28,35499965610,True,139240000,102940,139342940,False
1990,validator_35,101952623100,True,178508000,1489780,179997780,False
1991,validator_4,36626226552,True,145138993,1719900,146858893,True
1992,validator_0,37255766738,True,189579000,1913340,191492340,True
1993,validator_21,68327836389,True,60022001,464500,60486501,True
1994,validator_17,166532842838,True,85692997,3895100,89588097,True
1995,validator_27,101516278190,True,164625000,20273120,184898120,False
1996,validator_46,100101807740,True,67386000,1526700,68912700,False
1997,validator_2,39657158249,True,140330001,18795400,159125401,True
1998,validator_26,36589347150,True,43555000,18791700,62346700,False
1999,validator_9,37027963061,True,39617000,1188500,40805500,True
2000,validator_17,166646550130,True,113203002,504290,113707292,True
2001,validator_31,165323298490,True,127301000,1264680,128565680,False
2002,validator_14,102496152050,True,155456998,18772840,174229838,True
2003,validator_24,36147327056,True,43990004,952500,44942504,True
2004,validator_14,102763678720,True,265777000,1749670,267526670,True
2005,validator_31,165409046530,True,84507000,1241040,85748040,False
2006,validator_14,102901453126,True,134873006,2901400,137774406,True
2007,validator_29,35203510790,True,51608000,1834610,53442610,False
2008,validator_18,101917299383,True,118886997,1371500,120258497,True
2009,validator_19,69575517229,True,91576995,2088090,93665085,True
2010,validator_22,69443409722,True,118404002,5166190,123570192,True
2011,validator_37,69657675450,True,92439000,18336130,110775130,False
2012,validator_18,102048720283,True,130282000,1138900,131420900,True
2013,validator_42,36757005490,True,83842000,7850930,91692930,False
2014,validator_33,35829715250,True,115255000,3040080,118295080,False
2015,validator_42,36839848790,True,81796000,1047300,82843300,False
2016,validator_16,36972970873,True,205992998,673700,206666698,True
2017,validator_15,265494006324,True,117352000,1873500,119225500,True
2018,validator_19,69752930019,True,175350000,2062790,177412790,True
2019,validator_31,165496096930,True,86383000,667400,87050400,False
2020,validator_23,38409878029,True,70320002,3366900,73686902,True
2021,validator_34,264251780770,True,150277000,1813080,152090080,False
2022,validator_5,70017324189,True,203699009,2145240,205844249,True
2023,validator_6,36375606815,True,68511007,892880,69403887,True
2024,validator_34,264329921570,True,73138000,5002800,78140800,False
2025,validator_5,70177849067,True,137689998,22834880,160524878,True
2026,validator_24,36289078159,True,141431003,320100,141751103,True
2027,validator_33,35928626630,True,97660000,1251380,98911380,False
2028,validator_1,68895939028,True,143094999,1362900,144457899,True
2029,validator_10,36867653100,True,69662999,5985000,75647999,True
2030,validator_24,36367811860,True,70196001,8537700,78733701,True
2031,validator_27,101606224930,True,88649000,1297740,89946740,False
2032,validator_9,37103880759,True,73018998,2898700,75917698,True
2033,validator_10,36948297233,True,80044003,600130,80644133,True
2034,validator_8,38393630649,True,80343998,3278860,83622858,True
2035,validator_21,68454669284,True,125582995,1249900,126832895,True
2036,validator_34,264462227970,True,131689000,617400,132306400,False
2037,validator_28,35626500090,True,124828000,1706480,126534480,False
2038,validator_39,36934856590,True,69773000,1344100,71117100,False
2039,validator_6,36444388439,True,67988994,792630,68781624,True
2040,validator_38,35963895020,True,234924000,6974900,241898900,False
2041,validator_14,103038439725,True,136357999,628600,136986599,True
2042,validator_33,36060772450,True,124425000,7720820,132145820,False
2043,validator_26,36663171650,True,72032000,1792500,73824500,False
2044,validator_43,67804521160,True,64985000,1182040,66167040,False
2045,validator_14,103330392006,True,283764001,8188280,291952281,True
2046,validator_40,36869571590,True,76266000,652200,76918200,False
2047,validator_27,101742387830,True,117435000,18727900,136162900,False
2048,validator_40,36974875990,True,103212000,2092400,105304400,False
2049,validator_5,70387449584,True,209002997,597520,209600517,True
2050,validator_13,36820916138,True,202256002,1676600,203932602,True
2051,validator_47,68647430180,True,168724000,1821430,170545430,False
2052,validator_18,102138922580,True,89251997,950300,90202297,True
2053,validator_21,68565404581,True,108567997,2167300,110735297,True
2054,validator_39,36997528690,True,60702000,1970100,62672100,False
2055,validator_18,102255424321,True,115361001,1140740,116501741,True
2056,validator_14,103414261809,True,82942003,927800,83869803,True
2057,validator_38,36045030560,True,80366000,769540,81135540,False
2058,validator_9,37161961156,True,57767997,312400,58080397,True
2059,validator_1,68970456168,True,72247000,2270140,74517140,True
2060,validator_19,69841933117,True,81062998,7940100,89003098,True
2061,validator_45,36482120680,True,80331000,1352440,81683440,False
2062,validator_26,36782318180,True,117686000,1460530,119146530,False
2063,validator_23,38564558328,True,153648999,1031300,154680299,True
2064,validator_2,39735949648,True,76857999,1933400,78791399,True
2065,validator_27,101893880030,True,150898000,594200,151492200,False
2066,validator_38,36174974980,True,121265000,8679420,129944420,False
2067,validator_43,67924159460,True,118074000,1564300,119638300,False
2068,validator_32,37385099070,True,26083000,7898010,33981010,False
2069,validator_4,36795354149,True,167460997,1666600,169127597,True
2070,validator_1,69171147218,True,180641000,20050050,200691050,True
2071,validator_10,37006418351,True,57465998,655120,58121118,True
2072,validator_26,36969734010,True,186012000,1403830,187415830,False
2073,validator_27,101979194430,True,85070000,244400,85314400,False
2074,validator_27,102038514030,True,58017000,1302600,59319600,False
2075,validator_28,35789666490,True,127547000,35619400,163166400,False
2076,validator_44,102720933300,True,164798000,120700,164918700,False
2077,validator_6,36535523535,True,89789996,1345100,91135096,True
2078,validator_38,36243237620,True,60478000,7784640,68262640,False
2079,validator_48,164323009010,True,90441000,19989850,110430850,False
2080,validator_15,265554314105,True,59387001,920780,60307781,True
2081,validator_38,36314153550,True,70389000,526930,70915930,False
2082,validator_36,99512638640,True,213056000,145430,213201430,False
2083,validator_33,36196300150,True,129903000,5624700,135527700,False
2084,validator_17,166833924824,True,173886994,13487700,187374694,True
2085,validator_19,69967678213,True,123850996,1894100,125745096,True
2086,validator_19,70112663414,True,141118001,3867200,144985201,True
2087,validator_4,36936435542,True,133817993,7263400,141081393,True
2088,validator_17,166966871726,True,131335002,1611900,132946902,True
2089,validator_29,35325007690,True,121199000,297900,121496900,False
2090,validator_27,102159797930,True,119933000,1350900,121283900,False
2091,validator_33,36330802100,True,126248000,8253950,134501950,False
2092,validator_44,102786292800,True,62841000,2518500,65359500,False
2093,validator_28,35901512420,True,110574000,1271930,111845930,False
2094,validator_8,38526472483,True,131925994,915840,132841834,True
2095,validator_3,38050634204,True,156457000,666180,157123180,True
2096,validator_6,36655207313,True,118245998,1437780,119683778,True
2097,validator_42,36984163290,True,143909000,405500,144314500,False
2098,validator_42,37071429660,True,85274000,1992370,87266370,False
2099,validator_24,36471380857,True,102623997,945000,103568997,True
2100,validator_11,38480128084,True,116713997,2423560,119137557,True
2101,validator_48,164504851210,True,179884000,1958200,181842200,False
2102,validator_11,38634765784,True,153527000,1110700,154637700,True
2103,validator_15,265652023901,True,97210996,498800,97709796,True
2104,validator_48,164621202410,True,112728000,3623200,116351200,False
2105,validator_4,37077652937,True,135044995,6172400,141217395,True
2106,validator_29,35480593190,True,153010000,2575500,155585500,False
2107,validator_4,37179156238,True,99973001,1530300,101503301,True
2108,validator_48,164738857140,True,117440000,214730,117654730,False
2109,validator_33,36383805800,True,51408000,1595700,53003700,False
2110,validator_31,165613333870,True,107578000,9658940,117236940,False
2111,validator_41,69815550750,True,63975000,787600,64762600,False
2112,validator_34,264547607100,True,83654000,1725130,85379130,False
2113,validator_17,167042286560,True,74585004,829830,75414834,True
2114,validator_0,37529966263,True,246461005,27738520,274199525,True
2115,validator_40,37074846390,True,99266000,704400,99970400,False
2116,validator_27,102269361260,True,104253000,5310330,109563330,False
2117,validator_38,36484961890,True,150911000,19897340,170808340,False
2118,validator_7,70729985180,True,134983001,23094310,158077311,True
2119,validator_28,35986984110,True,82786000,2685690,85471690,False
2120,validator_36,99576841040,True,63394000,808400,64202400,False
2121,validator_45,36663617720,True,179782000,1715040,181497040,False
2122,validator_23,38724952532,True,157590004,2804200,160394204,True
2123,validator_24,36573628954,True,100795997,1452100,102248097,True
2124,validator_11,38748177287,True,112707003,704500,113411503,True
2125,validator_42,37265550660,True,186347000,7774000,194121000,False
2126,validator_36,99664028240,True,79546000,7641200,87187200,False
2127,validator_15,265736850067,True,83374996,1451170,84826166,True
2128,validator_6,36840572109,True,183071996,2292800,185364796,True
2129,validator_7,70928639869,True,197706999,947690,198654689,True
2130,validator_23,38813473269,True,87124997,1395740,88520737,True
2131,validator_31,165698483000,True,79392000,5757130,85149130,False
2132,validator_15,265823732056,True,84356999,2524990,86881989,True
2133,validator_47,68755933380,True,107286000,1217200,108503200,False
2134,validator_0,37622026066,True,90764003,1295800,92059803,True
2135,validator_41,69916659290,True,100436000,672540,101108540,False
2136,validator_5,70610215489,True,220902005,1863900,222765905,True
2137,validator_13,36987827436,True,130117998,36793300,166911298,True
2138,validator_44,102946021100,True,150707000,9021300,159728300,False
2139,validator_32,37454488590,True,68820000,569520,69389520,False
2140,validator_16,37048288912,True,74864999,453040,75318039,True
2141,validator_48,164801208180,True,61362000,989040,62351040,False
2142,validator_47,68916079810,True,155535000,4611430,160146430,False
2143,validator_45,36721060950,True,56667000,776230,57443230,False
2144,validator_44,103103340400,True,120222000,37097300,157319300,False
2145,validator_45,36894294680,True,171112000,2121730,173233730,False
2146,validator_21,68737420071,True,165695000,6320490,172015490,True
2147,validator_49,68261183010,True,129715000,10197520,139912520,False
2148,validator_10,37132013550,True,125131999,463200,125595199,True
2149,validator_40,37189228890,True,112999000,1383500,114382500,False
2150,validator_10,37225124567,True,91719997,1391020,93111017,True
2151,validator_1,69242954684,True,65868006,5939460,71807466,True
2152,validator_4,37318435598,True,138505000,774360,139279360,True
2153,validator_41,70079777870,True,160925000,2193580,163118580,False
2154,validator_9,37293509853,True,130888997,659700,131548697,True
2155,validator_35,102015337570,True,62422000,292470,62714470,False
2156,validator_5,70846345289,True,229030000,7099800,236129800,True
2157,validator_17,167214271229,True,169248999,2735670,171984669,True
2158,validator_3,38112383308,True,59895004,1854100,61749104,True
2159,validator_4,37431080056,True,110787008,1857450,112644458,True
2160,validator_22,69558257516,True,105776994,9070800,114847794,True
2161,validator_22,69676751215,True,117527999,965700,118493699,True
2162,validator_38,36606298090,True,119798000,1538200,121336200,False
2163,validator_14,103607041410,True,190159001,2620600,192779601,True
2164,validator_7,71020255038,True,90511999,1103170,91615169,True
2165,validator_40,37325689770,True,134461000,1999880,136460880,False
2166,validator_32,37594574070,True,138188000,1897480,140085480,False
2167,validator_26,37120879490,True,150769000,376480,151145480,False
2168,validator_15,266022369951,True,198128995,508900,198637895,True
2169,validator_39,37118716320,True,115262000,5925630,121187630,False
2170,validator_27,102364256160,True,93122000,1772900,94894900,False
2171,validator_1,69330475587,True,87044003,476900,87520903,True
2172,validator_7,71093100199,True,68086001,4759160,72845161,True
2173,validator_5,70976591026,True,128829007,1416730,130245737,True
2174,validator_37,69785308450,True,127034000,599000,127633000,False
2175,validator_12,103027982359,True,82985002,118500,83103502,True
2176,validator_7,71229781697,True,117716998,18964500,136681498,True
2177,validator_13,37071314136,True,83283000,203700,83486700,True
2178,validator_17,167365322928,True,149759999,1291700,151051699,True
2179,validator_49,68446507510,True,166059000,19265500,185324500,False
2180,validator_21,68877091602,True,120667001,19004530,139671531,True
2181,validator_17,167524460551,True,157614003,1523620,159137623,True
2182,validator_0,37767342868,True,143754002,1562800,145316802,True
2183,validator_1,69446702883,True,114009996,2217300,116227296,True
2184,validator_49,68549572010,True,101741000,1323500,103064500,False
2185,validator_1,69672098981,True,224369998,1026100,225396098,True
2186,validator_19,70204303918,True,91063004,577500,91640504,True
2187,validator_0,38003909000,True,224804002,11762130,236566132,True
2188,validator_35,102108635170,True,90801000,2496600,93297600,False
2189,validator_39,37216783820,True,97609000,458500,98067500,False
2190,validator_44,103174593060,True,70056000,1196660,71252660,False
2191,validator_33,36491360500,True,106926000,628700,107554700,False
2192,validator_6,36982509129,True,140713000,1224020,141937020,True
2193,validator_14,103672117601,True,64768001,308190,65076191,True
2194,validator_31,165752283660,True,51712000,2088660,53800660,False
2195,validator_19,70279484615,True,56937997,18242700,75180697,True
2196,validator_14,103757262703,True,84272002,873100,85145102,True
2197,validator_17,167579195068,True,53810997,923520,54734517,True
2198,validator_8,38642095679,True,96039996,19583200,115623196,True
2199,validator_1,69794414241,True,121789000,526260,122315260,True
2200,validator_36,99716591340,True,51839000,724100,52563100,False
2201,validator_36,99829286330,True,111405000,1289990,112694990,False
2202,validator_48,164975042780,True,173062000,772600,173834600,False
2203,validator_38,36819711760,True,212587000,826670,213413670,False
2204,validator_9,37377089589,True,82688996,890740,83579736,True
2205,validator_18,102332014353,True,76402002,188030,76590032,True
2206,validator_8,38829155223,True,170482004,16577540,187059544,True
2207,validator_22,69774226317,True,96075002,1400100,97475102,True
2208,validator_47,69004376110,True,87150000,1146300,88296300,False
2209,validator_45,37021993180,True,125298000,2400500,127698500,False
2210,validator_17,167713920067,True,132980999,1744000,134724999,True
2211,validator_39,37404280250,True,185580000,1916430,187496430,False
2212,validator_43,68077539000,True,152669000,710540,153379540,False
2213,validator_25,36507959460,True,113001000,2666900,115667900,False
2214,validator_41,70191468460,True,109947000,1743590,111690590,False
2215,validator_30,69189776430,True,135777000,622400,136399400,False
2216,validator_8,38900746114,True,70377001,1213890,71590891,True
2217,validator_11,38983840805,True,233042998,2620520,235663518,True
2218,validator_36,99899819710,True,69341000,1192380,70533380,False
2219,validator_33,36629853420,True,137332000,1160920,138492920,False
2220,validator_26,37258223380,True,130507000,6836890,137343890,False
2221,validator_42,37318037980,True,51812000,675320,52487320,False
2222,validator_30,69342922410,True,145088000,8057980,153145980,False
2223,validator_34,264609235300,True,60928000,700200,61628200,False
2224,validator_17,167846793589,True,127567002,5306520,132873522,True
2225,validator_22,69851770550,True,68952003,8592230,77544233,True
2226,validator_10,37336839770,True,110858003,857200,111715203,True
2227,validator_2,39851105484,True,114561996,593840,115155836,True
2228,validator_12,103224149656,True,159295997,36871300,196167297,True
2229,validator_4,37602361585,True,169212999,2068530,171281529,True
2230,validator_33,36691528000,True,59446000,2228580,61674580,False
2231,validator_0,38104656141,True,99967001,780140,100747141,True
2232,validator_33,36812543120,True,102670000,18345120,121015120,False
2233,validator_9,37493507787,True,115273998,1144200,116418198,True
2234,validator_40,37415324320,True,88740000,894550,89634550,False
2235,validator_18,102440106123,True,107301000,790770,108091770,True
2236,validator_20,37108557510,True,240564999,707620,241272619,True
2237,validator_43,68177787930,True,99419000,829930,100248930,False
2238,validator_21,69020157531,True,141921999,1143930,143065929,True
2239,validator_31,165828282360,True,67797000,8201700,75998700,False
2240,validator_15,266202385231,True,178331000,1684280,180015280,True
2241,validator_7,71356462197,True,106636000,20044500,126680500,True
2242,validator_27,102496765960,True,131422000,1087800,132509800,False
2243,validator_29,35567277410,True,80750000,5934220,86684220,False
2244,validator_4,37754754393,True,151588998,803810,152392808,True
2245,validator_4,37972231900,True,197261007,20216500,217477507,True
2246,validator_4,38197164371,True,222178001,2754470,224932471,True
2247,validator_37,69823318850,True,37888000,122400,38010400,False
2248,validator_47,69121017300,True,114837000,1804190,116641190,False
2249,validator_9,37565393790,True,70511003,1375000,71886003,True
2250,validator_31,165917723960,True,80635000,8806600,89441600,False
2251,validator_1,69887658846,True,91560005,1684600,93244605,True
2252,validator_11,39183726669,True,198283004,1602860,199885864,True
2253,validator_7,71645812503,True,287668006,1682300,289350306,True
2254,validator_25,36565473730,True,51103000,6411270,57514270,False
2255,validator_19,70372989116,True,92675001,829500,93504501,True
2256,validator_9,37633209065,True,61430005,6385270,67815275,True
2257,validator_46,100234420940,True,131153000,1460200,132613200,False
2258,validator_48,165085286370,True,92249000,17994590,110243590,False
2259,validator_42,37470110980,True,151782000,291000,152073000,False
2260,validator_36,100083184640,True,181898000,1466930,183364930,False
2261,validator_22,70012885748,True,160092998,1022200,161115198,True
2262,validator_43,68285499230,True,104860000,2851300,107711300,False
2263,validator_7,71721557701,True,74462998,1282200,75745198,True
2264,validator_8,39072174545,True,165853001,5575430,171428431,True
2265,validator_32,37629484690,True,34484000,426620,34910620,False
2266,validator_11,39273187700,True,87528001,1933030,89461031,True
2267,validator_48,165124048270,True,37623000,1138900,38761900,False
2268,validator_5,71052744439,True,75157993,995420,76153413,True
2269,validator_46,100394318640,True,159012000,885700,159897700,False
2270,validator_9,37711669767,True,77855002,605700,78460702,True
2271,validator_36,100190628110,True,106093000,1350470,107443470,False
2272,validator_4,38318824272,True,117544001,4115900,121659901,True
2273,validator_9,37868298971,True,155306004,1323200,156629204,True
2274,validator_0,38183060379,True,73011998,5392240,78404238,True
2275,validator_30,69495369610,True,150062000,2385200,152447200,False
2276,validator_31,166078967160,True,159874000,1369200,161243200,False
2277,validator_0,38279005315,True,77617996,18326940,95944936,True
2278,validator_7,71794432401,True,71329000,1545700,72874700,True
2279,validator_4,38451239972,True,131670000,745700,132415700,True
2280,validator_27,102580320060,True,73618000,9936100,83554100,False
2281,validator_35,102169467770,True,59812000,1020600,60832600,False
2282,validator_26,37406654990,True,147295000,1136610,148431610,False
2283,validator_2,40087228390,True,234328006,1794900,236122906,True
2284,validator_17,167986616414,True,136823995,2998830,139822825,True
2285,validator_0,38501832915,True,222488000,339600,222827600,True
2286,validator_27,102817483060,True,226594000,10569000,237163000,False
2287,validator_41,70225639260,True,32477000,1693800,34170800,False
2288,validator_23,39002803249,True,169999000,19330980,189329980,True
2289,validator_8,39137865646,True,64450001,1241100,65691101,True
2290,validator_44,103452867900,True,276524000,1750840,278274840,False
2291,validator_44,103577751200,True,123633000,1250300,124883300,False
2292,validator_36,100332984320,True,141648000,708210,142356210,False
2293,validator_37,69933516910,True,108819000,1379060,110198060,False
2294,validator_48,165219495130,True,93249000,2197860,95446860,False
2295,validator_10,37397996500,True,59355000,1801730,61156730,True
2296,validator_14,103956927104,True,198754001,910400,199664401,True
2297,validator_0,38656414414,True,153897999,683500,154581499,True
2298,validator_39,37516665940,True,111940000,445690,112385690,False
2299,validator_15,266281005926,True,78136995,483700,78620695,True
2300,validator_38,36862017060,True,41537000,768300,42305300,False
2301,validator_48,165310819440,True,90578000,746310,91324310,False
2302,validator_27,102875802160,True,56584000,1735100,58319100,False
2303,validator_8,39242293373,True,102688997,1738730,104427727,True
2304,validator_17,168095469456,True,108232002,621040,108853042,True
2305,validator_33,36928217440,True,113770000,1904320,115674320,False
2306,validator_17,168182468657,True,80161001,6838200,86999201,True
2307,validator_28,36031968110,True,42846000,2138000,44984000,False
2308,validator_49,68607124010,True,55550000,2002000,57552000,False
2309,validator_11,39381165204,True,107411004,566500,107977504,True
2310,validator_22,70150871452,True,135431004,2554700,137985704,True
2311,validator_48,165541796200,True,223242000,7734760,230976760,False
2312,validator_24,36789378280,True,213579006,2170320,215749326,True
2313,validator_7,71885184235,True,88715994,2035840,90751834,True
2314,validator_44,103689317540,True,110582000,984340,111566340,False
2315,validator_17,168243753256,True,48703999,12580600,61284599,True
2316,validator_26,37543965690,True,136348000,962700,137310700,False
2317,validator_14,104043715374,True,86742000,46270,86788270,True
2318,validator_40,37495985120,True,78539000,2121800,80660800,False
2319,validator_39,37672522700,True,136821000,19035760,155856760,False
2320,validator_49,68690235610,True,81604000,1507600,83111600,False
2321,validator_34,264706998000,True,89544000,8218700,97762700,False
2322,validator_43,68381172820,True,94004000,1669590,95673590,False
2323,validator_10,37596734633,True,176896993,21841140,198738133,True
2324,validator_11,39580488005,True,178403001,20919800,199322801,True
2325,validator_7,71992084436,True,105152001,1748200,106900201,True
2326,validator_38,36935221210,True,72844000,360150,73204150,False
2327,validator_31,166194937040,True,97641000,18328880,115969880,False
2328,validator_14,104140390462,True,90864998,5810090,96675088,True
2329,validator_14,104272126803,True,130372001,1364340,131736341,True
2330,validator_31,166422589160,True,202339000,25313120,227652120,False
2331,validator_49,68794110840,True,103255000,620230,103875230,False
2332,validator_31,166512732860,True,87713000,2430700,90143700,False
2333,validator_15,266400696227,True,117422001,2268300,119690301,True
2334,validator_1,70063077634,True,155771998,19646790,175418788,True
2335,validator_18,102547952123,True,105613000,2233000,107846000,True
2336,validator_13,37248642878,True,165165002,12163740,177328742,True
2337,validator_40,37627449600,True,130966000,498480,131464480,False
2338,validator_20,37240725307,True,130420997,1746800,132167797,True
2339,validator_46,100489295040,True,93449000,1527400,94976400,False
2340,validator_30,69533099040,True,37201000,528430,37729430,False
2341,validator_33,37047073280,True,117969000,886840,118855840,False
2342,validator_38,37108417110,True,168367000,4828900,173195900,False
2343,validator_44,103824143440,True,134000000,825900,134825900,False
2344,validator_28,36191861190,True,150597000,9296080,159893080,False
2345,validator_17,168351910833,True,89086997,19070580,108157577,True
2346,validator_24,36931157684,True,125714994,16064410,141779404,True
2347,validator_13,37427402214,True,177625006,1134330,178759336,True
2348,validator_3,38185585941,True,72408003,794630,73202633,True
2349,validator_13,37499156116,True,70498002,1255900,71753902,True
2350,validator_20,37304644693,True,61941996,1977390,63919386,True
2351,validator_3,38412022462,True,220471001,5965520,226436521,True
2352,validator_26,37696412110,True,146800000,5646420,152446420,False
2353,validator_4,38541161671,True,87741999,2179700,89921699,True
2354,validator_15,266532936024,True,129662997,2576800,132239797,True
2355,validator_7,72098205739,True,105844003,277300,106121303,True
2356,validator_32,37858653170,True,228373000,795480,229168480,False
2357,validator_49,68906722390,True,111593000,1018550,112611550,False
2358,validator_0,38771215557,True,105733003,9068140,114801143,True
2359,validator_12,103331819060,True,106993004,676400,107669404,True
2360,validator_35,102351797540,True,172954000,9375770,182329770,False
2361,validator_47,69259614080,True,129005000,9591780,138596780,False
2362,validator_26,37744559410,True,46792000,1355300,48147300,False
2363,validator_39,37736342800,True,63343000,477100,63820100,False
2364,validator_36,100416982300,True,83093000,904980,83997980,False
2365,validator_7,72192826637,True,93285998,1334900,94620898,True
2366,validator_40,37847524730,True,219311000,764130,220075130,False
2367,validator_21,69163577336,True,139656005,3763800,143419805,True
2368,validator_22,70230213080,True,76781998,2559630,79341628,True
2369,validator_12,103448564947,True,113629997,3115890,116745887,True
2370,validator_17,168443762623,True,90449000,1402790,91851790,True
2371,validator_21,69300774339,True,137018003,179000,137197003,True
2372,validator_30,69692159780,True,135027000,24033740,159060740,False
2373,validator_49,69072711790,True,146826000,19163400,165989400,False
2374,validator_34,264866404030,True,154867000,4539030,159406030,False
2375,validator_48,165650846410,True,106632000,2418210,109050210,False
2376,validator_47,69383133180,True,122564000,955100,123519100,False
2377,validator_17,168644640758,True,200016005,862130,200878135,True
2378,validator_48,165772590720,True,120119000,1625310,121744310,False
2379,validator_11,39675241442,True,93544997,1208440,94753437,True
2380,validator_47,69494018650,True,108977000,1908470,110885470,False
2381,validator_5,71191060441,True,118968002,19348000,138316002,True
2382,validator_9,38017971745,True,144333004,5339770,149672774,True
2383,validator_3,38648594739,True,226727997,9844280,236572277,True
2384,validator_38,37265675300,True,155986000,1272190,157258190,False
2385,validator_8,39389576319,True,144857006,2425940,147282946,True
2386,validator_18,102616900884,True,64000001,4948760,68948761,True
2387,validator_15,266722734856,True,182263002,7535830,189798832,True
2388,validator_29,35695196810,True,126945000,974400,127919400,False
2389,validator_22,70365368835,True,133360995,1794760,135155755,True
2390,validator_35,102620095770,True,267161000,1137230,268298230,False
2391,validator_37,70032710710,True,97546000,1647800,99193800,False
2392,validator_38,37366608200,True,99531000,1401900,100932900,False
2393,validator_43,68518129600,True,135176000,1780780,136956780,False
2394,validator_40,37911041420,True,63100000,416690,63516690,False
2395,validator_13,37582440318,True,65103002,18181200,83284202,True
2396,validator_7,72445118037,True,207816000,44475400,252291400,True
2397,validator_28,36274518690,True,82049000,608500,82657500,False
2398,validator_47,69641966180,True,146489000,1458530,147947530,False
2399,validator_30,69900860810,True,206262000,2439030,208701030,False
2400,validator_12,103583419288,True,134172001,682340,134854341,True
2401,validator_5,71447866461,True,251920000,4886020,256806020,True
2402,validator_48,165903535320,True,129379000,1565600,130944600,False
2403,validator_1,70134491601,True,66772997,4640970,71413967,True
2404,validator_31,166654815930,True,141606000,477070,142083070,False
2405,validator_7,72536286700,True,90067993,1100670,91168663,True
2406,validator_44,103950968380,True,126179000,645940,126824940,False
2407,validator_8,39596246242,True,193625993,13043930,206669923,True
2408,validator_17,168759532079,True,114165001,726320,114891321,True
2409,validator_22,70517394236,True,149830001,2195400,152025401,True
2410,validator_19,70536797917,True,163057001,751800,163808801,True
2411,validator_28,36397144590,True,121659000,966900,122625900,False
2412,validator_29,35888802230,True,191783000,1822420,193605420,False
2413,validator_9,38125629383,True,106628998,1028640,107657638,True
2414,validator_9,38190704720,True,64180997,894340,65075337,True
2415,validator_14,104376519222,True,90524999,13867420,104392419,True
2416,validator_18,102729995342,True,112724998,369460,113094458,True
2417,validator_19,70761393418,True,222519001,2076500,224595501,True
2418,validator_11,39740196485,True,63159003,1796040,64955043,True
2419,validator_2,40190449694,True,101534004,1687300,103221304,True
2420,validator_38,37442886600,True,75834000,444400,76278400,False
2421,validator_28,36532140670,True,127125000,7871080,134996080,False
2422,validator_2,40328258082,True,132384998,5423390,137808388,True
2423,validator_11,39805994987,True,64020002,1778500,65798502,True
2424,validator_21,69487132573,True,183240004,3118230,186358234,True
2425,validator_38,37540234730,True,96871000,477130,97348130,False
2426,validator_24,37109633181,True,175766997,2708500,178475497,True
2427,validator_19,70908460321,True,138968003,8098900,147066903,True
2428,validator_14,104492172121,True,115314999,337900,115652899,True
2429,validator_24,37214400112,True,104409001,357930,104766931,True
2430,validator_26,37925495840,True,178619000,2317430,180936430,False
2431,validator_20,37363915790,True,57836997,1434100,59271097,True
2432,validator_3,38786248131,True,129521992,8131400,137653392,True
2433,validator_6,37129449220,True,146218001,722090,146940091,True
2434,validator_14,104643478518,True,149247997,2058400,151306397,True
2435,validator_3,38933850370,True,147205999,396240,147602239,True
2436,validator_11,39901597781,True,76310994,19291800,95602794,True
2437,validator_6,37319455680,True,188096000,1910460,190006460,True
2438,validator_12,103674631387,True,89152999,2059100,91212099,True
2439,validator_34,264965255030,True,98294000,557000,98851000,False
2440,validator_17,168821700962,True,61362003,806880,62168883,True
2441,validator_48,166056096220,True,133640000,18920900,152560900,False
2442,validator_45,37109544380,True,87041000,510200,87551200,False
2443,validator_21,69800184676,True,312262003,790100,313052103,True
2444,validator_38,37628065290,True,87650000,180560,87830560,False
2445,validator_17,168967966431,True,143041009,3224460,146265469,True
2446,validator_44,104031966670,True,78034000,2964290,80998290,False
2447,validator_43,68652806340,True,133520000,1156740,134676740,False
2448,validator_40,37997770520,True,85845000,884100,86729100,False
2449,validator_6,37418610818,True,86563998,12591140,99155138,True
2450,validator_1,70196596893,True,61546002,559290,62105292,True
2451,validator_14,104793266198,True,140801000,8986680,149787680,True
2452,validator_24,37323621676,True,108839004,382560,109221564,True
2453,validator_20,37455892393,True,86348003,5628600,91976603,True
2454,validator_33,37203823790,True,148487000,8263510,156750510,False
2455,validator_16,37235266848,True,184950996,2026940,186977936,True
2456,validator_30,70032735740,True,130860000,1014930,131874930,False
2457,validator_7,72770568941,True,229417001,4865240,234282241,True
2458,validator_12,103935664985,True,253268998,7764600,261033598,True
2459,validator_15,266762040753,True,37952997,1352900,39305897,True
2460,validator_7,72865476869,True,94638998,268930,94907928,True
2461,validator_36,100603941530,True,168024000,18935230,186959230,False
2462,validator_35,102746938830,True,119183000,7660060,126843060,False
2463,validator_46,100722384830,True,213212000,19877790,233089790,False
2464,validator_37,70139826010,True,106800000,315300,107115300,False
2465,validator_23,39065132250,True,61923001,406000,62329001,True
2466,validator_34,265123559270,True,157425000,879240,158304240,False
2467,validator_7,73032758868,True,164192999,3089000,167281999,True
2468,validator_45,37176004670,True,65953000,507290,66460290,False
2469,validator_31,166740097080,True,83095000,2186150,85281150,False
2470,validator_13,37649169240,True,63189002,3539920,66728922,True
2471,validator_46,100816997230,True,92293000,2319400,94612400,False
2472,validator_45,37295406380,True,83417000,35984710,119401710,False
2473,validator_26,38039671340,True,88549000,25626500,114175500,False
2474,validator_22,70697642337,True,179257001,991100,180248101,True
2475,validator_31,166849490780,True,106428000,2965700,109393700,False
2476,validator_37,70218078910,True,77526000,726900,78252900,False
2477,validator_3,39119588518,True,185501998,236150,185738148,True
2478,validator_26,38146984440,True,106732000,581100,107313100,False
2479,validator_27,102947187740,True,70725000,660580,71385580,False
2480,validator_14,104872619102,True,77146004,2206900,79352904,True
2481,validator_37,70349247230,True,103374000,27794320,131168320,False
2482,validator_24,37497038630,True,155169004,18247950,173416954,True
2483,validator_47,69755181660,True,111388000,1827480,113215480,False
2484,validator_10,37739442576,True,141839003,868940,142707943,True
2485,validator_30,70117588170,True,83810000,1042430,84852430,False
2486,validator_34,265254350690,True,124893000,5898420,130791420,False
2487,validator_1,70327943894,True,128784001,2563000,131347001,True
2488,validator_14,104959505541,True,86232999,653440,86886439,True
2489,validator_3,39325265658,True,197946000,7731140,205677140,True
2490,validator_5,71528729965,True,75396004,5467500,80863504,True
2491,validator_36,100669697530,True,63540000,2216000,65756000,False
2492,validator_42,37571524080,True,100743000,670100,101413100,False
2493,validator_37,70464031920,True,113654000,1130690,114784690,False
2494,validator_26,38234163440,True,85335000,1844000,87179000,False
2495,validator_38,37723134950,True,93506000,1563660,95069660,False
2496,validator_40,38113979860,True,115258000,951340,116209340,False
2497,validator_17,169217325436,True,248080005,1279000,249359005,True
2498,validator_17,169354639561,True,136709995,604130,137314125,True
2499,validator_41,70327089340,True,99787000,1663080,101450080,False
2500,validator_14,105109341133,True,148949002,886590,149835592,True
2501,validator_5,71750028667,True,220642002,656700,221298702,True
2502,validator_45,37490038130,True,186539000,8092750,194631750,False
2503,validator_43,68766364680,True,111158000,2400340,113558340,False
2504,validator_24,37650067434,True,146880004,6148800,153028804,True
2505,validator_30,70235475940,True,117344000,543770,117887770,False
2506,validator_25,36659597360,True,89535000,4588630,94123630,False
2507,validator_48,166106022280,True,49345000,581060,49926060,False
2508,validator_26,38373372080,True,137835000,1373640,139208640,False
2509,validator_26,38453546180,True,78977000,1197100,80174100,False
2510,validator_35,102807898030,True,59374000,1585200,60959200,False
2511,validator_20,37539801892,True,83196999,712500,83909499,True
2512,validator_30,70307114340,True,70868000,770400,71638400,False
2513,validator_7,73165879267,True,131437999,1682400,133120399,True
2514,validator_13,37731091237,True,79020997,2901000,81921997,True
2515,validator_3,39459237057,True,131345999,2625400,133971399,True
2516,validator_45,37544928030,True,54405000,484900,54889900,False
2517,validator_32,38038365070,True,177975000,1736900,179711900,False
2518,validator_12,104102767192,True,165439007,1663200,167102207,True
2519,validator_21,69981322946,True,179818000,1320270,181138270,True
2520,validator_25,36754166360,True,92532000,2037000,94569000,False
2521,validator_40,38201551210,True,86195000,1376350,87571350,False
2522,validator_23,39232682248,True,166082998,1467000,167549998,True
2523,validator_3,39585681449,True,120652002,5792390,126444392,True
2524,validator_32,38185634070,True,127610000,19659000,147269000,False
2525,validator_34,265364082030,True,108626000,1105340,109731340,False
2526,validator_35,102895176930,True,86121000,1157900,87278900,False
2527,validator_38,37797145290,True,71889000,2121340,74010340,False
2528,validator_3,39659968349,True,65706000,8580900,74286900,True
2529,validator_7,73348569468,True,163673001,19017200,182690201,True
2530,validator_23,39395005747,True,161233999,1089500,162323499,True
2531,validator_40,38379499330,True,175685000,2263120,177948120,False
2532,validator_7,73508921900,True,155225002,5127430,160352432,True
2533,validator_11,39954226209,True,51237998,1390430,52628428,True
2534,validator_46,100947762290,True,124848000,5917060,130765060,False
2535,validator_4,38727864873,True,185101002,1602200,186703202,True
2536,validator_24,37850004233,True,199526999,409800,199936799,True
2537,validator_6,37543337518,True,123504000,1222700,124726700,True
2538,validator_32,38331508210,True,136847000,9027140,145874140,False
2539,validator_15,266902527805,True,137852002,2635050,140487052,True
2540,validator_32,38370857340,True,38991000,358130,39349130,False
2541,validator_35,103039775630,True,143604000,994700,144598700,False
2542,validator_10,37892559447,True,152113001,1003870,153116871,True
2543,validator_29,35994902460,True,104667000,1433230,106100230,False
2544,validator_48,166145670180,True,39005000,642900,39647900,False
2545,validator_23,39532578250,True,136828003,744500,137572503,True
2546,validator_36,100844575180,True,174098000,779650,174877650,False
2547,validator_7,73621146197,True,87041997,25182300,112224297,True
2548,validator_21,70134301490,True,126353004,26625540,152978544,True
2549,validator_48,166326170200,True,175117000,5383020,180500020,False
2550,validator_21,70210601931,True,75782001,518440,76300441,True
2551,validator_36,100980041380,True,134362000,1104200,135466200,False
2552,validator_45,37661189230,True,107409000,8852200,116261200,False
2553,validator_12,104283005211,True,162062999,18175020,180238019,True
2554,validator_39,37844667340,True,102141000,6183540,108324540,False
2555,validator_27,103032050670,True,84587000,275930,84862930,False
2556,validator_10,38102119748,True,200497001,9063300,209560301,True
2557,validator_33,37353747770,True,131163000,18760980,149923980,False
2558,validator_38,37957760980,True,158809000,1806690,160615690,False
2559,validator_0,38963561562,True,190307005,2039000,192346005,True
2560,validator_49,69231088970,True,158023000,354180,158377180,False
2561,validator_14,105223399834,True,112080001,1978700,114058701,True
2562,validator_33,37532548210,True,178314000,486440,178800440,False
2563,validator_19,71073873455,True,163298004,2115130,165413134,True
2564,validator_36,101132686010,True,151304000,1340630,152644630,False
2565,validator_41,70408821340,True,73864000,7868000,81732000,False
2566,validator_19,71189359061,True,107563006,7922600,115485606,True
2567,validator_3,39952494248,True,291139999,1385900,292525899,True
2568,validator_28,36705028170,True,164962000,7925500,172887500,False
2569,validator_2,40489260384,True,160121002,881300,161002302,True
2570,validator_42,37653811080,True,81864000,423000,82287000,False
2571,validator_34,265551932030,True,186863000,987000,187850000,False
2572,validator_49,69334666270,True,101303000,2274300,103577300,False
2573,validator_45,37762707690,True,101035000,483460,101518460,False
2574,validator_8,39710477539,True,106376997,7854300,114231297,True
2575,validator_49,69497961100,True,162575000,719830,163294830,False
2576,validator_4,38917417430,True,180966997,8585560,189552557,True
2577,validator_13,37998147395,True,260999998,6056160,267056158,True
2578,validator_20,37710160793,True,152237001,18121900,170358901,True
2579,validator_30,70422017310,True,114372000,530970,114902970,False
2580,validator_27,103113914410,True,73920000,7943740,81863740,False
2581,validator_25,36850839500,True,95126000,1547140,96673140,False
2582,validator_0,39061668302,True,97725000,381740,98106740,True
2583,validator_14,105382402650,True,157001996,2000820,159002816,True
2584,validator_18,102897057982,True,148535000,18527640,167062640,True
2585,validator_10,38339641150,True,234723002,2798400,237521402,True
2586,validator_2,40747071684,True,256264000,1547300,257811300,True
2587,validator_40,38557592930,True,174735000,3358600,178093600,False
2588,validator_47,69843164890,True,87458000,525230,87983230,False
2589,validator_13,38095940892,True,96482997,1310500,97793497,True
2590,validator_4,39022682228,True,103586998,1677800,105264798,True
2591,validator_15,267015842583,True,110987998,2326780,113314778,True
2592,validator_44,104081023790,True,45826000,3231120,49057120,False
2593,validator_27,103219189620,True,82645000,22630210,105275210,False
2594,validator_43,68940310480,True,172717000,1228800,173945800,False
2595,validator_9,38344831851,True,152313001,1814130,154127131,True
2596,validator_28,36790361290,True,84638000,695120,85333120,False
2597,validator_18,103038277161,True,139601999,1617180,141219179,True
2598,validator_5,71936401707,True,181313000,5060040,186373040,True
2599,validator_0,39171697034,True,109317002,711730,110028732,True
2600,validator_1,70579821667,True,251552003,325770,251877773,True
2601,validator_20,37992387390,True,281297997,928600,282226597,True
2602,validator_45,37861273320,True,96663000,1902630,98565630,False
2603,validator_5,72075177906,True,137026999,1749200,138776199,True
2604,validator_7,73708352098,True,86621001,584900,87205901,True
2605,validator_44,104144044810,True,57776000,5245020,63021020,False
2606,validator_6,37638862114,True,86954996,8569600,95524596,True
2607,validator_12,104496894548,True,212481997,1407340,213889337,True
2608,validator_2,40835689284,True,69873000,18744600,88617600,True
2609,validator_49,69598340240,True,98928000,1451140,100379140,False
2610,validator_22,70861181135,True,161988998,1549800,163538798,True
2611,validator_10,38470027750,True,127863000,2523600,130386600,True
2612,validator_18,103249676459,True,184671998,26727300,211399298,True
2613,validator_22,71060294449,True,198702994,410320,199113314,True
2614,validator_30,70529361510,True,106276000,1068200,107344200,False
2615,validator_17,169438686199,True,79607998,4438640,84046638,True
2616,validator_43,69160810780,True,202250000,18250300,220500300,False
2617,validator_2,40950464687,True,112084003,2691400,114775403,True
2618,validator_18,103401810758,True,150791999,1342300,152134299,True
2619,validator_42,37727961980,True,73747000,403900,74150900,False
2620,validator_39,38038448300,True,192555000,1225960,193780960,False
2621,validator_49,69671456670,True,71103000,2013430,73116430,False
2622,validator_15,267147494637,True,128369004,3283050,131652054,True
2623,validator_31,167024752880,True,172246000,3016100,175262100,False
2624,validator_46,101001973090,True,53894000,316800,54210800,False
2625,validator_41,70584340800,True,150391000,25128460,175519460,False
2626,validator_39,38130121600,True,90543000,1130300,91673300,False
2627,validator_9,38431257152,True,81690001,4735300,86425301,True
2628,validator_45,37972177940,True,110438000,466620,110904620,False
2629,validator_23,39682372573,True,131065003,18729320,149794323,True
2630,validator_20,38153152290,True,158160000,2604900,160764900,True
2631,validator_46,101119574390,True,114851000,2750300,117601300,False
2632,validator_17,169537356696,True,90453997,8216500,98670497,True
2633,validator_16,37367688945,True,130332997,2089100,132422097,True
2634,validator_37,70576329220,True,111594000,703300,112297300,False
2635,validator_0,39292655704,True,119380000,1578670,120958670,True
2636,validator_4,39175303233,True,150613005,2008000,152621005,True
2637,validator_15,267324356639,True,166690002,10172000,176862002,True
2638,validator_48,166537131680,True,209651000,1310480,210961480,False
2639,validator_39,38344719900,True,194449000,20149300,214598300,False
2640,validator_49,69779573480,True,107234000,882810,108116810,False
2641,validator_9,38487952681,True,56299999,395530,56695529,True
2642,validator_8,39818511363,True,105693004,2340820,108033824,True
2643,validator_44,104268563440,True,123336000,1182630,124518630,False
2644,validator_1,70692569364,True,93787997,18959700,112747697,True
2645,validator_7,73808389028,True,97560000,2476930,100036930,True
2646,validator_31,167146139100,True,120763000,623220,121386220,False
2647,validator_44,104438154960,True,167562000,2029520,169591520,False
2648,validator_22,71134252153,True,72893004,1064700,73957704,True
2649,validator_31,167315869730,True,167529000,2201630,169730630,False
2650,validator_25,36949189790,True,97996000,354290,98350290,False
2651,validator_30,70564519880,True,30200000,4958370,35158370,False
2652,validator_15,267615143142,True,289028003,1758500,290786503,True
2653,validator_8,39960795363,True,141640000,644000,142284000,True
2654,validator_18,103457216887,True,54703999,702130,55406129,True
2655,validator_31,167414322930,True,95942000,2511200,98453200,False
2656,validator_8,40067336462,True,105968999,572100,106541099,True
2657,validator_46,101194699780,True,74525000,600390,75125390,False
2658,validator_47,69982729990,True,138585000,980100,139565100,False
2659,validator_31,167485079230,True,62437000,8319300,70756300,False
2660,validator_19,71423864408,True,233310007,1195340,234505347,True
2661,validator_42,37794405180,True,64796000,1647200,66443200,False
2662,validator_35,103154730050,True,113651000,1303420,114954420,False
2663,validator_41,70744363840,True,157233000,2790040,160023040,False
2664,validator_37,70648507420,True,70818000,1360200,72178200,False
2665,validator_49,69891438220,True,111363000,501740,111864740,False
2666,validator_11,40035307208,True,77314999,3766000,81080999,True
2667,validator_34,265636802430,True,83872000,998400,84870400,False
2668,validator_40,38665315030,True,99930000,7792100,107722100,False
2669,validator_14,105492545547,True,90512997,19629900,110142897,True
2670,validator_32,38430153440,True,57388000,1908100,59296100,False
2671,validator_4,39451116393,True,275193000,620160,275813160,True
2672,validator_30,70656815580,True,91145000,1150700,92295700,False
2673,validator_7,73992755916,True,183659998,706890,184366888,True
2674,validator_3,40039548917,True,86184999,869670,87054669,True
2675,validator_41,70819890740,True,75287000,239900,75526900,False
2676,validator_49,70095782670,True,192083000,12261450,204344450,False
2677,validator_10,38601339582,True,129598002,1713830,131311832,True
2678,validator_1,70802101889,True,108228995,1303530,109532525,True
2679,validator_32,38529139210,True,79238000,19747770,98985770,False
2680,validator_17,169647309172,True,109364006,588470,109952476,True
2681,validator_18,103540829490,True,78719003,4893600,83612603,True
2682,validator_12,104699508408,True,201388000,1225860,202613860,True
2683,validator_29,36195877030,True,199285000,1689570,200974570,False
2684,validator_17,169877185733,True,227660001,2216560,229876561,True
2685,validator_4,39636084193,True,183913000,1054800,184967800,True
2686,validator_3,40160878716,True,98319999,23009800,121329799,True
2687,validator_43,69280409280,True,101358000,18240500,119598500,False
2688,validator_24,38025220331,True,173706998,1509100,175216098,True
2689,validator_48,166714947060,True,157953000,19862380,177815380,False
2690,validator_40,38760630720,True,93633000,1682690,95315690,False
2691,validator_25,37093665090,True,142133000,2342300,144475300,False
2692,validator_22,71265487094,True,125135001,6099940,131234941,True
2693,validator_30,70776421870,True,119325000,281290,119606290,False
2694,validator_34,265789585650,True,144322000,8461220,152783220,False
2695,validator_2,41054885950,True,103475003,946260,104421263,True
2696,validator_4,39749851988,True,113319995,447800,113767795,True
2697,validator_49,70229027600,True,132803000,441930,133244930,False
2698,validator_46,101227639460,True,31411000,1528680,32939680,False
2699,validator_23,39808662069,True,125593996,695500,126289496,True
2700,validator_28,36877721570,True,87326000,34280,87360280,False
2701,validator_3,40369520518,True,202147002,6494800,208641802,True
2702,validator_10,38757502382,True,130903000,25259800,156162800,True
2703,validator_46,101379485960,True,150360000,1486500,151846500,False
2704,validator_15,267706964064,True,90510002,1310920,91820922,True
2705,validator_15,267883781185,True,176463001,354120,176817121,True
2706,validator_49,70289744200,True,59841000,875600,60716600,False
2707,validator_49,70463242400,True,170655000,2843200,173498200,False
2708,validator_42,37861326800,True,66317000,604620,66921620,False
2709,validator_47,70168248190,True,165908000,19610200,185518200,False
2710,validator_44,104584615880,True,144602000,1858920,146460920,False
2711,validator_15,268089681326,True,197669001,8231140,205900141,True
2712,validator_1,71066899169,True,262628000,2169280,264797280,True
2713,validator_15,268198633404,True,107781998,1170080,108952078,True
2714,validator_8,40181990753,True,108689001,5965290,114654291,True
2715,validator_18,103696627586,True,155111996,686100,155798096,True
2716,validator_35,103335491350,True,161411000,19350300,180761300,False
2717,validator_11,40182595710,True,145397002,1891500,147288502,True
2718,validator_24,38272279232,True,228767001,18291900,247058901,True
2719,validator_22,71407908391,True,124131997,18289300,142421297,True
2720,validator_31,167613914230,True,128034000,801000,128835000,False
2721,validator_46,101497049660,True,108813000,8750700,117563700,False
2722,validator_49,70656373500,True,190325000,2806100,193131100,False
2723,validator_48,166822857540,True,107080000,830480,107910480,False
2724,validator_0,39514900304,True,202980000,19264600,222244600,True
2725,validator_32,38599071640,True,67897000,2035430,69932430,False
2726,validator_16,37646844178,True,277385003,1770230,279155233,True
2727,validator_3,40518695961,True,148818003,357440,149175443,True
2728,validator_46,101578689460,True,81471000,168800,81639800,False
2729,validator_19,71580379808,True,153810000,2705400,156515400,True
2730,validator_24,38497908803,True,224518001,1111570,225629571,True
2731,validator_23,39958215110,True,148492001,1061040,149553041,True
2732,validator_17,170034867133,True,149536000,8145400,157681400,True
2733,validator_3,40581646808,True,61000997,1949850,62950847,True
2734,validator_34,266004001490,True,199897000,14518840,214415840,False
2735,validator_34,266195141720,True,181574000,9566230,191140230,False
2736,validator_39,38440618700,True,93403000,2495800,95898800,False
2737,validator_45,38206610880,True,224617000,9815940,234432940,False
2738,validator_20,38333774165,True,179737005,884870,180621875,True
2739,validator_23,40114995912,True,155373002,1407800,156780802,True
2740,validator_7,74085067742,True,91636996,674830,92311826,True
2741,validator_40,38890137620,True,123892000,5614900,129506900,False
2742,validator_47,70238514390,True,43572000,26694200,70266200,False
2743,validator_29,36272992540,True,74343000,2772510,77115510,False
2744,validator_35,103413663550,True,77093000,1079200,78172200,False
2745,validator_25,37139479530,True,45396000,418440,45814440,False
2746,validator_33,37600789570,True,66885000,1356360,68241360,False
2747,validator_17,170129642965,True,93630002,1145830,94775832,True
2748,validator_15,268316538993,True,116294999,1610590,117905589,True
2749,validator_43,69402350280,True,113110000,8831000,121941000,False
2750,validator_43,69476982810,True,73959000,673530,74632530,False
2751,validator_2,41347215572,True,291448002,881620,292329622,True
2752,validator_35,103571143280,True,156276000,1203730,157479730,False
2753,validator_30,70870206270,True,86113000,7671400,93784400,False
2754,validator_5,72170439844,True,88881998,6379940,95261938,True
2755,validator_36,101342424610,True,207801000,1937600,209738600,False
2756,validator_32,38760794680,True,160939000,784040,161723040,False
2757,validator_43,69604738610,True,126930000,825800,127755800,False
2758,validator_26,38549219080,True,94706000,966900,95672900,False
2759,validator_9,38736081697,True,242659996,5469020,248129016,True
2760,validator_47,70300563080,True,60644000,1404690,62048690,False
2761,validator_15,268469591594,True,148248001,4804600,153052601,True
2762,validator_10,38856570512,True,97780000,1288130,99068130,True
2763,validator_21,70290242540,True,76460009,3180600,79640609,True
2764,validator_11,40374327104,True,189482004,2249390,191731394,True
2765,validator_0,39783561718,True,268033004,628410,268661414,True
2766,validator_28,37036163470,True,157552000,889900,158441900,False
2767,validator_10,38975241570,True,109962998,8708060,118671058,True
2768,validator_31,167710939150,True,91512000,5512920,97024920,False
2769,validator_33,37772204370,True,167701000,3713800,171414800,False
2770,validator_44,104705886260,True,116158000,5112380,121270380,False
2771,validator_40,39068458130,True,166626000,11694510,178320510,False
2772,validator_42,37954477100,True,91313000,1837300,93150300,False
2773,validator_17,170208008466,True,78232001,133500,78365501,True
2774,validator_16,37806951678,True,158864000,1243500,160107500,True
2775,validator_3,40752943012,True,169309004,1987200,171296204,True
2776,validator_16,37901599506,True,87215998,7431830,94647828,True
2777,validator_1,71191026868,True,104892999,19234700,124127699,True
2778,validator_21,70377572841,True,86600001,730300,87330301,True
2779,validator_46,101751056350,True,167569000,4797890,172366890,False
2780,validator_25,37249142730,True,106402000,3261200,109663200,False
2781,validator_22,71521117092,True,112503001,705700,113208701,True
2782,validator_36,101475883530,True,124707000,8751920,133458920,False
2783,validator_14,105755576526,True,248240999,14789980,263030979,True
2784,validator_47,70371539080,True,62557000,8419000,70976000,False
2785,validator_22,71657812887,True,135042995,1652800,136695795,True
2786,validator_14,105875817656,True,118990000,1251130,120241130,True
2787,validator_38,38073666500,True,114776000,1129520,115905520,False
2788,validator_29,36436313940,True,161686000,1635400,163321400,False
2789,validator_24,38585331602,True,86666999,755800,87422799,True
2790,validator_23,40280247209,True,164071997,1179300,165251297,True
2791,validator_8,40245621655,True,63060002,570900,63630902,True
2792,validator_8,40478903135,True,213199000,20082480,233281480,True
2793,validator_28,37116866790,True,70611000,10092320,80703320,False
2794,validator_43,69727324310,True,96681000,25904700,122585700,False
2795,validator_42,38089120170,True,133582000,1061070,134643070,False
2796,validator_41,70925053940,True,102861000,2302200,105163200,False
2797,validator_9,39060731899,True,280533002,44117200,324650202,True
2798,validator_37,70814001650,True,146685000,18809230,165494230,False
2799,validator_26,38629390680,True,78688000,1483600,80171600,False
2800,validator_24,38676378601,True,90345999,701000,91046999,True
2801,validator_17,170323705252,True,113507006,2189780,115696786,True
2802,validator_7,74237305548,True,151297006,940800,152237806,True
2803,validator_40,39188845460,True,120200000,187330,120387330,False
2804,validator_46,101907813750,True,154893000,1864400,156757400,False
2805,validator_18,103809876590,True,112190004,1059000,113249004,True
2806,validator_43,69793192330,True,64174000,1694020,65868020,False
2807,validator_6,37782787517,True,141741003,2184400,143925403,True
2808,validator_44,104743543150,True,35904000,1752890,37656890,False
2809,validator_35,103718040670,True,144765000,2132390,146897390,False
2810,validator_17,170440635251,True,116500999,429000,116929999,True
2811,validator_20,38491277001,True,152855006,4647830,157502836,True
2812,validator_48,166968017340,True,136848000,8311800,145159800,False
2813,validator_33,37901352610,True,120833000,8315240,129148240,False
2814,validator_41,71167277340,True,241602000,621400,242223400,False
2815,validator_19,71758278198,True,175527000,2371390,177898390,True
2816,validator_18,103934994291,True,116397001,8720700,125117701,True
2817,validator_47,70567688700,True,195686000,463620,196149620,False
2818,validator_20,38591114797,True,97092996,2744800,99837796,True
2819,validator_31,167840219330,True,126114000,3166180,129280180,False
2820,validator_25,37408618430,True,151702000,7773700,159475700,False
2821,validator_42,38254458660,True,159363000,5975490,165338490,False
2822,validator_12,104801077711,True,99558003,2011300,101569303,True
2823,validator_39,38574151110,True,131164000,2368410,133532410,False
2824,validator_41,71235095660,True,66786000,1032320,67818320,False
2825,validator_44,104865382880,True,121181000,658730,121839730,False
2826,validator_15,268588936892,True,111542998,7802300,119345298,True
2827,validator_46,102051183940,True,141804000,1566190,143370190,False
2828,validator_15,268697376586,True,99809994,8629700,108439694,True
2829,validator_36,101556318660,True,79763000,672130,80435130,False
2830,validator_30,70916028870,True,44657000,1165600,45822600,False
2831,validator_49,70797285690,True,133423000,7489190,140912190,False
2832,validator_30,71125075530,True,191059000,17987660,209046660,False
2833,validator_18,103996909293,True,59929002,1986000,61915002,True
2834,validator_5,72285498305,True,114598001,460460,115058461,True
2835,validator_12,105004520193,True,202102002,1340480,203442482,True
2836,validator_41,71407473160,True,170538000,1839500,172377500,False
2837,validator_39,38702965310,True,110059000,18755200,128814200,False
2838,validator_6,37893113418,True,109045001,1280900,110325901,True
2839,validator_38,38332564080,True,235954000,22943580,258897580,False
2840,validator_41,71466564900,True,57159000,1932740,59091740,False
2841,validator_40,39264443290,True,62399000,13198830,75597830,False
2842,validator_27,103312019650,True,92614000,216030,92830030,False
2843,validator_2,41545371275,True,190844003,7311700,198155703,True
2844,validator_31,167969191330,True,128474000,498000,128972000,False
2845,validator_16,38084891536,True,181974000,1318030,183292030,True
2846,validator_33,38059920720,True,146099000,12469110,158568110,False
2847,validator_16,38199545067,True,114105001,548530,114653531,True
2848,validator_41,71575194080,True,101790000,6839180,108629180,False
2849,validator_15,268908756288,True,209726002,1653700,211379702,True
2850,validator_30,71249929530,True,124472000,382000,124854000,False
2851,validator_28,37228516120,True,111103000,546330,111649330,False
2852,validator_32,38853382910,True,91642000,946230,92588230,False
2853,validator_29,36567726940,True,123599000,7814000,131413000,False
2854,validator_5,72565889202,True,278359997,2030900,280390897,True
2855,validator_11,40535433604,True,141548000,19558500,161106500,True
2856,validator_17,170695731154,True,236399003,18696900,255095903,True
2857,validator_6,38102673415,True,208749997,810000,209559997,True
2858,validator_14,106218213078,True,336385002,6010420,342395422,True
2859,validator_21,70558989566,True,179738005,1678720,181416725,True
2860,validator_29,36682187740,True,112742000,1718800,114460800,False
2861,validator_23,40484834237,True,202480998,2106030,204587028,True
2862,validator_27,103487260680,True,175192000,49030,175241030,False
2863,validator_22,71734307020,True,75857003,637130,76494133,True
2864,validator_30,71336697230,True,86628000,139700,86767700,False
2865,validator_32,38888353310,True,34684000,286400,34970400,False
2866,validator_31,168093676830,True,116928000,7557500,124485500,False
2867,validator_39,38782276190,True,77179000,2131880,79310880,False
2868,validator_13,38189885591,True,89056999,4887700,93944699,True
2869,validator_0,39893831340,True,100993002,9276620,110269622,True
2870,validator_49,70871012460,True,72380000,1346770,73726770,False
2871,validator_32,39066083350,True,170064000,7666040,177730040,False
2872,validator_11,40657570139,True,109834995,12301540,122136535,True
2873,validator_35,103869914170,True,149045000,2828500,151873500,False
2874,validator_24,38807240304,True,130542003,319700,130861703,True
2875,validator_17,170950223548,True,249483994,5008400,254492394,True
2876,validator_12,105157246296,True,151480003,1246100,152726103,True
2877,validator_19,71883633039,True,106547001,18807840,125354841,True
2878,validator_15,269073959450,True,160148002,5055160,165203162,True
2879,validator_10,39109845874,True,134187004,417300,134604304,True
2880,validator_23,40622234776,True,136172999,1227540,137400539,True
2881,validator_1,71428104869,True,236426001,652000,237078001,True
2882,validator_38,38384648080,True,51114000,970000,52084000,False
2883,validator_6,38259164819,True,154823004,1668400,156491404,True
2884,validator_28,37293279120,True,63476000,1287000,64763000,False
2885,validator_28,37358605480,True,64202000,1124360,65326360,False
2886,validator_49,70983405060,True,110380000,2012600,112392600,False
2887,validator_46,102185669660,True,115143000,19342720,134485720,False
2888,validator_31,168219411630,True,124897000,837800,125734800,False
2889,validator_31,168356064200,True,135746000,906570,136652570,False
2890,validator_36,101730467560,True,172604000,1544900,174148900,False
2891,validator_31,168449269680,True,92659000,546480,93205480,False
2892,validator_43,69952006470,True,157698000,1116140,158814140,False
2893,validator_26,38701519380,True,71284000,844700,72128700,False
2894,validator_41,71687675080,True,112247000,234000,112481000,False
2895,validator_8,40735589064,True,236430999,20254930,256685929,True
2896,validator_12,105387590090,True,224103994,6239800,230343794,True
2897,validator_37,70941303750,True,126396000,906100,127302100,False
2898,validator_5,72644814502,True,77651000,1274300,78925300,True
2899,validator_18,104121332514,True,124298001,125220,124423221,True
2900,validator_43,70060560170,True,107582000,971700,108553700,False
2901,validator_22,71838663859,True,102862999,1493840,104356839,True
2902,validator_18,104271671917,True,149972003,367400,150339403,True
2903,validator_44,104968509860,True,101830000,1296980,103126980,False
2904,validator_8,40980326578,True,240141994,4595520,244737514,True
2905,validator_47,70707009430,True,137257000,2063730,139320730,False
2906,validator_31,168534619010,True,85169000,180330,85349330,False
2907,validator_42,38374366690,True,117214000,2694030,119908030,False
2908,validator_26,38830853980,True,128801000,533600,129334600,False
2909,validator_35,103982274210,True,111370000,990040,112360040,False
2910,validator_22,71914895060,True,75924001,307200,76231201,True
2911,validator_10,39171734797,True,60801003,1087920,61888923,True
2912,validator_0,40047824183,True,153243003,749840,153992843,True
2913,validator_23,40758515474,True,128082998,8197700,136280698,True
2914,validator_46,102338513660,True,151822000,1022000,152844000,False
2915,validator_18,104429722816,True,156608999,1441900,158050899,True
2916,validator_14,106374313377,True,149789999,6310300,156100299,True
2917,validator_3,41006808573,True,252389001,1476560,253865561,True
2918,validator_30,71381678510,True,41583000,3398280,44981280,False
2919,validator_7,74309678352,True,71121004,1251800,72372804,True
2920,validator_49,71113681260,True,129357000,919200,130276200,False
2921,validator_47,70911506010,True,202970000,1526580,204496580,False
2922,validator_3,41159584972,True,150135999,2640400,152776399,True
2923,validator_46,102498231660,True,156541000,3177000,159718000,False
2924,validator_6,38438142875,True,177956996,1021060,178978056,True
2925,validator_6,38605039524,True,163217999,3678650,166896649,True
2926,validator_12,105606490989,True,217707999,1192900,218900899,True
2927,validator_47,71109839390,True,195438000,2895380,198333380,False
2928,validator_18,104576623716,True,141853000,5047900,146900900,True
2929,validator_26,38934313820,True,102967000,492840,103459840,False
2930,validator_18,104713172331,True,129588995,6959620,136548615,True
2931,validator_49,71192827920,True,70728000,8418660,79146660,False
2932,validator_42,38418587090,True,43678000,542400,44220400,False
2933,validator_42,38500148270,True,73919000,7642180,81561180,False
2934,validator_46,102682399960,True,183319000,849300,184168300,False
2935,validator_48,167043836440,True,74125000,1694100,75819100,False
2936,validator_24,39021433208,True,211262004,2930900,214192904,True
2937,validator_15,269154176394,True,76650004,3566940,80216944,True
2938,validator_21,70754581561,True,176080995,19511000,195591995,True
2939,validator_47,71223452690,True,106903000,6710300,113613300,False
2940,validator_15,269288982060,True,134432996,372670,134805666,True
2941,validator_40,39425224490,True,159207000,1574200,160781200,False
2942,validator_16,38386919262,True,180906995,6467200,187374195,True
2943,validator_24,39111480534,True,71327996,18719330,90047326,True
2944,validator_38,38640699580,True,255873000,178500,256051500,False
2945,validator_28,37462765480,True,103354000,806000,104160000,False
2946,validator_35,104069564190,True,86620000,669980,87289980,False
2947,validator_34,266338540020,True,141923000,1475300,143398300,False
2948,validator_35,104149251690,True,77868000,1819500,79687500,False
2949,validator_24,39285279535,True,165702001,8097000,173799001,True
2950,validator_18,104903133137,True,187662006,2298800,189960806,True
2951,validator_25,37484293330,True,74440000,1234900,75674900,False
2952,validator_31,168657169910,True,121112000,1438900,122550900,False
2953,validator_27,103609762320,True,114983000,7518640,122501640,False
2954,validator_22,72053305026,True,138028996,380970,138409966,True
2955,validator_26,39056782920,True,121669000,800100,122469100,False
2956,validator_3,41372976006,True,187007004,26384030,213391034,True
2957,validator_3,41494988188,True,121484002,528180,122012182,True
2958,validator_11,40725546971,True,67665002,311830,67976832,True
2959,validator_23,40844358276,True,84088002,1754800,85842802,True
2960,validator_28,37583659540,True,101489000,19405060,120894060,False
2961,validator_47,71308628830,True,66741000,18435140,85176140,False
2962,validator_47,71355063390,True,45240000,1194560,46434560,False
2963,validator_10,39275520278,True,103327001,458480,103785481,True
2964,validator_33,38219560020,True,158583000,1056300,159639300,False
2965,validator_26,39276523800,True,201395000,18345880,219740880,False
2966,validator_38,38758253180,True,109791000,7762600,117553600,False
2967,validator_49,71315049990,True,103565000,18657070,122222070,False
2968,validator_6,38713273244,True,100448000,7785720,108233720,True
2969,validator_46,102782649210,True,98610000,1639250,100249250,False
2970,validator_44,105034035910,True,55932000,9594050,65526050,False
2971,validator_5,72778276756,True,129767994,3694260,133462254,True
2972,validator_47,71438563890,True,75314000,8186500,83500500,False
2973,validator_3,41823478993,True,308522005,19968800,328490805,True
2974,validator_4,39923655366,True,172897998,905380,173803378,True
2975,validator_36,101911846660,True,180006000,1373100,181379100,False
2976,validator_1,71512765649,True,82432000,2228780,84660780,True
2977,validator_41,71820863980,True,132288000,900900,133188900,False
2978,validator_42,38718328770,True,198949000,19231500,218180500,False
2979,validator_37,71113060890,True,146552000,25205140,171757140,False
2980,validator_14,106505429697,True,112138000,18978320,131116320,True
2981,validator_1,71705951950,True,192761001,425300,193186301,True
2982,validator_17,171047501623,True,88748995,8529080,97278075,True
2983,validator_7,74456474250,True,145705998,1089900,146795898,True
2984,validator_38,38937499480,True,177289000,1957300,179246300,False
2985,validator_46,102889640800,True,105938000,1053590,106991590,False
2986,validator_8,41219247078,True,238443000,477500,238920500,True
2987,validator_6,38820967846,True,99713002,7981600,107694602,True
2988,validator_2,41863154010,True,316507005,1275730,317782735,True
2989,validator_11,40921759989,True,175577998,20635020,196213018,True
2990,validator_37,71216218530,True,83620000,19537640,103157640,False
2991,validator_12,105921105306,True,313649997,964320,314614317,True
2992,validator_23,40921687810,True,75970994,1358540,77329534,True
2993,validator_12,105968245135,True,46558999,580830,47139829,True
2994,validator_17,171156130620,True,107970997,658000,108628997,True
2995,validator_6,38917394887,True,95738001,689040,96427041,True
2996,validator_1,71823841845,True,116304995,1584900,117889895,True
2997,validator_21,70856381787,True,100007996,1792230,101800226,True
2998,validator_33,38325524720,True,105799000,165700,105964700,False
2999,validator_28,37714800540,True,107981000,23160000,131141000,False
3000,validator_28,37806289030,True,85281000,6207490,91488490,False
3001,validator_4,40023600168,True,84551002,15393800,99944802,True
3002,validator_49,71461872580,True,127392000,19430590,146822590,False
3003,validator_19,71987390821,True,103561002,196780,103757782,True
3004,validator_48,167079017840,True,34628000,553400,35181400,False
3005,validator_33,38381715060,True,54512000,1678340,56190340,False
3006,validator_26,39430059240,True,151583000,1952440,153535440,False
3007,validator_15,269462776843,True,173052003,742780,173794783,True
3008,validator_15,269626333546,True,153349003,10207700,163556703,True
3009,validator_2,42162571121,True,296562001,2855110,299417111,True
3010,validator_9,39168476289,True,107557000,187390,107744390,True
3011,validator_24,39419510712,True,133384997,846180,134231177,True
3012,validator_15,269767613347,True,140081001,1198800,141279801,True
3013,validator_36,102020090000,True,107767000,476340,108243340,False
3014,validator_10,39335453977,True,59463999,469700,59933699,True
3015,validator_31,168739538910,True,81530000,839000,82369000,False
3016,validator_46,103101331540,True,209406000,2284740,211690740,False
3017,validator_10,39401098850,True,64518003,1126870,65644873,True
3018,validator_47,71537511090,True,97696000,1251200,98947200,False
3019,validator_20,38757458197,True,165058000,1285400,166343400,True
3020,validator_29,36770670200,True,87076000,1406460,88482460,False
3021,validator_32,39321294950,True,254071000,1140600,255211600,False
3022,validator_18,105077024230,True,172335003,1556090,173891093,True
3023,validator_38,39026601050,True,80747000,8354570,89101570,False
3024,validator_23,41062137542,True,139634002,815730,140449732,True
3025,validator_30,71480138510,True,97785000,675000,98460000,False
3026,validator_47,71644088770,True,106235000,342680,106577680,False
3027,validator_37,71313589370,True,94454000,2916840,97370840,False
3028,validator_1,71880091038,True,54634993,1614200,56249193,True
3029,validator_42,38805993570,True,68937000,18727800,87664800,False
3030,validator_8,41335520782,True,115838004,435700,116273704,True
3031,validator_36,102146961500,True,125661000,1210500,126871500,False
3032,validator_14,106726653580,True,214377003,6846880,221223883,True
3033,validator_43,70153498870,True,91308000,1630700,92938700,False
3034,validator_40,39597408690,True,171288000,896200,172184200,False
3035,validator_0,40109078565,True,60250002,1004380,61254382,True
3036,validator_41,71889705950,True,64009000,4832970,68841970,False
3037,validator_46,103248333520,True,145240000,1761980,147001980,False
3038,validator_38,39127350950,True,99210000,1539900,100749900,False
3039,validator_17,171247523868,True,81398008,9995240,91393248,True
3040,validator_29,36896552070,True,124339000,1542870,125881870,False
3041,validator_25,37574532030,True,81846000,8392700,90238700,False
3042,validator_26,39542811940,True,110993000,1759700,112752700,False
3043,validator_29,36992676060,True,94122000,2001990,96123990,False
3044,validator_31,168871955960,True,106426000,25991050,132417050,False
3045,validator_45,38290518290,True,82178000,1729410,83907410,False
3046,validator_2,42381263944,True,212691003,6001820,218692823,True
3047,validator_36,102280433700,True,110341000,23131200,133472200,False
3048,validator_47,71729069570,True,84761000,219800,84980800,False
3049,validator_20,38923991994,True,165731997,801800,166533797,True
3050,validator_31,169013628060,True,139659000,2013100,141672100,False
3051,validator_36,102397812300,True,109366000,8012600,117378600,False
3052,validator_33,38438967860,True,56515000,737800,57252800,False
3053,validator_1,71985218423,True,103988995,1138390,105127385,True
3054,validator_38,39264312180,True,136389000,572230,136961230,False
3055,validator_31,169153670590,True,138634000,1408530,140042530,False
3056,validator_25,37701936450,True,121692000,5712420,127404420,False
3057,validator_14,106899516321,True,171077001,1785740,172862741,True
3058,validator_9,39261657606,True,88054997,5126320,93181317,True
3059,validator_5,72923085954,True,125584998,19224200,144809198,True
3060,validator_31,169243334690,True,88272000,1392100,89664100,False
3061,validator_38,39373742600,True,108193000,1237420,109430420,False
3062,validator_48,167222503020,True,124433000,19052180,143485180,False
3063,validator_45,38377564410,True,83227000,3819120,87046120,False
3064,validator_36,102554588820,True,154632000,2144520,156776520,False
3065,validator_45,38469317750,True,84893000,6860340,91753340,False
3066,validator_0,40186309062,True,76515997,714500,77230497,True
3067,validator_34,266472462420,True,127100000,6822400,133922400,False
3068,validator_20,39154749853,True,230155999,601860,230757859,True
3069,validator_34,266528205050,True,54917000,825630,55742630,False
3070,validator_49,71604616080,True,124518000,18225500,142743500,False
3071,validator_29,37035844860,True,37902000,5266800,43168800,False
3072,validator_9,39483476237,True,213345001,8473630,221818631,True
3073,validator_17,171404438610,True,130592002,26322740,156914742,True
3074,validator_21,71024829086,True,165751999,2695300,168447299,True
3075,validator_39,38894905420,True,87213000,25416230,112629230,False
3076,validator_44,105134580290,True,99288000,1256380,100544380,False
3077,validator_13,38316528292,True,124764001,1878700,126642701,True
3078,validator_18,105144971120,True,62056000,5890890,67946890,True
3079,validator_27,103669514550,True,58243000,1509230,59752230,False
3080,validator_7,74613629051,True,137835001,19319800,157154801,True
3081,validator_38,39526418140,True,151642000,1033540,152675540,False
3082,validator_37,71461923670,True,139146000,9188300,148334300,False
3083,validator_47,71929266370,True,199514000,682800,200196800,False
3084,validator_28,37911750410,True,86182000,19279380,105461380,False
3085,validator_10,39559134949,True,127800999,30235100,158036099,True
3086,validator_48,167308190100,True,84923000,764080,85687080,False
3087,validator_25,37813979170,True,110798000,1244720,112042720,False
3088,validator_27,103822138350,True,149966000,2657800,152623800,False
3089,validator_32,39404790750,True,82986000,509800,83495800,False
3090,validator_40,39700434290,True,100600000,2425600,103025600,False
3091,validator_0,40252049261,True,65057999,682200,65740199,True
3092,validator_48,167457664600,True,147683000,1791500,149474500,False
3093,validator_45,38507376590,True,36816000,1242840,38058840,False
3094,validator_13,38458889000,True,140633998,1726710,142360708,True
3095,validator_11,41232736288,True,274693999,36282300,310976299,True
3096,validator_14,106962130816,True,61470005,1144490,62614495,True
3097,validator_43,70366698890,True,194283000,18917020,213200020,False
3098,validator_22,72098930403,True,44957997,667380,45625377,True
3099,validator_10,39683439591,True,123329002,975640,124304642,True
3100,validator_18,105279993800,True,116158000,18864680,135022680,True
3101,validator_32,39457649850,True,51497000,1362100,52859100,False
3102,validator_29,37126980360,True,84022000,7113500,91135500,False
3103,validator_43,70468711710,True,101046000,966820,102012820,False
3104,validator_31,169398668570,True,135554000,19779880,155333880,False
3105,validator_19,72108384898,True,120942997,51080,120994077,True
3106,validator_40,39806491130,True,104352000,1704840,106056840,False
3107,validator_6,39044479689,True,126469002,615800,127084802,True
3108,validator_25,37881672960,True,60174000,7519790,67693790,False
3109,validator_13,38607940900,True,130224000,18827900,149051900,True
3110,validator_45,38669333590,True,158931000,3026000,161957000,False
3111,validator_46,103349129420,True,99776000,1019900,100795900,False
3112,validator_28,38020353590,True,107393000,1210180,108603180,False
3113,validator_45,38757144220,True,82852000,4958630,87810630,False
3114,validator_16,38449401182,True,62249000,232920,62481920,True
3115,validator_42,38914788470,True,107875000,919900,108794900,False
3116,validator_39,39048849920,True,153515000,429500,153944500,False
3117,validator_0,40384557127,True,131398996,1108870,132507866,True
3118,validator_48,167529977040,True,72006000,306440,72312440,False
3119,validator_27,103963083450,True,140652000,293100,140945100,False
3120,validator_48,167728555730,True,183135000,15443690,198578690,False
3121,validator_9,39681944433,True,196810996,1657200,198468196,True
3122,validator_19,72195254207,True,85998999,870310,86869309,True
3123,validator_23,41217219080,True,136681998,18399540,155081538,True
3124,validator_31,169484794500,True,76979000,9146930,86125930,False
3125,validator_31,169615120100,True,129583000,742600,130325600,False
3126,validator_46,103457637610,True,108192000,316190,108508190,False
3127,validator_17,171577132750,True,171739000,955140,172694140,True
3128,validator_36,102613692120,True,57843000,1260300,59103300,False
3129,validator_8,41614652723,True,278101001,1030940,279131941,True
3130,validator_32,39589082690,True,117619000,13813840,131432840,False
3131,validator_40,39934279330,True,125749000,2039200,127788200,False
3132,validator_3,41926061122,True,102254999,327130,102582129,True
3133,validator_8,41670485441,True,55591998,240720,55832718,True
3134,validator_30,71540642730,True,59762000,742220,60504220,False
3135,validator_11,41293635525,True,60084997,814240,60899237,True
3136,validator_3,42032137391,True,98028999,8047270,106076269,True
3137,validator_21,71215516602,True,189560996,1126520,190687516,True
3138,validator_12,106078702433,True,81450998,29006300,110457298,True
3139,validator_31,169766352000,True,150496000,735900,151231900,False
3140,validator_31,169842151590,True,74600000,1199590,75799590,False
3141,validator_10,39912215225,True,216349004,12426630,228775634,True
3142,validator_4,40172225182,True,147784994,840020,148625014,True
3143,validator_36,102771596440,True,156594000,1310320,157904320,False
3144,validator_2,42496722868,True,114192004,1266920,115458924,True
3145,validator_20,39324468448,True,167597995,2120600,169718595,True
3146,validator_23,41484464081,True,247549001,19696000,267245001,True
3147,validator_29,37231036390,True,102982000,1074030,104056030,False
3148,validator_3,42266790996,True,233239005,1414600,234653605,True
3149,validator_49,71752445370,True,146981000,848290,147829290,False
3150,validator_22,72215018599,True,110993996,5094200,116088196,True
3151,validator_43,70518837680,True,49003000,1122970,50125970,False
3152,validator_18,105400964997,True,102663997,18307200,120971197,True
3153,validator_24,39587255411,True,166379999,1364700,167744699,True
3154,validator_47,72038534870,True,97698000,11570500,109268500,False
3155,validator_28,38093452190,True,72555000,543600,73098600,False
3156,validator_35,104248410170,True,98884000,274480,99158480,False
3157,validator_41,72004507650,True,112097000,2704700,114801700,False
3158,validator_15,269914657527,True,146793000,251180,147044180,True
3159,validator_23,41683292405,True,197628994,1199330,198828324,True
3160,validator_40,40033428230,True,98405000,743900,99148900,False
3161,validator_23,41883466299,True,175816994,24356900,200173894,True
3162,validator_42,39030252470,True,97202000,18262000,115464000,False
3163,validator_18,105454519017,True,52554000,1000020,53554020,True
3164,validator_36,102903071440,True,112827000,18648000,131475000,False
3165,validator_43,70636102180,True,116623000,641500,117264500,False
3166,validator_0,40519485119,True,133344002,1583990,134927992,True
3167,validator_35,104333735270,True,83530000,1795100,85325100,False
3168,validator_0,40658230664,True,137258005,1487540,138745545,True
3169,validator_15,270049109454,True,132418997,2032930,134451927,True
3170,validator_13,38700882297,True,83429997,9511400,92941397,True
3171,validator_39,39197639820,True,148135000,654900,148789900,False
3172,validator_46,103655986790,True,197202000,1147180,198349180,False
3173,validator_27,104212929080,True,249454000,391630,249845630,False
3174,validator_41,72127302050,True,121304000,1490400,122794400,False
3175,validator_17,171675242751,True,90356001,7754000,98110001,True
3176,validator_47,72186203070,True,146450000,1218200,147668200,False
3177,validator_17,171864293983,True,188706002,345230,189051232,True
3178,validator_38,39601384960,True,73264000,1702820,74966820,False
3179,validator_23,41977662649,True,93409000,787350,94196350,True
3180,validator_17,171943150365,True,67098002,11758380,78856382,True
3181,validator_5,73133494585,True,209589001,819630,210408631,True
3182,validator_42,39200531550,True,168301000,1978080,170279080,False
3183,validator_29,37341311610,True,104914000,5361220,110275220,False
3184,validator_1,72086958727,True,100128004,1612300,101740304,True
3185,validator_33,38591512360,True,150975000,1569500,152544500,False
3186,validator_32,39719276600,True,127879000,2314910,130193910,False
3187,validator_5,73434279119,True,299344994,1439540,300784534,True
3188,validator_3,42427731901,True,133680005,27260900,160940905,True
3189,validator_27,104261116880,True,47658000,529800,48187800,False
3190,validator_15,270141434152,True,78937998,13386700,92324698,True
3191,validator_37,71537264470,True,73890000,1450800,75340800,False
3192,validator_30,71648969130,True,88089000,20237400,108326400,False
3193,validator_20,39434626448,True,109624000,534000,110158000,True
3194,validator_10,40071285828,True,140508003,18562600,159070603,True
3195,validator_1,72318896225,True,231400998,536500,231937498,True
3196,validator_4,40242045421,True,67039999,2780240,69820239,True
3197,validator_22,72510811270,True,294632001,1160670,295792671,True
3198,validator_33,38693159340,True,101080000,566980,101646980,False
3199,validator_7,74673321882,True,58200001,1492830,59692831,True
3200,validator_42,39248242740,True,47440000,271190,47711190,False
3201,validator_28,38168525790,True,74231000,842600,75073600,False
3202,validator_15,270291042449,True,140674997,8933300,149608297,True
3203,validator_3,42521067201,True,93018000,317300,93335300,True
3204,validator_43,70769125760,True,130863000,2160580,133023580,False
3205,validator_43,70912823760,True,142971000,727000,143698000,False
3206,validator_12,106170808661,True,84442998,7663230,92106228,True
3207,validator_11,41358766324,True,64565999,564800,65130799,True
3208,validator_7,74766357478,True,92083996,951600,93035596,True
3209,validator_34,266687669350,True,158023000,1441300,159464300,False
3210,validator_44,105242244160,True,102773000,4890870,107663870,False
3211,validator_24,39767034551,True,178533000,1246140,179779140,True
3212,validator_43,70996320590,True,81781000,1715830,83496830,False
3213,validator_38,39711197030,True,108845000,967070,109812070,False
3214,validator_26,39642372950,True,91460000,8101010,99561010,False
3215,validator_17,172200592755,True,250822990,6619400,257442390,True
3216,validator_32,39861795800,True,141960000,559200,142519200,False
3217,validator_9,39783298435,True,99936002,1418000,101354002,True
3218,validator_16,38512368779,True,59502997,3464600,62967597,True
3219,validator_8,41818445642,True,146125001,1835200,147960201,True
3220,validator_44,105428806700,True,150622000,35940540,186562540,False
3221,validator_1,72541268411,True,216528996,5843190,222372186,True
3222,validator_16,38606150075,True,92953996,827300,93781296,True
3223,validator_49,71949894370,True,195989000,1460000,197449000,False
3224,validator_14,107014710543,True,51740997,838730,52579727,True
3225,validator_27,104457895480,True,196533000,245600,196778600,False
3226,validator_22,72602669367,True,84540997,7317100,91858097,True
3227,validator_36,103050286740,True,127238000,19977300,147215300,False
3228,validator_31,170057571490,True,214434000,985900,215419900,False
3229,validator_44,105480218450,True,49465000,1946750,51411750,False
3230,validator_20,39556067860,True,118109992,3331420,121441412,True
3231,validator_15,270395127946,True,97912997,6172500,104085497,True
3232,validator_18,105587677047,True,131646000,1512030,133158030,True
3233,validator_15,270506592067,True,93078001,18386120,111464121,True
3234,validator_12,106463918565,True,291613004,1496900,293109904,True
3235,validator_31,170178792590,True,120092000,1129100,121221100,False
3236,validator_43,71114752540,True,117803000,628950,118431950,False
3237,validator_46,103702618490,True,44890000,1741700,46631700,False
3238,validator_36,103259658240,True,208952000,419500,209371500,False
3239,validator_31,170394761230,True,204721000,11247640,215968640,False
3240,validator_25,37989653550,True,107555000,425590,107980590,False
3241,validator_5,73548006647,True,111231998,2495530,113727528,True
3242,validator_40,40097391420,True,62186000,1777190,63963190,False
3243,validator_44,105598927350,True,117495000,1213900,118708900,False
3244,validator_36,103376991640,True,115643000,1690400,117333400,False
3245,validator_25,38089934940,True,99885000,396390,100281390,False
3246,validator_39,39370448920,True,170884000,1925100,172809100,False
3247,validator_3,42740963442,True,217714001,2182240,219896241,True
3248,validator_12,106642769972,True,177440997,1410410,178851407,True
3249,validator_16,38678490115,True,64381000,7959040,72340040,True
3250,validator_19,72369308909,True,172014002,2040700,174054702,True
3251,validator_12,106866298698,True,219906006,3622720,223528726,True
3252,validator_31,170512893420,True,118112000,20190,118132190,False
3253,validator_29,37541752010,True,197183000,3257400,200440400,False
3254,validator_27,104611054220,True,152842000,316740,153158740,False
3255,validator_32,39955459000,True,92600000,1063200,93663200,False
3256,validator_41,72198684150,True,70680000,702100,71382100,False
3257,validator_14,107110426839,True,94208006,1508290,95716296,True
3258,validator_7,74980601882,True,201254004,12990400,214244404,True
3259,validator_16,38809938919,True,129120004,2328800,131448804,True
3260,validator_7,75072120362,True,90634000,884480,91518480,True
3261,validator_10,40174363932,True,102966004,112100,103078104,True
3262,validator_38,39853207430,True,139837000,2173400,142010400,False
3263,validator_17,172448726993,True,246551998,1582240,248134238,True
3264,validator_15,270669200366,True,161294999,1313300,162608299,True
3265,validator_44,105779181030,True,177995000,2258680,180253680,False
3266,validator_40,40195926950,True,98011000,524530,98535530,False
3267,validator_27,104675334820,True,61498000,2782600,64280600,False
3268,validator_22,72744378339,True,139531002,2177970,141708972,True
3269,validator_18,105783334803,True,176708996,18948760,195657756,True
3270,validator_4,40445254304,True,184959003,18249880,203208883,True
3271,validator_16,38949781411,True,139457002,385490,139842492,True
3272,validator_48,167931159930,True,194999000,7605200,202604200,False
3273,validator_14,107242690619,True,124410000,7853780,132263780,True
3274,validator_17,172586923895,True,138103002,93900,138196902,True
3275,validator_39,39510725820,True,139431000,845900,140276900,False
3276,validator_27,104860937010,True,184153000,1449190,185602190,False
3277,validator_22,72838157941,True,91787002,1992600,93779602,True
3278,validator_15,270758738101,True,89132005,405730,89537735,True
3279,validator_16,39050060116,True,99798005,480700,100278705,True
3280,validator_23,42202534219,True,222464000,2407570,224871570,True
3281,validator_41,72378390190,True,178346000,1360040,179706040,False
3282,validator_43,71270124230,True,147530000,7841690,155371690,False
3283,validator_26,39805210500,True,158749000,4088550,162837550,False
3284,validator_0,40976250060,True,316710996,1308400,318019396,True
3285,validator_19,72555392410,True,173549001,12534500,186083501,True
3286,validator_29,37613034310,True,52140000,19142300,71282300,False
3287,validator_14,107411988515,True,149987996,19309900,169297896,True
3288,validator_33,38852583460,True,157489000,1935120,159424120,False
3289,validator_16,39156486115,True,104471999,1954000,106425999,True
3290,validator_35,104494032760,True,158024000,2273490,160297490,False
3291,validator_24,39895064958,True,126899997,1130410,128030407,True
3292,validator_11,41492986022,True,128651998,5567700,134219698,True
3293,validator_9,39921498432,True,129220997,8979000,138199997,True
3294,validator_40,40302983580,True,105394000,1662630,107056630,False
3295,validator_43,71341701290,True,69192000,2385060,71577060,False
3296,validator_32,40016186220,True,59660000,1067220,60727220,False
3297,validator_20,39654838288,True,98229998,540430,98770428,True
3298,validator_14,107563703331,True,151443996,270820,151714816,True
3299,validator_34,266791524230,True,95536000,8318880,103854880,False
3300,validator_48,168084280130,True,147780000,5340200,153120200,False
3301,validator_23,42327621118,True,122763999,2322900,125086899,True
3302,validator_8,41921450008,True,101643996,1360370,103004366,True
3303,validator_21,71301644804,True,85537002,591200,86128202,True
3304,validator_13,38741466882,True,38490005,2094580,40584585,True
3305,validator_49,72059288570,True,108583000,811200,109394200,False
3306,validator_23,42527701522,True,198864004,1216400,200080404,True
3307,validator_48,168217340390,True,130436000,2624260,133060260,False
3308,validator_12,107062625736,True,195882998,444040,196327038,True
3309,validator_43,71375833070,True,33096000,1035780,34131780,False
3310,validator_10,40314819728,True,138768996,1686800,140455796,True
3311,validator_22,72942322843,True,101468002,2696900,104164902,True
3312,validator_18,105892454611,True,107186008,1933800,109119808,True
3313,validator_14,107826209245,True,261365004,1140910,262505914,True
3314,validator_47,72235168570,True,48474000,491500,48965500,False
3315,validator_8,42098667976,True,176364998,852970,177217968,True
3316,validator_49,72179567070,True,94168000,26110500,120278500,False
3317,validator_26,39911235390,True,101316000,4708890,106024890,False
3318,validator_41,72509500040,True,129999000,1110850,131109850,False
3319,validator_36,103484253840,True,104928000,2334200,107262200,False
3320,validator_29,37669002310,True,53576000,2392000,55968000,False
3321,validator_15,270968712803,True,197633002,12341700,209974702,True
3322,validator_16,39304419146,True,146354001,1579030,147933031,True
3323,validator_7,75209500791,True,135233999,2146430,137380429,True
3324,validator_20,39757358186,True,102191998,327900,102519898,True
3325,validator_35,104624192360,True,128383000,1776600,130159600,False
3326,validator_43,71481762100,True,104122000,1807030,105929030,False
3327,validator_6,39213298988,True,168329999,489300,168819299,True
3328,validator_16,39388210765,True,82067999,1723620,83791619,True
3329,validator_25,38163199140,True,72815000,449200,73264200,False
3330,validator_31,170563907950,True,50315000,699530,51014530,False
3331,validator_23,42660885623,True,130903001,2281100,133184101,True
3332,validator_25,38216491840,True,52748000,544700,53292700,False
3333,validator_3,42886845122,True,143563000,2318680,145881680,True
3334,validator_40,40346600380,True,43187000,429800,43616800,False
3335,validator_12,107147289773,True,84088997,575040,84664037,True
3336,validator_23,42777713025,True,95315002,21512400,116827402,True
3337,validator_26,40025321290,True,113253000,832900,114085900,False
3338,validator_34,266882407850,True,89698000,1185620,90883620,False
3339,validator_19,72722958142,True,165156002,2409730,167565732,True
3340,validator_4,40601454608,True,154049004,2151300,156200304,True
3341,validator_2,42550643469,True,52039001,1881600,53920601,True
3342,validator_19,72907364345,True,183130003,1276200,184406203,True
3343,validator_47,72363083450,True,125776000,2138880,127914880,False
3344,validator_27,105058061870,True,194452000,2672860,197124860,False
3345,validator_48,168358963390,True,123243000,18380000,141623000,False
3346,validator_15,271033259408,True,63912005,634600,64546605,True
3347,validator_6,39462763359,True,248345001,1119370,249464371,True
3348,validator_26,40119521780,True,91502000,2698490,94200490,False
3349,validator_24,40020205155,True,112917997,12222200,125140197,True
3350,validator_16,39545583958,True,156298993,1074200,157373193,True
3351,validator_25,38281532170,True,64595000,445330,65040330,False
3352,validator_10,40452844556,True,136387998,1636830,138024828,True
3353,validator_11,41744433622,True,250935000,512600,251447600,True
3354,validator_3,43019614513,True,130548001,2221390,132769391,True
3355,validator_15,271139309905,True,105814997,235500,106050497,True
3356,validator_42,39429475940,True,176309000,4924200,181233200,False
3357,validator_5,73633878576,True,84577999,1293930,85871929,True
3358,validator_21,71426230806,True,115289002,9297000,124586002,True
3359,validator_42,39526337040,True,95423000,1438100,96861100,False
3360,validator_4,40744972512,True,133668004,9849900,143517904,True
3361,validator_31,170625341850,True,60233000,1200900,61433900,False
3362,validator_8,42259520125,True,159546999,1305150,160852149,True
3363,validator_28,38306918290,True,137896000,496500,138392500,False
3364,validator_18,106056901514,True,163528003,918900,164446903,True
3365,validator_24,40173003054,True,151013999,1783900,152797899,True
3366,validator_23,42874357925,True,94356000,2288900,96644900,True
3367,validator_33,38958110560,True,104179000,1348100,105527100,False
3368,validator_40,40411241360,True,58407000,6233980,64640980,False
3369,validator_19,73142123845,True,228090000,6669500,234759500,True
3370,validator_3,43279400032,True,241133999,18651520,259785519,True
3371,validator_39,39600185420,True,87806000,1653600,89459600,False
3372,validator_8,42361241016,True,99095001,2625890,101720891,True
3373,validator_43,71621275200,True,138518000,995100,139513100,False
3374,validator_6,39578815379,True,115324000,728020,116052020,True
3375,validator_6,39770111881,True,189090002,2206500,191296502,True
3376,validator_3,43543793325,True,263612993,780300,264393293,True
3377,validator_7,75359201788,True,144836997,4864000,149700997,True
3378,validator_35,104768215460,True,142663000,1360100,144023100,False
3379,validator_8,42556427417,True,194043001,1143400,195186401,True
3380,validator_16,39671312694,True,105241996,20486740,125728736,True
3381,validator_35,104854437760,True,84976000,1246300,86222300,False
3382,validator_13,38915351579,True,165548997,8335700,173884697,True
3383,validator_21,71591559322,True,163836996,1491520,165328516,True
3384,validator_1,72761990451,True,214738000,5984040,220722040,True
3385,validator_12,107224494712,True,69525999,7678940,77204939,True
3386,validator_20,39832866632,True,70110006,5398440,75508446,True
3387,validator_34,266964307150,True,81008000,891300,81899300,False
3388,validator_1,73008257752,True,237859001,8408300,246267301,True
3389,validator_26,40228064680,True,108449000,93900,108542900,False
3390,validator_49,72287578870,True,106909000,1102800,108011800,False
3391,validator_19,73339713543,True,193092998,4496700,197589698,True
3392,validator_1,73092083854,True,82983002,843100,83826102,True
3393,validator_31,170743680980,True,116311000,2028130,118339130,False
3394,validator_44,105872920830,True,86042000,7697800,93739800,False
3395,validator_19,73492813184,True,152062001,1037640,153099641,True
3396,validator_0,41156746649,True,180331999,164590,180496589,True
3397,validator_14,107952084986,True,124678001,1197740,125875741,True
3398,validator_16,39801681091,True,128741997,1626400,130368397,True
3399,validator_21,71736174425,True,144001003,614100,144615103,True
3400,validator_10,40736548355,True,283283999,419800,283703799,True
3401,validator_44,105949984930,True,67948000,9116100,77064100,False
3402,validator_16,39883950398,True,73594997,8674310,82269307,True
3403,validator_23,42960461225,True,84851000,1252300,86103300,True
3404,validator_33,39076338450,True,116620000,1607890,118227890,False
3405,validator_40,40469947330,True,58118000,587970,58705970,False
3406,validator_14,108133180072,True,172639006,8456080,181095086,True
3407,validator_31,170854357180,True,87981000,22695200,110676200,False
3408,validator_37,71598323650,True,59579000,1480180,61059180,False
3409,validator_11,41807752652,True,55269000,8050030,63319030,True
3410,validator_14,108442390852,True,286792000,22418780,309210780,True
3411,validator_41,72690929440,True,173344000,8085400,181429400,False
3412,validator_49,72390622870,True,100543000,2501000,103044000,False
3413,validator_26,40360816120,True,131385000,1366440,132751440,False
3414,validator_9,40105408469,True,181257997,2652040,183910037,True
3415,validator_9,40195614329,True,87602000,2603860,90205860,True
3416,validator_40,40589706830,True,118410000,1349500,119759500,False
3417,validator_15,271223912936,True,83668001,935030,84603031,True
3418,validator_28,38378557090,True,69789000,1849800,71638800,False
3419,validator_6,39953036169,True,182707998,216290,182924288,True
3420,validator_2,42794962506,True,226093997,18225040,244319037,True
3421,validator_13,39090187683,True,166871004,7965100,174836104,True
3422,validator_40,40672076330,True,81261000,1108500,82369500,False
3423,validator_47,72451289150,True,86336000,1869700,88205700,False
3424,validator_48,168500598510,True,140132000,1503120,141635120,False
3425,validator_49,72563279770,True,170067000,2589900,172656900,False
3426,validator_2,42890172311,True,93287005,1922800,95209805,True
3427,validator_35,104972570400,True,82190000,35942640,118132640,False
3428,validator_39,39660129580,True,58241000,1703160,59944160,False
3429,validator_41,72914556710,True,200774000,22853270,223627270,False
3430,validator_8,42715033611,True,155836994,2769200,158606194,True
3431,validator_41,73052710810,True,135428000,2726100,138154100,False
3432,validator_38,39891378070,True,37973000,197640,38170640,False
3433,validator_9,40244994277,True,47448998,1930950,49379948,True
3434,validator_15,271417903526,True,186179000,7811590,193990590,True
3435,validator_40,40796771030,True,124026000,668700,124694700,False
3436,validator_30,71810737930,True,161187000,581800,161768800,False
3437,validator_49,72738484390,True,174589000,615620,175204620,False
3438,validator_46,103875594290,True,170031000,2944800,172975800,False
3439,validator_42,39664164140,True,137412000,415100,137827100,False
3440,validator_16,40083211244,True,198102006,1158840,199260846,True
3441,validator_45,38868165820,True,106429000,4592600,111021600,False
3442,validator_2,42954036014,True,57714003,6149700,63863703,True
3443,validator_7,75634987014,True,273980996,1804230,275785226,True
3444,validator_5,73806182868,True,166972002,5332290,172304292,True
3445,validator_2,43065615517,True,110754003,825500,111579503,True
3446,validator_16,40168932546,True,79927002,5794300,85721302,True
3447,validator_48,168538522410,True,35633000,2290900,37923900,False
3448,validator_6,40038867894,True,85396995,434730,85831725,True
3449,validator_40,40910431030,True,112611000,1049000,113660000,False
3450,validator_4,40932395010,True,185432998,1989500,187422498,True
3451,validator_49,72825267490,True,78937000,7846100,86783100,False
3452,validator_39,39749160010,True,87759000,1271430,89030430,False
3453,validator_41,73110229900,True,49954000,7565090,57519090,False
3454,validator_27,105166931470,True,106300000,2569600,108869600,False
3455,validator_6,40120624293,True,81381999,374400,81756399,True
3456,validator_25,38394922510,True,112573000,817340,113390340,False
3457,validator_2,43304227519,True,230508002,8104000,238612002,True
3458,validator_43,71714820070,True,93350000,194870,93544870,False
3459,validator_32,40142412740,True,125222000,1004520,126226520,False
3460,validator_22,73013348918,True,66104005,4922070,71026075,True
3461,validator_18,106242957612,True,166486998,19569100,186056098,True
3462,validator_5,73929518173,True,122604005,731300,123335305,True
3463,validator_48,168714594230,True,175848000,223820,176071820,False
3464,validator_9,40386065895,True,140161998,909620,141071618,True
3465,validator_40,40984972530,True,73660000,881500,74541500,False
3466,validator_18,106305848904,True,54038002,8853290,62891292,True
3467,validator_20,39877056534,True,43714002,475900,44189902,True
3468,validator_26,40503445020,True,124429000,18199900,142628900,False
3469,validator_14,108577351451,True,134529999,430600,134960599,True
3470,validator_44,106047469430,True,76505000,20979500,97484500,False
3471,validator_22,73168893220,True,153632002,1912300,155544302,True
3472,validator_36,103603859620,True,118103000,1502780,119605780,False
3473,validator_5,74001079511,True,69147998,2413340,71561338,True
3474,validator_30,71989385450,True,165345000,13302520,178647520,False
3475,validator_5,74142858911,True,141377000,402400,141779400,True
3476,validator_31,171060388480,True,205846000,185300,206031300,False
3477,validator_18,106562734228,True,254200004,2685320,256885324,True
3478,validator_41,73271383640,True,153661000,7492740,161153740,False
3479,validator_10,40829262257,True,91996002,717900,92713902,True
3480,validator_44,106165427660,True,98014000,19944230,117958230,False
3481,validator_21,71816910024,True,79698999,1036600,80735599,True
3482,validator_25,38576025310,True,180770000,332800,181102800,False
3483,validator_13,39391629484,True,300768001,673800,301441801,True
3484,validator_45,39028241660,True,159180000,895840,160075840,False
3485,validator_19,73594661982,True,100759998,1088800,101848798,True
3486,validator_17,172701364594,True,112450999,1989700,114440699,True
3487,validator_35,105110041300,True,136104000,1366900,137470900,False
3488,validator_49,72882295890,True,56237000,791400,57028400,False
3489,validator_6,40344630093,True,222198000,1807800,224005800,True
3490,validator_12,107271243311,True,44681999,2066600,46748599,True
3491,validator_1,73199453348,True,105814994,1554500,107369494,True
3492,validator_15,271514725638,True,96167002,655110,96822112,True
3493,validator_2,43361235176,True,55810997,1196660,57007657,True
3494,validator_32,40275186640,True,131899000,874900,132773900,False
3495,validator_17,172843610997,True,141119003,1127400,142246403,True
3496,validator_31,171191222440,True,130416000,417960,130833960,False
3497,validator_42,39772381580,True,106299000,1918440,108217440,False
3498,validator_19,73726608881,True,130747999,1198900,131946899,True
3499,validator_32,40343054540,True,65816000,2051900,67867900,False
3500,validator_30,72100301770,True,109507000,1409320,110916320,False
3501,validator_39,39895318050,True,141240000,4918040,146158040,False
3502,validator_43,71918548600,True,198201000,5527530,203728530,False
3503,validator_48,168866236030,True,145450000,6191800,151641800,False
3504,validator_19,73780717678,True,52934997,1173800,54108797,True
3505,validator_47,72549904650,True,80097000,18518500,98615500,False
3506,validator_31,171284255570,True,92144000,889130,93033130,False
3507,validator_27,105254190070,True,86757000,501600,87258600,False
3508,validator_15,271740470441,True,225238993,505810,225744803,True
3509,validator_7,75830411574,True,193863000,1561560,195424560,True
3510,validator_40,41075250130,True,89964000,313600,90277600,False
3511,validator_6,40414697498,True,68457005,1610400,70067405,True
3512,validator_39,40020536980,True,106706000,18512930,125218930,False
3513,validator_0,41310760752,True,146078003,7936100,154014103,True
3514,validator_32,40467816760,True,121917000,2845220,124762220,False
3515,validator_48,168995726960,True,129381000,109930,129490930,False
3516,validator_46,104134445010,True,257293000,1557720,258850720,False
3517,validator_36,103766001020,True,160699000,1442400,162141400,False
3518,validator_30,72250799830,True,145055000,5443060,150498060,False
3519,validator_22,73278957800,True,104841000,5223580,110064580,True
3520,validator_20,40192673021,True,313216997,2399490,315616487,True
3521,validator_30,72447155310,True,188397000,7958480,196355480,False
3522,validator_30,72526307490,True,71490000,7662180,79152180,False
3523,validator_33,39218512950,True,140485000,1689500,142174500,False
3524,validator_1,73341426756,True,140576998,1396410,141973408,True
3525,validator_36,103890481290,True,118164000,6316270,124480270,False
3526,validator_17,173014058300,True,162152003,8295300,170447303,True
3527,validator_11,42008331651,True,198677999,1901000,200578999,True
3528,validator_5,74194844014,True,50228003,1757100,51985103,True
3529,validator_17,173203003979,True,187777999,1167680,188945679,True
3530,validator_15,271902868342,True,161078001,1319900,162397901,True
3531,validator_39,40156259980,True,116427000,19296000,135723000,False
3532,validator_27,105385044900,True,128782000,2072830,130854830,False
3533,validator_37,71695010650,True,95467000,1220000,96687000,False
3534,validator_19,73899102198,True,115965000,2419520,118384520,True
3535,validator_42,39888540280,True,115088000,1070700,116158700,False
3536,validator_38,39961598970,True,69189000,1031900,70220900,False
3537,validator_29,37814423010,True,136428000,8992700,145420700,False
3538,validator_2,43692764377,True,304777001,26752200,331529201,True
3539,validator_2,43909581516,True,214859999,1957140,216817139,True
3540,validator_26,40633546410,True,117383000,12718390,130101390,False
3541,validator_24,40255687347,True,81529993,1154300,82684293,True
3542,validator_26,40709362010,True,69467000,6348600,75815600,False
3543,validator_12,107444117037,True,171920996,952730,172873726,True
3544,validator_12,107593691878,True,141289001,8285840,149574841,True
3545,validator_21,71988020546,True,168932002,2178520,171110522,True
3546,validator_17,173410799581,True,206658002,1137600,207795602,True
3547,validator_23,43053815123,True,92374998,978900,93353898,True
3548,validator_6,40593941837,True,177472999,1771340,179244339,True
3549,validator_49,73040770490,True,156532000,1942600,158474600,False
3550,validator_17,173549807860,True,136885999,2122280,139008279,True
3551,validator_22,73405305899,True,125133999,1214100,126348099,True
3552,validator_43,72053689730,True,133462000,1679130,135141130,False
3553,validator_15,272177767866,True,274084004,815520,274899524,True
3554,validator_40,41241917030,True,166115000,551900,166666900,False
3555,validator_19,74111206100,True,193205002,18898900,212103902,True
3556,validator_38,40147108870,True,166794000,18715900,185509900,False
3557,validator_14,108670225951,True,92222000,652500,92874500,True
3558,validator_20,40331509546,True,136625995,2210530,138836525,True
3559,validator_4,41029844637,True,78831997,18617630,97449627,True
3560,validator_21,72112504575,True,117211999,7272030,124484029,True
3561,validator_35,105207734080,True,89203000,8489780,97692780,False
3562,validator_31,171387014850,True,101724000,1035280,102759280,False
3563,validator_38,40234198430,True,85976000,1113560,87089560,False
3564,validator_24,40570750747,True,313719000,1344400,315063400,True
3565,validator_35,105359082270,True,150427000,921190,151348190,False
3566,validator_21,72189220074,True,69551999,7163500,76715499,True
3567,validator_42,40030658380,True,133495000,8623100,142118100,False
3568,validator_20,40451313123,True,113917997,5885580,119803577,True
3569,validator_1,73458502637,True,112219001,4856880,117075881,True
3570,validator_4,41123980967,True,93460000,676330,94136330,True
3571,validator_14,108830151159,True,139864998,20060210,159925208,True
3572,validator_42,40170100680,True,119398000,20044300,139442300,False
3573,validator_41,73378582640,True,106531000,668000,107199000,False
3574,validator_26,40807140210,True,78357000,19421200,97778200,False
3575,validator_15,272475595276,True,296803000,1024410,297827410,True
3576,validator_6,40760368157,True,165306000,1120320,166426320,True
3577,validator_47,72615583550,True,65248000,430900,65678900,False
3578,validator_27,105471522800,True,85727000,750900,86477900,False
3579,validator_20,40493205719,True,41460996,431600,41892596,True
3580,validator_31,171583837850,True,195492000,1331000,196823000,False
3581,validator_13,39699325775,True,303408001,4288290,307696291,True
3582,validator_0,41576097570,True,264403998,932820,265336818,True
3583,validator_1,73551643410,True,92492003,648770,93140773,True
3584,validator_30,72622131670,True,94818000,1006180,95824180,False
3585,validator_21,72394421674,True,204529000,672600,205201600,True
3586,validator_21,72437176275,True,41381001,1373600,42754601,True
3587,validator_47,72828991650,True,194675000,18733100,213408100,False
3588,validator_39,40254931200,True,98226000,445220,98671220,False
3589,validator_3,43613352467,True,69057002,502140,69559142,True
3590,validator_5,74292739194,True,92876000,5019180,97895180,True
3591,validator_12,107796764580,True,202514002,558700,203072702,True
3592,validator_36,103987740320,True,96632000,627030,97259030,False
3593,validator_24,40631412847,True,59825000,837100,60662100,True
3594,validator_25,38743455530,True,166274000,1156220,167430220,False
3595,validator_17,173637673159,True,86680999,1184300,87865299,True
3596,validator_18,106681807666,True,118387998,685440,119073438,True
3597,validator_46,104277598150,True,133408000,9745140,143153140,False
3598,validator_49,73138447990,True,77026000,20651500,97677500,False
3599,validator_12,107988595777,True,190362997,1468200,191831197,True
3600,validator_11,42221095538,True,209799997,2963890,212763887,True
3601,validator_39,40420995320,True,141194000,24870120,166064120,False
3602,validator_7,76054962571,True,222474997,2076000,224550997,True
3603,validator_39,40512312220,True,90544000,772900,91316900,False
3604,validator_26,40978362410,True,160219000,11003200,171222200,False
3605,validator_43,72168441070,True,114415000,336340,114751340,False
3606,validator_43,72217830830,True,43280000,6109760,49389760,False
3607,validator_39,40661085120,True,148347000,425900,148772900,False
3608,validator_13,39816386297,True,114677002,2383520,117060522,True
3609,validator_0,41676348076,True,93226006,7024500,100250506,True
3610,validator_38,40345544430,True,108883000,2463000,111346000,False
3611,validator_42,40245533480,True,71608000,3824800,75432800,False
3612,validator_48,169159722860,True,158742000,5253900,163995900,False
3613,validator_10,40937563347,True,107939000,362090,108301090,True
3614,validator_31,171751088150,True,165023000,2227300,167250300,False
3615,validator_39,40712547450,True,46769000,4693330,51462330,False
3616,validator_13,39992673292,True,171397995,4889000,176286995,True
3617,validator_27,105608607490,True,136061000,1023690,137084690,False
3618,validator_47,72941118330,True,91204000,20922680,112126680,False
3619,validator_15,272628399677,True,147096001,5708400,152804401,True
3620,validator_8,42834965412,True,118981001,950800,119931801,True
3621,validator_28,38554599980,True,174506000,1536890,176042890,False
3622,validator_17,173707939759,True,70123000,143600,70266600,True
3623,validator_4,41359782308,True,234334001,1467340,235801341,True
3624,validator_28,38657170210,True,101805000,765230,102570230,False
3625,validator_5,74410591696,True,117077002,775500,117852502,True
3626,validator_19,74322353021,True,184507001,26639920,211146921,True
3627,validator_11,42318876677,True,95862999,1918140,97781139,True
3628,validator_19,74460322853,True,129661002,8308830,137969832,True
3629,validator_29,37929429810,True,109411000,5595800,115006800,False
3630,validator_0,41752072876,True,74302000,1422800,75724800,True
3631,validator_2,44036566544,True,125504998,1480030,126985028,True
3632,validator_29,38014782590,True,84542000,810780,85352780,False
3633,validator_22,73558865136,True,152897997,661240,153559237,True
3634,validator_39,40842553790,True,128393000,1613340,130006340,False
3635,validator_19,74559391986,True,93997003,5072130,99069133,True
3636,validator_27,105723973090,True,114848000,517600,115365600,False
3637,validator_30,72792575410,True,147838000,22605740,170443740,False
3638,validator_9,40515182696,True,128027001,1089800,129116801,True
3639,validator_0,41820513310,True,66236004,2204430,68440434,True
3640,validator_7,76107340173,True,52212002,165600,52377602,True
3641,validator_44,106340070460,True,173320000,1322800,174642800,False
3642,validator_41,73512334620,True,113909000,19842980,133751980,False
3643,validator_17,173835986141,True,125936002,2110380,128046382,True
3644,validator_36,104106086320,True,117292000,1054000,118346000,False
3645,validator_14,108962503322,True,131804003,548160,132352163,True
3646,validator_40,41388429370,True,145191000,1321340,146512340,False
3647,validator_32,40627692160,True,158849000,1026400,159875400,False
3648,validator_31,171870436750,True,98731000,20617600,119348600,False
3649,validator_32,40741054230,True,107869000,5493070,113362070,False
3650,validator_31,171995499450,True,123940000,1122700,125062700,False
3651,validator_21,72629856671,True,191939996,740400,192680396,True
3652,validator_41,73675889460,True,160934000,2620840,163554840,False
3653,validator_36,104247002120,True,138770000,2145800,140915800,False
3654,validator_49,73191014590,True,50355000,2211600,52566600,False
3655,validator_44,106437377500,True,95568000,1739040,97307040,False
3656,validator_1,73653320282,True,101339002,337870,101676872,True
3657,validator_31,172148589650,True,134494000,18596200,153090200,False
3658,validator_28,38794959570,True,129139000,8650360,137789360,False
3659,validator_8,43052982147,True,217574995,441740,218016735,True
3660,validator_26,41226207190,True,246886000,958780,247844780,False
3661,validator_39,40894517990,True,49994000,1970200,51964200,False
3662,validator_13,40176922322,True,165825000,18424030,184249030,True
3663,validator_16,40209906946,True,40220000,754400,40974400,True
3664,validator_35,105439498570,True,71631000,8785300,80416300,False
3665,validator_34,267034314790,True,68903000,1104640,70007640,False
3666,validator_3,44026242673,True,403438006,9452200,412890206,True
3667,validator_28,38908026670,True,112130000,937100,113067100,False
3668,validator_28,39027697710,True,118641000,1030040,119671040,False
3669,validator_21,72695879758,True,64196007,1827080,66023087,True
3670,validator_27,105895147610,True,168325000,2849520,171174520,False
3671,validator_26,41323202490,True,94073000,2922300,96995300,False
3672,validator_41,73766498460,True,85829000,4780000,90609000,False
3673,validator_35,105575789870,True,135590000,701300,136291300,False
3674,validator_17,173976620442,True,130360001,10274300,140634301,True
3675,validator_0,41956783911,True,135178001,1092600,136270601,True
3676,validator_32,40860686530,True,117759000,1873300,119632300,False
3677,validator_44,106597139080,True,155075000,4686580,159761580,False
3678,validator_25,38840105130,True,95188000,1461600,96649600,False
3679,validator_15,272710517778,True,81683001,435100,82118101,True
3680,validator_17,174178904489,True,200406997,1877050,202284047,True
3681,validator_45,39189661260,True,158623000,2796600,161419600,False
3682,validator_25,38991969930,True,150579000,1285800,151864800,False
3683,validator_47,73113373430,True,171377000,878100,172255100,False
3684,validator_39,41097751820,True,201319000,1914830,203233830,False
3685,validator_28,39215859310,True,187427000,734600,188161600,False
3686,validator_38,40435723030,True,88514000,1664600,90178600,False
3687,validator_26,41417211110,True,92440000,1568620,94008620,False
3688,validator_13,40465681081,True,269620999,19137760,288758759,True
3689,validator_1,73786741721,True,132551999,869440,133421439,True
3690,validator_24,40799472477,True,144883000,23176630,168059630,True
3691,validator_26,41559876340,True,141389000,1276230,142665230,False
3692,validator_14,109065492525,True,101661003,1328200,102989203,True
3693,validator_29,38102461490,True,69428000,18250900,87678900,False
3694,validator_22,73628484275,True,69154999,464140,69619139,True
3695,validator_12,108073118378,True,83726001,796600,84522601,True
3696,validator_5,74540796000,True,122253004,7951300,130204304,True
3697,validator_36,104434503010,True,169335000,18165890,187500890,False
3698,validator_40,41562684650,True,168868000,5387280,174255280,False
3699,validator_21,72860591060,True,161106002,3605300,164711302,True
3700,validator_34,267097040690,True,54149000,8576900,62725900,False
3701,validator_44,106716644180,True,118099000,1406100,119505100,False
3702,validator_43,72327111430,True,90364000,18916600,109280600,False
3703,validator_21,73008801960,True,145892000,2318900,148210900,True
3704,validator_27,105953902010,True,58300000,454400,58754400,False
3705,validator_34,267188785290,True,90225000,1519600,91744600,False
3706,validator_18,106808068383,True,125323997,936720,126260717,True
3707,validator_15,272902815316,True,172454998,19842540,192297538,True
3708,validator_4,41491827504,True,129909996,2135200,132045196,True
3709,validator_18,106967492485,True,157345002,2079100,159424102,True
3710,validator_40,41649829550,True,86656000,488900,87144900,False
3711,validator_13,40706628177,True,238890996,2056100,240947096,True
3712,validator_40,41745819850,True,75566000,20424300,95990300,False
3713,validator_34,267298497310,True,108426000,1286020,109712020,False
3714,validator_41,73866536960,True,98476000,1562500,100038500,False
3715,validator_28,39352352070,True,133243000,3249760,136492760,False
3716,validator_0,42091090145,True,132532004,1774230,134306234,True
3717,validator_20,40715380000,True,220733001,1441280,222174281,True
3718,validator_44,106842569760,True,123516000,2409580,125925580,False
3719,validator_7,76178061021,True,65182008,5538840,70720848,True
3720,validator_28,39479207970,True,125858000,997900,126855900,False
3721,validator_6,40915690096,True,152489999,2831940,155321939,True
3722,validator_32,41028114530,True,148155000,19273000,167428000,False
3723,validator_10,41105167916,True,165425999,2178570,167604569,True
3724,validator_44,107021796150,True,178928000,298390,179226390,False
3725,validator_19,74760983592,True,182917006,18674600,201591606,True
3726,validator_35,105818807930,True,241793000,1225060,243018060,False
3727,validator_27,106052196800,True,98012000,282790,98294790,False
3728,validator_40,41879239440,True,132207000,1212590,133419590,False
3729,validator_18,107040616485,True,72391000,733000,73124000,True
3730,validator_26,41691202970,True,130023000,1303630,131326630,False
3731,validator_27,106127655270,True,74780000,678470,75458470,False
3732,validator_45,39303678090,True,112551000,1465830,114016830,False
3733,validator_10,41193211306,True,86717000,1326390,88043390,True
3734,validator_16,40329723246,True,116014000,3802300,119816300,True
3735,validator_26,41757029000,True,62817000,3009030,65826030,False
3736,validator_48,169275901640,True,115222000,956780,116178780,False
3737,validator_34,267371216210,True,70281000,2437900,72718900,False
3738,validator_6,41041186154,True,123597998,1898060,125496058,True
3739,validator_23,43117918544,True,61481001,2622420,64103421,True
3740,validator_22,73863800273,True,233334998,1981000,235315998,True
3741,validator_23,43248469540,True,130444996,106000,130550996,True
3742,validator_12,108240486905,True,166520997,847530,167368527,True
3743,validator_29,38243098790,True,139416000,1221300,140637300,False
3744,validator_1,73914264997,True,127146996,376280,127523276,True
3745,validator_47,73296934830,True,178391000,5170400,183561400,False
3746,validator_27,106179566590,True,47677000,4234320,51911320,False
3747,validator_24,40862531477,True,60453000,2606000,63059000,True
3748,validator_45,39368188510,True,63529000,981420,64510420,False
3749,validator_17,174257585085,True,77813996,866600,78680596,True
3750,validator_34,267554831810,True,164540000,19075600,183615600,False
3751,validator_33,39350962040,True,131522000,927090,132449090,False
3752,validator_2,44173900142,True,135788998,1544600,137333598,True
3753,validator_35,105969685050,True,150106000,771120,150877120,False
3754,validator_20,40833262388,True,116484998,1397390,117882388,True
3755,validator_22,73993581546,True,125988003,3793270,129781273,True
3756,validator_33,39477686630,True,118731000,7993590,126724590,False
3757,validator_44,107135650530,True,111996000,1858380,113854380,False
3758,validator_37,71826361550,True,130634000,716900,131350900,False
3759,validator_18,107246523986,True,204441001,1466500,205907501,True
3760,validator_18,107424919545,True,176210999,2184560,178395559,True
3761,validator_11,42476362980,True,155834003,1652300,157486303,True
3762,validator_24,41019293594,True,155752997,1009120,156762117,True
3763,validator_49,73295522910,True,103553000,955320,104508320,False
3764,validator_35,106087305550,True,116686000,934500,117620500,False
3765,validator_49,73394599610,True,97318000,1758700,99076700,False
3766,validator_7,76342301289,True,163988998,251270,164240268,True
3767,validator_22,74223571263,True,228057007,1932710,229989717,True
3768,validator_43,72465314130,True,137652000,550700,138202700,False
3769,validator_41,73966991260,True,97463000,2991300,100454300,False
3770,validator_45,39418068410,True,49080000,799900,49879900,False
3771,validator_15,273067572945,True,162397999,2359630,164757629,True
3772,validator_39,41286969900,True,178778000,10440080,189218080,False
3773,validator_19,74946012495,True,173250003,11778900,185028903,True
3774,validator_34,267669433250,True,112909000,1692440,114601440,False
3775,validator_10,41314708106,True,120049000,1447800,121496800,True
3776,validator_26,41855111130,True,96758000,1324130,98082130,False
3777,validator_23,43387113442,True,130893002,7750900,138643902,True
3778,validator_43,72697880460,True,231467000,1099330,232566330,False
3779,validator_42,40325161910,True,78840000,788430,79628430,False
3780,validator_18,107474239524,True,48928999,390980,49319979,True
3781,validator_23,43493395374,True,87335002,18946930,106281932,True
3782,validator_33,39654140130,True,169823000,6630500,176453500,False
3783,validator_15,273160327845,True,90864000,1890900,92754900,True
3784,validator_35,106294505070,True,180642000,26557520,207199520,False
3785,validator_22,74373109754,True,147199001,2339490,149538491,True
3786,validator_3,44229672677,True,200955004,2475000,203430004,True
3787,validator_17,174363447622,True,98188997,7673540,105862537,True
3788,validator_42,40427668110,True,100014000,2492200,102506200,False
3789,validator_4,41660872107,True,168392003,652600,169044603,True
3790,validator_35,106393746260,True,98402000,839190,99241190,False
3791,validator_26,41979829530,True,122690000,2028400,124718400,False
3792,validator_36,104489028340,True,54085000,440330,54525330,False
3793,validator_39,41384587260,True,96750000,867360,97617360,False
3794,validator_25,39081320830,True,80148000,9202900,89350900,False
3795,validator_2,44235387443,True,60454001,1033300,61487301,True
3796,validator_5,74666238399,True,122827999,2614400,125442399,True
3797,validator_29,38414477490,True,170306000,1072700,171378700,False
3798,validator_9,40620629125,True,97460999,7985430,105446429,True
3799,validator_30,73051801550,True,256673000,2553140,259226140,False
3800,validator_17,174481198320,True,117005998,744700,117750698,True
3801,validator_40,42021333830,True,132874000,9220390,142094390,False
3802,validator_9,40736966326,True,107185001,9152200,116337201,True
3803,validator_9,40866267535,True,126931999,2369210,129301209,True
3804,validator_6,41202557752,True,142368998,19002600,161371598,True
3805,validator_14,109125960727,True,59732002,736200,60468202,True
3806,validator_15,273397423245,True,234354000,2741400,237095400,True
3807,validator_3,44378628107,True,146214000,2741430,148955430,True
3808,validator_20,40914672087,True,79332999,2076700,81409699,True
3809,validator_41,74137755160,True,163194000,7569900,170763900,False
3810,validator_36,104586791440,True,95843000,1920100,97763100,False
3811,validator_9,41027538669,True,159459004,1812130,161271134,True
3812,validator_17,174666907162,True,185651002,57840,185708842,True
3813,validator_34,267863923370,True,153501000,40989120,194490120,False
3814,validator_35,106483882460,True,89245000,891200,90136200,False
3815,validator_22,74545031527,True,170966003,955770,171921773,True
3816,validator_42,40535756790,True,103969000,4119680,108088680,False
3817,validator_6,41414084082,True,205977000,5549330,211526330,True
3818,validator_18,107587750022,True,113026998,483500,113510498,True
3819,validator_29,38529416320,True,113211000,1727830,114938830,False
3820,validator_39,41487940830,True,81992000,21361570,103353570,False
3821,validator_25,39187775330,True,104257000,2197500,106454500,False
3822,validator_38,40509552950,True,73217000,612920,73829920,False
3823,validator_3,44518234781,True,120440004,19166670,139606674,True
3824,validator_10,41447726206,True,118235000,14783100,133018100,True
3825,validator_14,109206941327,True,74681000,6299600,80980600,True
3826,validator_1,74021250900,True,105085003,1900900,106985903,True
3827,validator_21,73143683266,True,132051006,2830300,134881306,True
3828,validator_46,104400143070,True,115106000,7438920,122544920,False
3829,validator_23,43536674194,True,41840000,1438820,43278820,True
3830,validator_48,169459618170,True,183174000,542530,183716530,False
3831,validator_1,74277086598,True,232909998,22925700,255835698,True
3832,validator_44,107176424350,True,36139000,4634820,40773820,False
3833,validator_1,74497451597,True,219786999,578000,220364999,True
3834,validator_4,41796058746,True,133616999,1569640,135186639,True
3835,validator_3,44645793281,True,108350000,19208500,127558500,True
3836,validator_35,106634669440,True,149176000,1610980,150786980,False
3837,validator_1,74636882187,True,137585000,1845590,139430590,True
3838,validator_27,106288653500,True,107066000,2020910,109086910,False
3839,validator_4,42052797811,True,247092995,9646070,256739065,True
3840,validator_2,44345423284,True,108344001,1691840,110035841,True
3841,validator_29,38679066720,True,131437000,18213400,149650400,False
3842,validator_21,73233206663,True,84142997,5380400,89523397,True
3843,validator_21,73403575136,True,168893003,1475470,170368473,True
3844,validator_41,74260225440,True,120943000,1527280,122470280,False
3845,validator_36,104757584240,True,162644000,8148800,170792800,False
3846,validator_16,40430751085,True,100238999,788840,101027839,True
3847,validator_39,41639927770,True,150445000,1541940,151986940,False
3848,validator_17,174893390002,True,200621000,25861840,226482840,True
3849,validator_12,108404122810,True,162487005,1148900,163635905,True
3850,validator_17,175069578241,True,170101999,6086240,176188239,True
3851,validator_5,74839068796,True,168375997,4454400,172830397,True
3852,validator_15,273534126666,True,136441001,262420,136703421,True
3853,validator_31,172271217250,True,122223000,404600,122627600,False
3854,validator_46,104460185340,True,58918000,1124270,60042270,False
3855,validator_10,41571012902,True,104585996,18700700,123286696,True
3856,validator_36,104827752940,True,69450000,718700,70168700,False
3857,validator_26,42122398530,True,141922000,647000,142569000,False
3858,validator_19,75060447398,True,109289003,5145900,114434903,True
3859,validator_43,72810771200,True,94277000,18613740,112890740,False
3860,validator_1,74750304002,True,112700005,721810,113421815,True
3861,validator_20,41021942765,True,88600998,18669680,107270678,True
3862,validator_13,40767817176,True,60225999,963000,61188999,True
3863,validator_25,39301739830,True,111140000,2824500,113964500,False
3864,validator_42,40625062210,True,86435000,2870420,89305420,False
3865,validator_4,42213235994,True,159609003,829180,160438183,True
3866,validator_45,39605907390,True,179836000,8002980,187838980,False
3867,validator_22,74626344510,True,76015003,5297980,81312983,True
3868,validator_7,76567027586,True,223649997,1076300,224726297,True
3869,validator_22,74884688009,True,257677999,665500,258343499,True
3870,validator_10,41717057542,True,127838000,18206640,146044640,True
3871,validator_32,41225202270,True,193329000,3758740,197087740,False
3872,validator_34,267976759570,True,111819000,1017200,112836200,False
3873,validator_18,107664554043,True,76382001,422020,76804021,True
3874,validator_15,273622295596,True,86322000,1846930,88168930,True
3875,validator_41,74342764830,True,81051000,1488390,82539390,False
3876,validator_30,73183905690,True,131053000,1051140,132104140,False
3877,validator_22,74941456608,True,55333999,1434600,56768599,True
3878,validator_19,75263002741,True,200040003,2515340,202555343,True
3879,validator_18,107831103041,True,147789998,18759000,166548998,True
3880,validator_15,273797880202,True,173215006,2369600,175584606,True
3881,validator_48,169690992370,True,225911000,5463200,231374200,False
3882,validator_21,73544589839,True,125134003,15880700,141014703,True
3883,validator_8,43172728349,True,110623002,9123200,119746202,True
3884,validator_44,107317584580,True,117537000,23623230,141160230,False
3885,validator_16,40593116627,True,154688002,7677540,162365542,True
3886,validator_40,42113688460,True,73711000,18643630,92354630,False
3887,validator_20,41140233946,True,117912001,379180,118291181,True
3888,validator_42,40765867310,True,132500000,8305100,140805100,False
3889,validator_26,42294259530,True,167016000,4845000,171861000,False
3890,validator_41,74424487030,True,72485000,9237200,81722200,False
3891,validator_48,169945932970,True,250198000,4742600,254940600,False
3892,validator_1,74846642905,True,95994003,344900,96338903,True
3893,validator_32,41314669670,True,86765000,2702400,89467400,False
3894,validator_4,42361042196,True,93233002,54573200,147806202,True
3895,validator_47,73429516470,True,131040000,1541640,132581640,False
3896,validator_11,42605838200,True,127703000,1772220,129475220,True
3897,validator_11,42752510997,True,144906997,1765800,146672797,True
3898,validator_35,106735123840,True,99159000,1295400,100454400,False
3899,validator_1,75047404472,True,198976997,1784570,200761567,True
3900,validator_9,41142675770,True,114882001,255100,115137101,True
3901,validator_20,41408563945,True,267043999,1286000,268329999,True
3902,validator_34,268103310370,True,106282000,20268800,126550800,False
3903,validator_25,39467799330,True,164805000,1254500,166059500,False
3904,validator_19,75383326258,True,114514997,5808520,120323517,True
3905,validator_31,172350372180,True,77042000,2112930,79154930,False
3906,validator_19,75522644957,True,138758999,559700,139318699,True
3907,validator_41,74545487610,True,112115000,8885580,121000580,False
3908,validator_5,74957030624,True,117772998,188830,117961828,True
3909,validator_41,74658024500,True,104072000,8464890,112536890,False
3910,validator_32,41462253600,True,147531000,52930,147583930,False
3911,validator_28,39681674870,True,201756000,710900,202466900,False
3912,validator_17,175235858672,True,165762001,518430,166280431,True
3913,validator_34,268177229890,True,47551000,26368520,73919520,False
3914,validator_26,42343832350,True,46852000,2720820,49572820,False
3915,validator_39,41771047750,True,128723000,2396980,131119980,False
3916,validator_26,42428961150,True,77218000,7910800,85128800,False
3917,validator_24,41189837996,True,169459002,1085400,170544402,True
3918,validator_10,41839696165,True,120449003,2189620,122638623,True
3919,validator_2,44420488483,True,72112999,2952200,75065199,True
3920,validator_3,44738762798,True,92120997,848520,92969517,True
3921,validator_20,41504241891,True,94728006,949940,95677946,True
3922,validator_21,73615475843,True,69857004,1029000,70886004,True
3923,validator_38,40589577790,True,73427000,6597840,80024840,False
3924,validator_18,107976561363,True,132264002,13194320,145458322,True
3925,validator_15,274019661604,True,221098002,683400,221781402,True
3926,validator_8,43280131750,True,105156001,2247400,107403401,True
3927,validator_41,74749333330,True,89852000,1456830,91308830,False
3928,validator_0,42234119849,True,141660004,1369700,143029704,True
3929,validator_27,106356337940,True,66340000,1344440,67684440,False
3930,validator_32,41608257330,True,111932000,34071730,146003730,False
3931,validator_14,109312734654,True,104336997,1456330,105793327,True
3932,validator_19,75704506975,True,179390998,2471020,181862018,True
3933,validator_37,71866192380,True,38089000,1741830,39830830,False
3934,validator_35,106895133170,True,159087000,922330,160009330,False
3935,validator_25,39536211770,True,67719000,693440,68412440,False
3936,validator_13,40902062473,True,132017997,2227300,134245297,True
3937,validator_40,42358693190,True,244189000,815730,245004730,False
3938,validator_35,107114222770,True,217308000,1781600,219089600,False
3939,validator_10,42018310865,True,169988000,8626700,178614700,True
3940,validator_45,39677492990,True,66830000,4755600,71585600,False
3941,validator_36,105068405140,True,221779000,18873200,240652200,False
3942,validator_2,44600398623,True,174908000,5002140,179910140,True
3943,validator_3,44867024074,True,109521996,18739280,128261276,True
3944,validator_6,41535864510,True,111329998,10450430,121780428,True
3945,validator_20,41611575636,True,107002995,330750,107333745,True
3946,validator_24,41340478494,True,149323998,1316500,150640498,True
3947,validator_24,41444926711,True,102276997,2171220,104448217,True
3948,validator_25,39708325270,True,153574000,18539500,172113500,False
3949,validator_25,39848656970,True,138162000,2169700,140331700,False
3950,validator_14,109507214657,True,193840003,640000,194480003,True
3951,validator_21,73748509446,True,132625003,408600,133033603,True
3952,validator_18,108191573866,True,213573003,1439500,215012503,True
3953,validator_15,274090288197,True,70206003,420590,70626593,True
3954,validator_7,76658399783,True,90866997,505200,91372197,True
3955,validator_30,73265696840,True,80928000,863150,81791150,False
3956,validator_23,43606599991,True,68037997,1887800,69925797,True
3957,validator_21,73848316842,True,81645996,18161400,99807396,True
3958,validator_8,43453178391,True,171486001,1560640,173046641,True
3959,validator_0,42401182147,True,165026998,2035300,167062298,True
3960,validator_11,42825435300,True,71562003,1362300,72924303,True
3961,validator_32,41662170430,True,49064000,4849100,53913100,False
3962,validator_37,72199630080,True,325140000,8297700,333437700,False
3963,validator_24,41542129395,True,96810004,392680,97202684,True
3964,validator_39,41911145320,True,139313000,784570,140097570,False
3965,validator_14,109599310388,True,91647001,448730,92095731,True
3966,validator_22,75034249139,True,89801001,2991530,92792531,True
3967,validator_48,170037164000,True,77942000,13289030,91231030,False
3968,validator_7,76838237178,True,178552005,1285390,179837395,True
3969,validator_42,41080793310,True,312876000,2050000,314926000,False
3970,validator_10,42183303652,True,163657997,1334790,164992787,True
3971,validator_47,73522222270,True,74752000,17953800,92705800,False
3972,validator_22,75104987218,True,68968999,1769080,70738079,True
3973,validator_15,274276870563,True,185336996,1245370,186582366,True
3974,validator_34,268243131690,True,65143000,758800,65901800,False
3975,validator_12,108524959043,True,119589993,1246240,120836233,True
3976,validator_12,108674726342,True,148847999,919300,149767299,True
3977,validator_28,39800616600,True,117327000,1614730,118941730,False
3978,validator_17,175561990325,True,322739003,3392650,326131653,True
3979,validator_40,42418989920,True,58991000,1305730,60296730,False
3980,validator_43,72894160500,True,81679000,1710300,83389300,False
3981,validator_49,73516331010,True,120952000,779400,121731400,False
3982,validator_15,274365909165,True,88694002,344600,89038602,True
3983,validator_43,72982982800,True,88105000,717300,88822300,False
3984,validator_8,43556647311,True,102209000,1259920,103468920,True
3985,validator_28,39931441000,True,125704000,5120400,130824400,False
3986,validator_5,75141512156,True,183798002,683530,184481532,True
3987,validator_12,108774327861,True,99109999,491520,99601519,True
3988,validator_6,41593289906,True,56769996,655400,57425396,True
3989,validator_26,42523384950,True,93169000,1254800,94423800,False
3990,validator_13,41165064871,True,243393998,19608400,263002398,True
3991,validator_39,42034563920,True,121550000,1868600,123418600,False
3992,validator_22,75254457919,True,149378001,92700,149470701,True
3993,validator_45,39824830520,True,139168000,8169530,147337530,False
3994,validator_10,42346000786,True,160582004,2115130,162697134,True
3995,validator_46,104560254240,True,99707000,361900,100068900,False
3996,validator_10,42580495508,True,223967002,10527720,234494722,True
3997,validator_10,42769818344,True,188110006,1212830,189322836,True
3998,validator_30,73358263190,True,92321000,245350,92566350,False
3999,validator_29,38745809440,True,66112000,630720,66742720,False
4000,validator_17,175707257004,True,144594999,671680,145266679,True
4001,validator_10,42897921418,True,126687004,1416070,128103074,True
4002,validator_15,274515126702,True,130307007,18910530,149217537,True
4003,validator_41,74846663460,True,96535000,795130,97330130,False
4004,validator_42,41241290610,True,159352000,1145300,160497300,False
4005,validator_29,38894845040,True,146990000,2045600,149035600,False
4006,validator_41,74988202790,True,140513000,1026330,141539330,False
4007,validator_44,107441638380,True,123620000,433800,124053800,False
4008,validator_9,41197381752,True,54313002,392980,54705982,True
4009,validator_41,75108862900,True,110891000,9769110,120660110,False
4010,validator_14,109840859830,True,240452002,1097440,241549442,True
4011,validator_41,75321699340,True,207590000,5246440,212836440,False
4012,validator_31,172426172990,True,73943000,1857810,75800810,False
4013,validator_31,172516101620,True,85469000,4459630,89928630,False
4014,validator_21,74006747374,True,157182002,1248530,158430532,True
4015,validator_22,75378558067,True,123154998,945150,124100148,True
4016,validator_1,75272323012,True,224562000,356540,224918540,True
4017,validator_15,274621876002,True,87913000,18836300,106749300,True
4018,validator_8,43638552754,True,80265003,1640440,81905443,True
4019,validator_36,105116023140,True,46514000,1104000,47618000,False
4020,validator_29,38949719340,True,46506000,8368300,54874300,False
4021,validator_36,105188814270,True,67140000,5651130,72791130,False
4022,validator_49,73685151710,True,168448000,372700,168820700,False
4023,validator_38,40750147590,True,154352000,6217800,160569800,False
4024,validator_35,107216644510,True,93717000,8704740,102421740,False
4025,validator_38,40835849990,True,82968000,2734400,85702400,False
4026,validator_19,75787208379,True,82473004,228400,82701404,True
4027,validator_27,106464263570,True,107593000,332630,107925630,False
4028,validator_48,170086731840,True,48377000,1190840,49567840,False
4029,validator_8,43862780259,True,222879005,1348500,224227505,True
4030,validator_43,73056846200,True,72149000,1714400,73863400,False
4031,validator_38,40895069590,True,51266000,7953600,59219600,False
4032,validator_17,175773408883,True,65114999,1036880,66151879,True
4033,validator_32,41795406930,True,130767000,2469500,133236500,False
4034,validator_41,75511001740,True,188882000,420400,189302400,False
4035,validator_19,75929004920,True,122087001,19709540,141796541,True
4036,validator_27,106534770170,True,69742000,764600,70506600,False
4037,validator_21,74087308885,True,79322001,1239510,80561511,True
4038,validator_39,42151187200,True,113928000,2695280,116623280,False
4039,validator_7,76958380182,True,118314004,1829000,120143004,True
4040,validator_43,73145139600,True,87511000,782400,88293400,False
4041,validator_9,41261996336,True,59152994,5461590,64614584,True
4042,validator_36,105268285910,True,77645000,1826640,79471640,False
4043,validator_43,73193690500,True,48346000,204900,48550900,False
4044,validator_40,42551711920,True,132345000,377000,132722000,False
4045,validator_25,39936475100,True,78315000,9503130,87818130,False
4046,validator_32,41871990670,True,75996000,587740,76583740,False
4047,validator_33,39733526420,True,70224000,9162290,79386290,False
4048,validator_13,41308357068,True,135840997,7451200,143292197,True
4049,validator_44,107512785710,True,69998000,1149330,71147330,False
4050,validator_13,41471963808,True,160683000,2923740,163606740,True
4051,validator_41,75615766260,True,103145000,1619520,104764520,False
4052,validator_21,74215701585,True,127553000,839700,128392700,True
4053,validator_31,172660160120,True,143195000,863500,144058500,False
4054,validator_4,42402913296,True,41395000,476100,41871100,True
4055,validator_42,41353819610,True,111847000,682000,112529000,False
4056,validator_16,40806358056,True,193311999,19929430,213241429,True
4057,validator_40,42648651420,True,95464000,1475500,96939500,False
4058,validator_47,73738684200,True,215576000,885930,216461930,False
4059,validator_20,41726077833,True,113464997,1037200,114502197,True
4060,validator_48,170207610160,True,107142000,13736320,120878320,False
4061,validator_30,73399927530,True,40364000,1300340,41664340,False
4062,validator_1,75382716209,True,109741997,651200,110393197,True
4063,validator_48,170403717980,True,194072000,2035820,196107820,False
4064,validator_44,107647700350,True,126695000,8219640,134914640,False
4065,validator_0,42615312188,True,207557001,6573040,214130041,True
4066,validator_48,170564142280,True,151874000,8550300,160424300,False
4067,validator_6,41793598233,True,199658997,649330,200308327,True
4068,validator_2,44733687222,True,132539999,748600,133288599,True
4069,validator_16,40960767957,True,146506001,7903900,154409901,True
4070,validator_14,110113208028,True,267195998,5152200,272348198,True
4071,validator_38,40988839290,True,91589000,2180700,93769700,False
4072,validator_34,268288065680,True,43435000,1498990,44933990,False
4073,validator_32,41980130230,True,101437000,6702560,108139560,False
4074,validator_29,39062369440,True,112352000,298100,112650100,False
4075,validator_36,105324083380,True,47756000,8041470,55797470,False
4076,validator_44,107762539150,True,112190000,2648800,114838800,False
4077,validator_14,110284532568,True,170972000,352540,171324540,True
4078,validator_12,108845308197,True,70577996,402340,70980336,True
4079,validator_42,41501242050,True,145484000,1938440,147422440,False
4080,validator_15,274809096264,True,185625002,1595260,187220262,True
4081,validator_5,75260656959,True,118434003,710800,119144803,True
4082,validator_45,39936126190,True,110772000,523670,111295670,False
4083,validator_48,170758975610,True,188885000,5948330,194833330,False
4084,validator_28,40119184950,True,186607000,1136950,187743950,False
4085,validator_33,39849706830,True,115822000,358410,116180410,False
4086,validator_35,107388286610,True,170481000,1161100,171642100,False
4087,validator_0,42713022721,True,96253003,1457530,97710533,True
4088,validator_37,72460299690,True,242486000,18183610,260669610,False
4089,validator_31,172716434660,True,48257000,8017540,56274540,False
4090,validator_1,75482566809,True,98669000,1181600,99850600,True
4091,validator_46,104715677540,True,154636000,787300,155423300,False
4092,validator_44,107954408670,True,191250000,619520,191869520,False
4093,validator_15,274954369361,True,144500997,772100,145273097,True
4094,validator_21,74306180386,True,80539001,9939800,90478801,True
4095,validator_44,108112517870,True,157811000,298200,158109200,False
4096,validator_20,41778525266,True,51159003,1288430,52447433,True
4097,validator_34,268446727380,True,154852000,3809700,158661700,False
4098,validator_5,75432982545,True,170500006,1825580,172325586,True
4099,validator_41,75865254070,True,230223000,19264810,249487810,False
4100,validator_17,175911350570,True,132113007,5828680,137941687,True
4101,validator_31,172768902140,True,51023000,1444480,52467480,False
4102,validator_5,75635115526,True,194568001,7564980,202132981,True
4103,validator_8,44018781428,True,142384999,13616170,156001169,True
4104,validator_27,106688989970,True,152580000,1639800,154219800,False
4105,validator_23,43660821388,True,49198997,5022400,54221397,True
4106,validator_20,41855390963,True,75226997,1638700,76865697,True
4107,validator_10,43089221919,True,188689001,2611500,191300501,True
4108,validator_15,275126328475,True,171161004,798110,171959114,True
4109,validator_18,108390506566,True,190323000,8609700,198932700,True
4110,validator_47,73791058140,True,50388000,1985940,52373940,False
4111,validator_36,105436276160,True,109542000,2650780,112192780,False
4112,validator_13,41572947509,True,98925001,2058700,100983701,True
4113,validator_22,75474808400,True,95877003,373330,96250333,True
4114,validator_40,42764652520,True,111053000,4948100,116001100,False
4115,validator_7,77124783689,True,160327007,6076500,166403507,True
4116,validator_44,108199712400,True,86555000,639530,87194530,False
4117,validator_49,73754729390,True,67488000,2089680,69577680,False
4118,validator_1,75566478505,True,83617996,293700,83911696,True
4119,validator_11,42895497720,True,63140000,6922420,70062420,True
4120,validator_45,40006004790,True,65339000,4539600,69878600,False
4121,validator_44,108257126300,True,56277000,1136900,57413900,False
4122,validator_15,275217878476,True,90433001,1117000,91550001,True
4123,validator_19,76004061342,True,73428002,1628420,75056422,True
4124,validator_42,41578226250,True,57731000,19253200,76984200,False
4125,validator_26,42593817850,True,65054000,5378900,70432900,False
4126,validator_1,75781827288,True,214002993,1345790,215348783,True
4127,validator_28,40225173350,True,104023000,1965400,105988400,False
4128,validator_41,76020149310,True,154005000,890240,154895240,False
4129,validator_19,76232276177,True,226997995,1216840,228214835,True
4130,validator_5,75697870324,True,60679998,2074800,62754798,True
4131,validator_8,44114262329,True,94046001,1434900,95480901,True
4132,validator_22,75573693799,True,96499999,2385400,98885399,True
4133,validator_8,44225442230,True,109647001,1532900,111179901,True
4134,validator_38,41124982690,True,117727000,18416400,136143400,False
4135,validator_17,176087670447,True,174173997,2145880,176319877,True
4136,validator_22,75666134599,True,91874000,566800,92440800,True
4137,validator_35,107475447010,True,85792000,1368400,87160400,False
4138,validator_35,107641229310,True,165131000,651300,165782300,False
4139,validator_28,40333054470,True,90107000,17774120,107881120,False
4140,validator_22,75814371620,True,141219001,7018020,148237021,True
4141,validator_40,42875661390,True,103722000,7286870,111008870,False
4142,validator_15,275371106452,True,144646996,8580980,153227976,True
4143,validator_13,41693755410,True,117893001,2914900,120807901,True
4144,validator_11,43046458023,True,149433003,1527300,150960303,True
4145,validator_18,108565715297,True,174472001,736730,175208731,True
4146,validator_2,44964448542,True,229461000,1300320,230761320,True
4147,validator_49,73871500460,True,116246000,525070,116771070,False
4148,validator_32,42082795530,True,101631000,1034300,102665300,False
4149,validator_35,107731687710,True,84490000,5968400,90458400,False
4150,validator_26,42667766230,True,71407000,2541380,73948380,False
4151,validator_15,275517139250,True,138200998,7831800,146032798,True
4152,validator_4,42512208995,True,91472999,17822700,109295699,True
4153,validator_29,39166643110,True,101033000,3240670,104273670,False
4154,validator_32,42150541760,True,67000000,746230,67746230,False
4155,validator_19,76289923765,True,55785008,1862580,57647588,True
4156,validator_46,104769668670,True,52882000,1109130,53991130,False
4157,validator_11,43138000643,True,89596000,1946620,91542620,True
4158,validator_3,44933461668,True,65211994,1225600,66437594,True
4159,validator_20,41957284559,True,100686996,1206600,101893596,True
4160,validator_12,108904462500,True,57640003,1514300,59154303,True
4161,validator_41,76112433210,True,89215000,3068900,92283900,False
4162,validator_8,44281015220,True,54753000,819990,55572990,True
4163,validator_37,72590810890,True,123701000,6810200,130511200,False
4164,validator_9,41486569069,True,219220003,5352730,224572733,True
4165,validator_9,41622201769,True,132781000,2851700,135632700,True
4166,validator_7,77226236708,True,98065999,3387020,101453019,True
4167,validator_30,73455557330,True,54182000,1447800,55629800,False
4168,validator_18,108770148436,True,203486999,946140,204433139,True
4169,validator_31,172835340780,True,64882000,1556640,66438640,False
4170,validator_47,73844073340,True,52513000,502200,53015200,False
4171,validator_47,73945741840,True,101004000,664500,101668500,False
4172,validator_27,106832708990,True,141122000,2597020,143719020,False
4173,validator_2,45139579241,True,173872999,1257700,175130699,True
4174,validator_26,42789911430,True,119567000,2578200,122145200,False
4175,validator_36,105480382230,True,42248000,1858070,44106070,False
4176,validator_6,41930279865,True,135710002,971630,136681632,True
4177,validator_1,75977469576,True,193868998,1773290,195642288,True
4178,validator_15,275612210519,True,94260999,810270,95071269,True
4179,validator_37,72650299780,True,58762000,726890,59488890,False
4180,validator_10,43133302915,True,43287996,793000,44080996,True
4181,validator_15,275724229002,True,110679003,1339480,112018483,True
4182,validator_41,76175674080,True,45348000,17892870,63240870,False
4183,validator_7,77275373438,True,48120000,1016730,49136730,True
4184,validator_15,275984888501,True,252444999,8214500,260659499,True
4185,validator_48,170809165510,True,49315000,874900,50189900,False
4186,validator_29,39262044960,True,95143000,258850,95401850,False
4187,validator_21,74562578789,True,254217003,2181400,256398403,True
4188,validator_12,108953102436,True,48415996,223940,48639936,True
4189,validator_48,170946976680,True,111591000,26220170,137811170,False
4190,validator_1,76309146083,True,330585987,1090520,331676507,True
4191,validator_0,42855317027,True,141293006,1001300,142294306,True
4192,validator_16,41082461962,True,113326005,8368000,121694005,True
4193,validator_5,75764552864,True,66340000,342540,66682540,True
4194,validator_26,42846089760,True,55747000,431330,56178330,False
4195,validator_11,43270252940,True,126658997,5593300,132252297,True
4196,validator_23,43780301887,True,111334999,8145500,119480499,True
4197,validator_44,108343143200,True,85205000,811900,86016900,False
4198,validator_15,276087814099,True,101937998,987600,102925598,True
4199,validator_9,41785639139,True,155090000,8347370,163437370,True
4200,validator_37,72747133580,True,88189000,8644800,96833800,False
4201,validator_31,172959846520,True,101861000,22644740,124505740,False
4202,validator_3,45105417273,True,170857005,1098600,171955605,True
4203,validator_19,76373335391,True,81626996,1784630,83411626,True
4204,validator_6,42129906908,True,197568003,2059040,199627043,True
4205,validator_35,107801623810,True,68735000,1201100,69936100,False
4206,validator_3,45305980334,True,187709001,12854060,200563061,True
4207,validator_11,43432675041,True,143938001,18484100,162422101,True
4208,validator_46,104964179850,True,175621000,18890180,194511180,False
4209,validator_3,45418603538,True,110744004,1879200,112623204,True
4210,validator_29,39341939960,True,79047000,848000,79895000,False
4211,validator_46,105141457350,True,175919000,1358500,177277500,False
4212,validator_16,41261142590,True,171350998,7329630,178680628,True
4213,validator_3,45504100595,True,85036997,460060,85497057,True
4214,validator_24,41619696791,True,76126996,1440400,77567396,True
4215,validator_3,45630328195,True,117890000,8337600,126227600,True
4216,validator_10,43332240031,True,196498006,2439110,198937116,True
4217,validator_5,75919444464,True,154346000,545600,154891600,True
4218,validator_6,42297014707,True,166109999,997800,167107799,True
4219,validator_33,39910058450,True,52472000,7879620,60351620,False
4220,validator_16,41456166471,True,193342001,1681880,195023881,True
4221,validator_31,173065260120,True,84967000,20446600,105413600,False
4222,validator_24,41672079831,True,51607000,776040,52383040,True
4223,validator_3,45873809791,True,242081996,1399600,243481596,True
4224,validator_38,41331018090,True,204940000,1095400,206035400,False
4225,validator_43,73362745120,True,168361000,693620,169054620,False
4226,validator_39,42283549890,True,128964000,3398690,132362690,False
4227,validator_18,108876149535,True,104711999,1289100,106001099,True
4228,validator_18,108991340834,True,114338999,852300,115191299,True
4229,validator_38,41407274010,True,75932000,323920,76255920,False
4230,validator_46,105254767150,True,104768000,8541800,113309800,False
4231,validator_27,107026253590,True,190167000,3377600,193544600,False
4232,validator_36,105723701060,True,242369000,949830,243318830,False
4233,validator_16,41534355304,True,75757993,2430840,78188833,True
4234,validator_43,73488962800,True,107563000,18654680,126217680,False
4235,validator_15,276154748896,True,65831997,1102800,66934797,True
4236,validator_40,42919319630,True,43100000,558240,43658240,False
4237,validator_36,105799093760,True,57547000,17845700,75392700,False
4238,validator_43,73640408900,True,145277000,6169100,151446100,False
4239,validator_28,40529983000,True,188550000,8378530,196928530,False
4240,validator_12,109062095268,True,107753002,1239830,108992832,True
4241,validator_47,74031475740,True,85361000,372900,85733900,False
4242,validator_31,173227851550,True,132700000,29891430,162591430,False
4243,validator_45,40094222590,True,82419000,5798800,88217800,False
4244,validator_2,45232813042,True,91732001,1501800,93233801,True
4245,validator_29,39546103660,True,194572000,9591700,204163700,False
4246,validator_3,46170267909,True,295322998,1135120,296458118,True
4247,validator_34,268563005100,True,114728000,1549720,116277720,False
4248,validator_11,43498564421,True,64457000,1432380,65889380,True
4249,validator_45,40188895190,True,85492000,9180600,94672600,False
4250,validator_35,107882368210,True,79448000,1296400,80744400,False
4251,validator_49,73967302660,True,88372000,7430200,95802200,False
4252,validator_15,276290932712,True,133823996,2359820,136183816,True
4253,validator_16,41714743002,True,179393998,993700,180387698,True
4254,validator_4,42650991997,True,137419002,1364000,138783002,True
4255,validator_14,110478574701,True,187723003,6319130,194042133,True
4256,validator_30,73641573530,True,149170000,36846200,186016200,False
4257,validator_26,42978806050,True,112543000,20173290,132716290,False
4258,validator_15,276496889213,True,200078001,5878500,205956501,True
4259,validator_11,43681239117,True,157369996,25304700,182674696,True
4260,validator_3,46284954312,True,107198003,7488400,114686403,True
4261,validator_1,76443928782,True,133533999,1248700,134782699,True
4262,validator_6,42450191036,True,151033999,2142330,153176329,True
4263,validator_48,171027614180,True,78226000,2411500,80637500,False
4264,validator_38,41502880190,True,94952000,654180,95606180,False
4265,validator_12,109204277510,True,136487002,5695240,142182242,True
4266,validator_3,46428718514,True,142396002,1368200,143764202,True
4267,validator_19,76554715188,True,173125997,8253800,181379797,True
4268,validator_11,43894529916,True,201433999,11856800,213290799,True
4269,validator_0,43092198920,True,213172003,23709890,236881893,True
4270,validator_39,42375126180,True,86114000,5462290,91576290,False
4271,validator_45,40376380670,True,180864000,6621480,187485480,False
4272,validator_49,74142306160,True,173508000,1495500,175003500,False
4273,validator_22,75950201024,True,134604004,1225400,135829404,True
4274,validator_47,74122452540,True,89146000,1830800,90976800,False
4275,validator_22,76007128555,True,54124011,2803520,56927531,True
4276,validator_14,110607702979,True,127100998,2027280,129128278,True
4277,validator_26,43197789050,True,216987000,1996000,218983000,False
4278,validator_30,73739464330,True,95680000,2210800,97890800,False
4279,validator_49,74298988090,True,155838000,843930,156681930,False
4280,validator_23,43923835910,True,137820003,5714020,143534023,True
4281,validator_46,105408806950,True,152561000,1478800,154039800,False
4282,validator_17,176308513545,True,219667998,1175100,220843098,True
4283,validator_48,171141449580,True,102471000,11364400,113835400,False
4284,validator_5,76036478975,True,95969001,21065510,117034511,True
4285,validator_49,74513034450,True,212862000,1184360,214046360,False
4286,validator_32,42345883210,True,190199000,5142450,195341450,False
4287,validator_10,43479982627,True,137973996,9768600,147742596,True
4288,validator_30,73870681730,True,119783000,11434400,131217400,False
4289,validator_35,107972397510,True,80802000,9227300,90029300,False
4290,validator_33,40023278580,True,110742000,2478130,113220130,False
4291,validator_6,42526740436,True,75982000,567400,76549400,True
4292,validator_22,76119940020,True,104115995,8695470,112811465,True
4293,validator_5,76184446774,True,142265999,5701800,147967799,True
4294,validator_49,74707786050,True,193704000,1047600,194751600,False
4295,validator_31,173298904730,True,66068000,4985180,71053180,False
4296,validator_46,105499438180,True,89706000,925230,90631230,False
4297,validator_43,73776716300,True,135941000,366400,136307400,False
4298,validator_21,74617214587,True,52570998,2064800,54635798,True
4299,validator_8,44417639927,True,130218007,6406700,136624707,True
4300,validator_46,105579835680,True,70329000,10068500,80397500,False
4301,validator_1,76563073304,True,118717002,427520,119144522,True
4302,validator_15,276648355856,True,149267003,2199640,151466643,True
4303,validator_36,105906357160,True,106141000,1122400,107263400,False
4304,validator_18,109080172833,True,87733999,1098000,88831999,True
4305,validator_37,72892031080,True,137301000,7596500,144897500,False
4306,validator_7,77383984133,True,85056995,23553700,108610695,True
4307,validator_8,44577201626,True,159036999,524700,159561699,True
4308,validator_15,276782106258,True,126217002,7533400,133750402,True
4309,validator_34,268665271140,True,100708000,1558040,102266040,False
4310,validator_21,74737735697,True,102308000,18213110,120521110,True
4311,validator_7,77548694162,True,154719999,9990030,164710029,True
4312,validator_17,176458989014,True,124799989,25675480,150475469,True
4313,validator_15,276900720163,True,117319005,1294900,118613905,True
4314,validator_45,40458328570,True,78490000,3457900,81947900,False
4315,validator_39,42564406120,True,187403000,1876940,189279940,False
4316,validator_46,105684052280,True,102815000,1401600,104216600,False
4317,validator_26,43249016480,True,49999000,1228430,51227430,False
4318,validator_1,76690963006,True,121168002,6721700,127889702,True
4319,validator_4,42887706798,True,235601001,1113800,236714801,True
4320,validator_15,277079448360,True,175928997,2799200,178728197,True
4321,validator_22,76307726014,True,185978994,1807000,187785994,True
4322,validator_5,76332952613,True,148055999,449840,148505839,True
4323,validator_9,41988267336,True,200116997,2511200,202628197,True
4324,validator_48,171234215990,True,91837000,929410,92766410,False
4325,validator_29,39648244360,True,101778000,362700,102140700,False
4326,validator_44,108430609100,True,86621000,844900,87465900,False
4327,validator_45,40599984510,True,139672000,1983940,141655940,False
4328,validator_19,76708733092,True,152534004,1483900,154017904,True
4329,validator_7,77638684544,True,84938002,5052380,89990382,True
4330,validator_34,268750383940,True,81437000,3675800,85112800,False
4331,validator_46,105783316220,True,95777000,3486940,99263940,False
4332,validator_13,41812792614,True,117170004,1867200,119037204,True
4333,validator_28,40674750780,True,144230000,537780,144767780,False
4334,validator_12,109317908212,True,103321002,10309700,113630702,True
4335,validator_31,173424821610,True,121429000,4487880,125916880,False
4336,validator_37,73011722100,True,118665000,1026020,119691020,False
4337,validator_26,43307161980,True,57181000,964500,58145500,False
4338,validator_31,173525299310,True,82490000,17987700,100477700,False
4339,validator_13,41948981311,True,135259997,928700,136188697,True
4340,validator_0,43193420830,True,100660000,561910,101221910,True
4341,validator_33,40144511300,True,120760000,472720,121232720,False
4342,validator_27,107133771120,True,107185000,332530,107517530,False
4343,validator_0,43328262430,True,127210000,7631600,134841600,True
4344,validator_17,176608559214,True,148077000,1493200,149570200,True
4345,validator_24,41798433862,True,121692001,4662030,126354031,True
4346,validator_38,41623224290,True,112983000,7361100,120344100,False
4347,validator_6,42623635634,True,96283998,611200,96895198,True
4348,validator_13,42069799673,True,119299002,1519360,120818362,True
4349,validator_2,45315822842,True,64308000,18701800,83009800,True
4350,validator_41,76262340860,True,81222000,5444780,86666780,False
4351,validator_29,39873925360,True,217971000,7710000,225681000,False
4352,validator_48,171379930010,True,136106000,9608020,145714020,False
4353,validator_42,41691616950,True,111491000,1899700,113390700,False
4354,validator_37,73102061700,True,89137000,1202600,90339600,False
4355,validator_4,43084829774,True,173934996,23187980,197122976,True
4356,validator_18,109178743312,True,79457999,19112480,98570479,True
4357,validator_4,43228393699,True,134641005,8922920,143563925,True
4358,validator_47,74198502470,True,74332000,1717930,76049930,False
4359,validator_8,44640828232,True,63267006,359600,63626606,True
4360,validator_17,176797471864,True,170232000,18680650,188912650,True
4361,validator_20,42026388098,True,68023999,1079540,69103539,True
4362,validator_10,43583714896,True,102126999,1605270,103732269,True
4363,validator_23,44027591836,True,95069996,8685930,103755926,True
4364,validator_8,44722031131,True,63114999,18087900,81202899,True
4365,validator_6,42735511440,True,105862006,6013800,111875806,True
4366,validator_9,42241122534,True,233113998,19741200,252855198,True
4367,validator_9,42302996436,True,61260002,613900,61873902,True
4368,validator_16,41838417420,True,121863998,1810420,123674418,True
4369,validator_5,76506076213,True,171823000,1300600,173123600,True
4370,validator_15,277214717562,True,134884002,385200,135269202,True
4371,validator_15,277405641364,True,188965002,1958800,190923802,True
4372,validator_44,108580986530,True,147825000,2552430,150377430,False
4373,validator_26,43428228780,True,120597000,469800,121066800,False
4374,validator_42,41788418050,True,78962000,17839100,96801100,False
4375,validator_11,43973301413,True,77649997,1121500,78771497,True
4376,validator_16,42111622962,True,271010002,2195540,273205542,True
4377,validator_30,74045508670,True,173642000,1184940,174826940,False
4378,validator_15,277542944061,True,136984997,317700,137302697,True
4379,validator_45,40686602850,True,82152000,4466340,86618340,False
4380,validator_29,39999932300,True,116608000,9398940,126006940,False
4381,validator_33,40225860800,True,80226000,1123500,81349500,False
4382,validator_22,76411540501,True,102279997,1534490,103814487,True
4383,validator_34,268896263280,True,143822000,2057340,145879340,False
4384,validator_39,42671276320,True,106293000,577200,106870200,False
4385,validator_27,107233565920,True,98571000,1223800,99794800,False
4386,validator_9,42460828839,True,155004003,2828400,157832403,True
4387,validator_24,41941504599,True,141619997,1450740,143070737,True
4388,validator_48,171483945040,True,103767000,248030,104015030,False
4389,validator_43,73973429620,True,195203000,1510320,196713320,False
4390,validator_18,109281627682,True,102283000,601370,102884370,True
4391,validator_14,110833531078,True,224891999,936100,225828099,True
4392,validator_37,73188407300,True,84785000,1560600,86345600,False
4393,validator_48,171713054820,True,219290000,9819780,229109780,False
4394,validator_12,109401042210,True,74111998,9022000,83133998,True
4395,validator_27,107305684420,True,71203000,915500,72118500,False
4396,validator_3,46505740911,True,75614997,1407400,77022397,True
4397,validator_40,42979745060,True,41535000,18890430,60425430,False
4398,validator_46,105814253060,True,29526000,1410840,30936840,False
4399,validator_2,45459213989,True,124425997,18965150,143391147,True
4400,validator_5,76631963332,True,125287999,599120,125887119,True
4401,validator_34,269050253980,True,153375000,615700,153990700,False
4402,validator_1,76873728195,True,181688999,1076190,182765189,True
4403,validator_18,109457932460,True,175671998,632780,176304778,True
4404,validator_30,74162948270,True,116133000,1306600,117439600,False
4405,validator_32,42483664530,True,136114000,1667320,137781320,False
4406,validator_18,109563182542,True,99674002,5576080,105250082,True
4407,validator_25,40102564000,True,163444000,2644900,166088900,False
4408,validator_49,74834203230,True,125425000,992180,126417180,False
4409,validator_48,171892629620,True,178249000,1325800,179574800,False
4410,validator_43,74163511750,True,184379000,5703130,190082130,False
4411,validator_18,109701897047,True,136204005,2510500,138714505,True
4412,validator_7,77877109667,True,236748003,1677120,238425123,True
4413,validator_14,111049937246,True,209081998,7324170,216406168,True
4414,validator_9,42624349770,True,162678001,842930,163520931,True
4415,validator_6,42896404261,True,152457001,8435820,160892821,True
4416,validator_3,46665794090,True,157992999,2060180,160053179,True
4417,validator_6,43060944059,True,155512998,9026800,164539798,True
4418,validator_17,176990731557,True,187748993,5510700,193259693,True
4419,validator_39,42746738020,True,73642000,1819700,75461700,False
4420,validator_13,42145951289,True,74500996,1650620,76151616,True
4421,validator_34,269195089810,True,144117000,718830,144835830,False
4422,validator_1,77232627717,True,357833002,1066520,358899522,True
4423,validator_20,42179450703,True,150651005,2411600,153062605,True
4424,validator_47,74354712430,True,137098000,19111960,156209960,False
4425,validator_28,40765086240,True,87847000,2488460,90335460,False
4426,validator_5,76766921930,True,133901998,1056600,134958598,True
4427,validator_15,277747823702,True,178892001,25987640,204879641,True
4428,validator_36,105999377750,True,92073000,947590,93020590,False
4429,validator_48,172005496740,True,112310000,557120,112867120,False
4430,validator_28,40883251740,True,116058000,2107500,118165500,False
4431,validator_18,109811303735,True,104937998,4468690,109406688,True
4432,validator_5,76892858631,True,123944001,1992700,125936701,True
4433,validator_31,173624566610,True,98263000,1004300,99267300,False
4434,validator_28,41041232140,True,157105000,875400,157980400,False
4435,validator_45,40782027950,True,93568000,1857100,95425100,False
4436,validator_14,111276950589,True,225782003,1231340,227013343,True
4437,validator_10,43646361398,True,62235002,411500,62646502,True
4438,validator_39,42904259320,True,151736000,5785300,157521300,False
4439,validator_26,43543767280,True,105575000,9963500,115538500,False
4440,validator_45,40913910350,True,126594000,5288400,131882400,False
4441,validator_14,111411622761,True,133119002,1553170,134672172,True
4442,validator_19,76931291473,True,219682991,2875390,222558381,True
4443,validator_5,76976272353,True,82348002,1065720,83413722,True
4444,validator_17,177051983806,True,60477999,774250,61252249,True
4445,validator_34,269322001610,True,125665000,1246800,126911800,False
4446,validator_38,41765738830,True,141612000,902540,142514540,False
4447,validator_34,269436677410,True,113643000,1032800,114675800,False
4448,validator_15,277917295021,True,167177999,2293320,169471319,True
4449,validator_17,177254649285,True,202125999,539480,202665479,True
4450,validator_22,76566090302,True,147015001,7534800,154549801,True
4451,validator_40,43202978660,True,221454000,1779600,223233600,False
4452,validator_26,43716303780,True,170329000,2207500,172536500,False
4453,validator_28,41191324140,True,148264000,1828000,150092000,False
4454,validator_23,44176790996,True,141718000,7481160,149199160,True
4455,validator_2,45540549421,True,80924992,410440,81335432,True
4456,validator_15,278082448322,True,147037001,18116300,165153301,True
4457,validator_41,76303976760,True,40113000,1522900,41635900,False
4458,validator_7,77982620190,True,104861003,649520,105510523,True
4459,validator_37,73265513280,True,59346000,17759980,77105980,False
4460,validator_23,44298073486,True,119341000,1941490,121282490,True
4461,validator_35,108172826310,True,199460000,968800,200428800,False
4462,validator_14,111500341984,True,87741003,978220,88719223,True
4463,validator_19,76977165271,True,45529998,343800,45873798,True
4464,validator_36,106208747450,True,208783000,586700,209369700,False
4465,validator_20,42345032907,True,158214004,7368200,165582204,True
4466,validator_45,41087967350,True,173123000,934000,174057000,False
4467,validator_42,41964701530,True,158327000,17956480,176283480,False
4468,validator_17,177471382920,True,196575005,20158630,216733635,True
4469,validator_36,106411977450,True,200850000,2380000,203230000,False
4470,validator_1,77324350413,True,90404996,1317700,91722696,True
4471,validator_34,269634802130,True,190471000,7653720,198124720,False
4472,validator_6,43163533580,True,97766001,4823520,102589521,True
4473,validator_23,44394144085,True,95640999,429600,96070599,True
4474,validator_8,44863007610,True,121854999,19121480,140976479,True
4475,validator_9,42785072691,True,159786001,936920,160722921,True
4476,validator_43,74213838550,True,49569000,757800,50326800,False
4477,validator_38,41979839370,True,212296000,1804540,214100540,False
4478,validator_26,43884347880,True,167581000,463100,168044100,False
4479,validator_31,173698741110,True,71931000,2243500,74174500,False
4480,validator_14,111691589524,True,180500000,10747540,191247540,True
4481,validator_47,74458720810,True,103350000,658380,104008380,False
4482,validator_32,42562025430,True,76669000,1691900,78360900,False
4483,validator_2,45729580827,True,184963006,4068400,189031406,True
4484,validator_34,269703055730,True,66855000,1398600,68253600,False
4485,validator_15,278241104122,True,139596000,19059800,158655800,True
4486,validator_19,77088612370,True,110484999,962100,111447099,True
4487,validator_41,76391804740,True,87186000,641980,87827980,False
4488,validator_15,278362169105,True,119737003,1327980,121064983,True
4489,validator_34,269788769730,True,85286000,428000,85714000,False
4490,validator_49,74924071760,True,88817000,1051530,89868530,False
4491,validator_46,105901666700,True,86294000,1119640,87413640,False
4492,validator_31,173841602410,True,130272000,12589300,142861300,False
4493,validator_48,172108902760,True,95441000,7965020,103406020,False
4494,validator_23,44444224887,True,48427002,1653800,50080802,True
4495,validator_18,109893662335,True,56167000,26191600,82358600,True
4496,validator_23,44560624286,True,107573999,8825400,116399399,True
4497,validator_43,74418519450,True,199767000,4913900,204680900,False
4498,validator_46,105959979360,True,57367000,945660,58312660,False
4499,validator_21,75016908219,True,276379992,2792530,279172522,True
4500,validator_8,44915495410,True,51516000,971800,52487800,True
4501,validator_9,42867907794,True,81652003,1183100,82835103,True
4502,validator_40,43259471680,True,54408000,2085020,56493020,False
4503,validator_47,74623495110,True,157258000,7516300,164774300,False
4504,validator_37,73385408470,True,108280000,11615190,119895190,False
4505,validator_29,40077367300,True,76407000,1028000,77435000,False
4506,validator_40,43409779160,True,140346000,9961480,150307480,False
4507,validator_35,108298317940,True,122891000,2600630,125491630,False
4508,validator_40,43479605860,True,69446000,380700,69826700,False
4509,validator_15,278548417236,True,184790001,1458130,186248131,True
4510,validator_29,40150615820,True,50639000,22609520,73248520,False
4511,validator_43,74538739750,True,119421000,799300,120220300,False
4512,validator_8,45083876561,True,167708001,673150,168381151,True
4513,validator_21,75123181556,True,105332997,940340,106273337,True
4514,validator_37,73575275990,True,182166000,7701520,189867520,False
4515,validator_7,78037870922,True,55142002,108730,55250732,True
4516,validator_44,108632073930,True,46087000,5000400,51087400,False
4517,validator_43,74619874650,True,79793000,1341900,81134900,False
4518,validator_10,43759243334,True,94250006,18631930,112881936,True
4519,validator_49,75029685960,True,96548000,9066200,105614200,False
4520,validator_44,108805008650,True,171155000,1779720,172934720,False
4521,validator_17,177643659324,True,171895004,381400,172276404,True
4522,validator_14,111807987151,True,115088997,1308630,116397627,True
4523,validator_6,43215180984,True,50852004,795400,51647404,True
4524,validator_31,173960078110,True,104642000,13833700,118475700,False
4525,validator_22,76771340705,True,187011003,18239400,205250403,True
4526,validator_38,42177693000,True,196870000,983630,197853630,False
4527,validator_36,106496511720,True,83264000,1270270,84534270,False
4528,validator_21,75270547559,True,139570003,7796000,147366003,True
4529,validator_26,44096489300,True,207497000,4644420,212141420,False
4530,validator_17,177773620922,True,129693998,267600,129961598,True
4531,validator_9,43017906295,True,148872001,1126500,149998501,True
4532,validator_45,41186100630,True,97412000,721280,98133280,False
4533,validator_0,43416057114,True,86765004,1029680,87794684,True
4534,validator_28,41341767290,True,131315000,19128150,150443150,False
4535,validator_21,75408515656,True,137279997,688100,137968097,True
4536,validator_36,106669184170,True,171449000,1223450,172672450,False
4537,validator_42,42163492430,True,195806000,2984900,198790900,False
4538,validator_42,42286307630,True,121837000,978200,122815200,False
4539,validator_20,42436514509,True,90743002,738600,91481602,True
4540,validator_15,278698633139,True,147476003,2739900,150215903,True
4541,validator_30,74318717560,True,150003000,5766290,155769290,False
4542,validator_36,106810004270,True,135292000,5528100,140820100,False
4543,validator_3,46876192791,True,205268001,5130700,210398701,True
4544,validator_30,74531560070,True,210670000,2172510,212842510,False
4545,validator_17,177948148750,True,173920998,606830,174527828,True
4546,validator_12,109660120039,True,239936999,19140830,259077829,True
4547,validator_24,42054840096,True,112833997,501500,113335497,True
4548,validator_34,269898182560,True,107655000,1757830,109412830,False
4549,validator_6,43351231383,True,127252999,8797400,136050399,True
4550,validator_27,107424393520,True,117798000,911100,118709100,False
4551,validator_45,41328766750,True,141774000,892120,142666120,False
4552,validator_41,76473123620,True,79463000,1855880,81318880,False
4553,validator_15,278744107639,True,43168000,2306500,45474500,True
4554,validator_35,108392003060,True,92872000,813120,93685120,False
4555,validator_26,44200079830,True,103161000,429530,103590530,False
4556,validator_19,77225637271,True,136393001,631900,137024901,True
4557,validator_23,44695366613,True,133299997,1442330,134742327,True
4558,validator_7,78228510748,True,189957996,681830,190639826,True
4559,validator_47,74712064930,True,88456000,113820,88569820,False
4560,validator_11,44092611115,True,101274002,18035700,119309702,True
4561,validator_5,77087549089,True,109472006,1804730,111276736,True
4562,validator_30,74735324710,True,202506000,1258640,203764640,False
4563,validator_24,42158333107,True,101796001,1697010,103493011,True
4564,validator_28,41489101690,True,145762000,1572400,147334400,False
4565,validator_31,174026708110,True,58848000,7782000,66630000,False
4566,validator_14,112067611429,True,258789998,834280,259624278,True
4567,validator_7,78408763850,True,179247002,1006100,180253102,True
4568,validator_44,108879334050,True,73947000,378400,74325400,False
4569,validator_9,43117916195,True,99106000,903900,100009900,True
4570,validator_18,110037857135,True,142827000,1367800,144194800,True
4571,validator_15,278904939695,True,159889006,943050,160832056,True
4572,validator_7,78569593153,True,159239003,1590300,160829303,True
4573,validator_23,44810255457,True,113852004,1036840,114888844,True
4574,validator_23,45018633553,True,207030996,1347100,208378096,True
4575,validator_35,108498873170,True,105785000,1085110,106870110,False
4576,validator_43,74670145250,True,49820000,450600,50270600,False
4577,validator_42,42359018430,True,70967000,1743800,72710800,False
4578,validator_17,178053220059,True,104927999,143310,105071309,True
4579,validator_18,110171966334,True,125449999,8659200,134109199,True
4580,validator_37,73740925650,True,147483000,18166660,165649660,False
4581,validator_15,279115838099,True,197796004,13102400,210898404,True
4582,validator_35,108566928770,True,65603000,2452600,68055600,False
4583,validator_21,75514893179,True,105174003,1203520,106377523,True
4584,validator_18,110326330615,True,149382001,4982280,154364281,True
4585,validator_32,42713328330,True,148571000,2731900,151302900,False
4586,validator_6,43524743607,True,170133004,3379220,173512224,True
4587,validator_40,43604637760,True,123993000,1038900,125031900,False
4588,validator_31,174303135310,True,275252000,1175200,276427200,False
4589,validator_18,110441529313,True,95790998,19407700,115198698,True
4590,validator_18,110601409217,True,158432004,1447900,159879904,True
4591,validator_25,40167897940,True,64330000,1003940,65333940,False
4592,validator_27,107495572620,True,69235000,1944100,71179100,False
4593,validator_33,40381614040,True,153646000,2107240,155753240,False
4594,validator_7,78669672159,True,99104006,975000,100079006,True
4595,validator_49,75098540660,True,58976000,9878700,68854700,False
4596,validator_8,45263022159,True,160054998,19090600,179145598,True
4597,validator_46,106049027160,True,87056000,1991800,89047800,False
4598,validator_15,279264060498,True,148076999,145400,148222399,True
4599,validator_27,107598941720,True,102362000,1007100,103369100,False
4600,validator_35,108617451570,True,49714000,808800,50522800,False
4601,validator_26,44332390960,True,131514000,797130,132311130,False
4602,validator_0,43547776016,True,129796002,1922900,131718902,True
4603,validator_15,279370442578,True,102558000,3824080,106382080,True
4604,validator_49,75245845550,True,146036000,1268890,147304890,False
4605,validator_29,40406513010,True,254877000,1020190,255897190,False
4606,validator_27,107806035620,True,206515000,578900,207093900,False
4607,validator_34,270011631460,True,93696000,19752900,113448900,False
4608,validator_25,40322027120,True,134645000,19484180,154129180,False
4609,validator_20,42512214761,True,66963002,8737250,75700252,True
4610,validator_7,78816000361,True,145410002,918200,146328202,True
4611,validator_34,270086382660,True,53259000,21492200,74751200,False
4612,validator_0,43678464192,True,127185996,3502180,130688176,True
4613,validator_45,41429770850,True,98544000,2460100,101004100,False
4614,validator_29,40477883600,True,70206000,1164590,71370590,False
4615,validator_1,77468232414,True,143426001,456000,143882001,True
4616,validator_1,77543160986,True,72778002,2150570,74928572,True
4617,validator_18,110747370442,True,144862995,1098230,145961225,True
4618,validator_25,40387671400,True,65023000,621280,65644280,False
4619,validator_25,40469050920,True,81150000,229520,81379520,False
4620,validator_19,77376118472,True,149417001,1064200,150481201,True
4621,validator_36,106977569660,True,166775000,790390,167565390,False
4622,validator_17,178265064562,True,203222003,8622500,211844503,True
4623,validator_38,42303784400,True,124427000,1664400,126091400,False
4624,validator_45,41538314050,True,107202000,1341200,108543200,False
4625,validator_10,43876177976,True,115979002,955640,116934642,True
4626,validator_30,74787658110,True,49789000,2544400,52333400,False
4627,validator_48,172189361760,True,79138000,1321000,80459000,False
4628,validator_12,110111706867,True,449161998,2424830,451586828,True
4629,validator_23,45216764689,True,197027996,1103140,198131136,True
4630,validator_0,43796850925,True,116479993,1906740,118386733,True
4631,validator_33,40533997960,True,144008000,8375920,152383920,False
4632,validator_1,77660176688,True,115399002,1616700,117015702,True
4633,validator_41,76639953020,True,147784000,19045400,166829400,False
4634,validator_17,178376212561,True,108433999,2714000,111147999,True
4635,validator_33,40648000360,True,108807000,5195400,114002400,False
4636,validator_14,112166096927,True,96785998,1699500,98485498,True
4637,validator_23,45297327098,True,78641999,1920410,80562409,True
4638,validator_17,178426291464,True,49178003,900900,50078903,True
4639,validator_47,74817235660,True,103116000,2054730,105170730,False
4640,validator_36,107111924360,True,132962000,1392700,134354700,False
4641,validator_1,77837108528,True,176247000,684840,176931840,True
4642,validator_34,270291231790,True,203675000,1174130,204849130,False
4643,validator_2,45824242627,True,74928000,19733800,94661800,True
4644,validator_17,178609228551,True,180898997,2038090,182937087,True
4645,validator_41,76721051720,True,79992000,1106700,81098700,False
4646,validator_39,43057855740,True,152932000,664420,153596420,False
4647,validator_30,74924572550,True,135769000,1145440,136914440,False
4648,validator_27,107935977720,True,128499000,1443100,129942100,False
4649,validator_40,43714311800,True,108504000,1170040,109674040,False
4650,validator_13,42229608590,True,82645001,1012300,83657301,True
4651,validator_31,174490640030,True,187094000,410720,187504720,False
4652,validator_25,40574074690,True,96810000,8213770,105023770,False
4653,validator_18,110831972621,True,84287009,315170,84602179,True
4654,validator_49,75357012050,True,105215000,5951500,111166500,False
4655,validator_2,45964869431,True,138539004,2087800,140626804,True
4656,validator_7,78924206361,True,107187000,1019000,108206000,True
4657,validator_5,77166734889,True,78467000,718800,79185800,True
4658,validator_35,108689006270,True,67012000,4542700,71554700,False
4659,validator_27,108007669160,True,62817000,8874440,71691440,False
4660,validator_18,110934852949,True,101888998,991330,102880328,True
4661,validator_15,279468636877,True,78660999,19533300,98194299,True
4662,validator_48,172263621960,True,72944000,1316200,74260200,False
4663,validator_2,46128612955,True,150285004,13458520,163743524,True
4664,validator_36,107227941980,True,114581000,1436620,116017620,False
4665,validator_48,172421482660,True,154992000,2868700,157860700,False
4666,validator_2,46227788483,True,98229998,945530,99175528,True
4667,validator_0,43989716024,True,192096999,768100,192865099,True
4668,validator_26,44395587200,True,55572000,7624240,63196240,False
4669,validator_16,42195402064,True,83333002,446100,83779102,True
4670,validator_27,108064756890,True,55486000,1601730,57087730,False
4671,validator_5,77352980750,True,172472001,13773860,186245861,True
4672,validator_24,42258599205,True,98550998,1715100,100266098,True
4673,validator_20,42664874762,True,152117001,543000,152660001,True
4674,validator_32,42884788630,True,165154000,6306300,171460300,False
4675,validator_29,40583628200,True,75195000,30549600,105744600,False
4676,validator_15,279540766117,True,64625000,7504240,72129240,True
4677,validator_8,45408412059,True,142334000,3055900,145389900,True
4678,validator_5,77446693651,True,93578001,134900,93712901,True
4679,validator_3,47075392990,True,195804999,3395200,199200199,True
4680,validator_42,42489807070,True,130278000,510640,130788640,False
4681,validator_7,79024240381,True,99484000,550020,100034020,True
4682,validator_17,178757793354,True,147369003,1195800,148564803,True
4683,validator_9,43231917828,True,112146003,1855630,114001633,True
4684,validator_21,75599326081,True,82034002,2398900,84432902,True
4685,validator_48,172569375250,True,140140000,7752590,147892590,False
4686,validator_40,43779312900,True,62261000,2740100,65001100,False
4687,validator_21,75655225108,True,55325997,573030,55899027,True
4688,validator_40,43875006910,True,95589000,105010,95694010,False
4689,validator_21,75740439806,True,84637998,576700,85214698,True
4690,validator_16,42273069163,True,76952999,714100,77667099,True
4691,validator_14,112335443953,True,167742996,1604030,169347026,True
4692,validator_0,44120592023,True,129066999,1809000,130875999,True
4693,validator_45,41610640150,True,71451000,875100,72326100,False
4694,validator_9,43429139989,True,196789001,433160,197222161,True
4695,validator_34,270395876590,True,102717000,1927800,104644800,False
4696,validator_32,43049641010,True,146871000,17981380,164852380,False
4697,validator_29,40728481800,True,143272000,1581600,144853600,False
4698,validator_40,43916336010,True,40603000,726100,41329100,False
4699,validator_2,46319374215,True,90824002,761730,91585732,True
4700,validator_48,172725362770,True,155077000,910520,155987520,False
4701,validator_6,43744861833,True,213748996,6369230,220118226,True
4702,validator_48,172875579650,True,147720000,2496880,150216880,False
4703,validator_23,45406015495,True,99788997,8899400,108688397,True
4704,validator_17,178997670854,True,221207000,18670500,239877500,True
4705,validator_44,108960563550,True,80062000,1167500,81229500,False
4706,validator_25,40699171170,True,105727000,19369480,125096480,False
4707,validator_9,43600345908,True,166108999,5096920,171205919,True
4708,validator_5,77631536992,True,177301001,7542340,184843341,True
4709,validator_14,112527278194,True,168720001,23114240,191834241,True
4710,validator_7,79296050979,True,271108998,701600,271810598,True
4711,validator_19,77511039556,True,116721004,18200080,134921084,True
4712,validator_18,111039570502,True,104151003,566550,104717553,True
4713,validator_38,42494753280,True,190143000,825880,190968880,False
4714,validator_28,41611631100,True,121265000,1264410,122529410,False
4715,validator_8,45601226654,True,173889995,18924600,192814595,True
4716,validator_11,44218078221,True,123484006,1983100,125467106,True
4717,validator_27,108165180090,True,99759000,664200,100423200,False
4718,validator_13,42407563629,True,177044999,910040,177955039,True
4719,validator_28,41701869700,True,88943000,1295600,90238600,False
4720,validator_2,46471992329,True,150374994,2243120,152618114,True
4721,validator_0,44242606424,True,119180001,2834400,122014401,True
4722,validator_46,106156637060,True,87996000,19613900,107609900,False
4723,validator_7,79437921807,True,140531998,1338830,141870828,True
4724,validator_15,279577412796,True,36159999,486680,36646679,True
4725,validator_6,43850010535,True,104893002,255700,105148702,True
4726,validator_0,44413732422,True,168900008,2225990,171125998,True
4727,validator_39,43139010740,True,80115000,1040000,81155000,False
4728,validator_26,44448735500,True,50873000,2275300,53148300,False
4729,validator_34,270502164710,True,87668000,18620120,106288120,False
4730,validator_21,75911021311,True,152570005,18011500,170581505,True
4731,validator_32,43171318320,True,113640000,8037310,121677310,False
4732,validator_3,47216227086,True,138524996,2309100,140834096,True
4733,validator_21,76169024413,True,250164002,7839100,258003102,True
4734,validator_15,279679862496,True,101851000,598700,102449700,True
4735,validator_19,77683216199,True,162158003,10018640,172176643,True
4736,validator_27,108300387610,True,132941000,2266520,135207520,False
4737,validator_15,279734838297,True,54579001,396800,54975801,True
4738,validator_23,45567550897,True,161104002,431400,161535402,True
4739,validator_11,44302240900,True,83972999,189680,84162679,True
4740,validator_10,43943529515,True,66763999,587540,67351539,True
4741,validator_2,46574552125,True,100534996,2024800,102559796,True
4742,validator_29,40910550800,True,181401000,668000,182069000,False
4743,validator_24,42313179282,True,54001997,578080,54580077,True
4744,validator_31,174627758830,True,130432000,6686800,137118800,False
4745,validator_18,111174847400,True,134671998,604900,135276898,True
4746,validator_19,77809807828,True,124596999,1994630,126591629,True
4747,validator_42,42575396270,True,85174000,415200,85589200,False
4748,validator_2,46681191422,True,105620997,1018300,106639297,True
4749,validator_40,43986327050,True,68792000,1199040,69991040,False
4750,validator_36,107374983060,True,144310000,2731080,147041080,False
4751,validator_34,270665357210,True,136439000,26753500,163192500,False
4752,validator_20,42846644592,True,179013000,2756830,181769830,True
4753,validator_47,74936511990,True,118480000,796330,119276330,False
4754,validator_7,79679238908,True,238891001,2426100,241317101,True
4755,validator_30,75002110870,True,76917000,621320,77538320,False
4756,validator_31,174713111710,True,85025000,327880,85352880,False
4757,validator_25,40816920990,True,117530000,219820,117749820,False
4758,validator_30,75232729060,True,229753000,865190,230618190,False
4759,validator_9,43734499152,True,129466004,4687240,134153244,True
4760,validator_43,74743870350,True,71901000,1824100,73725100,False
4761,validator_21,76334105715,True,164353002,728300,165081302,True
4762,validator_14,112740555096,True,213001002,275900,213276902,True
4763,validator_9,43803120729,True,67598997,1022580,68621577,True
4764,validator_25,40898644390,True,79728000,1995400,81723400,False
4765,validator_0,44597094924,True,179759002,3603500,183362502,True
4766,validator_33,40800420690,True,151006000,1414330,152420330,False
4767,validator_33,40946781130,True,145496000,864440,146360440,False
4768,validator_23,45759910901,True,190123004,2237000,192360004,True
4769,validator_28,41784782980,True,81686000,1227280,82913280,False
4770,validator_31,174801690140,True,82862000,5716430,88578430,False
4771,validator_6,43963568294,True,112177999,1379760,113557759,True
4772,validator_34,270753300110,True,87344000,598900,87942900,False
4773,validator_17,179130439133,True,132643999,124280,132768279,True
4774,validator_35,108791816770,True,97800000,5010500,102810500,False
4775,validator_15,279965267776,True,227923999,2505480,230429479,True
4776,validator_19,78001027025,True,190247997,971200,191219197,True
4777,validator_3,47350598321,True,130412995,3958240,134371235,True
4778,validator_9,43981200028,True,177917999,161300,178079299,True
4779,validator_13,42572749631,True,163464002,1722000,165186002,True
4780,validator_4,43472783002,True,244007003,382300,244389303,True
4781,validator_39,43225768470,True,84491000,2266730,86757730,False
4782,validator_15,280104833707,True,137660001,1905930,139565931,True
4783,validator_12,110278084291,True,165278994,1098430,166377424,True
4784,validator_11,44382440004,True,74610004,5589100,80199104,True
4785,validator_18,111256400104,True,77042004,4510700,81552704,True
4786,validator_16,42392292446,True,118659003,564280,119223283,True
4787,validator_46,106296669960,True,131524000,8508900,140032900,False
4788,validator_41,76849546780,True,126843000,1652060,128495060,False
4789,validator_19,78172207956,True,170993001,187930,171180931,True
4790,validator_42,42653322540,True,72948000,4978270,77926270,False
4791,validator_47,74997280510,True,59160000,1608520,60768520,False
4792,validator_3,47399609732,True,47540001,1471410,49011411,True
4793,validator_14,112915317397,True,172399001,2363300,174762301,True
4794,validator_6,44059647896,True,91261002,4818600,96079602,True
4795,validator_45,41688095180,True,74512000,2943030,77455030,False
4796,validator_22,76920881804,True,148340999,1200100,149541099,True
4797,validator_32,43313153620,True,140799000,1036300,141835300,False
4798,validator_6,44190928582,True,111152996,20127690,131280686,True
4799,validator_37,73817875350,True,75820000,1129700,76949700,False
4800,validator_43,74882535520,True,130556000,8109170,138665170,False
4801,validator_15,280262055335,True,156356998,864630,157221628,True
4802,validator_48,172976431030,True,82570000,18281380,100851380,False
4803,validator_10,44058325244,True,112822999,1972730,114795729,True
4804,validator_37,73995045050,True,153257000,23912700,177169700,False
4805,validator_16,42446731451,True,53225005,1214000,54439005,True
4806,validator_11,44599050231,True,214795997,1814230,216610227,True
4807,validator_35,108982536500,True,188983000,1736730,190719730,False
4808,validator_46,106386022780,True,68814000,20538820,89352820,False
4809,validator_24,42440681481,True,126569999,932200,127502199,True
4810,validator_44,109122890190,True,160666000,1660640,162326640,False
4811,validator_17,179235554537,True,95746004,9369400,105115404,True
4812,validator_25,41042231550,True,142275000,1312160,143587160,False
4813,validator_31,174962004380,True,159547000,767240,160314240,False
4814,validator_27,108385519810,True,49470000,35662200,85132200,False
4815,validator_22,76963871604,True,41653000,1336800,42989800,True
4816,validator_22,77251875411,True,286644997,1358810,288003807,True
4817,validator_30,75311970560,True,78440000,801500,79241500,False
4818,validator_21,76482640710,True,146597995,1937000,148534995,True
4819,validator_2,46836854319,True,154189997,1472900,155662897,True
4820,validator_17,179410677736,True,173917999,1205200,175123199,True
4821,validator_38,42576133260,True,62893000,18486980,81379980,False
4822,validator_49,75409896550,True,49955000,2929500,52884500,False
4823,validator_7,79804420007,True,123590999,1590100,125181099,True
4824,validator_40,44148391150,True,153808000,8256100,162064100,False
4825,validator_5,77736445190,True,104048998,859200,104908198,True
4826,validator_39,43345428800,True,116024000,3636330,119660330,False
4827,validator_27,108515712210,True,128279000,1913400,130192400,False
4828,validator_20,42917724294,True,69855002,1224700,71079702,True
4829,validator_23,45825606624,True,65514003,181720,65695723,True
4830,validator_49,75635565980,True,200078000,25591430,225669430,False
4831,validator_35,109116965100,True,127455000,6973600,134428600,False
4832,validator_10,44205100242,True,145337998,1437000,146774998,True
4833,validator_15,280375412035,True,104777000,8579700,113356700,True
4834,validator_30,75462920860,True,150257000,693300,150950300,False
4835,validator_13,42636553230,True,62103999,1699600,63803599,True
4836,validator_13,42759395536,True,120553006,2289300,122842306,True
4837,validator_0,44796889252,True,199663998,130330,199794328,True
4838,validator_8,45810267880,True,207526996,1514230,209041226,True
4839,validator_49,75770853380,True,134128000,1159400,135287400,False
4840,validator_4,43710997470,True,237049998,1164470,238214468,True
4841,validator_36,107446775190,True,70600000,1192130,71792130,False
4842,validator_38,42661016060,True,84352000,530800,84882800,False
4843,validator_9,44089507930,True,106951002,1356900,108307902,True
4844,validator_1,78035891769,True,197624001,1159240,198783241,True
4845,validator_7,80002017392,True,197118005,479380,197597385,True
4846,validator_36,107607764310,True,154139000,6850120,160989120,False
4847,validator_42,42720956940,True,65966000,1668400,67634400,False
4848,validator_9,44182665308,True,88502998,4654380,93157378,True
4849,validator_1,78200013003,True,163575004,546230,164121234,True
4850,validator_27,108610031350,True,91735000,2584140,94319140,False
4851,validator_32,43523776760,True,208026000,2597140,210623140,False
4852,validator_39,43482882530,True,135738000,1715730,137453730,False
4853,validator_49,75909329360,True,137919000,556980,138475980,False
4854,validator_25,41117293150,True,66480000,8581600,75061600,False
4855,validator_16,42603718595,True,156289004,698140,156987144,True
4856,validator_19,78296877576,True,123616000,1053620,124669620,True
4857,validator_34,270868543310,True,114639000,604200,115243200,False
4858,validator_2,47003470454,True,161772995,4843140,166616135,True
4859,validator_45,41852882320,True,164407000,380140,164787140,False
4860,validator_4,43765134769,True,52635999,1501300,54137299,True
4861,validator_7,80140010578,True,134802996,3190190,137993186,True
4862,validator_42,42805341040,True,78968000,5416100,84384100,False
4863,validator_19,78422262079,True,124483003,901500,125384503,True
4864,validator_11,44677882831,True,77384000,1448600,78832600,True
4865,validator_14,113041831319,True,125683002,830920,126513922,True
4866,validator_40,44220098460,True,71402000,305310,71707310,False
4867,validator_40,44363235960,True,141259000,1878500,143137500,False
4868,validator_12,110406606390,True,128215999,306100,128522099,True
4869,validator_2,47125760993,True,113055999,9234540,122290539,True
4870,validator_46,106510784620,True,113244000,11517840,124761840,False
4871,validator_14,113311193863,True,267910004,1452540,269362544,True
4872,validator_36,107667635210,True,59815000,55900,59870900,False
4873,validator_5,77863317993,True,126577003,295800,126872803,True
4874,validator_48,173064539630,True,87902000,206600,88108600,False
4875,validator_1,78406430384,True,200745001,5672380,206417381,True
4876,validator_36,107769398290,True,96120000,5643080,101763080,False
4877,validator_34,270920926410,True,50376000,2007100,52383100,False
4878,validator_14,113372469261,True,60674998,600400,61275398,True
4879,validator_36,107803973480,True,32565000,2010190,34575190,False
4880,validator_22,77345334261,True,85665000,7793850,93458850,True
4881,validator_6,44427151504,True,233388992,2833930,236222922,True
4882,validator_16,42748375995,True,144114000,543400,144657400,True
4883,validator_37,74072814180,True,59178000,18591130,77769130,False
4884,validator_20,43130870393,True,207571999,5574100,213146099,True
4885,validator_26,44582534310,True,133341000,457810,133798810,False
4886,validator_17,179537040455,True,125520999,841720,126362719,True
4887,validator_42,42913130270,True,106528000,1261230,107789230,False
4888,validator_8,45892173181,True,80493001,1412300,81905301,True
4889,validator_9,44270821951,True,70153003,18003640,88156643,True
4890,validator_15,280499362817,True,113548002,10402780,123950782,True
4891,validator_42,42962340370,True,47784000,1426100,49210100,False
4892,validator_30,75558476940,True,95016000,540080,95556080,False
4893,validator_46,106640021720,True,128107000,1130100,129237100,False
4894,validator_5,77989163970,True,125041997,803980,125845977,True
4895,validator_27,108722789550,True,108353000,4405200,112758200,False
4896,validator_49,76025035850,True,114547000,1159490,115706490,False
4897,validator_41,77064159200,True,209429000,5183420,214612420,False
4898,validator_41,77225079300,True,142205000,18715100,160920100,False
4899,validator_6,44536764543,True,107733999,1879040,109613039,True
4900,validator_8,45958982080,True,61452999,5355900,66808899,True
4901,validator_48,173164381310,True,91038000,8803680,99841680,False
4902,validator_22,77536012161,True,189880000,797900,190677900,True
4903,validator_17,179637468893,True,99075008,1353430,100428438,True
4904,validator_16,42912871394,True,163127999,1367400,164495399,True
4905,validator_31,175097500980,True,127869000,7627600,135496600,False
4906,validator_47,75053474640,True,48132000,8062130,56194130,False
4907,validator_36,107858345920,True,46205000,8167440,54372440,False
4908,validator_47,75113638540,True,52496000,7667900,60163900,False
4909,validator_36,107958495930,True,94369000,5781010,100150010,False
4910,validator_32,43686622060,True,160411000,2434300,162845300,False
4911,validator_19,78519670608,True,96686999,721530,97408529,True
4912,validator_43,75148761720,True,257902000,8324200,266226200,False
4913,validator_13,42893585367,True,114055991,20133840,134189831,True
4914,validator_3,47567054471,True,166286999,1157740,167444739,True
4915,validator_2,47328001424,True,201396001,844430,202240431,True
4916,validator_4,43841935363,True,74779004,2021590,76800594,True
4917,validator_8,46002571410,True,41746000,1843330,43589330,True
4918,validator_34,271091717710,True,169762000,1029300,170791300,False
4919,validator_34,271193938790,True,58741000,43480080,102221080,False
4920,validator_14,113467579902,True,94778001,332640,95110641,True
4921,validator_39,43516191760,True,33182000,127230,33309230,False
4922,validator_49,76131927250,True,104125000,2766400,106891400,False
4923,validator_21,76585069307,True,101153997,1274600,102428597,True
4924,validator_34,271325503580,True,130105000,1459790,131564790,False
4925,validator_16,43206619627,True,292244003,1504230,293748233,True
4926,validator_4,44144170461,True,286696998,15538100,302235098,True
4927,validator_47,75197955260,True,82584000,1732720,84316720,False
4928,validator_10,44329871315,True,122094003,2677070,124771073,True
4929,validator_4,44233550661,True,86614000,2766200,89380200,True
4930,validator_10,44507124084,True,168066999,9185770,177252769,True
4931,validator_37,74292901210,True,218593000,1494030,220087030,False
4932,validator_16,43397913023,True,185909996,5383400,191293396,True
4933,validator_5,78191697668,True,193610998,8922700,202533698,True
4934,validator_14,113589032386,True,119054004,2398480,121452484,True
4935,validator_33,41087831030,True,139326000,1723900,141049900,False
4936,validator_33,41217310820,True,128039000,1440790,129479790,False
4937,validator_29,41022203090,True,92970000,18682290,111652290,False
4938,validator_49,76197334930,True,64904000,503680,65407680,False
4939,validator_2,47585539586,True,255663002,1875160,257538162,True
4940,validator_0,45031569743,True,233900001,780490,234680491,True
4941,validator_23,45915746842,True,70629998,19510220,90140218,True
4942,validator_39,43674606140,True,139625000,18789380,158414380,False
4943,validator_26,44710090510,True,109455000,18101200,127556200,False
4944,validator_12,110515808342,True,107538002,1663950,109201952,True
4945,validator_25,41228508250,True,110093000,1122100,111215100,False
4946,validator_22,77739569958,True,201622997,1934800,203557797,True
4947,validator_9,44433194920,True,142397999,19974970,162372969,True
4948,validator_28,41891441500,True,105958000,700520,106658520,False
4949,validator_37,74339443950,True,43695000,2847740,46542740,False
4950,validator_27,108836945950,True,112393000,1763400,114156400,False
4951,validator_34,271474633980,True,148782000,348400,149130400,False
4952,validator_18,111477760906,True,220889002,471800,221360802,True
4953,validator_10,44698710773,True,190177999,1408690,191586689,True
4954,validator_14,113731211207,True,133531001,8647820,142178821,True
4955,validator_37,74460540390,True,119649000,1447440,121096440,False
4956,validator_34,271617754480,True,117545000,25575500,143120500,False
4957,validator_23,46004546682,True,88353000,446840,88799840,True
4958,validator_30,75635811240,True,76289000,1045300,77334300,False
4959,validator_44,109225242620,True,102041000,311430,102352430,False
4960,validator_15,280607130414,True,106562997,1204600,107767597,True
4961,validator_38,42793522160,True,129821000,2685100,132506100,False
4962,validator_35,109226757900,True,108548000,1244800,109792800,False
4963,validator_41,77254321430,True,28884000,358130,29242130,False
4964,validator_36,108123225830,True,158616000,6113900,164729900,False
4965,validator_37,74575147390,True,113844000,763000,114607000,False
4966,validator_6,44660413841,True,121807998,1841300,123649298,True
4967,validator_30,75722599820,True,85145000,1643580,86788580,False
4968,validator_4,44353668989,True,118501998,1616330,120118328,True
4969,validator_8,46150929589,True,146540999,1817180,148358179,True
4970,validator_10,44798999772,True,98600999,1688000,100288999,True
4971,validator_44,109447741040,True,221530000,968420,222498420,False
4972,validator_15,280651713898,True,43837004,746480,44583484,True
4973,validator_0,45176098340,True,143424997,1103600,144528597,True
4974,validator_39,43772574020,True,95829000,2138880,97967880,False
4975,validator_36,108309402530,True,183863000,2313700,186176700,False
4976,validator_14,113828582612,True,96497005,874400,97371405,True
4977,validator_43,75282068410,True,131771000,1535690,133306690,False
4978,validator_48,173301610040,True,130500000,6728730,137228730,False
4979,validator_14,113916219013,True,85900001,1736400,87636401,True
4980,validator_5,78350249371,True,149269003,9282700,158551703,True
4981,validator_37,74685855350,True,109101000,1606960,110707960,False
4982,validator_36,108467754060,True,155229000,3122530,158351530,False
4983,validator_5,78565122973,True,196528002,18345600,214873602,True
4984,validator_25,41278357550,True,48838000,1011300,49849300,False
4985,validator_37,74749799080,True,61713000,2230730,63943730,False
4986,validator_1,78515407680,True,108760996,216300,108977296,True
4987,validator_24,42606054893,True,140141012,25232400,165373412,True
4988,validator_3,47751386074,True,183095003,1236600,184331603,True
4989,validator_49,76338640790,True,139151000,2154860,141305860,False
4990,validator_39,43967654930,True,193350000,1730910,195080910,False
4991,validator_16,43511987326,True,111415003,2659300,114074303,True
4992,validator_15,280770178701,True,117855003,609800,118464803,True
4993,validator_45,42009240820,True,155641000,717500,156358500,False
4994,validator_41,77346002910,True,90165000,1516480,91681480,False
4995,validator_31,175261816910,True,145647000,18668930,164315930,False
4996,validator_49,76437295120,True,91034000,7620330,98654330,False
4997,validator_35,109303838330,True,76145000,935430,77080430,False
4998,validator_0,45405275020,True,228221000,955680,229176680,True
4999,validator_0,45586747458,True,181304998,167440,181472438,True
5000,validator_47,75388026740,True,189703000,368480,190071480,False
5001,validator_0,45790689595,True,203267997,674140,203942137,True
5002,validator_8,46247281721,True,87103002,9249130,96352132,True
5003,validator_27,108962643280,True,124826000,871330,125697330,False
5004,validator_27,109115515160,True,152407000,464880,152871880,False
5005,validator_28,41949080170,True,56177000,1461670,57638670,False
5006,validator_29,41187545630,True,164302000,1040540,165342540,False
5007,validator_39,44076808730,True,90987000,18166800,109153800,False
5008,validator_32,43787200840,True,100025000,553780,100578780,False
5009,validator_42,43159208950,True,195172000,1696580,196868580,False
5010,validator_10,44897869168,True,97837996,1031400,98869396,True
5011,validator_5,78715630373,True,149411000,1096400,150507400,True
5012,validator_30,75803788120,True,78812000,2376300,81188300,False
5013,validator_30,75972388220,True,160017000,8583100,168600100,False
5014,validator_23,46104700414,True,92782002,7371730,100153732,True
5015,validator_8,46340118653,True,74415002,18421930,92836932,True
5016,validator_40,44486630550,True,121698000,1696590,123394590,False
5017,validator_21,76667024885,True,63888998,18066580,81955578,True
5018,validator_9,44669422162,True,230382002,5845240,236227242,True
5019,validator_34,271730762940,True,105076000,7932460,113008460,False
5020,validator_39,44242861330,True,165057000,995600,166052600,False
5021,validator_18,111623628905,True,144843999,1024000,145867999,True
5022,validator_1,78722834679,True,207115999,311000,207426999,True
5023,validator_46,106765775160,True,120214000,5539440,125753440,False
5024,validator_5,78931911449,True,211848006,4433070,216281076,True
5025,validator_11,44781685323,True,102530992,1271500,103802492,True
5026,validator_5,79090640594,True,156646005,2083140,158729145,True
5027,validator_18,111718116200,True,92270995,2216300,94487295,True
5028,validator_0,45889384695,True,96978000,1717100,98695100,True
5029,validator_22,77863279925,True,121007997,2701970,123709967,True
5030,validator_48,173398588040,True,96655000,323000,96978000,False
5031,validator_19,78686075709,True,146773001,19632100,166405101,True
5032,validator_5,79138469492,True,46852998,975900,47828898,True
5033,validator_37,74896839040,True,137304000,9735960,147039960,False
5034,validator_43,75401928710,True,119127000,733300,119860300,False
5035,validator_45,42174756110,True,164932000,583290,165515290,False
5036,validator_11,44856646874,True,74313001,648550,74961551,True
5037,validator_17,179780252992,True,141323999,1460100,142784099,True
5038,validator_14,114070539194,True,152663001,1657180,154320181,True
5039,validator_10,45203137566,True,305039998,228400,305268398,True
5040,validator_15,280877220324,True,106095993,945630,107041623,True
5041,validator_19,78778251383,True,90603004,1572670,92175674,True
5042,validator_44,109518949840,True,68513000,2695800,71208800,False
5043,validator_19,78892046242,True,111221999,2572860,113794859,True
5044,validator_26,44843917820,True,132813000,1014310,133827310,False
5045,validator_11,44979530874,True,120759000,2125000,122884000,True
5046,validator_12,110716002462,True,198960000,1234120,200194120,True
5047,validator_29,41319490320,True,124122000,7822690,131944690,False
5048,validator_0,45992521193,True,94706998,8429500,103136498,True
5049,validator_17,179845564298,True,63322006,1989300,65311306,True
5050,validator_3,47893882674,True,140182000,2314600,142496600,True
5051,validator_6,44787481721,True,125778000,1289880,127067880,True
5052,validator_21,76727822386,True,59852001,945500,60797501,True
5053,validator_6,44907778621,True,114080000,6216900,120296900,True
5054,validator_45,42279258510,True,101590000,2912400,104502400,False
5055,validator_4,44627577531,True,269096002,4812540,273908542,True
5056,validator_44,109630520340,True,110628000,942500,111570500,False
5057,validator_3,48019571904,True,124341000,1348230,125689230,True
5058,validator_23,46206576414,True,100018000,1858000,101876000,True
5059,validator_21,76967880690,True,216930004,23128300,240058304,True
5060,validator_49,76643504620,True,169069000,37140500,206209500,False
5061,validator_30,76011577740,True,36949000,2240520,39189520,False
5062,validator_24,42752310595,True,145818002,437700,146255702,True
5063,validator_18,111803854697,True,77286997,8451500,85738497,True
5064,validator_11,45197456975,True,212477001,5449100,217926101,True
5065,validator_6,45012899918,True,103885997,1235300,105121297,True
5066,validator_15,280963194021,True,85216997,756700,85973697,True
5067,validator_48,173533320910,True,134432000,300870,134732870,False
5068,validator_5,79314736992,True,175623000,644500,176267500,True
5069,validator_28,42062315770,True,112894000,341600,113235600,False
5070,validator_1,78900897966,True,177564997,498290,178063287,True
5071,validator_48,173695251510,True,159350000,2580600,161930600,False
5072,validator_39,44490940870,True,246971000,1108540,248079540,False
5073,validator_4,44757352826,True,128970995,804300,129775295,True
5074,validator_34,271951678040,True,220115000,800100,220915100,False
5075,validator_23,46418344031,True,191994997,19772620,211767617,True
5076,validator_47,75578914940,True,170153000,20735200,190888200,False
5077,validator_4,44911811077,True,153795001,663250,154458251,True
5078,validator_16,43685690030,True,167226004,6476700,173702704,True
5079,validator_10,45488557505,True,283322999,2096940,285419939,True
5080,validator_36,108614241800,True,145150000,1337740,146487740,False
5081,validator_29,41433584960,True,113150000,944640,114094640,False
5082,validator_11,45296341377,True,98200002,684400,98884402,True
5083,validator_18,111970961790,True,161716993,5390100,167107093,True
5084,validator_2,47702236387,True,116050001,646800,116696801,True
5085,validator_31,175353258410,True,89972000,1469500,91441500,False
5086,validator_3,48126996806,True,105509002,1915900,107424902,True
5087,validator_0,46106875817,True,113682994,671630,114354624,True
5088,validator_17,179919192572,True,72443994,1184280,73628274,True
5089,validator_41,77443904410,True,95873000,2028500,97901500,False
5090,validator_9,44935555363,True,265877001,256200,266133201,True
5091,validator_27,109204218060,True,87820000,882900,88702900,False
5092,validator_27,109275207260,True,70078000,911200,70989200,False
5093,validator_11,45406525472,True,107682995,2501100,110184095,True
5094,validator_1,79075429593,True,173901997,629630,174531627,True
5095,validator_27,109379024860,True,103247000,570600,103817600,False
5096,validator_22,77991506295,True,126565000,1661370,128226370,True
5097,validator_35,109382178330,True,77862000,478000,78340000,False
5098,validator_27,109491195880,True,111595000,576020,112171020,False
5099,validator_19,78952822938,True,60283996,492700,60776696,True
5100,validator_11,45562452603,True,155182001,745130,155927131,True
5101,validator_25,41430562390,True,149859000,2345840,152204840,False
5102,validator_10,45626629111,True,136472006,1599600,138071606,True
5103,validator_6,45062924122,True,48687004,1337200,50024204,True
5104,validator_29,41619972660,True,178217000,8170700,186387700,False
5105,validator_32,43876230980,True,83448000,5582140,89030140,False
5106,validator_1,79178131692,True,100743999,1958100,102702099,True
5107,validator_6,45186755150,True,122333998,1497030,123831028,True
5108,validator_9,45206061181,True,269605998,899820,270505818,True
5109,validator_17,180053319242,True,129281000,4845670,134126670,True
5110,validator_18,112012846590,True,41836000,48800,41884800,True
5111,validator_19,79088978946,True,135102998,1053010,136156008,True
5112,validator_25,41568394080,True,119630000,18201690,137831690,False
5113,validator_15,281049786850,True,78626999,7965830,86592829,True
5114,validator_30,76214879370,True,190749000,12552630,203301630,False
5115,validator_47,75657952770,True,74108000,4929830,79037830,False
5116,validator_34,272106729020,True,153038000,2012980,155050980,False
5117,validator_30,76328185440,True,111817000,1489070,113306070,False
5118,validator_13,43132426466,True,230757999,8083100,238841099,True
5119,validator_36,108686711320,True,72066000,403520,72469520,False
5120,validator_5,79444564857,True,124948995,4878870,129827865,True
5121,validator_27,109578077570,True,85005000,1876690,86881690,False
5122,validator_14,114231137595,True,159772001,826400,160598401,True
5123,validator_42,43279163630,True,119016000,938680,119954680,False
5124,validator_19,79203867494,True,112497998,2390550,114888548,True
5125,validator_30,76461970640,True,133117000,668200,133785200,False
5126,validator_3,48262226908,True,135132002,98100,135230102,True
5127,validator_43,75522424310,True,118523000,1972600,120495600,False
5128,validator_26,44892081200,True,42503000,5660380,48163380,False
5129,validator_33,41362008820,True,139423000,5275000,144698000,False
5130,validator_47,75765081870,True,106889000,240100,107129100,False
5131,validator_13,43266943399,True,132991993,1524940,134516933,True
5132,validator_16,43878442274,True,174406004,18346240,192752244,True
5133,validator_12,110863755848,True,145441996,2311390,147753386,True
5134,validator_35,109499510330,True,115959000,1373000,117332000,False
5135,validator_34,272159318310,True,51985000,604290,52589290,False
5136,validator_7,80364216629,True,221445001,2761050,224206051,True
5137,validator_27,109694841370,True,115172000,1591800,116763800,False
5138,validator_26,45136094420,True,225261000,18752220,244013220,False
5139,validator_27,109798528270,True,85605000,18081900,103686900,False
5140,validator_6,45352605223,True,163952003,1898070,165850073,True
5141,validator_2,47827923187,True,124888000,798800,125686800,True
5142,validator_6,45436564840,True,81348997,2610620,83959617,True
5143,validator_34,272255931110,True,96296000,316800,96612800,False
5144,validator_37,75001154640,True,103161000,1154600,104315600,False
5145,validator_15,281099567172,True,48993002,787320,49780322,True
5146,validator_0,46262856375,True,155525998,454560,155980558,True
5147,validator_27,109909888170,True,110311000,1048900,111359900,False
5148,validator_19,79342933128,True,120019004,19046630,139065634,True
5149,validator_40,44528003850,True,40888000,485300,41373300,False
5150,validator_20,43247413595,True,115479002,1064200,116543202,True
5151,validator_19,79455176212,True,80991994,31251090,112243084,True
5152,validator_44,109747537790,True,115455000,1562450,117017450,False
5153,validator_25,41676998980,True,107437000,1167900,108604900,False
5154,validator_45,42416420410,True,136561000,600900,137161900,False
5155,validator_30,76510000510,True,46047000,1982870,48029870,False
5156,validator_16,44070310804,True,190584000,1284530,191868530,True
5157,validator_46,106854062360,True,87186000,1101200,88287200,False
5158,validator_17,180193942646,True,140091004,532400,140623404,True
5159,validator_39,44646869340,True,154260000,1668470,155928470,False
5160,validator_29,41707028790,True,85126000,1930130,87056130,False
5161,validator_24,42926436066,True,172416001,1709470,174125471,True
5162,validator_13,43478781826,True,211101007,737420,211838427,True
5163,validator_27,109999854310,True,88406000,1560140,89966140,False
5164,validator_15,281182148132,True,81765000,815960,82580960,True
5165,validator_37,75159861840,True,153151000,5556200,158707200,False
5166,validator_5,79533221659,True,88246002,410800,88656802,True
5167,validator_26,45294128260,True,157093000,940840,158033840,False
5168,validator_17,180245549646,True,51426000,181000,51607000,True
5169,validator_23,46593285230,True,168371999,6569200,174941199,True
5170,validator_23,46704780230,True,109335000,2160000,111495000,True
5171,validator_16,44325745742,True,249376998,6057940,255434938,True
5172,validator_46,107017083960,True,160348000,2673600,163021600,False
5173,validator_14,114446652295,True,214622000,892700,215514700,True
5174,validator_35,109562430930,True,61387000,1533600,62920600,False
5175,validator_3,48348690308,True,86293000,170400,86463400,True
5176,validator_49,76684824110,True,39661000,1658490,41319490,False
5177,validator_35,109671518470,True,90726000,18361540,109087540,False
5178,validator_45,42543989450,True,120880000,6689040,127569040,False
5179,validator_16,44436471862,True,109196000,1530120,110726120,True
5180,validator_46,107160028260,True,134956000,7988300,142944300,False
5181,validator_49,76816691400,True,129765000,2102290,131867290,False
5182,validator_43,75645778070,True,122784000,569760,123353760,False
5183,validator_13,43695506326,True,214896000,1828500,216724500,True
5184,validator_46,107242695200,True,81432000,1234940,82666940,False
5185,validator_7,80540130232,True,171237003,4676600,175913603,True
5186,validator_6,45584359376,True,146501006,1293530,147794536,True
5187,validator_44,109958211290,True,204860000,5813500,210673500,False
5188,validator_27,110081497620,True,80867000,776310,81643310,False
5189,validator_45,42635991550,True,86383000,5619100,92002100,False
5190,validator_9,45328179716,True,120440005,1678530,122118535,True
5191,validator_27,110132308720,True,49597000,1214100,50811100,False
5192,validator_48,173796199610,True,100214000,734100,100948100,False
5193,validator_0,46304735155,True,41620000,258780,41878780,True
5194,validator_19,79547816314,True,91163002,1477100,92640102,True
5195,validator_14,114550400397,True,97881002,5867100,103748102,True
5196,validator_7,80724576530,True,166055998,18390300,184446298,True
5197,validator_13,43781939736,True,84187000,2246410,86433410,True
5198,validator_0,46485607657,True,179549002,1323500,180872502,True
5199,validator_6,45664967176,True,79877000,730800,80607800,True
5200,validator_16,44547337335,True,92252003,18613470,110865473,True
5201,validator_1,79233423688,True,54419996,872000,55291996,True
5202,validator_6,45764292448,True,98825002,500270,99325272,True
5203,validator_41,77621140730,True,150871000,26365320,177236320,False
5204,validator_20,43451304992,True,203264997,626400,203891397,True
5205,validator_17,180343264149,True,95966003,1748500,97714503,True
5206,validator_4,45150470075,True,237087998,1571000,238658998,True
5207,validator_29,41830153670,True,119940000,3184880,123124880,False
5208,validator_25,41806845120,True,117475000,12371140,129846140,False
5209,validator_3,48477183652,True,127841004,652340,128493344,True
5210,validator_24,43026899109,True,99356003,1107040,100463043,True
5211,validator_20,43605870891,True,153170999,1394900,154565899,True
5212,validator_34,272339552110,True,83063000,558000,83621000,False
5213,validator_2,47928018786,True,80833999,19261600,100095599,True
5214,validator_18,112058320986,True,43283996,2190400,45474396,True
5215,validator_45,42743827950,True,106150000,1686400,107836400,False
5216,validator_8,46475749854,True,134560001,1071200,135631201,True
5217,validator_34,272435560440,True,94690000,1318330,96008330,False
5218,validator_47,75825647470,True,54905000,5660600,60565600,False
5219,validator_36,108901525090,True,213442000,1371770,214813770,False
5220,validator_12,111040871045,True,176424997,690200,177115197,True
5221,validator_16,44821548542,True,272395007,1816200,274211207,True
5222,validator_30,76623916410,True,103085000,10830900,113915900,False
5223,validator_19,79638909044,True,90467000,625730,91092730,True
5224,validator_13,43902253673,True,119528007,785930,120313937,True
5225,validator_19,79875540139,True,231227995,5403100,236631095,True
5226,validator_13,44096556473,True,192729000,1573800,194302800,True
5227,validator_4,45284118212,True,125797997,7850140,133648137,True
5228,validator_18,112246684966,True,186354000,2009980,188363980,True
5229,validator_39,44756223110,True,103276000,6077770,109353770,False
5230,validator_35,109909880400,True,199634000,38727930,238361930,False
5231,validator_46,107345695000,True,95750000,7249800,102999800,False
5232,validator_34,272554721840,True,117365000,1796400,119161400,False
5233,validator_27,110199561920,True,65749000,1504200,67253200,False
5234,validator_33,41508209470,True,127241000,18959650,146200650,False
5235,validator_14,114670074676,True,118953999,720280,119674279,True
5236,validator_34,272632817280,True,77571000,524440,78095440,False
5237,validator_17,180554978347,True,206775998,4938200,211714198,True
5238,validator_21,77032597718,True,64199998,517030,64717028,True
5239,validator_5,79582504897,True,47855998,1427240,49283238,True
5240,validator_46,107482178820,True,131772000,4711820,136483820,False
5241,validator_42,43350947330,True,70662000,1121700,71783700,False
5242,validator_4,45394877311,True,103229999,7529100,110759099,True
5243,validator_24,43235690811,True,203460002,5331700,208791702,True
5244,validator_22,78103075967,True,109400002,2169670,111569672,True
5245,validator_26,45420854400,True,120853000,5873140,126726140,False
5246,validator_24,43315465116,True,79170005,604300,79774305,True
5247,validator_17,180648574445,True,92811998,784100,93596098,True
5248,validator_6,45947824379,True,165058001,18473930,183531931,True
5249,validator_37,75219133080,True,58510000,761240,59271240,False
5250,validator_11,45635705357,True,70665004,2587750,73252754,True
5251,validator_23,46820144432,True,113810002,1554200,115364202,True
5252,validator_36,108999541590,True,97245000,771500,98016500,False
5253,validator_34,272863780470,True,229976000,987190,230963190,False
5254,validator_7,80841251334,True,116234004,440800,116674804,True
5255,validator_11,45750176670,True,113536003,935310,114471313,True
5256,validator_2,48056490016,True,127835000,636230,128471230,True
5257,validator_41,77731605630,True,92163000,18301900,110464900,False
5258,validator_8,46589446399,True,111813005,1883540,113696545,True
5259,validator_28,42141301870,True,78105000,881100,78986100,False
5260,validator_17,180758458862,True,108692997,1191420,109884417,True
5261,validator_21,77235649220,True,200455002,2596500,203051502,True
5262,validator_29,41963786080,True,114962000,18670410,133632410,False
5263,validator_29,42146838680,True,181720000,1332600,183052600,False
5264,validator_18,112312254453,True,64588007,981480,65569487,True
5265,validator_19,79962150639,True,86121000,489500,86610500,True
5266,validator_41,77799021670,True,65424000,1992040,67416040,False
5267,validator_48,173963715410,True,166677000,838800,167515800,False
5268,validator_15,281262029131,True,76882999,2998000,79880999,True
5269,validator_37,75261982170,True,40061000,2788090,42849090,False
5270,validator_41,77958333870,True,158389000,923200,159312200,False
5271,validator_40,44669556050,True,141279000,273200,141552200,False
5272,validator_47,75952703570,True,108143000,18913100,127056100,False
5273,validator_31,175479725400,True,124839000,1627990,126466990,False
5274,validator_6,46066491859,True,118459000,208480,118667480,True
5275,validator_43,75696948570,True,50144000,1026500,51170500,False
5276,validator_45,42819872050,True,73906000,2138100,76044100,False
5277,validator_5,79656049212,True,72729995,814320,73544315,True
5278,validator_34,272977216010,True,112807000,628540,113435540,False
5279,validator_19,80065723939,True,102990000,583300,103573300,True
5280,validator_18,112401942954,True,87408001,2280500,89688501,True
5281,validator_48,174036040850,True,53939000,18386440,72325440,False
5282,validator_44,110065838200,True,103761000,3865910,107626910,False
5283,validator_23,46965742430,True,143265998,2332000,145597998,True
5284,validator_37,75436710050,True,171485000,3242880,174727880,False
5285,validator_8,46698697502,True,108706003,545100,109251103,True
5286,validator_47,76036171370,True,81563000,1904800,83467800,False
5287,validator_34,273063312750,True,84894000,1202740,86096740,False
5288,validator_45,42949170050,True,128544000,754000,129298000,False
5289,validator_18,112473852253,True,70623999,1285300,71909299,True
5290,validator_2,48245605315,True,186865999,2249300,189115299,True
5291,validator_17,180943120890,True,182521998,2140030,184662028,True
5292,validator_43,75845041270,True,140038000,8054700,148092700,False
5293,validator_1,79293946469,True,60053001,469780,60522781,True
5294,validator_48,174143079430,True,106269000,769580,107038580,False
5295,validator_35,110109974200,True,198542000,1551800,200093800,False
5296,validator_19,80180070237,True,113800998,545300,114346298,True
5297,validator_30,76704147190,True,78621000,1609780,80230780,False
5298,validator_6,46195061562,True,127545003,1024700,128569703,True
5299,validator_47,76189125670,True,151047000,1907300,152954300,False
5300,validator_33,41622360630,True,112124000,2027160,114151160,False
5301,validator_29,42341602690,True,186269000,8495010,194764010,False
5302,validator_20,43727377691,True,114982000,6524800,121506800,True
5303,validator_15,281394438432,True,130785001,1624300,132409301,True
5304,validator_0,46595146956,True,89360999,20178300,109539299,True
5305,validator_24,43422500915,True,105006999,2028800,107035799,True
5306,validator_7,80941119439,True,76026005,23842100,99868105,True
5307,validator_26,45473268200,True,50172000,2241800,52413800,False
5308,validator_6,46417380587,True,221070995,1248030,222319025,True
5309,validator_37,75610487750,True,173471000,306700,173777700,False
5310,validator_9,45547351249,True,194680003,24491530,219171533,True
5311,validator_47,76277625970,True,87941000,559300,88500300,False
5312,validator_9,45622607053,True,69712004,5543800,75255804,True
5313,validator_36,109048913390,True,48956000,415800,49371800,False
5314,validator_20,43861390917,True,132459996,1553230,134013226,True
5315,validator_8,46753111922,True,46210000,8204420,54414420,True
5316,validator_9,45790867275,True,159409002,8851220,168260222,True
5317,validator_12,111168543672,True,125066997,2605630,127672627,True
5318,validator_39,44957585540,True,200347000,1015430,201362430,False
5319,validator_4,45542201618,True,145830007,1494300,147324307,True
5320,validator_28,42265548670,True,121754000,2492800,124246800,False
5321,validator_42,43441241530,True,89405000,889200,90294200,False
5322,validator_45,43040506850,True,84033000,7303800,91336800,False
5323,validator_19,80389988832,True,208999995,918600,209918595,True
5324,validator_10,45719540510,True,92476999,434400,92911399,True
5325,validator_38,42944459810,True,149649000,1288650,150937650,False
5326,validator_24,43604129811,True,179173996,2454900,181628896,True
5327,validator_20,44031454078,True,151091001,18972160,170063161,True
5328,validator_32,43990702380,True,114160000,311400,114471400,False
5329,validator_39,45043393390,True,85576000,231850,85807850,False
5330,validator_11,45853190269,True,101213999,1799600,103013599,True
5331,validator_15,281491146737,True,96173005,535300,96708305,True
5332,validator_14,114825497414,True,148865998,6556740,155422738,True
5333,validator_16,44876254643,True,53763001,943100,54706101,True
5334,validator_33,41746326730,True,123196000,770100,123966100,False
5335,validator_48,174205658630,True,62090000,489200,62579200,False
5336,validator_21,77401379638,True,150566998,15163420,165730418,True
5337,validator_36,109120914760,True,70316000,1685370,72001370,False
5338,validator_25,42032297120,True,196871000,28581000,225452000,False
5339,validator_15,281657646506,True,165714999,784770,166499769,True
5340,validator_34,273330296750,True,266551000,433000,266984000,False
5341,validator_34,273489846190,True,157914000,1635440,159549440,False
5342,validator_46,107581301420,True,96309000,2813600,99122600,False
5343,validator_32,44116039380,True,121929000,3408000,125337000,False
5344,validator_45,43157923680,True,107210000,10206830,117416830,False
5345,validator_42,43505275430,True,63390000,643900,64033900,False
5346,validator_1,79418702301,True,116387002,8368830,124755832,True
5347,validator_36,109270005160,True,147980000,1110400,149090400,False
5348,validator_24,43683804313,True,77368002,2306500,79674502,True
5349,validator_0,46685677958,True,89441002,1090000,90531002,True
5350,validator_21,77492056939,True,89573001,1104300,90677301,True
5351,validator_22,78169601465,True,65092998,1432500,66525498,True
5352,validator_17,181044246534,True,100167004,958640,101125644,True
5353,validator_26,45666041530,True,191507000,1266330,192773330,False
5354,validator_19,80533710581,True,135431999,8289750,143721749,True
5355,validator_34,273720675030,True,230168000,660840,230828840,False
5356,validator_30,76847049880,True,140997000,1905690,142902690,False
5357,validator_46,107669003820,True,86455000,1247400,87702400,False
5358,validator_14,114900649989,True,73391005,1761570,75152575,True
5359,validator_2,48449733004,True,203258999,868690,204127689,True
5360,validator_24,43984787651,True,298192998,2790340,300983338,True
5361,validator_28,42341959550,True,75631000,779880,76410880,False
5362,validator_15,281809536223,True,151394997,494720,151889717,True
5363,validator_11,46030977683,True,169718004,8069410,177787414,True
5364,validator_46,107738291020,True,61622000,7665200,69287200,False
5365,validator_24,44078550852,True,92350001,1413200,93763201,True
5366,validator_36,109333161050,True,62763000,392890,63155890,False
5367,validator_48,174322840170,True,98627000,18554540,117181540,False
5368,validator_39,45118490110,True,73619000,1477720,75096720,False
5369,validator_36,109509765780,True,175293000,1311730,176604730,False
5370,validator_43,75995729770,True,142680000,8008500,150688500,False
5371,validator_25,42099140520,True,65313000,1530400,66843400,False
5372,validator_37,75793776680,True,176962000,6326930,183288930,False
5373,validator_41,78027636470,True,68456000,846600,69302600,False
5374,validator_33,41834885730,True,70262000,18297000,88559000,False
5375,validator_15,281979408014,True,166692001,3179790,169871791,True
5376,validator_37,75911644320,True,117353000,514640,117867640,False
5377,validator_18,112756088456,True,281022003,1214200,282236203,True
5378,validator_29,42417164890,True,59961000,15601200,75562200,False
5379,validator_25,42262741060,True,144810000,18790540,163600540,False
5380,validator_8,47035170813,True,278412001,3646890,282058891,True
5381,validator_3,48665769670,True,185361998,3224020,188586018,True
5382,validator_32,44209558570,True,91572000,1947190,93519190,False
5383,validator_40,44825360950,True,152756000,3048900,155804900,False
5384,validator_3,48757253171,True,90383001,1100500,91483501,True
5385,validator_2,48711642880,True,252734006,9175870,261909876,True
5386,validator_46,107845365950,True,105752000,1322930,107074930,False
5387,validator_15,282162009609,True,156009995,26591600,182601595,True
5388,validator_17,181143360631,True,98004997,1109100,99114097,True
5389,validator_46,107981539850,True,134557000,1616900,136173900,False
5390,validator_36,109560143680,True,50024000,353900,50377900,False
5391,validator_18,112924780557,True,168023001,669100,168692101,True
5392,validator_17,181481025077,True,336659006,1005440,337664446,True
5393,validator_7,81076752040,True,135289001,343600,135632601,True
5394,validator_44,110224314430,True,156349000,2127230,158476230,False
5395,validator_48,174382674610,True,57447000,2387440,59834440,False
5396,validator_17,181624216277,True,142021000,1170200,143191200,True
5397,validator_24,44177418147,True,97990995,876300,98867295,True
5398,validator_49,76978566400,True,155713000,6162000,161875000,False
5399,validator_38,43043972430,True,95953000,3559620,99512620,False
5400,validator_1,79574165238,True,155218997,243940,155462937,True
5401,validator_19,80638646518,True,98677997,6257940,104935937,True
5402,validator_17,181794036217,True,167586000,2233940,169819940,True
5403,validator_21,77551993714,True,59689995,246780,59936775,True
5404,validator_33,41895806340,True,58517000,2403610,60920610,False
5405,validator_19,80801306318,True,161852000,807800,162659800,True
5406,validator_26,45816596750,True,149885000,670220,150555220,False
5407,validator_37,75971123780,True,58648000,831460,59479460,False
5408,validator_49,77028984290,True,49490000,927890,50417890,False
5409,validator_15,282324977151,True,161883002,1084540,162967542,True
5410,validator_19,80987838323,True,186300005,232000,186532005,True
5411,validator_8,47276162254,True,238946001,2045440,240991441,True
5412,validator_32,44348537970,True,137765000,1214400,138979400,False
5413,validator_10,45853548912,True,110835002,23173400,134008402,True
5414,validator_36,109618257980,True,56753000,1361300,58114300,False
5415,validator_48,174534614940,True,150759000,1181330,151940330,False
5416,validator_36,109708944730,True,89080000,1606750,90686750,False
5417,validator_22,78370654297,True,199662002,1390830,201052832,True
5418,validator_31,175586914220,True,100613000,6575820,107188820,False
5419,validator_40,45017299550,True,190697000,1241600,191938600,False
5420,validator_10,46054069511,True,169463999,31056600,200520599,True
5421,validator_4,45614106921,True,70402003,1503300,71905303,True
5422,validator_25,42369870290,True,105672000,1457230,107129230,False
5423,validator_36,109820570230,True,111002000,623500,111625500,False
5424,validator_47,76328272510,True,46998000,3648540,50646540,False
5425,validator_21,77681733203,True,128872999,866490,129739489,True
5426,validator_18,112981931555,True,56274998,876000,57150998,True
5427,validator_24,44386986026,True,208178999,1388880,209567879,True
5428,validator_15,282444327347,True,116940996,2409200,119350196,True
5429,validator_12,111260855991,True,90705999,1606320,92312319,True
5430,validator_43,76159137500,True,143763000,19644730,163407730,False
5431,validator_3,48807705064,True,49057003,1394890,50451893,True
5432,validator_15,282546584648,True,101910001,347300,102257301,True
5433,validator_10,46181603438,True,91559007,35974920,127533927,True
5434,validator_36,109904284230,True,80998000,2716000,83714000,False
5435,validator_12,111404340432,True,143194001,290440,143484441,True
5436,validator_15,282630017449,True,82560001,872800,83432801,True
5437,validator_47,76540694310,True,192842000,19579800,212421800,False
5438,validator_36,110088915060,True,182512000,2118830,184630830,False
5439,validator_2,48931330617,True,218784997,902740,219687737,True
5440,validator_21,77770738801,True,86714998,2290600,89005598,True
5441,validator_31,175781931820,True,193734000,1283600,195017600,False
5442,validator_24,44523504923,True,136125997,392900,136518897,True
5443,validator_44,110352522130,True,126631000,1576700,128207700,False
5444,validator_41,78128591410,True,100464000,490940,100954940,False
5445,validator_49,77115228470,True,85400000,844180,86244180,False
5446,validator_47,76627046410,True,85671000,681100,86352100,False
5447,validator_39,45277355200,True,158382000,483090,158865090,False
5448,validator_26,45962831410,True,126777000,19457660,146234660,False
5449,validator_49,77276849650,True,160780000,841180,161621180,False
5450,validator_44,110478691930,True,125246000,923800,126169800,False
5451,validator_15,282796134091,True,165389002,727640,166116642,True
5452,validator_9,45922506675,True,130846000,793400,131639400,True
5453,validator_36,110218363960,True,126704000,2744900,129448900,False
5454,validator_22,78587555798,True,196605001,20296500,216901501,True
5455,validator_47,76684749410,True,56542000,1161000,57703000,False
5456,validator_34,273767181900,True,45311000,1195870,46506870,False
5457,validator_0,46781067239,True,90620001,4769280,95389281,True
5458,validator_33,41968284080,True,65147000,7330740,72477740,False
5459,validator_3,48910215096,True,100150002,2360030,102510032,True
5460,validator_49,77360006950,True,81867000,1290300,83157300,False
5461,validator_48,174629413020,True,88710000,6088080,94798080,False
5462,validator_8,47498194151,True,220595997,1435900,222031897,True
5463,validator_25,42471459890,True,100132000,1457600,101589600,False
5464,validator_6,46676756578,True,250839001,8536990,259375991,True
5465,validator_12,111469762029,True,60817997,4603600,65421597,True
5466,validator_14,114960838296,True,54665007,5523300,60188307,True
5467,validator_17,182047121916,True,252353999,731700,253085699,True
5468,validator_10,46369554838,True,169685000,18266400,187951400,True
5469,validator_25,42508846690,True,35848000,1538800,37386800,False
5470,validator_34,273841458200,True,65594000,8682300,74276300,False
5471,validator_49,77447994870,True,87526000,461920,87987920,False
5472,validator_18,113127272446,True,144518001,822890,145340891,True
5473,validator_38,43158700430,True,113870000,858000,114728000,False
5474,validator_13,44198603176,True,101621003,425700,102046703,True
5475,validator_27,110276312760,True,75686000,1064840,76750840,False
5476,validator_36,110382955790,True,163856000,735830,164591830,False
5477,validator_35,110189894700,True,77686000,2234500,79920500,False
5478,validator_36,110552528790,True,161869000,7704000,169573000,False
5479,validator_44,110585717080,True,106702000,323150,107025150,False
5480,validator_48,174763086020,True,132075000,1598000,133673000,False
5481,validator_30,76959372620,True,111758000,564740,112322740,False
5482,validator_1,79768494876,True,190779998,3549640,194329638,True
5483,validator_34,273967151960,True,124429000,1264760,125693760,False
5484,validator_8,47628982049,True,128506998,2280900,130787898,True
5485,validator_15,282931294688,True,131938997,3221600,135160597,True
5486,validator_13,44366409598,True,166963002,843420,167806422,True
5487,validator_36,110664035540,True,108768000,2738750,111506750,False
5488,validator_32,44443714390,True,94828000,348420,95176420,False
5489,validator_3,49031877433,True,119636997,2025340,121662337,True
5490,validator_20,44154970720,True,123123002,393640,123516642,True
5491,validator_19,81134079221,True,145611998,628900,146240898,True
5492,validator_17,182211383232,True,146333996,17927320,164261316,True
5493,validator_16,44919654945,True,42544002,856300,43400302,True
5494,validator_29,42627601170,True,192087000,18349280,210436280,False
5495,validator_15,283061091787,True,127905999,1891100,129797099,True
5496,validator_42,43596377560,True,90027000,1075130,91102130,False
5497,validator_15,283132564026,True,70520999,951240,71472239,True
5498,validator_42,43746424090,True,148208000,1838530,150046530,False
5499,validator_12,111618489464,True,146923995,1803440,148727435,True
5500,validator_39,45409430840,True,113659000,18416640,132075640,False
5501,validator_25,42594751470,True,84544000,1360780,85904780,False
5502,validator_3,49147318531,True,113820998,1620100,115441098,True
5503,validator_11,46224048903,True,192366000,705220,193071220,True
5504,validator_27,110383918480,True,89089000,18516720,107605720,False
5505,validator_10,46550823970,True,180890992,378140,181269132,True
5506,validator_14,115133786827,True,170950001,1998530,172948531,True
5507,validator_0,46877208935,True,94571996,1569700,96141696,True
5508,validator_16,44994859186,True,74687001,517240,75204241,True
5509,validator_38,43293760500,True,127063000,7997070,135060070,False
5510,validator_16,45088932486,True,92797000,1276300,94073300,True
5511,validator_32,44535437280,True,90345000,1377890,91722890,False
5512,validator_34,274053877190,True,76311000,10414230,86725230,False
5513,validator_25,42691407870,True,95584000,1072400,96656400,False
5514,validator_22,78829447841,True,240778003,1114040,241892043,True
5515,validator_2,49070690921,True,133800004,5560300,139360304,True
5516,validator_5,79749248614,True,92544002,655400,93199402,True
5517,validator_39,45517042420,True,99807000,7804580,107611580,False
5518,validator_19,81269354517,True,133445996,1829300,135275296,True
5519,validator_13,44582910501,True,190672003,25828900,216500903,True
5520,validator_35,110346894590,True,156418000,581890,156999890,False
5521,validator_35,110373082990,True,25919000,269400,26188400,False
5522,validator_4,45913188423,True,297332002,1749500,299081502,True
5523,validator_44,110757901610,True,170474000,1710530,172184530,False
5524,validator_17,182390552829,True,178668997,500600,179169597,True
5525,validator_43,76212084900,True,44875000,8072400,52947400,False
5526,validator_46,108038842850,True,55651000,1652000,57303000,False
5527,validator_42,43857620320,True,109912000,1284230,111196230,False
5528,validator_31,175891499800,True,107428000,2139980,109567980,False
5529,validator_43,76336232500,True,105331000,18816600,124147600,False
5530,validator_42,43978571180,True,119704000,1246860,120950860,False
5531,validator_28,42480797790,True,137584000,1254240,138838240,False
5532,validator_9,46153522516,True,228125001,2890840,231015841,True
5533,validator_29,42714764370,True,79659000,7504200,87163200,False
5534,validator_21,77898483902,True,119571001,8174100,127745101,True
5535,validator_6,46852315809,True,173972001,1587230,175559231,True
5536,validator_19,81475478186,True,204510999,1612670,206123669,True
5537,validator_49,77596162230,True,147585000,582360,148167360,False
5538,validator_27,110601716650,True,215860000,1938170,217798170,False
5539,validator_6,47043395405,True,188505996,2573600,191079596,True
5540,validator_41,78365872200,True,235965000,1315790,237280790,False
5541,validator_6,47151188506,True,104963001,2830100,107793101,True
5542,validator_31,176085885300,True,193855000,530500,194385500,False
5543,validator_27,110638009440,True,34905000,1387790,36292790,False
5544,validator_32,44642179380,True,105190000,1552100,106742100,False
5545,validator_9,46347984417,True,192273001,2188900,194461901,True
5546,validator_33,42050181680,True,80303000,1594600,81897600,False
5547,validator_40,45133904750,True,111345000,5260200,116605200,False
5548,validator_42,44067407500,True,88390000,446320,88836320,False
5549,validator_14,115274406227,True,139677000,942400,140619400,True
5550,validator_39,45607852610,True,82073000,8737190,90810190,False
5551,validator_36,110721187270,True,50934000,6217730,57151730,False
5552,validator_31,176117636000,True,30916000,834700,31750700,False
5553,validator_4,46000535294,True,80040001,7306870,87346871,True
5554,validator_21,78038471600,True,138542998,1444700,139987698,True
5555,validator_49,77759239030,True,143411000,19665800,163076800,False
5556,validator_20,44356074596,True,198560996,2542880,201103876,True
5557,validator_13,44737925839,True,154345998,669340,155015338,True
5558,validator_46,108098297850,True,58624000,831000,59455000,False
5559,validator_44,110918283890,True,159799000,583280,160382280,False
5560,validator_9,46530891018,True,182390001,516600,182906601,True
5561,validator_7,81291497339,True,207328999,7416300,214745299,True
5562,validator_47,76790239410,True,103788000,1702000,105490000,False
5563,validator_39,45708660010,True,95618000,5189400,100807400,False
5564,validator_27,110722689880,True,83013000,1667440,84680440,False
5565,validator_24,44635043907,True,109534004,2004980,111538984,True
5566,validator_3,49324857060,True,176480999,1057530,177538529,True
5567,validator_46,108159299920,True,59456000,1546070,61002070,False
5568,validator_25,42787680330,True,85705000,10567460,96272460,False
5569,validator_22,78954988381,True,124588000,952540,125540540,True
5570,validator_42,44160673500,True,92869000,397000,93266000,False
5571,validator_30,77114302990,True,153858000,1072370,154930370,False
5572,validator_27,110852644430,True,128826000,1128550,129954550,False
5573,validator_26,46062566950,True,98046000,1689540,99735540,False
5574,validator_25,42954630030,True,157406000,9543700,166949700,False
5575,validator_34,274191413930,True,135341000,2195740,137536740,False
5576,validator_38,43487130430,True,192608000,761930,193369930,False
5577,validator_15,283254140607,True,98320001,23256580,121576581,True
5578,validator_22,79044291985,True,89153004,150600,89303604,True
5579,validator_41,78455783800,True,87859000,2052600,89911600,False
5580,validator_1,80036339377,True,262179001,5665500,267844501,True
5581,validator_28,42595753020,True,96519000,18436230,114955230,False
5582,validator_47,76884448480,True,93349000,860070,94209070,False
5583,validator_7,81402265340,True,110239001,529000,110768001,True
5584,validator_9,46717316220,True,179877002,6548200,186425202,True
5585,validator_27,110961992530,True,108755000,593100,109348100,False
5586,validator_30,77194941290,True,80284000,354300,80638300,False
5587,validator_22,79178883423,True,133193998,1397440,134591438,True
5588,validator_14,115409859757,True,134405000,1048530,135453530,True
5589,validator_7,81469069021,True,64776991,2026690,66803681,True
5590,validator_41,78564164500,True,102357000,6023700,108380700,False
5591,validator_25,43102825750,True,144675000,3520720,148195720,False
5592,validator_26,46230200390,True,165742000,1891440,167633440,False
5593,validator_30,77340015020,True,144426000,647730,145073730,False
5594,validator_15,283400929484,True,145330997,1457880,146788877,True
5595,validator_47,77009812250,True,123195000,2168770,125363770,False
5596,validator_19,81590512985,True,113637999,1396800,115034799,True
5597,validator_27,111022580430,True,59894000,693900,60587900,False
5598,validator_43,76471378280,True,128918000,6227780,135145780,False
5599,validator_21,78173238504,True,133937004,829900,134766904,True
5600,validator_40,45208329840,True,73938000,487090,74425090,False
5601,validator_40,45328495270,True,118933000,1232430,120165430,False
5602,validator_33,42145919580,True,95468000,269900,95737900,False
5603,validator_30,77456575020,True,115415000,1145000,116560000,False
5604,validator_46,108322789650,True,162826000,663730,163489730,False
5605,validator_1,80166482873,True,119530996,10612500,130143496,True
5606,validator_36,110940448380,True,218792000,469110,219261110,False
5607,validator_18,113282182345,True,152855999,2053900,154909899,True
5608,validator_30,77534967720,True,77742000,650700,78392700,False
5609,validator_30,77576283720,True,40353000,963000,41316000,False
5610,validator_5,79925655812,True,176201998,205200,176407198,True
5611,validator_27,111150046180,True,126855000,610750,127465750,False
5612,validator_32,44816338510,True,170448000,3711130,174159130,False
5613,validator_34,274276303140,True,83639000,1250210,84889210,False
5614,validator_24,44752267608,True,116658001,565700,117223701,True
5615,validator_44,111035649690,True,116463000,902800,117365800,False
5616,validator_17,182564807028,True,156314999,17939200,174254199,True
5617,validator_1,80263414076,True,96044003,887200,96931203,True
5618,validator_10,46750665470,True,198646000,1195500,199841500,True
5619,validator_6,47421898127,True,233888001,36821620,270709621,True
5620,validator_27,111252757920,True,94949000,7762740,102711740,False
5621,validator_4,46123490401,True,120682997,2272110,122955107,True
5622,validator_47,77155291030,True,144583000,895780,145478780,False
5623,validator_18,113364374236,True,73646001,8545890,82191891,True
5624,validator_46,108384680450,True,60905000,985800,61890800,False
5625,validator_1,80351411978,True,87694002,303900,87997902,True
5626,validator_7,81569319722,True,94846001,5404700,100250701,True
5627,validator_4,46217089819,True,72658998,20940420,93599418,True
5628,validator_42,44243461600,True,82371000,417100,82788100,False
5629,validator_34,274387668270,True,92473000,18892130,111365130,False
5630,validator_19,81767962266,True,175030001,2419280,177449281,True
5631,validator_35,110464955690,True,83525000,8347700,91872700,False
5632,validator_11,46274743262,True,50185999,508360,50694359,True
5633,validator_15,283500375974,True,90714000,8732490,99446490,True
5634,validator_31,176208723650,True,90339000,748650,91087650,False
5635,validator_31,176290295650,True,80436000,1136000,81572000,False
5636,validator_14,115515752456,True,105018999,873700,105892699,True
5637,validator_42,44298262180,True,53747000,1053580,54800580,False
5638,validator_10,46880414127,True,127416007,2332650,129748657,True
5639,validator_41,78652884200,True,88170000,549700,88719700,False
5640,validator_31,176457588180,True,140611000,26681530,167292530,False
5641,validator_15,283628646581,True,126048997,2221610,128270607,True
5642,validator_10,47042852532,True,160790005,1648400,162438405,True
5643,validator_35,110588669970,True,121183000,2531280,123714280,False
5644,validator_0,47071108337,True,189545002,4354400,193899402,True
5645,validator_10,47193796914,True,150145002,799380,150944382,True
5646,validator_40,45413454770,True,84320000,639500,84959500,False
5647,validator_18,113499399520,True,133393994,1631290,135025284,True
5648,validator_9,46778739052,True,53810002,7612830,61422832,True
5649,validator_35,110644772540,True,51552000,4550570,56102570,False
5650,validator_21,78351776701,True,175856997,2681200,178538197,True
5651,validator_27,111385584220,True,131356000,1470300,132826300,False
5652,validator_33,42259154710,True,110565000,2670130,113235130,False
5653,validator_46,108465399490,True,78684000,2035040,80719040,False
5654,validator_43,76550691780,True,74609000,4704500,79313500,False
5655,validator_43,76623897560,True,71480000,1725780,73205780,False
5656,validator_7,81699541525,True,128830003,1391800,130221803,True
5657,validator_4,46272089717,True,45939998,9059900,54999898,True
5658,validator_31,176527577200,True,67893000,2096020,69989020,False
5659,validator_11,46431877762,True,156248000,886500,157134500,True
5660,validator_12,111810959448,True,180605004,11864980,192469984,True
5661,validator_38,43639163730,True,151660000,373300,152033300,False
5662,validator_17,182644283932,True,78636004,840900,79476904,True
5663,validator_44,111195851290,True,142112000,18089600,160201600,False
5664,validator_4,46374834408,True,100501001,2243690,102744691,True
5665,validator_35,110726353140,True,80584000,996600,81580600,False
5666,validator_39,45836851810,True,109987000,18204800,128191800,False
5667,validator_11,46552413902,True,118724000,1812140,120536140,True
5668,validator_37,76060261580,True,87379000,1758800,89137800,False
5669,validator_14,115597185462,True,79556996,1876010,81433006,True
5670,validator_44,111248882990,True,52283000,748700,53031700,False
5671,validator_41,78793405000,True,129823000,10697800,140520800,False
5672,validator_9,46919511750,True,139337998,1434700,140772698,True
5673,validator_2,49243477543,True,171351002,1435620,172786622,True
5674,validator_24,44882279318,True,129487000,524710,130011710,True
5675,validator_1,80485352106,True,126175998,7764130,133940128,True
5676,validator_31,176686922350,True,158362000,983150,159345150,False
5677,validator_10,47362772752,True,168544998,430840,168975838,True
5678,validator_6,47540971324,True,118323997,749200,119073197,True
5679,validator_45,43273411620,True,114404000,1083940,115487940,False
5680,validator_25,43249931670,True,146410000,695920,147105920,False
5681,validator_47,77221640170,True,47584000,18765140,66349140,False
5682,validator_12,111933556847,True,120341999,2255400,122597399,True
5683,validator_26,46319197070,True,87090000,1906680,88996680,False
5684,validator_7,81810409529,True,109703004,1165000,110868004,True
5685,validator_36,111048147210,True,105588000,2110830,107698830,False
5686,validator_45,43356091320,True,80955000,1724700,82679700,False
5687,validator_39,45897788950,True,58901000,2036140,60937140,False
5688,validator_10,47480308683,True,115871001,1664930,117535931,True
5689,validator_41,78916296800,True,121456000,1435800,122891800,False
5690,validator_11,46612753205,True,59163003,1176300,60339303,True
5691,validator_33,42370249310,True,109595000,1499600,111094600,False
5692,validator_21,78439071192,True,85844001,1450490,87294491,True
5693,validator_35,110837070440,True,109602000,1115300,110717300,False
5694,validator_4,46510656019,True,133451001,2370610,135821611,True
5695,validator_37,76197693100,True,131447000,5984520,137431520,False
5696,validator_26,46399047570,True,77179000,2671500,79850500,False
5697,validator_4,46655396221,True,139273002,5467200,144740202,True
5698,validator_36,111155298910,True,98002000,9149700,107151700,False
5699,validator_39,46037650450,True,137075000,2786500,139861500,False
5700,validator_30,77709810520,True,133359000,167800,133526800,False
5701,validator_30,77825102710,True,114004000,1288190,115292190,False
5702,validator_23,47183818302,True,215986002,2089870,218075872,True
5703,validator_19,81972400745,True,204068999,369480,204438479,True
5704,validator_37,76354950600,True,156128000,1129500,157257500,False
5705,validator_40,45499598770,True,80100000,6044000,86144000,False
5706,validator_22,79286242622,True,107060999,298200,107359199,True
5707,validator_15,283803033943,True,169781002,4606360,174387362,True
5708,validator_2,49325348360,True,81451997,418820,81870817,True
5709,validator_7,81987471063,True,176136004,925530,177061534,True
5710,validator_47,77290496550,True,66543000,2313380,68856380,False
5711,validator_18,113782170822,True,281647002,1124300,282771302,True
5712,validator_5,80008222144,True,80540002,2026330,82566332,True
5713,validator_37,76475073300,True,114884000,5238700,120122700,False
5714,validator_16,45196665389,True,107030003,702900,107732903,True
5715,validator_9,47021800146,True,100493996,1794400,102288396,True
5716,validator_27,111483585920,True,90310000,7691700,98001700,False
5717,validator_49,77795114930,True,29230000,6645900,35875900,False
5718,validator_16,45475885298,True,251440009,27779900,279219909,True
5719,validator_38,43748959260,True,108638000,1157530,109795530,False
5720,validator_6,47780405020,True,232920996,6512700,239433696,True
5721,validator_5,80129708422,True,103561998,17924280,121486278,True
5722,validator_44,111348699090,True,99122000,694100,99816100,False
5723,validator_18,113861151209,True,76040997,2939390,78980387,True
5724,validator_36,111270145990,True,110304000,4543080,114847080,False
5725,validator_18,113928877511,True,66614002,1112300,67726302,True
5726,validator_19,82126415582,True,136308007,17706830,154014837,True
5727,validator_48,174836462250,True,65525000,7851230,73376230,False
5728,validator_25,43396812370,True,144122000,2758700,146880700,False
5729,validator_31,176770686940,True,76362000,7402590,83764590,False
5730,validator_30,77984960170,True,151831000,8026460,159857460,False
5731,validator_14,115694982202,True,96301000,1495740,97796740,True
5732,validator_41,78997118360,True,59623000,21198560,80821560,False
5733,validator_18,114061883008,True,131956997,1048500,133005497,True
5734,validator_1,80584184711,True,98217005,615600,98832605,True
5735,validator_46,108627703990,True,160711000,1593500,162304500,False
5736,validator_10,47618889426,True,130389003,8191740,138580743,True
5737,validator_21,78586034094,True,144385002,2577900,146962902,True
5738,validator_28,42684937320,True,70063000,19121300,89184300,False
5739,validator_6,47835705321,True,53822001,1478300,55300301,True
5740,validator_40,45588878570,True,88337000,942800,89279800,False
5741,validator_22,79348799450,True,60553998,2002830,62556828,True
5742,validator_11,46718278805,True,86575000,18950600,105525600,True
5743,validator_9,47231191618,True,191312002,18079470,209391472,True
5744,validator_38,43857887360,True,99386000,9542100,108928100,False
5745,validator_31,176910406460,True,136340000,3379520,139719520,False
5746,validator_37,76532161200,True,56097000,990900,57087900,False
5747,validator_12,112049657249,True,114788002,1312400,116100402,True
5748,validator_5,80434584922,True,302952000,1924500,304876500,True
5749,validator_28,42797285150,True,107452000,4895830,112347830,False
5750,validator_45,43521774940,True,165318000,365620,165683620,False
5751,validator_1,80720937332,True,133720001,3032620,136752621,True
5752,validator_20,44529050729,True,170969993,2006140,172976133,True
5753,validator_27,111569154340,True,84734000,834420,85568420,False
5754,validator_2,49399722520,True,55252000,19122160,74374160,True
5755,validator_42,44347433200,True,47780000,1391020,49171020,False
5756,validator_35,110911767240,True,72942000,1754800,74696800,False
5757,validator_4,46821828520,True,161499999,4932300,166432299,True
5758,validator_14,115831420035,True,135366993,1070840,136437833,True
5759,validator_9,47368198588,True,136529000,477970,137006970,True
5760,validator_11,46819367908,True,98623003,2466100,101089103,True
5761,validator_33,42420894910,True,49284000,1361600,50645600,False
5762,validator_44,111487809490,True,137457000,1653400,139110400,False
5763,validator_49,77951023970,True,155423000,486040,155909040,False
5764,validator_44,111557351590,True,68179000,1363100,69542100,False
5765,validator_39,46131226850,True,85925000,7651400,93576400,False
5766,validator_15,284023447838,True,211354005,9059890,220413895,True
5767,validator_47,77412545080,True,117059000,4989530,122048530,False
5768,validator_32,44895328640,True,78711000,279130,78990130,False
5769,validator_43,76712813460,True,68557000,20358900,88915900,False
5770,validator_46,108756260890,True,127524000,1032900,128556900,False
5771,validator_29,42798632790,True,82832000,1036420,83868420,False
5772,validator_21,78740280996,True,152546002,1700900,154246902,True
5773,validator_8,47717731953,True,87603004,1146900,88749904,True
5774,validator_20,44630803129,True,100116000,1636400,101752400,True
5775,validator_18,114140139307,True,77461999,794300,78256299,True
5776,validator_29,42878318920,True,78459000,1227130,79686130,False
5777,validator_24,45181531619,True,298734001,518300,299252301,True
5778,validator_34,274452593310,True,63130000,1795040,64925040,False
5779,validator_35,111016262890,True,103129000,1366650,104495650,False
5780,validator_46,108830276890,True,72720000,1296000,74016000,False
5781,validator_3,49400957359,True,75883999,216300,76100299,True
5782,validator_41,79217938500,True,211742000,9078140,220820140,False
5783,validator_43,76809510160,True,77530000,19166700,96696700,False
5784,validator_34,274588821410,True,133678000,2550100,136228100,False
5785,validator_17,182819228831,True,173791999,1152900,174944899,True
5786,validator_17,183035306499,True,215860998,216670,216077668,True
5787,validator_27,111707629410,True,137103000,1372070,138475070,False
5788,validator_17,183087928297,True,50501998,2119800,52621798,True
5789,validator_16,45584716769,True,108118001,713470,108831471,True
5790,validator_8,47821738357,True,102557004,1449400,104006404,True
5791,validator_1,80820580238,True,99240006,402900,99642906,True
5792,validator_30,78115519700,True,129974000,585530,130559530,False
5793,validator_25,43564538270,True,162306000,5419900,167725900,False
5794,validator_7,82163966607,True,176047004,448540,176495544,True
5795,validator_37,76697282820,True,156604000,8517620,165121620,False
5796,validator_30,78191603330,True,74973000,1110630,76083630,False
5797,validator_16,45648843168,True,62895999,1230400,64126399,True
5798,validator_34,274713426630,True,104457000,20148220,124605220,False
5799,validator_28,42954711640,True,155666000,1760490,157426490,False
5800,validator_44,111658119490,True,99127000,1640900,100767900,False
5801,validator_25,43661358560,True,77523000,19297290,96820290,False
5802,validator_41,79357653950,True,137634000,2081450,139715450,False
5803,validator_27,111836529950,True,121536000,7364540,128900540,False
5804,validator_2,49580509622,True,174210002,6577100,180787102,True
5805,validator_17,183144526097,True,55869000,728800,56597800,True
5806,validator_47,77513671920,True,99964000,1162840,101126840,False
5807,validator_21,78864341293,True,121721997,2338300,124060297,True
5808,validator_24,45418767515,True,236390996,844900,237235896,True
5809,validator_28,43035347780,True,78930000,1706140,80636140,False
5810,validator_44,111789399860,True,126088000,5192370,131280370,False
5811,validator_30,78320976260,True,126942000,2430930,129372930,False
5812,validator_10,47885980047,True,265094001,1996620,267090621,True
5813,validator_26,46465913660,True,64915000,1951090,66866090,False
5814,validator_12,112168658340,True,100771001,18230090,119001091,True
5815,validator_41,79425862480,True,67053000,1155530,68208530,False
5816,validator_34,274838285520,True,124432000,426890,124858890,False
5817,validator_48,175020975150,True,174765000,9747900,184512900,False
5818,validator_27,112051287070,True,212912000,1845120,214757120,False
5819,validator_41,79528756720,True,101960000,934240,102894240,False
5820,validator_20,44728488228,True,95304999,2380100,97685099,True
5821,validator_27,112235056370,True,182198000,1571300,183769300,False
5822,validator_18,114345579660,True,203986993,1453360,205440353,True
5823,validator_42,44420926800,True,65802000,7691600,73493600,False
5824,validator_40,45766517990,True,174775000,2864420,177639420,False
5825,validator_24,45549386561,True,129421996,1197050,130619046,True
5826,validator_9,47530811206,True,154841998,7770620,162612618,True
5827,validator_47,77594908720,True,80781000,455800,81236800,False
5828,validator_49,78071417470,True,117291000,3102500,120393500,False
5829,validator_25,43803272460,True,140772000,1141900,141913900,False
5830,validator_21,78936836196,True,69650003,2844900,72494903,True
5831,validator_21,79096620536,True,158608000,1176340,159784340,True
5832,validator_42,44506603700,True,84952000,724900,85676900,False
5833,validator_42,44653570300,True,146731000,235600,146966600,False
5834,validator_26,46581355060,True,115386000,55400,115441400,False
5835,validator_42,44751095190,True,77764000,19760890,97524890,False
5836,validator_35,111159529990,True,141949000,1318100,143267100,False
5837,validator_17,183205264726,True,59097999,1640630,60738629,True
5838,validator_47,77732376100,True,136373000,1094380,137467380,False
5839,validator_12,112243854445,True,73840005,1356100,75196105,True
5840,validator_22,79635020650,True,284726000,1495200,286221200,True
5841,validator_17,183266011437,True,55208001,5538710,60746711,True
5842,validator_34,274975481140,True,118183000,19012620,137195620,False
5843,validator_36,111419966290,True,148043000,1777300,149820300,False
5844,validator_11,46960142816,True,139628008,1146900,140774908,True
5845,validator_44,111909405420,True,119720000,285560,120005560,False
5846,validator_18,114462869692,True,115848002,1442030,117290032,True
5847,validator_4,47019953820,True,195537000,2588300,198125300,True
5848,validator_30,78419621320,True,97314000,1331060,98645060,False
5849,validator_11,47085634118,True,125289002,202300,125491302,True
5850,validator_15,284266025769,True,241199001,1378930,242577931,True
5851,validator_31,176987818150,True,76408000,1003690,77411690,False
5852,validator_26,46653008100,True,71150000,503040,71653040,False
5853,validator_11,47252120059,True,163155001,3330940,166485941,True
5854,validator_26,46740079100,True,86468000,603000,87071000,False
5855,validator_0,47187652165,True,115760998,782830,116543828,True
5856,validator_9,47760199802,True,222802996,6585600,229388596,True
5857,validator_4,47136052199,True,115140999,957380,116098379,True
5858,validator_35,111323122290,True,161871000,1721300,163592300,False
5859,validator_36,111494950760,True,72939000,2045470,74984470,False
5860,validator_15,284407389381,True,140528002,835610,141363612,True
5861,validator_31,177059356730,True,70752000,786580,71538580,False
5862,validator_36,111645965260,True,148840000,2174500,151014500,False
5863,validator_10,47972757576,True,85766999,1010530,86777529,True
5864,validator_30,78623506660,True,203716000,169340,203885340,False
5865,validator_11,47377619089,True,120113000,5386030,125499030,True
5866,validator_34,275110162160,True,133498000,1183020,134681020,False
5867,validator_16,45826325704,True,176980996,501540,177482536,True
5868,validator_2,49622087760,True,40641998,936140,41578138,True
5869,validator_30,78805223900,True,161808000,19909240,181717240,False
5870,validator_48,175143565890,True,120604000,1986740,122590740,False
5871,validator_15,284515259080,True,105502999,2366700,107869699,True
5872,validator_12,112347478242,True,102350997,1272800,103623797,True
5873,validator_34,275230938960,True,118805000,1971800,120776800,False
5874,validator_28,43164797680,True,129063000,386900,129449900,False
5875,validator_24,45764669484,True,196350003,18932920,215282923,True
5876,validator_34,275301779660,True,52985000,17855700,70840700,False
5877,validator_35,111378085090,True,54173000,789800,54962800,False
5878,validator_15,284629105472,True,111754002,2092390,113846392,True
5879,validator_49,78203388170,True,131373000,597700,131970700,False
5880,validator_40,45998718850,True,230720000,1480860,232200860,False
5881,validator_22,79759472971,True,115612001,8840320,124452321,True
5882,validator_49,78350323410,True,146466000,469240,146935240,False
5883,validator_24,45836432110,True,71333996,428630,71762626,True
5884,validator_29,43032455550,True,153197000,939630,154136630,False
5885,validator_15,284728107570,True,98139998,862100,99002098,True
5886,validator_27,112332396000,True,96853000,486630,97339630,False
5887,validator_35,111572788410,True,191966000,2737320,194703320,False
5888,validator_35,111623446410,True,50137000,521000,50658000,False
5889,validator_34,275429879160,True,127407000,692500,128099500,False
5890,validator_7,82395674910,True,223981003,7727300,231708303,True
5891,validator_48,175209147780,True,64739000,842890,65581890,False
5892,validator_36,111727178360,True,73382000,7831100,81213100,False
5893,validator_39,46257075950,True,123559000,2290100,125849100,False
5894,validator_30,78921245900,True,114553000,1469000,116022000,False
5895,validator_15,284822448369,True,93103999,1236800,94340799,True
5896,validator_1,80898950075,True,78026997,342840,78369837,True
5897,validator_39,46451237990,True,192570000,1592040,194162040,False
5898,validator_3,49525748159,True,106166000,18624800,124790800,True
5899,validator_33,42513872390,True,92795000,182480,92977480,False
5900,validator_15,285071747171,True,228750002,20548800,249298802,True
5901,validator_11,47620669391,True,232997002,10053300,243050302,True
5902,validator_26,46816084930,True,74904000,1101830,76005830,False
5903,validator_37,76939021520,True,240349000,1389700,241738700,False
5904,validator_35,111691708040,True,68041000,220630,68261630,False
5905,validator_46,108924125730,True,75926000,17922840,93848840,False
5906,validator_15,285220925311,True,147732000,1446140,149178140,True
5907,validator_12,112578815949,True,212711007,18626700,231337707,True
5908,validator_25,43962977240,True,158895000,809780,159704780,False
5909,validator_39,46531780010,True,79047000,1495020,80542020,False
5910,validator_32,45060510580,True,164309000,872940,165181940,False
5911,validator_17,183504826639,True,233700002,5115200,238815202,True
5912,validator_37,77096264590,True,120837000,36406070,157243070,False
5913,validator_35,111864269440,True,172083000,478400,172561400,False
5914,validator_24,46009469436,True,170954996,2082330,173037326,True
5915,validator_25,44111607920,True,130240000,18390680,148630680,False
5916,validator_17,183629611038,True,122346999,2437400,124784399,True
5917,validator_19,82321698963,True,194764001,519380,195283381,True
5918,validator_6,48059836724,True,216175003,7956400,224131403,True
5919,validator_40,46058885270,True,59585000,581420,60166420,False
5920,validator_34,275507987400,True,72098000,6010240,78108240,False
5921,validator_13,44819252379,True,80704000,622540,81326540,True
5922,validator_34,275621902500,True,113159000,756100,113915100,False
5923,validator_9,47899870891,True,139383999,287090,139671089,True
5924,validator_45,43599288670,True,74308000,3205730,77513730,False
5925,validator_19,82389968366,True,59933003,8336400,68269403,True
5926,validator_22,79869225590,True,102820999,6931620,109752619,True
5927,validator_15,285397213442,True,175471001,817130,176288131,True
5928,validator_13,44944039977,True,124239998,547600,124787598,True
5929,validator_35,111956875750,True,91789000,817310,92606310,False
5930,validator_7,82621354509,True,218023999,7655600,225679599,True
5931,validator_14,115945030866,True,112039001,1571830,113610831,True
5932,validator_1,81040126876,True,134705001,6471800,141176801,True
5933,validator_30,78962064300,True,38769000,2049400,40818400,False
5934,validator_3,49647007101,True,119940002,1318940,121258942,True
5935,validator_44,111971913600,True,43937000,18571180,62508180,False
5936,validator_25,44287772320,True,174846000,1318400,176164400,False
5937,validator_2,49692013560,True,69144000,781800,69925800,True
5938,validator_28,43238292660,True,72211000,1283980,73494980,False
5939,validator_46,109063921030,True,137880000,1915300,139795300,False
5940,validator_41,79694878570,True,161434000,4687850,166121850,False
5941,validator_21,79206015541,True,101333005,8062000,109395005,True
5942,validator_20,44925335248,True,195562000,1285020,196847020,True
5943,validator_41,79803211800,True,105558000,2775230,108333230,False
5944,validator_24,46096543439,True,86078003,996000,87074003,True
5945,validator_10,48059047734,True,68374998,17915160,86290158,True
5946,validator_29,43066793450,True,29317000,5020900,34337900,False
5947,validator_6,48226885925,True,161431001,5618200,167049201,True
5948,validator_22,80048856388,True,178882998,747800,179630798,True
5949,validator_27,112477354830,True,143500000,1458830,144958830,False
5950,validator_49,78454051010,True,102862000,865600,103727600,False
5951,validator_28,43389761140,True,150737000,731480,151468480,False
5952,validator_10,48269356063,True,209179999,1128330,210308329,True
5953,validator_7,82770132204,True,147877005,900690,148777695,True
5954,validator_4,47360026980,True,222278001,1696780,223974781,True
5955,validator_44,112078281730,True,105776000,592130,106368130,False
5956,validator_46,109251220030,True,186195000,1104000,187299000,False
5957,validator_43,76915227060,True,97345000,8371900,105716900,False
5958,validator_26,46856277430,True,38019000,2173500,40192500,False
5959,validator_42,44854760290,True,97699000,5966100,103665100,False
5960,validator_38,43959694650,True,91989000,9818290,101807290,False
5961,validator_17,183800418634,True,168374996,2432600,170807596,True
5962,validator_4,47559213880,True,197517000,1669900,199186900,True
5963,validator_25,44387143520,True,93798000,5573200,99371200,False
5964,validator_39,46594259050,True,59574000,2905040,62479040,False
5965,validator_8,47952212232,True,128206995,2266880,130473875,True
5966,validator_38,44033065880,True,65607000,7764230,73371230,False
5967,validator_18,114533724194,True,69323002,1531500,70854502,True
5968,validator_46,109389787510,True,130505000,8062480,138567480,False
5969,validator_8,48147439236,True,194055004,1172000,195227004,True
5970,validator_33,42629540790,True,114074000,1594400,115668400,False
5971,validator_0,47353095169,True,164984004,459000,165443004,True
5972,validator_16,46018182044,True,191159000,697340,191856340,True
5973,validator_22,80203630725,True,144998007,9776330,154774337,True
5974,validator_34,275670365640,True,47091000,1372140,48463140,False
5975,validator_28,43508918440,True,117153000,2004300,119157300,False
5976,validator_21,79261476739,True,55108998,352200,55461198,True
5977,validator_14,116078580528,True,124715002,8834660,133549662,True
5978,validator_2,49883620542,True,186384002,5222980,191606982,True
5979,validator_20,45030409950,True,102186002,2888700,105074702,True
5980,validator_37,77175451630,True,73199000,5988040,79187040,False
5981,validator_0,47512994408,True,153866999,6032240,159899239,True
5982,validator_0,47684819443,True,170398005,1427030,171825035,True
5983,validator_5,80615137828,True,154476006,26076900,180552906,True
5984,validator_42,44958573790,True,103202000,611500,103813500,False
5985,validator_2,50096827440,True,195019998,18186900,213206898,True
5986,validator_49,78551064910,True,95507000,1506900,97013900,False
5987,validator_39,46737573250,True,140528000,2786200,143314200,False
5988,validator_29,43174650450,True,106007000,1850000,107857000,False
5989,validator_34,275763166640,True,85496000,7305000,92801000,False
5990,validator_32,45178477970,True,117243000,724390,117967390,False
5991,validator_48,175284884980,True,74155000,1582200,75737200,False
5992,validator_11,47735826787,True,114501996,655400,115157396,True
5993,validator_4,47706523807,True,142255997,5053930,147309927,True
5994,validator_43,76981616740,True,65303000,1086680,66389680,False
5995,validator_31,177159264370,True,99013000,894640,99907640,False
5996,validator_2,50460302243,True,344282003,19192800,363474803,True
5997,validator_16,46115513221,True,96396997,934180,97331177,True
5998,validator_9,48055578390,True,154637999,1069500,155707499,True
5999,validator_7,82872830608,True,99468004,3230400,102698404,True
6000,validator_21,79441422836,True,160243997,19702100,179946097,True
6001,validator_18,114590741937,True,56736003,281740,57017743,True
6002,validator_4,47779954434,True,72831997,598630,73430627,True
6003,validator_48,175361640480,True,67373000,9382500,76755500,False
6004,validator_23,47317779104,True,114698002,19262800,133960802,True
6005,validator_36,111797833500,True,69613000,1042140,70655140,False
6006,validator_42,45141358010,True,182356000,428220,182784220,False
6007,validator_23,47475446502,True,138461998,19205400,157667398,True
6008,validator_24,46151127639,True,54271000,313200,54584200,True
6009,validator_31,177295690470,True,99770000,36656100,136426100,False
6010,validator_44,112274926350,True,193978000,2666620,196644620,False
6011,validator_35,111998188990,True,39990000,1323240,41313240,False
6012,validator_15,285764020743,True,365343001,1464300,366807301,True
6013,validator_30,79158736740,True,183153000,13519440,196672440,False
6014,validator_45,43741683350,True,140279000,2115680,142394680,False
6015,validator_45,43948463480,True,205857000,923130,206780130,False
6016,validator_31,177397933470,True,94398000,7845000,102243000,False
6017,validator_6,48381629143,True,147285998,7457220,154743218,True
6018,validator_48,175651679480,True,270057000,19982000,290039000,False
6019,validator_8,48193016536,True,44395000,1182300,45577300,True
6020,validator_25,44514882160,True,126992000,746640,127738640,False
6021,validator_42,45219822240,True,72916000,5548230,78464230,False
6022,validator_35,112087711180,True,88280000,1242190,89522190,False
6023,validator_5,80758315178,True,142354000,823350,143177350,True
6024,validator_15,285861497081,True,97162998,313340,97476338,True
6025,validator_17,183915294632,True,113987998,888000,114875998,True
6026,validator_42,45387976830,True,167962000,192590,168154590,False
6027,validator_34,275804903120,True,40386000,1350480,41736480,False
6028,validator_17,184119009734,True,202561002,1154100,203715102,True
6029,validator_9,48321061308,True,256283008,9199910,265482918,True
6030,validator_8,48337312783,True,141958007,2338240,144296247,True
6031,validator_5,80929867520,True,170764002,788340,171552342,True
6032,validator_40,46146006340,True,78348000,8773070,87121070,False
6033,validator_42,45515226930,True,125645000,1605100,127250100,False
6034,validator_1,81111103310,True,69559004,1417430,70976434,True
6035,validator_37,77273843850,True,92623000,5769220,98392220,False
6036,validator_8,48506701979,True,168484996,904200,169389196,True
6037,validator_45,44105022780,True,155847000,712300,156559300,False
6038,validator_29,43338141490,True,162936000,555040,163491040,False
6039,validator_42,45623189830,True,89560000,18402900,107962900,False
6040,validator_43,77087134090,True,104514000,1003350,105517350,False
6041,validator_46,109505929250,True,116004000,137740,116141740,False
6042,validator_37,77393250150,True,118263000,1143300,119406300,False
6043,validator_41,79902654060,True,98262000,1180260,99442260,False
6044,validator_40,46204158240,True,42835000,15316900,58151900,False
6045,validator_5,81025226659,True,93019999,2339140,95359139,True
6046,validator_11,47945584674,True,191672997,18084890,209757887,True
6047,validator_16,46188922804,True,72866003,543580,73409583,True
6048,validator_28,43739761480,True,210949000,19894040,230843040,False
6049,validator_24,46368806939,True,216621000,1058300,217679300,True
6050,validator_21,79597510641,True,155686005,401800,156087805,True
6051,validator_28,43869285460,True,128225000,1298980,129523980,False
6052,validator_37,77457701250,True,59632000,4819100,64451100,False
6053,validator_12,112629027876,True,49188997,1022930,50211927,True
6054,validator_39,46919278890,True,181590000,115640,181705640,False
6055,validator_47,77866486700,True,132169000,1941600,134110600,False
6056,validator_19,82591267396,True,183116000,18183030,201299030,True
6057,validator_4,47924437733,True,142922999,1560300,144483299,True
6058,validator_30,79347409870,True,187178000,1495130,188673130,False
6059,validator_1,81405335807,True,293396997,835500,294232497,True
6060,validator_46,109590257450,True,58693000,25635200,84328200,False
6061,validator_39,47008908780,True,88919000,710890,89629890,False
6062,validator_35,112154268720,True,61653000,4904540,66557540,False
6063,validator_26,46933646870,True,75914000,1455440,77369440,False
6064,validator_40,46339870440,True,133410000,2302200,135712200,False
6065,validator_32,45344857290,True,166008000,371320,166379320,False
6066,validator_41,80018209260,True,115066000,489200,115555200,False
6067,validator_12,112784239998,True,150628002,4584120,155212122,True
6068,validator_29,43406068920,True,66747000,1180430,67927430,False
6069,validator_1,81709287909,True,285268002,18684100,303952102,True
6070,validator_13,45183480681,True,215172004,24268700,239440704,True
6071,validator_14,116156133038,True,74788000,2764510,77552510,True
6072,validator_4,48105212730,True,180214997,560000,180774997,True
6073,validator_22,80341902166,True,137190001,1081440,138271441,True
6074,validator_26,47058744070,True,124123000,974200,125097200,False
6075,validator_7,83114478801,True,239579003,2069190,241648193,True
6076,validator_0,47766018113,True,79865000,1333670,81198670,True
6077,validator_35,112170638320,True,15531000,838600,16369600,False
6078,validator_37,77620878850,True,162314000,863600,163177600,False
6079,validator_29,43544041280,True,135956000,2016360,137972360,False
6080,validator_15,285934589805,True,72490004,602720,73092724,True
6081,validator_49,78734804610,True,182284000,1455700,183739700,False
6082,validator_41,80100131060,True,62810000,19111800,81921800,False
6083,validator_27,112614950840,True,136580000,1016010,137596010,False
6084,validator_41,80191401460,True,86233000,5037400,91270400,False
6085,validator_34,275885619720,True,79824000,892600,80716600,False
6086,validator_9,48417638243,True,95822995,753940,96576935,True
6087,validator_31,177582478250,True,184013000,531780,184544780,False
6088,validator_5,81150157361,True,123725002,1205700,124930702,True
6089,validator_40,46433656040,True,86152000,7633600,93785600,False
6090,validator_45,44180977480,True,56896000,19058700,75954700,False
6091,validator_13,45428723279,True,243198998,2043600,245242598,True
6092,validator_16,46298579102,True,87028998,22627300,109656298,True
6093,validator_49,78892370590,True,155031000,2534980,157565980,False
6094,validator_5,81212776759,True,62421998,197400,62619398,True
6095,validator_23,47588490203,True,112287001,756700,113043701,True
6096,validator_30,79421330200,True,47321000,26599330,73920330,False
6097,validator_21,79721992710,True,123559999,922070,124482069,True
6098,validator_4,48201408036,True,94543006,1652300,96195306,True
6099,validator_27,112685903640,True,69149000,1803800,70952800,False
6100,validator_13,45564233999,True,127684000,7826720,135510720,True
6101,validator_14,116245700944,True,86805006,2762900,89567906,True
6102,validator_20,45107077550,True,76262000,405600,76667600,True
6103,validator_12,112895212568,True,110108000,864570,110972570,True
6104,validator_22,80432717625,True,89458999,1356460,90815459,True
6105,validator_14,116494076462,True,247012998,1362520,248375518,True
6106,validator_32,45387828490,True,42303000,668200,42971200,False
6107,validator_19,82728774202,True,136669006,837800,137506806,True
6108,validator_41,80325483460,True,116011000,18071000,134082000,False
6109,validator_13,45654460321,True,88651002,1575320,90226322,True
6110,validator_11,48123648305,True,178058001,5630,178063631,True
6111,validator_30,79591122700,True,168566000,1226500,169792500,False
6112,validator_2,50731413119,True,264706996,6403880,271110876,True
6113,validator_34,276075472720,True,185356000,4497000,189853000,False
6114,validator_7,83206675961,True,89785000,2412160,92197160,True
6115,validator_17,184333031533,True,210248999,3772800,214021799,True
6116,validator_9,48493158846,True,74480003,1040600,75520603,True
6117,validator_11,48354468506,True,228711001,2109200,230820201,True
6118,validator_39,47187114180,True,177646000,559400,178205400,False
6119,validator_33,42729641980,True,99008000,1093190,100101190,False
6120,validator_46,109778119350,True,187169000,692900,187861900,False
6121,validator_27,112737659540,True,51163000,592900,51755900,False
6122,validator_21,80035769998,True,312073998,1703290,313777288,True
6123,validator_46,109943117290,True,162967000,2030940,164997940,False
6124,validator_12,112985629247,True,90146999,269680,90416679,True
6125,validator_48,175790012680,True,135823000,2510200,138333200,False
6126,validator_40,46494893370,True,60409000,828330,61237330,False
6127,validator_19,82832282103,True,102263001,1244900,103507901,True
6128,validator_15,286071921230,True,91722995,45608430,137331425,True
6129,validator_33,42904341930,True,172886000,1813950,174699950,False
6130,validator_9,48597261750,True,93741004,10361900,104102904,True
6131,validator_24,46466381141,True,95369002,2205200,97574202,True
6132,validator_47,77975879300,True,101170000,8222600,109392600,False
6133,validator_40,46577431370,True,81045000,1493000,82538000,False
6134,validator_11,48485766994,True,94428998,36869490,131298488,True
6135,validator_2,50868560319,True,135517000,1630200,137147200,True
6136,validator_40,46633360650,True,54851000,1078280,55929280,False
6137,validator_44,112465292850,True,172643000,17723500,190366500,False
6138,validator_37,77818557090,True,196034000,1644240,197678240,False
6139,validator_8,48599976880,True,91237001,2037900,93274901,True
6140,validator_1,81834548910,True,106627001,18634000,125261001,True
6141,validator_48,175841928780,True,51105000,811100,51916100,False
6142,validator_28,43946355460,True,76173000,897000,77070000,False
6143,validator_23,47783736704,True,194865001,381500,195246501,True
6144,validator_20,45303370439,True,181677999,14614890,196292889,True
6145,validator_46,110042153790,True,91328000,7708500,99036500,False
6146,validator_21,80198597608,True,162083000,744610,162827610,True
6147,validator_20,45406751839,True,101138000,2243400,103381400,True
6148,validator_8,48738070679,True,137584999,508800,138093799,True
6149,validator_20,45477158534,True,67037995,3368700,70406695,True
6150,validator_21,80354674628,True,155293000,784020,156077020,True
6151,validator_0,47825745052,True,58207999,1518940,59726939,True
6152,validator_13,45804069667,True,146311996,3297350,149609346,True
6153,validator_46,110120297090,True,77441000,702300,78143300,False
6154,validator_15,286198684424,True,124940994,1822200,126763194,True
6155,validator_23,47860419751,True,58391007,18292040,76683047,True
6156,validator_25,44594354460,True,70721000,8751300,79472300,False
6157,validator_43,77149463590,True,60981000,1348500,62329500,False
6158,validator_31,177653788140,True,68810000,2499890,71309890,False
6159,validator_9,48732186692,True,134772002,152940,134924942,True
6160,validator_17,184388938533,True,54292000,1615000,55907000,True
6161,validator_42,45675540730,True,50970000,1380900,52350900,False
6162,validator_4,48413726038,True,206886002,5432000,212318002,True
6163,validator_29,43621356420,True,76653000,662140,77315140,False
6164,validator_46,110338635920,True,216288000,2050830,218338830,False
6165,validator_20,45585678157,True,105946003,2573620,108519623,True
6166,validator_30,79698538180,True,104204000,3211480,107415480,False
6167,validator_39,47367039280,True,178627000,1298100,179925100,False
6168,validator_14,116773821734,True,277648002,2097270,279745272,True
6169,validator_23,48003694089,True,142671998,602340,143274338,True
6170,validator_32,45444738920,True,38714000,18196430,56910430,False
6171,validator_20,45711009678,True,123981001,1350520,125331521,True
6172,validator_14,116932815134,True,139119000,19874400,158993400,True
6173,validator_32,45562327240,True,116362000,1226320,117588320,False
6174,validator_11,48610794389,True,124224995,802400,125027395,True
6175,validator_38,44096585600,True,62193000,1326720,63519720,False
6176,validator_41,80504420590,True,170220000,8717130,178937130,False
6177,validator_13,45936009666,True,131633999,306000,131939999,True
6178,validator_41,80646668770,True,136816000,5432180,142248180,False
6179,validator_28,44058135660,True,103799000,7981200,111780200,False
6180,validator_19,82897806403,True,64582000,942300,65524300,True
6181,validator_34,276221879520,True,138047000,8359800,146406800,False
6182,validator_27,112917513160,True,178066000,1787620,179853620,False
6183,validator_30,79827658700,True,128139000,981520,129120520,False
6184,validator_17,184725308722,True,334514999,1855190,336370189,True
6185,validator_35,112217101610,True,44982000,1481290,46463290,False
6186,validator_23,48100225480,True,89120001,7411390,96531391,True
6187,validator_22,80620757235,True,179378000,8661610,188039610,True
6188,validator_9,48827186888,True,94277996,722200,95000196,True
6189,validator_34,276382265760,True,155761000,4625240,160386240,False
6190,validator_26,47142721000,True,82763000,1213930,83976930,False
6191,validator_15,286245391527,True,45381003,1326100,46707103,True
6192,validator_5,81352402758,True,139414999,211000,139625999,True
6193,validator_7,83265493159,True,57786998,1030200,58817198,True
6194,validator_35,112318242830,True,100844000,297220,101141220,False
6195,validator_21,80525756013,True,169834995,1246390,171081385,True
6196,validator_36,111899586700,True,81612000,20141200,101753200,False
6197,validator_18,114721841328,True,128712991,2386400,131099391,True
6198,validator_21,80660177112,True,133770999,650100,134421099,True
6199,validator_45,44288306280,True,106446000,882800,107328800,False
6200,validator_5,81519214587,True,165422999,1388830,166811829,True
6201,validator_12,113060151449,True,72289002,2233200,74522202,True
6202,validator_48,175983422000,True,141018000,475220,141493220,False
6203,validator_15,286461494330,True,215672003,430800,216102803,True
6204,validator_40,46748205410,True,112595000,2249760,114844760,False
6205,validator_15,286539192732,True,75665002,2033400,77698402,True
6206,validator_17,184821924721,True,95201999,1414000,96615999,True
6207,validator_42,45774358230,True,79701000,19116500,98817500,False
6208,validator_5,81649602971,True,129161994,1226390,130388384,True
6209,validator_42,45889240630,True,113140000,1742400,114882400,False
6210,validator_0,47887200552,True,56087000,5368500,61455500,True
6211,validator_45,44462478180,True,173661000,510900,174171900,False
6212,validator_28,44233346690,True,166658000,8553030,175211030,False
6213,validator_44,112691662130,True,207639000,18730280,226369280,False
6214,validator_1,81946001237,True,110198997,1253330,111452327,True
6215,validator_29,43712598450,True,90790000,452030,91242030,False
6216,validator_21,80766156713,True,105244001,735600,105979601,True
6217,validator_24,46592897141,True,125942000,574000,126516000,True
6218,validator_7,83385423389,True,106205000,13725230,119930230,True
6219,validator_0,48024040254,True,118129002,18710700,136839702,True
6220,validator_19,83097323132,True,180313999,19202730,199516729,True
6221,validator_38,44193029800,True,95921000,523200,96444200,False
6222,validator_34,276583915590,True,201000000,649830,201649830,False
6223,validator_32,45719820160,True,152171000,5321920,157492920,False
6224,validator_31,177738518470,True,83556000,1174330,84730330,False
6225,validator_27,113244304850,True,325003000,1788690,326791690,False
6226,validator_15,286852484163,True,294385991,18905440,313291431,True
6227,validator_30,80012692420,True,182856000,2177720,185033720,False
6228,validator_39,47533412660,True,165336000,1037380,166373380,False
6229,validator_3,49762853700,True,108344999,7501600,115846599,True
6230,validator_19,83169781634,True,71332002,1126500,72458502,True
6231,validator_20,45823933775,True,111925997,998100,112924097,True
6232,validator_46,110451609420,True,108278000,4695500,112973500,False
6233,validator_37,77897862990,True,78297000,1008900,79305900,False
6234,validator_27,113421515200,True,176520000,690350,177210350,False
6235,validator_27,113507357420,True,85541000,301220,85842220,False
6236,validator_39,47625288160,True,87585000,4290500,91875500,False
6237,validator_37,78103898390,True,205014000,1021400,206035400,False
6238,validator_38,44317255500,True,118813000,5412700,124225700,False
6239,validator_12,113217127568,True,156432999,543120,156976119,True
6240,validator_45,44629989340,True,165918000,1593160,167511160,False
6241,validator_34,276678171120,True,93689000,566530,94255530,False
6242,validator_35,112406468550,True,86224000,2001720,88225720,False
6243,validator_14,117065866331,True,132469997,581200,133051197,True
6244,validator_49,79009048670,True,115757000,921080,116678080,False
6245,validator_23,48239820869,True,137040999,2554390,139595389,True
6246,validator_17,185031664960,True,207805999,1934240,209740239,True
6247,validator_39,47744695200,True,118119000,1288040,119407040,False
6248,validator_48,176113244600,True,128443000,1379600,129822600,False
6249,validator_8,48887728440,True,149168001,489760,149657761,True
6250,validator_3,49916730138,True,153602998,273440,153876438,True
6251,validator_3,50054832939,True,132903001,5199800,138102801,True
6252,validator_19,83308435572,True,135884998,2768940,138653938,True
6253,validator_33,43032435730,True,120623000,7470800,128093800,False
6254,validator_29,43825484250,True,112083000,802800,112885800,False
6255,validator_10,48343916860,True,66430997,8129800,74560797,True
6256,validator_46,110592316150,True,140207000,499730,140706730,False
6257,validator_21,80880856138,True,111653995,3045430,114699425,True
6258,validator_40,46879666250,True,130862000,598840,131460840,False
6259,validator_47,78105146630,True,120759000,8508330,129267330,False
6260,validator_14,117208896107,True,142487996,541780,143029776,True
6261,validator_32,45936593380,True,216014000,759220,216773220,False
6262,validator_30,80110048660,True,96642000,714240,97356240,False
6263,validator_23,48427650070,True,181323001,6506200,187829201,True
6264,validator_40,47008213690,True,126860000,1687440,128547440,False
6265,validator_27,113669102020,True,161619000,125600,161744600,False
6266,validator_15,286970734381,True,117404998,845220,118250218,True
6267,validator_48,176281786520,True,167107000,1434920,168541920,False
6268,validator_40,47108054930,True,99524000,317240,99841240,False
6269,validator_48,176395786000,True,101493000,12506480,113999480,False
6270,validator_15,287110315870,True,137774999,1806490,139581489,True
6271,validator_15,287321329172,True,208834002,2179300,211013302,True
6272,validator_10,48403737061,True,59533001,287200,59820201,True
6273,validator_10,48512362801,True,89718000,18907740,108625740,True
6274,validator_0,48259658058,True,216838004,18779800,235617804,True
6275,validator_44,112767296630,True,50687000,24947500,75634500,False
6276,validator_13,46123755564,True,186230998,1514900,187745898,True
6277,validator_3,50176570229,True,113033000,8704290,121737290,True
6278,validator_47,78157449320,True,50259000,2043690,52302690,False
6279,validator_24,46710694963,True,115399002,2398820,117797822,True
6280,validator_42,46037346530,True,146977000,1128900,148105900,False
6281,validator_48,176589157700,True,191305000,2066700,193371700,False
6282,validator_39,47885769500,True,140017000,1057300,141074300,False
6283,validator_17,185248355074,True,214561994,2128120,216690114,True
6284,validator_43,77221717460,True,71382000,871870,72253870,False
6285,validator_33,43177341150,True,125675000,19230420,144905420,False
6286,validator_13,46225075371,True,99672007,1647800,101319807,True
6287,validator_10,48570988296,True,57273005,1352490,58625495,True
6288,validator_18,114824611210,True,100647002,2122880,102769882,True
6289,validator_7,83494991086,True,102862997,6704700,109567697,True
6290,validator_32,46012215870,True,75016000,606490,75622490,False
6291,validator_16,46537266902,True,238245000,442800,238687800,True
6292,validator_37,78179061720,True,73403000,1760330,75163330,False
6293,validator_38,44378104790,True,59484000,1365290,60849290,False
6294,validator_21,81070629597,True,183388999,6384460,189773459,True
6295,validator_18,114935826724,True,105218994,5996520,111215514,True
6296,validator_45,44712459040,True,73330000,9139700,82469700,False
6297,validator_2,51009879350,True,121855001,19464030,141319031,True
6298,validator_9,48925149716,True,79528998,18433830,97962828,True
6299,validator_10,48659349237,True,87625001,735940,88360941,True
6300,validator_19,83467161811,True,157426999,1299240,158726239,True
6301,validator_33,43284530250,True,98771000,8418100,107189100,False
6302,validator_3,50296515326,True,119239997,705100,119945097,True
6303,validator_15,287433537872,True,110446000,1762700,112208700,True
6304,validator_2,51259195352,True,248411002,905000,249316002,True
6305,validator_20,45883984543,True,58798998,1251770,60050768,True
6306,validator_0,48570218359,True,309064001,1496300,310560301,True
6307,validator_46,110727414670,True,134249000,849520,135098520,False
6308,validator_40,47284026430,True,148956000,27015500,175971500,False
6309,validator_33,43373909610,True,84189000,5190360,89379360,False
6310,validator_11,48719597690,True,107874001,929300,108803301,True
6311,validator_27,113763783820,True,92335000,2346800,94681800,False
6312,validator_20,46003218158,True,118498995,734620,119233615,True
6313,validator_15,287563279160,True,128108998,1632290,129741288,True
6314,validator_4,48540767163,True,122281005,4760120,127041125,True
6315,validator_49,79182189490,True,171178000,1962820,173140820,False
6316,validator_19,83576446191,True,109110000,174380,109284380,True
6317,validator_15,287739071959,True,174974999,817800,175792799,True
6318,validator_7,83736318717,True,240050001,1277630,241327631,True
6319,validator_32,46125606510,True,111843000,1547640,113390640,False
6320,validator_1,82160387535,True,213735998,650300,214386298,True
6321,validator_42,46160230230,True,121175000,1708700,122883700,False
6322,validator_2,51346856850,True,86863998,797500,87661498,True
6323,validator_33,43598169810,True,223362000,898200,224260200,False
6324,validator_33,43743286010,True,126807000,18309200,145116200,False
6325,validator_15,287887554158,True,146741999,1740200,148482199,True
6326,validator_14,117352867065,True,142472998,1497960,143970958,True
6327,validator_40,47360349430,True,75241000,1082000,76323000,False
6328,validator_45,44792230840,True,78914000,857800,79771800,False
6329,validator_21,81308737899,True,235008002,3100300,238108302,True
6330,validator_13,46433594350,True,206897999,1620980,208518979,True
6331,validator_44,112847648670,True,60131000,20221040,80352040,False
6332,validator_37,78345768920,True,164923000,1784200,166707200,False
6333,validator_0,48734665355,True,163094996,1352000,164446996,True
6334,validator_13,46555474523,True,121202003,678170,121880173,True
6335,validator_24,46889705852,True,153008009,26002880,179010889,True
6336,validator_20,46120011154,True,116495996,297000,116792996,True
6337,validator_20,46182508681,True,54550997,7946530,62497527,True
6338,validator_39,47970530160,True,71004000,13756660,84760660,False
6339,validator_9,49015886915,True,89545999,1191200,90737199,True
6340,validator_3,50491679623,True,193187997,1976300,195164297,True
6341,validator_5,81866882053,True,211602002,5677080,217279082,True
6342,validator_49,79330553760,True,122497000,25867270,148364270,False
6343,validator_27,113932671020,True,166897000,1990200,168887200,False
6344,validator_41,80804030330,True,138914000,18447560,157361560,False
6345,validator_47,78200222820,True,41327000,1446500,42773500,False
6346,validator_24,46991231249,True,100974997,550400,101525397,True
6347,validator_2,51534510747,True,186360997,1292900,187653897,True
6348,validator_49,79547628000,True,211078000,5996240,217074240,False
6349,validator_42,46247920130,True,85746000,1943900,87689900,False
6350,validator_3,50560601642,True,68038999,883020,68922019,True
6351,validator_7,83829268320,True,91600003,1349600,92949603,True
6352,validator_34,276801132610,True,120736000,2225490,122961490,False
6353,validator_22,80701672137,True,78329002,2585900,80914902,True
6354,validator_18,115036293250,True,95731996,4734530,100466526,True
6355,validator_38,44576122270,True,178950000,19067480,198017480,False
6356,validator_22,80839246116,True,129386999,8186980,137573979,True
6357,validator_9,49199465137,True,182564002,1014220,183578222,True
6358,validator_10,49035367436,True,367404999,8613200,376018199,True
6359,validator_27,114029943920,True,96587000,685900,97272900,False
6360,validator_42,46380154130,True,130647000,1587000,132234000,False
6361,validator_25,44771509860,True,174951000,2204400,177155400,False
6362,validator_0,48879033979,True,140933004,3435620,144368624,True
6363,validator_42,46514771590,True,132886000,1731460,134617460,False
6364,validator_37,78424544320,True,78422000,353400,78775400,False
6365,validator_24,47083712045,True,90873996,1606800,92480796,True
6366,validator_43,77321565900,True,98315000,1533440,99848440,False
6367,validator_46,110781937540,True,52834000,1688870,54522870,False
6368,validator_12,113435039406,True,216468998,1442840,217911838,True
6369,validator_28,44304353930,True,68990000,2017240,71007240,False
6370,validator_24,47248561834,True,164104999,744790,164849789,True
6371,validator_12,113692484543,True,247697997,9747140,257445137,True
6372,validator_38,44674629970,True,84782000,13725700,98507700,False
6373,validator_8,49187288880,True,297659000,1901440,299560440,True
6374,validator_43,77506864300,True,184428000,870400,185298400,False
6375,validator_3,50648993819,True,83680997,4711180,88392177,True
6376,validator_5,81970901781,True,102045998,1973730,104019728,True
6377,validator_16,46845757000,True,307584998,905100,308490098,True
6378,validator_37,78487346560,True,43679000,19123240,62802240,False
6379,validator_44,112904190070,True,55596000,945400,56541400,False
6380,validator_37,78613515760,True,124355000,1814200,126169200,False
6381,validator_38,44751488560,True,75422000,1436590,76858590,False
6382,validator_17,185343338676,True,94678002,305600,94983602,True
6383,validator_21,81389686191,True,80351002,597290,80948292,True
6384,validator_34,276886855450,True,85248000,474840,85722840,False
6385,validator_6,48477760069,True,95286996,843930,96130926,True
6386,validator_21,81574168225,True,152602004,31880030,184482034,True
6387,validator_35,112565717290,True,157921000,1327740,159248740,False
6388,validator_43,77611555560,True,102747000,1944260,104691260,False
6389,validator_7,83938161019,True,107220999,1671700,108892699,True
6390,validator_32,46267441430,True,141041000,793920,141834920,False
6391,validator_27,114069556450,True,31439000,8173530,39612530,False
6392,validator_44,113019889100,True,97566000,18133030,115699030,False
6393,validator_42,46624901490,True,108195000,1934900,110129900,False
6394,validator_4,48670219968,True,129143005,309800,129452805,True
6395,validator_5,82090099985,True,117233994,1964210,119198204,True
6396,validator_31,177828628000,True,81220000,8889530,90109530,False
6397,validator_47,78368037450,True,166094000,1720630,167814630,False
6398,validator_18,115201025955,True,162200005,2532700,164732705,True
6399,validator_47,78426252250,True,58159000,55800,58214800,False
6400,validator_32,46390667830,True,122146000,1080400,123226400,False
6401,validator_4,48779585066,True,101440998,7924100,109365098,True
6402,validator_29,43943740150,True,117495000,760900,118255900,False
6403,validator_49,79659514900,True,110385000,1501900,111886900,False
6404,validator_26,47272170700,True,121019000,8430700,129449700,False
6405,validator_0,48960899227,True,80566008,1299240,81865248,True
6406,validator_15,288008330977,True,119847999,928820,120776819,True
6407,validator_24,47398003412,True,147744998,1696580,149441578,True
6408,validator_18,115314674850,True,112391995,1256900,113648895,True
6409,validator_13,46709677325,True,152721002,1481800,154202802,True
6410,validator_5,82227344083,True,136236998,1007100,137244098,True
6411,validator_14,117571292292,True,192173997,26251230,218425227,True
6412,validator_48,176732561710,True,123467000,19937010,143404010,False
6413,validator_7,84097536021,True,157914002,1461000,159375002,True
6414,validator_48,176828116610,True,94431000,1123900,95554900,False
6415,validator_49,79854711400,True,170351000,24845500,195196500,False
6416,validator_34,276950893850,True,43591000,20447400,64038400,False
6417,validator_9,49354729335,True,146990998,8273200,155264198,True
6418,validator_40,47429702030,True,68454000,898600,69352600,False
6419,validator_34,277010805050,True,58876000,1035200,59911200,False
6420,validator_1,82228813426,True,68198001,227890,68425891,True
6421,validator_35,112694603490,True,127360000,1526200,128886200,False
6422,validator_19,83746317223,True,167775002,2096030,169871032,True
6423,validator_33,43835330740,True,89133000,2911730,92044730,False
6424,validator_17,185420967147,True,77482001,146470,77628471,True
6425,validator_0,49113671727,True,152564000,208500,152772500,True
6426,validator_19,83893100726,True,127226003,19557500,146783503,True
6427,validator_34,277127900150,True,97734000,19361100,117095100,False
6428,validator_21,81726391105,True,151233000,989880,152222880,True
6429,validator_31,177938818680,True,108573000,1617680,110190680,False
6430,validator_10,49144712476,True,107380000,1965040,109345040,True
6431,validator_18,115472904254,True,149410004,8819400,158229404,True
6432,validator_14,117723983821,True,151459999,1231530,152691529,True
6433,validator_31,178050201310,True,109720000,1662630,111382630,False
6434,validator_6,48622696387,True,144257998,678320,144936318,True
6435,validator_42,46917458910,True,284497000,8060420,292557420,False
6436,validator_28,44530872010,True,226102000,416080,226518080,False
6437,validator_0,49165378325,True,50179998,1526600,51706598,True
6438,validator_36,112019608520,True,114555000,5466820,120021820,False
6439,validator_2,51598591346,True,62529999,1550600,64080599,True
6440,validator_18,115648021497,True,137304993,37812250,175117243,True
6441,validator_40,47548947530,True,117158000,2087500,119245500,False
6442,validator_12,113813982295,True,102821002,18676750,121497752,True
6443,validator_46,110904654540,True,121821000,896000,122717000,False
6444,validator_30,80218903890,True,102662000,6193230,108855230,False
6445,validator_33,43923043540,True,86635000,1077800,87712800,False
6446,validator_49,80085352000,True,229665000,975600,230640600,False
6447,validator_26,47474893300,True,176723000,25999600,202722600,False
6448,validator_47,78556210450,True,122062000,7896200,129958200,False
6449,validator_35,112823111120,True,127776000,731630,128507630,False
6450,validator_24,47480871730,True,63309998,19558320,82868318,True
6451,validator_39,48143232680,True,167696000,5006520,172702520,False
6452,validator_39,48253873860,True,109461000,1180180,110641180,False
6453,validator_4,48885754363,True,104867997,1301300,106169297,True
6454,validator_31,178221470410,True,169324000,1945100,171269100,False
6455,validator_38,44887560840,True,135306000,766280,136072280,False
6456,validator_17,185516627373,True,94212996,1447230,95660226,True
6457,validator_48,176973765300,True,145126000,522690,145648690,False
6458,validator_24,47597178403,True,111463003,4843670,116306673,True
6459,validator_27,114271865150,True,184348000,17960700,202308700,False
6460,validator_26,47582533780,True,106366000,1274480,107640480,False
6461,validator_45,44995610580,True,201511000,1868740,203379740,False
6462,validator_11,48984471733,True,263435003,1439040,264874043,True
6463,validator_19,84095521025,True,174518999,27901300,202420299,True
6464,validator_22,80898523914,True,58485998,791800,59277798,True
6465,validator_25,44895045660,True,121725000,1810800,123535800,False
6466,validator_40,47652624850,True,103208000,469320,103677320,False
6467,validator_14,117880007521,True,135731000,20292700,156023700,True
6468,validator_12,113922516099,True,107673004,860800,108533804,True
6469,validator_1,82323494218,True,93782992,897800,94680792,True
6470,validator_19,84313308850,True,216811005,976820,217787825,True
6471,validator_16,46965299600,True,110248000,9294600,119542600,True
6472,validator_5,82518006078,True,286698995,3963000,290661995,True
6473,validator_28,44643498670,True,112180000,446660,112626660,False
6474,validator_15,288185795074,True,174961997,2502100,177464097,True
6475,validator_29,44056054170,True,112090000,224020,112314020,False
6476,validator_33,44052607340,True,127442000,2121800,129563800,False
6477,validator_17,185643822641,True,107001998,20193270,127195268,True
6478,validator_41,80956508960,True,132357000,20121630,152478630,False
6479,validator_19,84414731432,True,65280992,36141590,101422582,True
6480,validator_43,77794154860,True,174417000,8182300,182599300,False
6481,validator_18,115767307695,True,118237998,1048200,119286198,True
6482,validator_40,47793287450,True,138764000,1898600,140662600,False
6483,validator_24,47641761683,True,44545000,38280,44583280,True
6484,validator_10,49239149572,True,93674996,762100,94437096,True
6485,validator_28,44774183070,True,129895000,789400,130684400,False
6486,validator_41,81156804160,True,199709000,586200,200295200,False
6487,validator_27,114381455950,True,108293000,1297800,109590800,False
6488,validator_4,48938301262,True,50807999,1738900,52546899,True
6489,validator_19,84500348055,True,84832003,784620,85616623,True
6490,validator_42,46960557610,True,42705000,393700,43098700,False
6491,validator_11,49161130733,True,175498000,1161000,176659000,True
6492,validator_9,49493322732,True,136242997,2350400,138593397,True
6493,validator_32,46491666660,True,100326000,672830,100998830,False
6494,validator_9,49741394723,True,240441001,7630990,248071991,True
6495,validator_8,49473635381,True,284302991,2043510,286346501,True
6496,validator_49,80287517400,True,190008000,12157400,202165400,False
6497,validator_1,82499807245,True,175267997,1045030,176313027,True
6498,validator_34,277309692370,True,181141000,651220,181792220,False
6499,validator_32,46572181860,True,79875000,640200,80515200,False
6500,validator_6,48824052782,True,199700995,1655400,201356395,True
6501,validator_37,78821788540,True,203064000,5208780,208272780,False
6502,validator_44,113128177390,True,106301000,1987290,108288290,False
6503,validator_47,78625478890,True,63336000,5932440,69268440,False
6504,validator_3,50794677621,True,144497002,1186800,145683802,True
6505,validator_15,288305181797,True,110082993,9303730,119386723,True
6506,validator_40,47923622370,True,109909000,20425920,130334920,False
6507,validator_13,46854139023,True,142725998,1735700,144461698,True
6508,validator_3,51019278724,True,223236003,1365100,224601103,True
6509,validator_34,277413352510,True,102130000,1530140,103660140,False
6510,validator_13,46965224268,True,109514005,1571240,111085245,True
6511,validator_27,114635645680,True,253232000,957730,254189730,False
6512,validator_31,178365112230,True,138139000,5502820,143641820,False
6513,validator_0,49324401026,True,158760001,262700,159022701,True
6514,validator_42,47089921210,True,128481000,882600,129363600,False
6515,validator_16,47107554402,True,133960002,8294800,142254802,True
6516,validator_15,288379782827,True,73776000,825030,74601030,True
6517,validator_9,49873816263,True,131921000,500540,132421540,True
6518,validator_31,178480745610,True,113765000,1868380,115633380,False
6519,validator_49,80362955300,True,74507000,930900,75437900,False
6520,validator_47,78702766290,True,57919000,19368400,77287400,False
6521,validator_44,113241709690,True,94748000,18784300,113532300,False
6522,validator_19,84646616352,True,145607997,660300,146268297,True
6523,validator_36,112112900820,True,92258000,1034300,93292300,False
6524,validator_14,118051643819,True,151867998,19768300,171636298,True
6525,validator_16,47211501609,True,102531997,1415210,103947207,True
6526,validator_40,48118074000,True,187232000,7219630,194451630,False
6527,validator_45,45117157170,True,120538000,1008590,121546590,False
6528,validator_33,44122883140,True,65562000,4713800,70275800,False
6529,validator_32,46707574060,True,127985000,7407200,135392200,False
6530,validator_18,115890071994,True,117225999,5538300,122764299,True
6531,validator_12,114023735104,True,100064005,1155000,101219005,True
6532,validator_43,77868355490,True,71981000,2219630,74200630,False
6533,validator_11,49272014395,True,110196002,687660,110883662,True
6534,validator_38,44972653170,True,84537000,555330,85092330,False
6535,validator_36,112273371260,True,159572000,898440,160470440,False
6536,validator_32,46865801760,True,156491000,1736700,158227700,False
6537,validator_47,78849288990,True,145092000,1430700,146522700,False
6538,validator_21,81838671099,True,103851994,8428000,112279994,True
6539,validator_2,51821685649,True,222399003,695300,223094303,True
6540,validator_46,111073210740,True,140665000,27891200,168556200,False
6541,validator_32,46970405530,True,99695000,4908770,104603770,False
6542,validator_6,49040910766,True,215933004,924980,216857984,True
6543,validator_47,79001310090,True,150431000,1590100,152021100,False
6544,validator_8,49637508523,True,163208002,665140,163873142,True
6545,validator_25,45007900650,True,111023000,1831990,112854990,False
6546,validator_17,185714855982,True,69381001,1652340,71033341,True
6547,validator_12,114120691304,True,95511000,1445200,96956200,True
6548,validator_21,81934785230,True,95279001,835130,96114131,True
6549,validator_30,80347272790,True,108608000,19760900,128368900,False
6550,validator_35,112912052120,True,87446000,1495000,88941000,False
6551,validator_16,47315956698,True,100171999,4283090,104455089,True
6552,validator_41,81214702960,True,53208000,4690800,57898800,False
6553,validator_40,48253328300,True,129657000,5597300,135254300,False
6554,validator_1,82619822488,True,111617003,8398240,120015243,True
6555,validator_24,47813501584,True,159033001,12706900,171739901,True
6556,validator_23,48552933303,True,121552003,3731230,125283233,True
6557,validator_39,48370645760,True,95931000,20840900,116771900,False
6558,validator_40,48379978600,True,125646000,1004300,126650300,False
6559,validator_38,45106236030,True,113701000,19881860,133582860,False
6560,validator_1,82711952587,True,86026999,6103100,92130099,True
6561,validator_7,84278847117,True,162766996,18544100,181311096,True
6562,validator_30,80416301710,True,68767000,261920,69028920,False
6563,validator_8,49711715329,True,68545006,5661800,74206806,True
6564,validator_18,116118350526,True,226211002,2067530,228278532,True
6565,validator_45,45235127250,True,117433000,537080,117970080,False
6566,validator_28,44821099990,True,45883000,1033920,46916920,False
6567,validator_12,114280940705,True,152805001,7444400,160249401,True
6568,validator_45,45377910150,True,141827000,955900,142782900,False
6569,validator_48,177094932570,True,120387000,780270,121167270,False
6570,validator_9,49971152462,True,97048999,287200,97336199,True
6571,validator_11,49425065890,True,152197995,853500,153051495,True
6572,validator_24,47920171986,True,69988002,36682400,106670402,True
6573,validator_48,177167975990,True,71925000,1118420,73043420,False
6574,validator_38,45261014640,True,143999000,10779610,154778610,False
6575,validator_42,47224261940,True,115401000,18939730,134340730,False
6576,validator_5,82640685403,True,102858995,19820330,122679325,True
6577,validator_5,82798900204,True,148950001,9264800,158214801,True
6578,validator_19,84830832547,True,183327995,888200,184216195,True
6579,validator_25,45104063500,True,94928000,1234850,96162850,False
6580,validator_17,185841359485,True,126036003,467500,126503503,True
6581,validator_27,114691673730,True,55497000,531050,56028050,False
6582,validator_11,49627910090,True,201514000,1330200,202844200,True
6583,validator_2,51923441748,True,92469999,9286100,101756099,True
6584,validator_49,80485096040,True,120865000,1275740,122140740,False
6585,validator_44,113328001880,True,84922000,1370190,86292190,False
6586,validator_0,49457712022,True,131874996,1436000,133310996,True
6587,validator_22,80976506311,True,72813997,5168400,77982397,True
6588,validator_28,44943210390,True,121021000,1089400,122110400,False
6589,validator_31,178559906690,True,77331000,1830080,79161080,False
6590,validator_37,78932512340,True,109529000,1194800,110723800,False
6591,validator_3,51099381226,True,79070002,1032500,80102502,True
6592,validator_43,77919429590,True,31987000,19087100,51074100,False
6593,validator_31,178668123690,True,105994000,2223000,108217000,False
6594,validator_9,50118265065,True,145654003,1458600,147112603,True
6595,validator_23,48691088807,True,136298004,1857500,138155504,True
6596,validator_48,177219676650,True,49338000,2362660,51700660,False
6597,validator_27,114851502730,True,158964000,865000,159829000,False
6598,validator_47,79148569690,True,146666000,593600,147259600,False
6599,validator_24,48075763727,True,154606001,985740,155591741,True
6600,validator_38,45429600040,True,149728000,18857400,168585400,False
6601,validator_21,82219197723,True,248086003,36326490,284412493,True
6602,validator_31,178756469190,True,87571000,774500,88345500,False
6603,validator_16,47447930892,True,131340004,634190,131974194,True
6604,validator_39,48510094200,True,120812000,18636440,139448440,False
6605,validator_23,48771582938,True,78924001,1570130,80494131,True
6606,validator_42,47367467440,True,142253000,952500,143205500,False
6607,validator_35,112969112140,True,56597000,463020,57060020,False
6608,validator_12,114440581282,True,158642997,997580,159640577,True
6609,validator_15,288473920608,True,93402001,735780,94137781,True
6610,validator_36,112355155070,True,81081000,702810,81783810,False
6611,validator_32,47012681000,True,41242000,1033470,42275470,False
6612,validator_25,45353353130,True,231265000,18024630,249289630,False
6613,validator_17,185935084543,True,92412998,1312060,93725058,True
6614,validator_43,78130875690,True,210489000,957100,211446100,False
6615,validator_3,51166863227,True,66820001,662000,67482001,True
6616,validator_23,48862685881,True,90914003,188940,91102943,True
6617,validator_39,48647335440,True,136788000,453240,137241240,False
6618,validator_30,80545842000,True,126786000,2754290,129540290,False
6619,validator_0,49524472173,True,66042001,718150,66760151,True
6620,validator_22,81118619512,True,140784001,1329200,142113201,True
6621,validator_43,78263491920,True,131414000,1202230,132616230,False
6622,validator_8,49801544926,True,88491007,1338590,89829597,True
6623,validator_23,48935109750,True,67538999,4884870,72423869,True
6624,validator_18,116309655403,True,189067997,2236880,191304877,True
6625,validator_48,177359414620,True,138829000,908970,139737970,False
6626,validator_5,82941358537,True,139109003,3349330,142458333,True
6627,validator_12,114547139461,True,101184999,5373180,106558179,True
6628,validator_3,51337089856,True,168666999,1559630,170226629,True
6629,validator_14,118123893219,True,72116000,133400,72249400,True
6630,validator_32,47155388400,True,136236000,6471400,142707400,False
6631,validator_12,114722341488,True,174638997,563030,175202027,True
6632,validator_10,49425875973,True,184618001,2108400,186726401,True
6633,validator_44,113431939580,True,102355000,1582700,103937700,False
6634,validator_39,48731748880,True,83115000,1298440,84413440,False
6635,validator_19,84964341742,True,130732005,2777190,133509195,True
6636,validator_20,46253947881,True,70649000,790200,71439200,True
6637,validator_32,47318352140,True,161522000,1441740,162963740,False
6638,validator_24,48235917906,True,158213999,1940180,160154179,True
6639,validator_27,114903384330,True,50747000,1134600,51881600,False
6640,validator_10,49529931210,True,102442997,1612240,104055237,True
6641,validator_7,84522305010,True,241816003,1641890,243457893,True
6642,validator_7,84708924954,True,177967004,8652940,186619944,True
6643,validator_22,81256469986,True,119049004,18801470,137850474,True
6644,validator_21,82362985692,True,143411999,375970,143787969,True
6645,validator_35,113076798140,True,91651000,16035000,107686000,False
6646,validator_5,83114789839,True,172154002,1277300,173431302,True
6647,validator_18,116507499004,True,196666001,1177600,197843601,True
6648,validator_35,113294449540,True,209498000,8153400,217651400,False
6649,validator_16,47620899992,True,172392000,577100,172969100,True
6650,validator_16,47718932768,True,96202996,1829780,98032776,True
6651,validator_29,44133319350,True,76175000,1090180,77265180,False
6652,validator_24,48356855804,True,102327998,18609900,120937898,True
6653,validator_10,49660493349,True,129511999,1050140,130562139,True
6654,validator_17,186068425543,True,131701000,1640000,133341000,True
6655,validator_47,79237130830,True,87539000,1022140,88561140,False
6656,validator_2,52095346106,True,170813998,1090360,171904358,True
6657,validator_23,49175858840,True,239123000,1626090,240749090,True
6658,validator_35,113412963920,True,118274000,240380,118514380,False
6659,validator_41,81344296870,True,128910000,683910,129593910,False
6660,validator_25,45494018930,True,139879000,786800,140665800,False
6661,validator_17,186337481186,True,267723003,1332640,269055643,True
6662,validator_31,178837218490,True,79434000,1315300,80749300,False
6663,validator_30,80714115630,True,149184000,19089630,168273630,False
6664,validator_34,277548652610,True,134117000,1183100,135300100,False
6665,validator_16,47850455150,True,130070002,1452380,131522382,True
6666,validator_16,48026521801,True,174014001,2052650,176066651,True
6667,validator_0,49678486168,True,153083995,930000,154013995,True
6668,validator_30,80836163060,True,121321000,726430,122047430,False
6669,validator_26,47651421980,True,61035000,7853200,68888200,False
6670,validator_27,115011018570,True,99845000,7789240,107634240,False
6671,validator_48,177469102420,True,108139000,1548800,109687800,False
6672,validator_35,113570679520,True,157023000,692600,157715600,False
6673,validator_23,49350458339,True,173385999,1213500,174599499,True
6674,validator_42,47459443340,True,84239000,7736900,91975900,False
6675,validator_43,78426267870,True,156269000,6506950,162775950,False
6676,validator_27,115124646070,True,93563000,20064500,113627500,False
6677,validator_7,84870269312,True,159288998,2055360,161344358,True
6678,validator_44,113651379060,True,218221000,1218480,219439480,False
6679,validator_28,45020379620,True,76402000,767230,77169230,False
6680,validator_17,186538386727,True,186395001,14510540,200905541,True
6681,validator_33,44250763140,True,125589000,2291000,127880000,False
6682,validator_0,49801884797,True,122535999,862630,123398629,True
6683,validator_27,115263926670,True,137496000,1784600,139280600,False
6684,validator_35,113712239850,True,138968000,2592330,141560330,False
6685,validator_29,44286019750,True,132986000,19714400,152700400,False
6686,validator_22,81428857256,True,172051000,336270,172387270,True
6687,validator_35,113819229650,True,97546000,9443800,106989800,False
6688,validator_38,45570254940,True,134984000,5670900,140654900,False
6689,validator_11,49777527358,True,140786998,8830270,149617268,True
6690,validator_19,85106737127,True,136077005,6318380,142395385,True
6691,validator_31,178918494430,True,81237000,38940,81275940,False
6692,validator_46,111150763440,True,75692000,1860700,77552700,False
6693,validator_44,113732290690,True,79480000,1431630,80911630,False
6694,validator_7,85008483046,True,136991994,1221740,138213734,True
6695,validator_46,111216558940,True,63922000,1873500,65795500,False
6696,validator_36,112420416090,True,64140000,1121020,65261020,False
6697,validator_6,49190469142,True,144281996,5276380,149558376,True
6698,validator_37,79008932040,True,53260000,23159700,76419700,False
6699,validator_31,179053635860,True,130590000,4551430,135141430,False
6700,validator_34,277649166210,True,99431000,1082600,100513600,False
6701,validator_18,116721014899,True,213126995,388900,213515895,True
6702,validator_3,51445085159,True,85424003,22571300,107995303,True
6703,validator_38,45762016440,True,190687000,1074500,191761500,False
6704,validator_0,49962720237,True,160817000,18440,160835440,True
6705,validator_39,48877897870,True,144979000,1169990,146148990,False
6706,validator_41,81406354950,True,43250000,18808080,62058080,False
6707,validator_1,82903858191,True,189983004,1922600,191905604,True
6708,validator_3,51609711163,True,163785004,841000,164626004,True
6709,validator_13,47076092793,True,109289005,1579520,110868525,True
6710,validator_18,116806085801,True,83730002,1340900,85070902,True
6711,validator_9,50172436862,True,53384997,786800,54171797,True
6712,validator_37,79122888320,True,112353000,1603280,113956280,False
6713,validator_1,83054189092,True,137928001,12402900,150330901,True
6714,validator_20,46421118061,True,166135000,1035180,167170180,True
6715,validator_48,177542879420,True,72088000,1689000,73777000,False
6716,validator_14,118243264917,True,118370998,1000700,119371698,True
6717,validator_36,112588394890,True,167314000,664800,167978800,False
6718,validator_6,49359514241,True,151005999,18039100,169045099,True
6719,validator_5,83280899375,True,157595996,8513540,166109536,True
6720,validator_44,113888903290,True,155153000,1459600,156612600,False
6721,validator_48,177649343020,True,105350000,1113600,106463600,False
6722,validator_9,50252158765,True,65755003,13966900,79721903,True
6723,validator_5,83386391872,True,104497997,994500,105492497,True
6724,validator_1,83239545893,True,180284001,5072800,185356801,True
6725,validator_48,177726483120,True,76131000,1009100,77140100,False
6726,validator_41,81555972130,True,149074000,543180,149617180,False
6727,validator_47,79330347950,True,92000000,1217120,93217120,False
6728,validator_2,52209153358,True,108486992,5320260,113807252,True
6729,validator_18,116970657876,True,155122995,9449080,164572075,True
6730,validator_26,47839350120,True,185465000,2463140,187928140,False
6731,validator_24,48505068931,True,147203997,1009130,148213127,True
6732,validator_5,83606540710,True,218090998,2057840,220148838,True
6733,validator_20,46542803296,True,118942995,2742240,121685235,True
6734,validator_9,50400243805,True,147801000,284040,148085040,True
6735,validator_26,47939177020,True,98480000,1346900,99826900,False
6736,validator_26,48056403820,True,116676000,550800,117226800,False
6737,validator_31,179116125860,True,60564000,1926000,62490000,False
6738,validator_1,83315570551,True,56930998,19093660,76024658,True
6739,validator_37,79212817420,True,89274000,655100,89929100,False
6740,validator_45,45478249690,True,99011000,1328540,100339540,False
6741,validator_44,113945386480,True,56100000,383190,56483190,False
6742,validator_15,288540649226,True,65963998,764620,66728618,True
6743,validator_27,115316648870,True,51929000,793200,52722200,False
6744,validator_37,79304930520,True,88670000,3443100,92113100,False
6745,validator_8,49865845627,True,63756001,544700,64300701,True
6746,validator_1,83538722044,True,222532003,619490,223151493,True
6747,validator_28,45267514550,True,245691000,1443930,247134930,False
6748,validator_41,81712641070,True,148053000,8615940,156668940,False
6749,validator_49,80599410480,True,113921000,393440,114314440,False
6750,validator_0,50079825165,True,115357998,1746930,117104928,True
6751,validator_14,118356694415,True,112509998,919500,113429498,True
6752,validator_5,83732063909,True,112162999,13360200,125523199,True
6753,validator_24,48563950234,True,57846003,1035300,58881303,True
6754,validator_18,117120623376,True,131958000,18007500,149965500,True
6755,validator_24,48681082634,True,115364000,1768400,117132400,True
6756,validator_33,44362053140,True,109470000,1820000,111290000,False
6757,validator_7,85114608525,True,105418999,706480,106125479,True
6758,validator_20,46685693206,True,135177000,7712910,142889910,True
6759,validator_36,112742709090,True,153447000,867200,154314200,False
6760,validator_43,78499220810,True,63827000,9125940,72952940,False
6761,validator_5,83912847047,True,179511998,1271140,180783138,True
6762,validator_4,49210731163,True,266469001,5960900,272429901,True
6763,validator_6,49521655960,True,161244999,896720,162141719,True
6764,validator_12,114969708686,True,245826998,1540200,247367198,True
6765,validator_13,47177369095,True,99618002,1658300,101276302,True
6766,validator_37,79414136520,True,107952000,1254000,109206000,False
6767,validator_41,81865829270,True,152977000,211200,153188200,False
6768,validator_46,111329777440,True,112339000,879500,113218500,False
6769,validator_2,52358279459,True,147966001,1160100,149126101,True
6770,validator_48,177844730960,True,110190000,8057840,118247840,False
6771,validator_39,48987177470,True,101296000,7983600,109279600,False
6772,validator_12,115205472917,True,229220001,6544230,235764231,True
6773,validator_44,114230825780,True,284581000,858300,285439300,False
6774,validator_48,177963740040,True,117562000,1447080,119009080,False
6775,validator_13,47275417694,True,96364999,1683600,98048599,True
6776,validator_27,115514780760,True,179689000,18442890,198131890,False
6777,validator_19,85250234923,True,142379996,1117800,143497796,True
6778,validator_38,45967057550,True,186654000,18387110,205041110,False
6779,validator_35,113874929960,True,49560000,6140310,55700310,False
6780,validator_20,46742794907,True,55372001,1729700,57101701,True
6781,validator_10,49750493957,True,89051998,948610,90000608,True
6782,validator_9,50599229342,True,191468997,7516540,198985537,True
6783,validator_8,49998552420,True,131629003,1077790,132706793,True
6784,validator_0,50159396908,True,78827003,744740,79571743,True
6785,validator_9,50699607342,True,99068000,1310000,100378000,True
6786,validator_23,49392838138,True,41359999,1019800,42379799,True
6787,validator_21,82550187207,True,167723995,19477520,187201515,True
6788,validator_14,118410989216,True,52856001,1438800,54294801,True
6789,validator_21,82667513527,True,116977000,349320,117326320,True
6790,validator_12,115396137250,True,189677003,987330,190664333,True
6791,validator_37,79599644020,True,184578000,929500,185507500,False
6792,validator_6,49583353360,True,59577000,2120400,61697400,True
6793,validator_43,78733180210,True,233323000,636400,233959400,False
6794,validator_26,48127169360,True,65498000,5267540,70765540,False
6795,validator_30,81035912560,True,198948000,801500,199749500,False
6796,validator_7,85240773630,True,123989005,2176100,126165105,True
6797,validator_12,115553506690,True,152541000,4828440,157369440,True
6798,validator_6,49703467702,True,119308002,806340,120114342,True
6799,validator_17,186737429557,True,188562000,10480830,199042830,True
6800,validator_30,81174204260,True,135851000,2440700,138291700,False
6801,validator_47,79415855290,True,82711000,2796340,85507340,False
6802,validator_22,81535326854,True,103436998,3032600,106469598,True
6803,validator_18,117300636373,True,160879997,19133000,180012997,True
6804,validator_30,81255754890,True,81381000,169630,81550630,False
6805,validator_35,113979081690,True,98498000,5653730,104151730,False
6806,validator_41,81939157970,True,71897000,1431700,73328700,False
6807,validator_30,81390930290,True,127056000,8119400,135175400,False
6808,validator_32,47468848470,True,149838000,658330,150496330,False
6809,validator_31,179192219820,True,74659000,1434960,76093960,False
6810,validator_26,48232487020,True,104731000,586660,105317660,False
6811,validator_40,48453147900,True,70166000,3003300,73169300,False
6812,validator_48,178100036940,True,135195000,1101900,136296900,False
6813,validator_29,44406359350,True,114987000,5352600,120339600,False
6814,validator_41,82084943300,True,144624000,1161330,145785330,False
6815,validator_36,112981190790,True,236301000,2180700,238481700,False
6816,validator_44,114377111340,True,138391000,7894560,146285560,False
6817,validator_44,114548660940,True,148402000,23147600,171549600,False
6818,validator_44,114664786370,True,115356000,769430,116125430,False
6819,validator_12,115652979389,True,98291999,1180700,99472699,True
6820,validator_8,50083691849,True,83975999,1163430,85139429,True
6821,validator_30,81486005290,True,93987000,1088000,95075000,False
6822,validator_9,50850101146,True,149833004,660800,150493804,True
6823,validator_18,117451430292,True,130346999,20446920,150793919,True
6824,validator_14,118514619660,True,103447004,183440,103630444,True
6825,validator_48,178255053840,True,134510000,20506900,155016900,False
6826,validator_39,49115971500,True,127570000,1224030,128794030,False
6827,validator_1,83692266132,True,148553998,4990090,153544088,True
6828,validator_34,277816652880,True,165891000,1595670,167486670,False
6829,validator_4,49258415200,True,46488997,1195040,47684037,True
6830,validator_22,81757881234,True,197137000,25417380,222554380,True
6831,validator_32,47571657570,True,101876000,933100,102809100,False
6832,validator_44,114773535070,True,108165000,583700,108748700,False
6833,validator_11,49951861554,True,172278996,2055200,174334196,True
6834,validator_19,85431244382,True,173548999,7460460,181009459,True
6835,validator_49,80705892780,True,87944000,18538300,106482300,False
6836,validator_48,178333740540,True,77415000,1271700,78686700,False
6837,validator_11,50064417280,True,111180996,1374730,112555726,True
6838,validator_23,49529891736,True,131962998,5090600,137053598,True
6839,validator_26,48333663520,True,100266000,910500,101176500,False
6840,validator_17,186846840317,True,109351000,59760,109410760,True
6841,validator_38,46061411550,True,86031000,8323000,94354000,False
6842,validator_6,49905572967,True,199037005,3068260,202105265,True
6843,validator_37,79700777520,True,100231000,902500,101133500,False
6844,validator_32,47650953250,True,73185000,6110680,79295680,False
6845,validator_40,48522916500,True,68317000,1451600,69768600,False
6846,validator_8,50152103151,True,67211002,1200300,68411302,True
6847,validator_27,115639894490,True,124401000,712730,125113730,False
6848,validator_9,51056038743,True,197164997,8772600,205937597,True
6849,validator_7,85427505763,True,186268003,464130,186732133,True
6850,validator_3,51790694041,True,150002998,30979880,180982878,True
6851,validator_24,48765554237,True,83215003,1256600,84471603,True
6852,validator_3,51914664342,True,122308001,1662300,123970301,True
6853,validator_8,50402171052,True,223794001,26273900,250067901,True
6854,validator_16,48118931010,True,90203999,2205210,92409209,True
6855,validator_38,46191994440,True,121788000,8794890,130582890,False
6856,validator_41,82237813470,True,152362000,508170,152870170,False
6857,validator_22,81864024033,True,105223999,918800,106142799,True
6858,validator_48,178437113640,True,101693000,1680100,103373100,False
6859,validator_18,117627565633,True,167629001,8506340,176135341,True
6860,validator_7,85602290563,True,173864000,920800,174784800,True
6861,validator_31,179350954120,True,153685000,5049300,158734300,False
6862,validator_19,85585670888,True,154227006,199500,154426506,True
6863,validator_7,85685752364,True,81861001,1600800,83461801,True
6864,validator_21,82863719710,True,172476003,23730180,196206183,True
6865,validator_29,44500351550,True,93586000,406200,93992200,False
6866,validator_46,111520502940,True,184921000,5804500,190725500,False
6867,validator_21,83061885288,True,195742998,2422580,198165578,True
6868,validator_20,46897234248,True,154085001,354340,154439341,True
6869,validator_31,179478375850,True,126022000,1399730,127421730,False
6870,validator_24,48864251769,True,96028002,2669530,98697532,True
6871,validator_49,80844616780,True,136346000,2378000,138724000,False
6872,validator_21,83165637422,True,84686004,19066130,103752134,True
6873,validator_2,52504821752,True,145600003,942290,146542293,True
6874,validator_4,49395566734,True,132003004,5148530,137151534,True
6875,validator_18,117835612551,True,200553998,7492920,208046918,True
6876,validator_29,44649328580,True,148731000,246030,148977030,False
6877,validator_47,79563437290,True,139929000,7653000,147582000,False
6878,validator_24,48990683190,True,124776001,1655420,126431421,True
6879,validator_8,50675158093,True,272332001,655040,272987041,True
6880,validator_6,50064034873,True,157709006,752900,158461906,True
6881,validator_14,118598849290,True,79904000,4325630,84229630,True
6882,validator_39,49250299100,True,134247000,80600,134327600,False
6883,validator_32,47755136230,True,103411000,771980,104182980,False
6884,validator_34,277910077580,True,92450000,974700,93424700,False
6885,validator_28,45309874070,True,40914000,1445520,42359520,False
6886,validator_44,114974866270,True,188476000,12855200,201331200,False
6887,validator_14,118840457389,True,223743999,17864100,241608099,True
6888,validator_7,85750522364,True,64390000,380000,64770000,True
6889,validator_34,278070689440,True,158548000,2063860,160611860,False
6890,validator_9,51220425170,True,163489997,896430,164386427,True
6891,validator_44,115088001850,True,112029000,1106580,113135580,False
6892,validator_7,85850227344,True,75964000,23740980,99704980,True
6893,validator_5,84005697287,True,90667000,2183240,92850240,True
6894,validator_0,50261424229,True,101659001,368320,102027321,True
6895,validator_39,49295699200,True,45094000,306100,45400100,False
6896,validator_27,115686019540,True,44437000,1688050,46125050,False
6897,validator_22,81952977354,True,81028001,7925320,88953321,True
6898,validator_5,84119871035,True,113943998,229750,114173748,True
6899,validator_11,50206099101,True,117506001,24175820,141681821,True
6900,validator_10,49998615756,True,236155999,11965800,248121799,True
6901,validator_28,45414410000,True,98725000,5810930,104535930,False
6902,validator_32,47809338830,True,52311000,1891600,54202600,False
6903,validator_5,84195756483,True,74978998,906450,75885448,True
6904,validator_16,48291783109,True,153828999,19023100,172852099,True
6905,validator_19,85718347871,True,131291003,1385980,132676983,True
6906,validator_28,45499792900,True,83132000,2250900,85382900,False
6907,validator_37,79889087400,True,187679000,630880,188309880,False
6908,validator_3,52118074576,True,202380004,1030230,203410234,True
6909,validator_41,82350783140,True,111860000,1109670,112969670,False
6910,validator_19,85846345675,True,127768004,229800,127997804,True
6911,validator_26,48447180620,True,111855000,1662100,113517100,False
6912,validator_45,45685337990,True,203515000,3573300,207088300,False
6913,validator_37,79963377600,True,73730000,560200,74290200,False
6914,validator_5,84312706283,True,110071000,6878800,116949800,True
6915,validator_17,186994272796,True,146478999,953480,147432479,True
6916,validator_33,44571387370,True,208720000,614230,209334230,False
6917,validator_19,86085557317,True,238171002,1040640,239211642,True
6918,validator_25,45534065550,True,39306000,740620,40046620,False
6919,validator_31,179629771480,True,149323000,2072630,151395630,False
6920,validator_28,45615093300,True,113197000,2103400,115300400,False
6921,validator_45,45814283090,True,123368000,5577100,128945100,False
6922,validator_49,80970896010,True,124439000,1840230,126279230,False
6923,validator_6,50150761275,True,81470002,5256400,86726402,True
6924,validator_40,48584838000,True,42929000,18992500,61921500,False
6925,validator_38,46272376810,True,78938000,1444370,80382370,False
6926,validator_9,51301800070,True,61956000,19418900,81374900,True
6927,validator_42,47573353580,True,112504000,1406240,113910240,False
6928,validator_16,48426946637,True,116801998,18361530,135163528,True
6929,validator_14,118896424680,True,54419001,1548290,55967291,True
6930,validator_4,49503461435,True,106584001,1310700,107894701,True
6931,validator_19,86275605136,True,188507999,1539820,190047819,True
6932,validator_8,50813800976,True,136140993,2501890,138642883,True
6933,validator_37,80075182970,True,111213000,592370,111805370,False
6934,validator_35,114129298190,True,149683000,533500,150216500,False
6935,validator_45,45888877120,True,72490000,2104030,74594030,False
6936,validator_2,52659523254,True,152444002,2257500,154701502,True
6937,validator_13,47344971982,True,67237998,2316290,69554288,True
6938,validator_15,288736607230,True,194467004,1491000,195958004,True
6939,validator_44,115278656950,True,171812000,18843100,190655100,False
6940,validator_48,178564768670,True,122938000,4717030,127655030,False
6941,validator_17,187153605797,True,154083001,5250000,159333001,True
6942,validator_23,49653398833,True,108524997,14982100,123507097,True
6943,validator_37,80171792190,True,94570000,2039220,96609220,False
6944,validator_15,288896863229,True,159472999,783000,160255999,True
6945,validator_0,50332298336,True,70407997,466110,70874107,True
6946,validator_36,113089078820,True,105947000,1941030,107888030,False
6947,validator_49,81044122150,True,65443000,7783140,73226140,False
6948,validator_25,45627577090,True,85965000,7546540,93511540,False
6949,validator_35,114312550290,True,181502000,1750100,183252100,False
6950,validator_1,83876555735,True,166310003,17979600,184289603,True
6951,validator_46,111592428140,True,70756000,1169200,71925200,False
6952,validator_31,179764082380,True,129762000,4548900,134310900,False
6953,validator_42,47707913120,True,133939000,620540,134559540,False
6954,validator_20,47031026370,True,132430002,1362120,133792122,True
6955,validator_38,46405840630,True,130611000,2852820,133463820,False
6956,validator_22,82032601587,True,74151003,5473230,79624233,True
6957,validator_23,49742482053,True,83812000,5271220,89083220,True
6958,validator_15,289020990829,True,123824000,303600,124127600,True
6959,validator_22,82183658790,True,149811003,1246200,151057203,True
6960,validator_8,50952321072,True,137296996,1223100,138520096,True
6961,validator_6,50326683772,True,157819997,18102500,175922497,True
6962,validator_32,47864468730,True,53378000,1751900,55129900,False
6963,validator_41,82435721970,True,84114000,824830,84938830,False
6964,validator_23,49908810153,True,163328000,3000100,166328100,True
6965,validator_18,117945022966,True,108341995,1068420,109410415,True
6966,validator_18,118053556767,True,107483001,1050800,108533801,True
6967,validator_16,48553685818,True,117336001,9403180,126739181,True
6968,validator_26,48623314850,True,175461000,673230,176134230,False
6969,validator_14,119021785409,True,123397999,1962730,125360729,True
6970,validator_2,52851032557,True,170879003,20630300,191509303,True
6971,validator_34,278138529140,True,67114000,725700,67839700,False
6972,validator_15,289175929810,True,147318001,7620980,154938981,True
6973,validator_41,82535178570,True,98764000,692600,99456600,False
6974,validator_31,179825476880,True,60987000,407500,61394500,False
6975,validator_14,119189954008,True,166762999,1405600,168168599,True
6976,validator_22,82299183592,True,107907002,7617800,115524802,True
6977,validator_11,50362873889,True,155027998,1746790,156774788,True
6978,validator_10,50241409755,True,227079999,15714000,242793999,True
6979,validator_8,51024015053,True,70823001,870980,71693981,True
6980,validator_17,187244788296,True,89143999,2038500,91182499,True
6981,validator_5,84447507884,True,133684001,1117600,134801601,True
6982,validator_41,82647814570,True,111639000,997000,112636000,False
6983,validator_34,278200906340,True,54762000,7615200,62377200,False
6984,validator_18,118198273265,True,135850998,8865500,144716498,True
6985,validator_8,51143399756,True,117651003,1733700,119384703,True
6986,validator_2,52997480652,True,145616995,831100,146448095,True
6987,validator_32,47928642830,True,63341000,833100,64174100,False
6988,validator_46,111711433540,True,117530000,1475400,119005400,False
6989,validator_18,118247081125,True,48366000,441860,48807860,True
6990,validator_22,82399639923,True,99741001,715330,100456331,True
6991,validator_36,113174520520,True,82022000,3419700,85441700,False
6992,validator_9,51514994758,True,211394998,1799690,213194688,True
6993,validator_20,47161571142,True,129787002,757770,130544772,True
6994,validator_14,119366150209,True,174971001,1225200,176196201,True
6995,validator_46,111877281750,True,156955000,8893210,165848210,False
6996,validator_24,49068730593,True,77739003,308400,78047403,True
6997,validator_47,79626883030,True,62823000,622740,63445740,False
6998,validator_43,78875132240,True,141138000,814030,141952030,False
6999,validator_33,44715359950,True,141815000,2157580,143972580,False
7000,validator_36,113223101820,True,46646000,1935300,48581300,False
7001,validator_14,119419436809,True,52721000,565600,53286600,True
7002,validator_45,45998835920,True,105062000,4896800,109958800,False
7003,validator_2,53157697846,True,155500994,4716200,160217194,True
7004,validator_45,46138492520,True,139135000,521600,139656600,False
7005,validator_32,48185856130,True,256956000,257300,257213300,False
7006,validator_23,50051123580,True,137604997,4708430,142313427,True
7007,validator_16,48629919919,True,75152001,1082100,76234101,True
7008,validator_15,289277971009,True,101529999,511200,102041199,True
7009,validator_3,52230120474,True,110794998,1250900,112045898,True
7010,validator_36,113339925360,True,98445000,18378540,116823540,False
7011,validator_31,179935594700,True,101220000,8897820,110117820,False
7012,validator_34,278294692440,True,75388000,18398100,93786100,False
7013,validator_37,80330734490,True,157600000,1342300,158942300,False
7014,validator_36,113509353470,True,168627000,801110,169428110,False
7015,validator_42,47790466820,True,81234000,1319700,82553700,False
7016,validator_28,45713451000,True,96100000,2257700,98357700,False
7017,validator_46,112042817150,True,139207000,26328400,165535400,False
7018,validator_7,85905360319,True,54104995,1027980,55132975,True
7019,validator_38,46569769570,True,162176000,1752940,163928940,False
7020,validator_11,50651356888,True,263323999,25159000,288482999,True
7021,validator_14,119529381834,True,109001005,944020,109945025,True
7022,validator_31,180087388360,True,146217000,5576660,151793660,False
7023,validator_13,47534760780,True,188998998,789800,189788798,True
7024,validator_11,50774314594,True,122161006,796700,122957706,True
7025,validator_38,46694314070,True,122292000,2252500,124544500,False
7026,validator_17,187338851985,True,88558989,5504700,94063689,True
7027,validator_43,79042854810,True,149015000,18707570,167722570,False
7028,validator_36,113646540170,True,135846000,1340700,137186700,False
7029,validator_15,289370269112,True,91237003,1061100,92298103,True
7030,validator_7,86013274660,True,106123001,1791340,107914341,True
7031,validator_18,118383933560,True,135972005,880430,136852435,True
7032,validator_3,52490037713,True,240856999,19060240,259917239,True
7033,validator_30,81606707870,True,118808000,1894580,120702580,False
7034,validator_17,187472706621,True,132371996,1482640,133854636,True
7035,validator_48,178702151870,True,131870000,5513200,137383200,False
7036,validator_8,51253648779,True,101503993,8745030,110249023,True
7037,validator_22,82539789024,True,135485001,4664100,140149101,True
7038,validator_34,278408921530,True,96130000,18099090,114229090,False
7039,validator_33,44812654850,True,88519000,8775900,97294900,False
7040,validator_15,289499989412,True,111430000,18290300,129720300,True
7041,validator_41,82713863200,True,64596000,1452630,66048630,False
7042,validator_12,115831403425,True,176855996,1568040,178424036,True
7043,validator_31,180192194450,True,103074000,1732090,104806090,False
7044,validator_6,50514835675,True,182895003,5256900,188151903,True
7045,validator_18,118611528361,True,226370001,1224800,227594801,True
7046,validator_49,81180567350,True,135156000,1289200,136445200,False
7047,validator_3,52728748609,True,236834996,1875900,238710896,True
7048,validator_45,46185941420,True,46619000,829900,47448900,False
7049,validator_5,84701013875,True,240803001,12702990,253505991,True
7050,validator_46,112179768670,True,128416000,8535520,136951520,False
7051,validator_43,79140335710,True,96339000,1141900,97480900,False
7052,validator_7,86065701503,True,51825003,601840,52426843,True
7053,validator_12,115900533920,True,67698005,1432490,69130495,True
7054,validator_44,115380282950,True,100801000,825000,101626000,False
7055,validator_9,51647278339,True,131226001,1057580,132283581,True
7056,validator_17,187626964501,True,153095000,1162880,154257880,True
7057,validator_21,83309952938,True,143143996,1171520,144315516,True
7058,validator_26,48772443020,True,140440000,8688170,149128170,False
7059,validator_18,118744273563,True,127769992,4975210,132745202,True
7060,validator_33,45019865110,True,201907000,5303260,207210260,False
7061,validator_39,49407846620,True,109259000,2888420,112147420,False
7062,validator_34,278493908930,True,83620000,1367400,84987400,False
7063,validator_44,115575438750,True,194422000,733800,195155800,False
7064,validator_35,114387572820,True,74819000,203530,75022530,False
7065,validator_30,81680053310,True,72608000,737440,73345440,False
7066,validator_10,50356158985,True,114561000,188230,114749230,True
7067,validator_6,50594077771,True,72845996,6396100,79242096,True
7068,validator_31,180266310530,True,73360000,756080,74116080,False
7069,validator_39,49523238020,True,108378000,7013400,115391400,False
7070,validator_11,50920487580,True,144695006,1477980,146172986,True
7071,validator_1,84052129967,True,175178002,396230,175574232,True
7072,validator_12,116165248216,True,255767996,8946300,264714296,True
7073,validator_47,79795327530,True,166348000,2096500,168444500,False
7074,validator_48,178944831710,True,241197000,1482840,242679840,False
7075,validator_7,86203518702,True,136371999,1445200,137817199,True
7076,validator_32,48261128130,True,74474000,798000,75272000,False
7077,validator_38,46780649370,True,85572000,763300,86335300,False
7078,validator_31,180334198060,True,67834000,53530,67887530,False
7079,validator_14,119732116134,True,193508000,9226300,202734300,True
7080,validator_33,45046166910,True,25823000,478800,26301800,False
7081,validator_29,44732352880,True,81370000,1654300,83024300,False
7082,validator_26,48891024300,True,117427000,1154280,118581280,False
7083,validator_49,81326142750,True,144442000,1133400,145575400,False
7084,validator_30,81809848110,True,128840000,954800,129794800,False
7085,validator_34,278578297630,True,83539000,849700,84388700,False
7086,validator_18,118946204846,True,201230003,701280,201931283,True
7087,validator_12,116238475318,True,71898002,1329100,73227102,True
7088,validator_34,278704809910,True,125905000,607280,126512280,False
7089,validator_49,81611349810,True,284692000,515060,285207060,False
7090,validator_20,47362241923,True,200262001,408780,200670781,True
7091,validator_23,50160288221,True,108257001,907640,109164641,True
7092,validator_32,48342871230,True,81096000,647100,81743100,False
7093,validator_46,112341841690,True,160481000,1592020,162073020,False
7094,validator_47,79920369630,True,124007000,1035100,125042100,False
7095,validator_49,81719050640,True,92552000,15148830,107700830,False
7096,validator_18,119151557843,True,203671997,1681000,205352997,True
7097,validator_48,179029492290,True,84154000,506580,84660580,False
7098,validator_17,187754753509,True,119460008,8329000,127789008,True
7099,validator_20,47449498926,True,81573003,5684000,87257003,True
7100,validator_27,115766888240,True,79880000,988700,80868700,False
7101,validator_17,187798578509,True,43291000,534000,43825000,True
7102,validator_43,79244340310,True,85726000,18278600,104004600,False
7103,validator_22,82881052423,True,322642999,18620400,341263399,True
7104,validator_41,82864413500,True,142908000,7642300,150550300,False
7105,validator_43,79319129310,True,74164000,625000,74789000,False
7106,validator_27,115862889930,True,94233000,1768690,96001690,False
7107,validator_8,51360099509,True,106001000,449730,106450730,True
7108,validator_28,45879190800,True,165202000,537800,165739800,False
7109,validator_37,80427009280,True,87887000,8387790,96274790,False
7110,validator_15,289604226144,True,102692002,1544730,104236732,True
7111,validator_45,46283625120,True,88665000,9018700,97683700,False
7112,validator_49,82004394500,True,277251000,8092860,285343860,False
7113,validator_24,49157340294,True,88111001,498700,88609701,True
7114,validator_23,50280223949,True,114717998,5217730,119935728,True
7115,validator_48,179137238890,True,107157000,589600,107746600,False
7116,validator_34,278802567040,True,96123000,1634130,97757130,False
7117,validator_17,187973727304,True,173197995,1950800,175148795,True
7118,validator_30,81888583610,True,77591000,1144500,78735500,False
7119,validator_29,44786389680,True,51339000,2697800,54036800,False
7120,validator_10,50570387230,True,211889005,2339240,214228245,True
7121,validator_46,112471653490,True,126839000,2972800,129811800,False
7122,validator_40,48701940470,True,109097000,8005470,117102470,False
7123,validator_5,84761826694,True,60413999,398820,60812819,True
7124,validator_47,80085516670,True,162657000,2490040,165147040,False
7125,validator_33,45116339010,True,69048000,1124100,70172100,False
7126,validator_4,49682183537,True,177627002,1095100,178722102,True
7127,validator_4,49894751543,True,211989006,579000,212568006,True
7128,validator_30,82005635710,True,116456000,596100,117052100,False
7129,validator_37,80530902280,True,102338000,1555000,103893000,False
7130,validator_29,44923657160,True,135553000,1714480,137267480,False
7131,validator_37,80608865460,True,76666000,1297180,77963180,False
7132,validator_16,48704015519,True,71768000,2327600,74095600,True
7133,validator_19,86338051131,True,54676995,7769000,62445995,True
7134,validator_31,180541443960,True,188369000,18876900,207245900,False
7135,validator_31,180710169960,True,148696000,20030000,168726000,False
7136,validator_40,48896802100,True,194607000,254630,194861630,False
7137,validator_28,46067988900,True,188684000,114100,188798100,False
7138,validator_4,50034148841,True,137239998,2157300,139397298,True
7139,validator_26,48965364800,True,71916000,2424500,74340500,False
7140,validator_39,49629482050,True,104677000,1567030,106244030,False
7141,validator_5,84938090936,True,156070002,20194240,176264242,True
7142,validator_31,180765347260,True,55121000,56300,55177300,False
7143,validator_6,50676444371,True,82004000,362600,82366600,True
7144,validator_42,47917864660,True,126806000,591840,127397840,False
7145,validator_17,188077623486,True,95707002,8189180,103896182,True
7146,validator_2,53318106723,True,157966997,2441880,160408877,True
7147,validator_31,180958259380,True,187590000,5322120,192912120,False
7148,validator_49,82125402440,True,101945000,19062940,121007940,False
7149,validator_26,49096331400,True,123838000,7128600,130966600,False
7150,validator_12,116309889016,True,70390998,1022700,71413698,True
7151,validator_18,119363138985,True,211213002,368140,211581142,True
7152,validator_22,83083726365,True,201904002,769940,202673942,True
7153,validator_0,50419927971,True,78417995,9211640,87629635,True
7154,validator_8,51562665588,True,197804999,4761080,202566079,True
7155,validator_47,80206695170,True,113673000,7505500,121178500,False
7156,validator_47,80320447070,True,111057000,2694900,113751900,False
7157,validator_18,119499427918,True,134251003,2037930,136288933,True
7158,validator_8,51605861087,True,41669999,1525500,43195499,True
7159,validator_47,80369035470,True,47585000,1003400,48588400,False
7160,validator_43,79490418040,True,152305000,18983730,171288730,False
7161,validator_38,46890566700,True,103493000,6424330,109917330,False
7162,validator_48,179186112690,True,47904000,969800,48873800,False
7163,validator_30,82148173210,True,141001000,1536500,142537500,False
7164,validator_9,51789120173,True,141023004,818830,141841834,True
7165,validator_34,279013516440,True,208395000,2554400,210949400,False
7166,validator_14,119862992334,True,127958000,2918200,130876200,True
7167,validator_15,289695919365,True,90129001,1564220,91693221,True
7168,validator_44,115691815880,True,115840000,537130,116377130,False
7169,validator_17,188220018193,True,141384007,1010700,142394707,True
7170,validator_40,48966906580,True,68835000,1269480,70104480,False
7171,validator_44,115795915980,True,85585000,18515100,104100100,False
7172,validator_33,45218697510,True,101428000,930500,102358500,False
7173,validator_11,50971840817,True,50198997,1154240,51353237,True
7174,validator_36,113770900770,True,123264000,1096600,124360600,False
7175,validator_7,86345983605,True,121881003,20583900,142464903,True
7176,validator_31,181104542580,True,145278000,1005200,146283200,False
7177,validator_32,48530023020,True,168330000,18821790,187151790,False
7178,validator_22,83299822049,True,214037004,2058680,216095684,True
7179,validator_36,113841546570,True,70152000,493800,70645800,False
7180,validator_31,181223798280,True,115169000,4086700,119255700,False
7181,validator_12,116527147623,True,215146007,2112600,217258607,True
7182,validator_12,116755397753,True,224019000,4231130,228250130,True
7183,validator_15,289867665097,True,170158002,1587730,171745732,True
7184,validator_12,116995667251,True,239104998,1164500,240269498,True
7185,validator_39,49786276840,True,153984000,2810790,156794790,False
7186,validator_22,83427126447,True,107395998,19908400,127304398,True
7187,validator_32,48640590120,True,108499000,2068100,110567100,False
7188,validator_24,49290602728,True,125299004,7963430,133262434,True
7189,validator_17,188319544789,True,91070996,8455600,99526596,True
7190,validator_20,47568437624,True,109839998,9098700,118938698,True
7191,validator_34,279138592440,True,123280000,1796000,125076000,False
7192,validator_34,279222618840,True,82339000,1687400,84026400,False
7193,validator_7,86465175737,True,117654002,1538130,119192132,True
7194,validator_8,51745665167,True,137368000,2436080,139804080,True
7195,validator_17,188449389700,True,128478001,1366910,129844911,True
7196,validator_47,80554858310,True,184649000,1173840,185822840,False
7197,validator_34,279373997640,True,132766000,18612800,151378800,False
7198,validator_9,51965676074,True,176516001,39900,176555901,True
7199,validator_45,46417358920,True,128940000,4793800,133733800,False
7200,validator_17,188631692526,True,181828996,473830,182302826,True
7201,validator_42,48038002260,True,100890000,19247600,120137600,False
7202,validator_3,52908668237,True,167269998,12649630,179919628,True
7203,validator_17,188766635930,True,127015004,7928400,134943404,True
7204,validator_19,86451593129,True,104127998,9414000,113541998,True
7205,validator_16,48933668543,True,221181004,8472020,229653024,True
7206,validator_11,51134552121,True,160737004,1974300,162711304,True
7207,validator_0,50539166761,True,117056000,2182790,119238790,True
7208,validator_35,114489322480,True,97830000,3919660,101749660,False
7209,validator_25,45796561090,True,168118000,866000,168984000,False
7210,validator_30,82232055160,True,75529000,8352950,83881950,False
7211,validator_39,49891298430,True,103511000,1510590,105021590,False
7212,validator_13,47641345713,True,105260003,1324930,106584933,True
7213,validator_1,84128645167,True,54039000,22476200,76515200,True
7214,validator_4,50136971045,True,83120004,19702200,102822204,True
7215,validator_14,120082895552,True,201941998,17961220,219903218,True
7216,validator_13,47780712592,True,137100999,2265880,139366879,True
7217,validator_25,45925407490,True,126812000,2034400,128846400,False
7218,validator_41,82952367790,True,87725000,229290,87954290,False
7219,validator_5,85086071632,True,146724996,1255700,147980696,True
7220,validator_17,188828479631,True,60958001,885700,61843701,True
7221,validator_13,47871927988,True,90047996,1167400,91215396,True
7222,validator_11,51266705617,True,131928996,224500,132153496,True
7223,validator_40,49108529180,True,132308000,9314600,141622600,False
7224,validator_22,83607774867,True,179553000,1095420,180648420,True
7225,validator_4,50362501584,True,206580999,18949540,225530539,True
7226,validator_18,119553292118,True,52580000,1284200,53864200,True
7227,validator_28,46233308640,True,163228000,2091740,165319740,False
7228,validator_34,279507075590,True,126726000,6351950,133077950,False
7229,validator_47,80641688230,True,68609000,18220920,86829920,False
7230,validator_20,47706433721,True,135673997,2322100,137996097,True
7231,validator_25,46021265170,True,94365000,1492680,95857680,False
7232,validator_37,80741390850,True,132009000,516390,132525390,False
7233,validator_46,112525465490,True,53341000,471000,53812000,False
7234,validator_0,50672571758,True,131308997,2096000,133404997,True
7235,validator_20,47766351511,True,58288000,1629790,59917790,True
7236,validator_1,84274627767,True,145530000,452600,145982600,True
7237,validator_9,52186587434,True,202065000,18846360,220911360,True
7238,validator_12,117263612453,True,267304002,641200,267945202,True
7239,validator_2,53424114950,True,97896997,8111230,106008227,True
7240,validator_4,50538502242,True,173723998,2276660,176000658,True
7241,validator_49,82273835940,True,147731000,702500,148433500,False
7242,validator_4,50719898438,True,180189996,1206200,181396196,True
7243,validator_6,50770010568,True,92223997,1342200,93566197,True
7244,validator_39,49976352770,True,84093000,961340,85054340,False
7245,validator_15,290059954547,True,188860000,3429450,192289450,True
7246,validator_35,114638657110,True,139911000,9423630,149334630,False
7247,validator_27,115968625810,True,104347000,1388880,105735880,False
7248,validator_10,50722168451,True,132114001,19667220,151781221,True
7249,validator_49,82408147100,True,132774000,1537160,134311160,False
7250,validator_35,114818616450,True,174053000,5906340,179959340,False
7251,validator_37,80876809890,True,133990000,1429040,135419040,False
7252,validator_9,52367753539,True,179649005,1517100,181166105,True
7253,validator_26,49233406300,True,135810000,1264900,137074900,False
7254,validator_45,46478667520,True,59317000,1991600,61308600,False
7255,validator_13,47941381991,True,69076003,378000,69454003,True
7256,validator_29,45082333990,True,157529000,1147830,158676830,False
7257,validator_33,45390884150,True,171609000,577640,172186640,False
7258,validator_3,53004239368,True,94629001,942130,95571131,True
7259,validator_46,112688830910,True,162722000,643420,163365420,False
7260,validator_6,50895501364,True,122967996,2522800,125490796,True
7261,validator_17,188875221932,True,28023001,18719300,46742301,True
7262,validator_31,181357352680,True,133005000,549400,133554400,False
7263,validator_19,86611525953,True,154326004,5606820,159932824,True
7264,validator_35,114881148250,True,61389000,1142800,62531800,False
7265,validator_13,48074188592,True,113443001,19363600,132806601,True
7266,validator_24,49534308551,True,242130003,1575820,243705823,True
7267,validator_41,82998243890,True,43303000,2573100,45876100,False
7268,validator_26,49366475080,True,131592000,1476780,133068780,False
7269,validator_1,84464844290,True,182274003,7942520,190216523,True
7270,validator_23,50470183846,True,187870997,2088900,189959897,True
7271,validator_7,86624476058,True,156735001,2565320,159300321,True
7272,validator_13,48225226190,True,149008998,2028600,151037598,True
7273,validator_46,112800686840,True,110159000,1696930,111855930,False
7274,validator_14,120186403253,True,102243001,1264700,103507701,True
7275,validator_39,50053988060,True,76435000,1200290,77635290,False
7276,validator_41,83074530890,True,75157000,1130000,76287000,False
7277,validator_12,117468021483,True,203930000,479030,204409030,True
7278,validator_49,82572759000,True,146039000,18572900,164611900,False
7279,validator_31,181529643300,True,171465000,825620,172290620,False
7280,validator_8,51845918774,True,99310997,942610,100253607,True
7281,validator_14,120342053151,True,154234998,1414900,155649898,True
7282,validator_29,45146298920,True,62199000,1765930,63964930,False
7283,validator_7,86705882460,True,81124002,282400,81406402,True
7284,validator_35,115022721280,True,133951000,7622030,141573030,False
7285,validator_18,119610112358,True,55083000,1737240,56820240,True
7286,validator_0,50814442100,True,140760002,1110340,141870342,True
7287,validator_14,120532322651,True,189257000,1012500,190269500,True
7288,validator_19,86751200350,True,136304997,3369400,139674397,True
7289,validator_42,48094615760,True,55901000,712500,56613500,False
7290,validator_18,119760483762,True,148663004,1708400,150371404,True
7291,validator_9,52508896979,True,140417000,726440,141143440,True
7292,validator_38,47006927180,True,115748000,612480,116360480,False
7293,validator_32,48751552320,True,107762000,3200200,110962200,False
7294,validator_38,47132996780,True,124984000,1085600,126069600,False
7295,validator_15,290169665249,True,108115002,1595700,109710702,True
7296,validator_0,50929872229,True,110169999,5260130,115430129,True
7297,validator_27,116140201210,True,164682000,6893400,171575400,False
7298,validator_47,80684028130,True,39907000,2432900,42339900,False
7299,validator_15,290262508798,True,92022999,820550,92843549,True
7300,validator_33,45500031790,True,108164000,983640,109147640,False
7301,validator_3,53169036772,True,163756004,1041400,164797404,True
7302,validator_15,290432604197,True,168041999,2053400,170095399,True
7303,validator_8,52106857456,True,258438002,2500680,260938682,True
7304,validator_0,51035410729,True,103355000,2183500,105538500,True
7305,validator_3,53346804271,True,177448999,318500,177767499,True
7306,validator_21,83388746508,True,78647000,146570,78793570,True
7307,validator_48,179241378030,True,47816000,7449340,55265340,False
7308,validator_15,290684960999,True,251862002,494800,252356802,True
7309,validator_19,86927821955,True,175959005,662600,176621605,True
7310,validator_13,48354636529,True,128936999,473340,129410339,True
7311,validator_19,87083405860,True,150360005,5223900,155583905,True
7312,validator_34,279663849890,True,133578000,23196300,156774300,False
7313,validator_42,48224025480,True,127131000,2278720,129409720,False
7314,validator_34,279708966040,True,40018000,5098150,45116150,False
7315,validator_29,45376160720,True,228496000,1365800,229861800,False
7316,validator_7,86825529063,True,118830003,816600,119646603,True
7317,validator_3,53528390691,True,179357000,2229420,181586420,True
7318,validator_27,116208264110,True,67724000,338900,68062900,False
7319,validator_26,49438203710,True,70868000,860630,71728630,False
7320,validator_4,50842337864,True,116396996,6042430,122439426,True
7321,validator_19,87209365958,True,124327998,1632100,125960098,True
7322,validator_42,48347383580,True,121532000,1826100,123358100,False
7323,validator_47,80804772720,True,118489000,2255590,120744590,False
7324,validator_4,51030907462,True,186604998,1964600,188569598,True
7325,validator_3,53610323288,True,81089997,842600,81932597,True
7326,validator_3,53661650930,True,50926002,401640,51327642,True
7327,validator_47,80935987420,True,130754000,460700,131214700,False
7328,validator_37,81020830070,True,141924000,2096180,144020180,False
7329,validator_31,181619413850,True,87694000,2076550,89770550,False
7330,validator_11,51543912614,True,270739997,6467000,277206997,True
7331,validator_21,83527489940,True,129738002,9005430,138743432,True
7332,validator_12,117587188823,True,118380000,787340,119167340,True
7333,validator_29,45573685620,True,178649000,18875900,197524900,False
7334,validator_47,81040620620,True,81528000,23105200,104633200,False
7335,validator_3,53853633459,True,191197999,784530,191982529,True
7336,validator_40,49290361610,True,181368000,464430,181832430,False
7337,validator_28,46295630440,True,43464000,18857800,62321800,False
7338,validator_15,290804603976,True,113455997,6186980,119642977,True
7339,validator_26,49600986450,True,161299000,1483740,162782740,False
7340,validator_31,181704993880,True,83509000,2071030,85580030,False
7341,validator_5,85198618600,True,109282998,3263970,112546968,True
7342,validator_1,84617800890,True,147804000,5152600,152956600,True
7343,validator_35,115133306980,True,108029000,2556700,110585700,False
7344,validator_15,290962085978,True,156772002,710000,157482002,True
7345,validator_20,48034350128,True,267560997,437620,267998617,True
7346,validator_8,52172307253,True,62027997,3421800,65449797,True
7347,validator_18,119853988443,True,88295001,5209680,93504681,True
7348,validator_35,115208977760,True,73973000,1697780,75670780,False
7349,validator_23,50594366429,True,121693003,2489580,124182583,True
7350,validator_30,82457023660,True,223102000,1866500,224968500,False
7351,validator_16,49128054143,True,193459000,926600,194385600,True
7352,validator_48,179320437430,True,78021000,1038400,79059400,False
7353,validator_8,52235645952,True,63270999,67700,63338699,True
7354,validator_4,51134460460,True,103286998,266000,103552998,True
7355,validator_25,46070510960,True,49065000,180790,49245790,False
7356,validator_3,54024324460,True,168581001,2110000,170691001,True
7357,validator_28,46429189410,True,131954000,1604970,133558970,False
7358,validator_0,51116261373,True,75866004,4984640,80850644,True
7359,validator_37,81114464270,True,74719000,18915200,93634200,False
7360,validator_22,83759368552,True,131932005,19661680,151593685,True
7361,validator_49,82733616800,True,159532000,1325800,160857800,False
7362,validator_36,113957818370,True,115183000,1088800,116271800,False
7363,validator_31,181896011880,True,189602000,1416000,191018000,False
7364,validator_7,86996444163,True,168664000,2251100,170915100,True
7365,validator_31,182000156710,True,97970000,6174830,104144830,False
7366,validator_17,188948648732,True,71629000,1797800,73426800,True
7367,validator_19,87305935057,True,72397999,24171100,96569099,True
7368,validator_0,51213032084,True,95071001,1699710,96770711,True
7369,validator_39,50142991750,True,66095000,22908690,89003690,False
7370,validator_1,84703014691,True,83593001,1620800,85213801,True
7371,validator_37,81228204770,True,112427000,1313500,113740500,False
7372,validator_48,179425138130,True,98269000,6431700,104700700,False
7373,validator_39,50260620050,True,99452000,18176300,117628300,False
7374,validator_31,182144090640,True,143783000,150930,143933930,False
7375,validator_22,83883859573,True,114768001,9723020,124491021,True
7376,validator_29,45702188420,True,128191000,311800,128502800,False
7377,validator_47,81113144490,True,70385000,2138870,72523870,False
7378,validator_3,54084568059,True,59356999,886600,60243599,True
7379,validator_39,50301362650,True,38551000,2191600,40742600,False
7380,validator_6,50991074725,True,94001001,1572360,95573361,True
7381,validator_15,291071306118,True,108034000,1186140,109220140,True
7382,validator_38,47190706560,True,57412000,297780,57709780,False
7383,validator_23,50688983652,True,75938003,18679220,94617223,True
7384,validator_31,182286842240,True,120300000,22451600,142751600,False
7385,validator_16,49240388246,True,111222003,1112100,112334103,True
7386,validator_8,52346870454,True,110009002,1215500,111224502,True
7387,validator_31,182465912740,True,148347000,30723500,179070500,False
7388,validator_46,112876548840,True,74908000,954000,75862000,False
7389,validator_15,291183460295,True,109127997,3026180,112154177,True
7390,validator_39,50419313010,True,117253000,697360,117950360,False
7391,validator_36,114130911890,True,155020000,18073520,173093520,False
7392,validator_4,51285907260,True,151009000,437800,151446800,True
7393,validator_33,45553147930,True,52762000,354140,53116140,False
7394,validator_26,49673837880,True,71980000,871430,72851430,False
7395,validator_28,46582716090,True,151218000,2308680,153526680,False
7396,validator_32,48832879120,True,60491000,20835800,81326800,False
7397,validator_7,87104351960,True,104753007,3154790,107907797,True
7398,validator_46,112950171570,True,72365000,1257730,73622730,False
7399,validator_40,49449161910,True,157113000,1687300,158800300,False
7400,validator_45,46643667800,True,163309000,1691280,165000280,False
7401,validator_21,83767747241,True,235833001,4424300,240257301,True
7402,validator_10,50907375255,True,166045004,19161800,185206804,True
7403,validator_25,46134197960,True,62833000,854000,63687000,False
7404,validator_18,119987968154,True,126123001,7856710,133979711,True
7405,validator_34,279780190940,True,65460000,5764900,71224900,False
7406,validator_24,49584820281,True,48881000,1630730,50511730,True
7407,validator_4,51377311247,True,86855997,4547990,91403987,True
7408,validator_9,52609739877,True,100427998,414900,100842898,True
7409,validator_28,46731670990,True,146141000,2813900,148954900,False
7410,validator_20,48156278723,True,111181995,10746600,121928595,True
7411,validator_11,51735681258,True,186508004,5260640,191768644,True
7412,validator_0,51381992307,True,166966003,1994220,168960223,True
7413,validator_7,87262459763,True,144570003,13537800,158107803,True
7414,validator_25,46241706230,True,107372000,136270,107508270,False
7415,validator_44,115888272370,True,74400000,17956390,92356390,False
7416,validator_4,51532531102,True,148510995,6708860,155219855,True
7417,validator_23,50850995152,True,155862000,6149500,162011500,True
7418,validator_8,52451814974,True,103472000,1472520,104944520,True
7419,validator_20,48257242660,True,80969997,19993940,100963937,True
7420,validator_24,49685842382,True,83248001,17774100,101022101,True
7421,validator_2,53538473449,True,113804999,553500,114358499,True
7422,validator_1,84882288892,True,151192001,28082200,179274201,True
7423,validator_24,49723624485,True,35935003,1847100,37782103,True
7424,validator_2,53672395251,True,132918002,1003800,133921802,True
7425,validator_41,83174129990,True,98737000,862100,99599100,False
7426,validator_3,54212652657,True,123339998,4744600,128084598,True
7427,validator_17,189013058732,True,63557000,853000,64410000,True
7428,validator_22,84004547657,True,118943994,1744090,120688084,True
7429,validator_39,50550921410,True,130207000,1401400,131608400,False
7430,validator_7,87360708065,True,97500002,748300,98248302,True
7431,validator_17,189145502276,True,126549994,5893550,132443544,True
7432,validator_19,87415887656,True,108068999,1883600,109952599,True
7433,validator_14,120612464870,True,78753999,1388220,80142219,True
7434,validator_1,85027677509,True,144645997,742620,145388617,True
7435,validator_9,52669928679,True,59275002,913800,60188802,True
7436,validator_28,46851849220,True,100677000,19501230,120178230,False
7437,validator_0,51485278037,True,101219000,2066730,103285730,True
7438,validator_18,120048235351,True,59453997,813200,60267197,True
7439,validator_12,117711681721,True,104644998,19847900,124492898,True
7440,validator_19,87643029155,True,200293999,26847500,227141499,True
7441,validator_14,120744254907,True,129198997,2591040,131790037,True
7442,validator_7,87582634265,True,221572000,354200,221926200,True
7443,validator_25,46495956430,True,241710000,12540200,254250200,False
7444,validator_12,117996281311,True,282876000,1723590,284599590,True
7445,validator_20,48399326734,True,141483994,600080,142084074,True
7446,validator_24,49834798383,True,110433998,739900,111173898,True
7447,validator_43,79566739080,True,57115000,19206040,76321040,False
7448,validator_0,51632883640,True,145764003,1841600,147605603,True
7449,validator_38,47455853000,True,262609000,2537440,265146440,False
7450,validator_7,87674307963,True,90899998,773700,91673698,True
7451,validator_16,49382541895,True,135786999,6366650,142153649,True
7452,validator_16,49530350094,True,144538999,3269200,147808199,True
7453,validator_32,48925861460,True,92355000,627340,92982340,False
7454,validator_27,116404422240,True,195870000,288130,196158130,False
7455,validator_11,51877496259,True,139679001,2136000,141815001,True
7456,validator_15,291318565834,True,133844999,1260540,135105539,True
7457,validator_12,118147354532,True,142802001,8271220,151073221,True
7458,validator_43,79708561980,True,140872000,950900,141822900,False
7459,validator_22,84097266082,True,91045005,1673420,92718425,True
7460,validator_30,82577549580,True,117597000,2928920,120525920,False
7461,validator_5,85337050339,True,133296999,5134740,138431739,True
7462,validator_43,79876566680,True,159118000,8886700,168004700,False
7463,validator_34,279885849640,True,104446000,1212700,105658700,False
7464,validator_13,48439134657,True,82369998,2128130,84498128,True
7465,validator_34,279935542110,True,48047000,1645470,49692470,False
7466,validator_44,115991086170,True,102423000,390800,102813800,False
7467,validator_4,51748550046,True,214268004,1750940,216018944,True
7468,validator_48,179560325630,True,126607000,8580500,135187500,False
7469,validator_12,118326122214,True,177955002,812680,178767682,True
7470,validator_25,46591622060,True,94415000,1250630,95665630,False
7471,validator_32,48992741960,True,54196000,12684500,66880500,False
7472,validator_36,114207393670,True,74963000,1518780,76481780,False
7473,validator_3,54316032943,True,102459996,920290,103380286,True
7474,validator_4,51877122371,True,125481005,3091320,128572325,True
7475,validator_4,51991805469,True,91712998,22970100,114683098,True
7476,validator_26,49749535760,True,75155000,542880,75697880,False
7477,validator_47,81303191430,True,188920000,1126940,190046940,False
7478,validator_36,114406390100,True,193209000,5787430,198996430,False
7479,validator_42,48549348780,True,200762000,1203200,201965200,False
7480,validator_49,82956766400,True,203145000,20004600,223149600,False
7481,validator_24,49960465379,True,124089996,1577000,125666996,True
7482,validator_27,116585731580,True,161919000,19390340,181309340,False
7483,validator_27,116876469340,True,290325000,412760,290737760,False
7484,validator_12,118448369741,True,122063997,183530,122247527,True
7485,validator_34,280130860010,True,194281000,1036900,195317900,False
7486,validator_27,117007100920,True,128157000,2474580,130631580,False
7487,validator_25,46678680160,True,81807000,5251100,87058100,False
7488,validator_48,179656492360,True,94919000,1247730,96166730,False
7489,validator_46,113122453590,True,170867000,1415020,172282020,False
7490,validator_14,120807221714,True,59337007,3629800,62966807,True
7491,validator_7,87807457060,True,124590997,8558100,133149097,True
7492,validator_16,49677333885,True,134539001,12444790,146983791,True
7493,validator_21,83875361045,True,107532004,81800,107613804,True
7494,validator_39,50617070510,True,64782000,1367100,66149100,False
7495,validator_34,280249435210,True,110975000,7600200,118575200,False
7496,validator_20,48557468934,True,157563000,579200,158142200,True
7497,validator_27,117140067050,True,131853000,1113130,132966130,False
7498,validator_11,52060213854,True,163747995,18969600,182717595,True
7499,validator_33,45657923030,True,86068000,18707100,104775100,False
7500,validator_44,116064625770,True,65899000,7640600,73539600,False
7501,validator_36,114486165000,True,77367000,2407900,79774900,False
7502,validator_18,120206882780,True,157933999,713430,158647429,True
7503,validator_11,52105716857,True,44497003,1006000,45503003,True
7504,validator_4,52175900260,True,182850001,1244790,184094791,True
7505,validator_48,179886250880,True,210906000,18852520,229758520,False
7506,validator_22,84237155742,True,139041000,848660,139889660,True
7507,validator_5,85537183240,True,198679001,1453900,200132901,True
7508,validator_8,52706470096,True,245865002,8790120,254655122,True
7509,validator_13,48595429556,True,155131999,1162900,156294899,True
7510,validator_10,51045703258,True,136425003,1903000,138328003,True
7511,validator_16,49852108868,True,165617003,9157980,174774983,True
7512,validator_16,49923767509,True,70033001,1625640,71658641,True
7513,validator_15,291514105063,True,194691999,847230,195539229,True
7514,validator_19,87752611588,True,108299003,1283430,109582433,True
7515,validator_37,81331368540,True,101559000,1604770,103163770,False
7516,validator_46,113226669780,True,102896000,1320190,104216190,False
7517,validator_48,179939092650,True,51892000,949770,52841770,False
7518,validator_26,49852449560,True,93543000,9370800,102913800,False
7519,validator_46,113345110880,True,112493000,5948100,118441100,False
7520,validator_44,116234139970,True,167181000,2333200,169514200,False
7521,validator_14,120999745316,True,169123002,23400600,192523602,True
7522,validator_42,48705297380,True,146861000,9087600,155948600,False
7523,validator_11,52332897864,True,222193007,4988000,227181007,True
7524,validator_44,116331788670,True,95623000,2025700,97648700,False
7525,validator_22,84323581646,True,84894004,1531900,86425904,True
7526,validator_19,87876822936,True,122405998,1805350,124211348,True
7527,validator_0,51800757842,True,162682002,5192200,167874202,True
7528,validator_31,182597124730,True,130012000,1199990,131211990,False
7529,validator_39,50718774530,True,101025000,679020,101704020,False
7530,validator_12,118561808082,True,111898001,1540340,113438341,True
7531,validator_26,49944627360,True,91353000,824800,92177800,False
7532,validator_36,114545995510,True,58231000,1599510,59830510,False
7533,validator_15,291671742791,True,149589998,8047730,157637728,True
7534,validator_10,51101892704,True,54948996,1240450,56189446,True
7535,validator_33,45780412130,True,116690000,5799100,122489100,False
7536,validator_5,85670067338,True,120740998,12143100,132884098,True
7537,validator_32,49119364190,True,125855000,767230,126622230,False
7538,validator_31,182758124410,True,159586000,1413680,160999680,False
7539,validator_14,121170321221,True,169868995,706910,170575905,True
7540,validator_31,182952919880,True,191664000,3131470,194795470,False
7541,validator_0,51883626847,True,81517005,1352000,82869005,True
7542,validator_7,87933311062,True,123596002,2258000,125854002,True
7543,validator_17,189202669173,True,55185997,1980900,57166897,True
7544,validator_34,280386690810,True,134458000,2797600,137255600,False
7545,validator_14,121248600725,True,77305004,974500,78279504,True
7546,validator_15,291800092382,True,128286001,63590,128349591,True
7547,validator_34,280517168650,True,128515000,1962840,130477840,False
7548,validator_5,85803638637,True,125564999,8006300,133571299,True
7549,validator_30,82646715040,True,67595000,1570460,69165460,False
7550,validator_31,183080734180,True,119981000,7833300,127814300,False
7551,validator_22,84435228248,True,110247002,1399600,111646602,True
7552,validator_27,117225965430,True,59694000,26204380,85898380,False
7553,validator_45,46765010580,True,103107000,18235780,121342780,False
7554,validator_20,48702139896,True,134852002,9818960,144670962,True
7555,validator_20,48864371855,True,142479999,19751960,162231959,True
7556,validator_28,46938796120,True,85612000,1334900,86946900,False
7557,validator_36,114613650310,True,65746000,1908800,67654800,False
7558,validator_38,47543233960,True,86603000,777960,87380960,False
7559,validator_40,49502609460,True,52880000,567550,53447550,False
7560,validator_15,292066394277,True,266087995,213900,266301895,True
7561,validator_37,81384010420,True,52476000,165880,52641880,False
7562,validator_9,52831140180,True,153369001,7842500,161211501,True
7563,validator_31,183221195180,True,138314000,2147000,140461000,False
7564,validator_17,189247252898,True,43914995,668730,44583725,True
7565,validator_26,50154545260,True,207964000,1953900,209917900,False
7566,validator_45,46829803580,True,64128000,665000,64793000,False
7567,validator_23,50906885979,True,55248997,641830,55890827,True
7568,validator_21,83952133147,True,74519002,2253100,76772102,True
7569,validator_39,50806470980,True,85753000,1943450,87696450,False
7570,validator_19,88013751036,True,135909000,1019100,136928100,True
7571,validator_18,120329653173,True,104544003,18226390,122770393,True
7572,validator_12,118754027484,True,189581002,2638400,192219402,True
7573,validator_23,50965683278,True,58700999,96300,58797299,True
7574,validator_2,53863111912,True,187685001,3031660,190716661,True
7575,validator_12,118855073582,True,100255998,790100,101046098,True
7576,validator_10,51249040650,True,146150006,997940,147147946,True
7577,validator_46,113395328280,True,47350000,2867400,50217400,False
7578,validator_28,47054737720,True,110938000,5003600,115941600,False
7579,validator_17,189372389758,True,124260000,876860,125136860,True
7580,validator_16,49988714531,True,63070002,1877020,64947022,True
7581,validator_27,117310510360,True,76800000,7744930,84544930,False
7582,validator_4,52330039057,True,152659997,1478800,154138797,True
7583,validator_13,48862382879,True,265954003,999320,266953323,True
7584,validator_35,115283428260,True,65751000,8699500,74450500,False
7585,validator_21,84224604486,True,271389999,1081340,272471339,True
7586,validator_35,115504879660,True,220239000,1212400,221451400,False
7587,validator_23,51084056580,True,117537002,836300,118373302,True
7588,validator_3,54410848644,True,92880001,1935700,94815701,True
7589,validator_46,113485625180,True,88073000,2223900,90296900,False
7590,validator_32,49244849130,True,123775000,1709940,125484940,False
7591,validator_29,45904507820,True,200857000,1462400,202319400,False
7592,validator_1,85142720684,True,113943005,1100170,115043175,True
7593,validator_23,51169433875,True,83614995,1762300,85377295,True
7594,validator_1,85298299146,True,154439002,1139460,155578462,True
7595,validator_12,118938673755,True,82906003,694170,83600173,True
7596,validator_1,85582041932,True,264679996,19062790,283742786,True
7597,validator_6,51106375810,True,114120005,1181080,115301085,True
7598,validator_35,115635429310,True,125659000,4890650,130549650,False
7599,validator_0,51999185810,True,114481993,1076970,115558963,True
7600,validator_15,292221516801,True,153586994,1535530,155122524,True
7601,validator_15,292388454596,True,158444995,8492800,166937795,True
7602,validator_21,84345024985,True,119920999,499500,120420499,True
7603,validator_23,51325081266,True,153183001,2464390,155647391,True
7604,validator_6,51187356011,True,71797001,9183200,80980201,True
7605,validator_3,54613405343,True,202125999,430700,202556699,True
7606,validator_23,51509671454,True,183478998,1111190,184590188,True
7607,validator_46,113597703920,True,109241000,2837740,112078740,False
7608,validator_47,81419604830,True,114943000,1470400,116413400,False
7609,validator_46,113746187620,True,128459000,20024700,148483700,False
7610,validator_3,54714256140,True,85732997,15117800,100850797,True
7611,validator_12,119093173585,True,153488000,1011830,154499830,True
7612,validator_7,88094969767,True,160632005,1026700,161658705,True
7613,validator_10,51436971750,True,187124000,807100,187931100,True
7614,validator_34,280675500580,True,157662000,669930,158331930,False
7615,validator_13,49013192981,True,149797002,1013100,150810102,True
7616,validator_14,121424699223,True,170403998,5694500,176098498,True
7617,validator_42,48801709770,True,89094000,7318390,96412390,False
7618,validator_39,50923554570,True,114668000,2415590,117083590,False
7619,validator_14,121617573097,True,189296004,3577870,192873874,True
7620,validator_20,49043700652,True,177630997,1697800,179328797,True
7621,validator_49,83047685600,True,90160000,759200,90919200,False
7622,validator_9,52917757784,True,85452004,1165600,86617604,True
7623,validator_6,51288738340,True,75959999,25422330,101382329,True
7624,validator_30,82828884340,True,181435000,734300,182169300,False
7625,validator_6,51391584704,True,102557004,289360,102846364,True
7626,validator_34,280812814050,True,128957000,8356470,137313470,False
7627,validator_22,84534712346,True,94449998,5034100,99484098,True
7628,validator_21,84462154884,True,111966999,5162900,117129899,True
7629,validator_10,51520854348,True,80843998,3038600,83882598,True
7630,validator_15,292531750899,True,143187003,109300,143296303,True
7631,validator_33,45833348830,True,52659000,277700,52936700,False
7632,validator_4,52642368449,True,286188992,26140400,312329392,True
7633,validator_5,85993737809,True,188419992,1679180,190099172,True
7634,validator_33,45888845630,True,51380000,4116800,55496800,False
7635,validator_48,180021682830,True,77384000,5206180,82590180,False
7636,validator_19,88107569640,True,86206004,7612600,93818604,True
7637,validator_25,46758457560,True,79551000,226400,79777400,False
7638,validator_36,114749108330,True,116811000,18647020,135458020,False
7639,validator_4,52812748850,True,169432001,948400,170380401,True
7640,validator_29,46130245960,True,224640000,1098140,225738140,False
7641,validator_36,114805459030,True,51549000,4801700,56350700,False
7642,validator_4,52874931540,True,60824000,1358690,62182690,True
7643,validator_15,292631765198,True,99371999,642300,100014299,True
7644,validator_1,85702897230,True,120590998,264300,120855298,True
7645,validator_28,47137850820,True,82165000,948100,83113100,False
7646,validator_39,51073324870,True,148504000,1266300,149770300,False
7647,validator_41,83313066890,True,136535000,2401900,138936900,False
7648,validator_27,117382516480,True,64110000,7896120,72006120,False
7649,validator_13,49215761727,True,199940006,2628740,202568746,True
7650,validator_10,51637952476,True,115310998,1787130,117098128,True
7651,validator_23,51692960158,True,161989004,21299700,183288704,True
7652,validator_9,53094960977,True,175842003,1361190,177203193,True
7653,validator_3,54788757243,True,73627003,874100,74501103,True
7654,validator_48,180082395330,True,59810000,902500,60712500,False
7655,validator_43,80025925880,True,148747000,612200,149359200,False
7656,validator_22,84630123675,True,89922999,5488330,95411329,True
7657,validator_17,189563713276,True,191004998,318520,191323518,True
7658,validator_37,81453536520,True,61425000,8101100,69526100,False
7659,validator_25,46884540540,True,125221000,861980,126082980,False
7660,validator_39,51215037510,True,140720000,992640,141712640,False
7661,validator_28,47214721520,True,72167000,4703700,76870700,False
7662,validator_31,183281313780,True,58842000,1276600,60118600,False
7663,validator_41,83456366990,True,138330000,4970100,143300100,False
7664,validator_28,47319816940,True,99473000,5622420,105095420,False
7665,validator_29,46296577770,True,165689000,642810,166331810,False
7666,validator_46,113967827790,True,202661000,18979170,221640170,False
7667,validator_14,121713093338,True,93998001,1522240,95520241,True
7668,validator_35,115808588920,True,171722000,1437610,173159610,False
7669,validator_23,51792660259,True,91046001,8654100,99700101,True
7670,validator_34,280935681680,True,121800000,1067630,122867630,False
7671,validator_11,52470043253,True,135356999,1788390,137145389,True
7672,validator_28,47418405440,True,98025000,563500,98588500,False
7673,validator_31,183419060700,True,137026000,720920,137746920,False
7674,validator_6,51591774707,True,197965003,2225000,200190003,True
7675,validator_11,52705383792,True,211325999,24014540,235340539,True
7676,validator_7,88282335469,True,186514002,851700,187365702,True
7677,validator_1,85901100528,True,196670998,1532300,198203298,True
7678,validator_41,83590248730,True,133278000,603740,133881740,False
7679,validator_21,84580029399,True,117580005,294510,117874515,True
7680,validator_17,189633563151,True,68109995,1739880,69849875,True
7681,validator_49,83148717700,True,98577000,2455100,101032100,False
7682,validator_46,114033800490,True,63081000,2891700,65972700,False
7683,validator_12,119256580910,True,162090005,1317320,163407325,True
7684,validator_15,292907295596,True,273076998,2453400,275530398,True
7685,validator_19,88228429535,True,94328995,26530900,120859895,True
7686,validator_13,49446564034,True,229131007,1671300,230802307,True
7687,validator_31,183480016880,True,58845000,2111180,60956180,False
7688,validator_20,49190252685,True,145628003,924030,146552033,True
7689,validator_2,54127588014,True,241999002,22477100,264476102,True
7690,validator_12,119364172613,True,107330003,261700,107591703,True
7691,validator_32,49448770030,True,202387000,1533900,203920900,False
7692,validator_42,48922691640,True,120302000,679870,120981870,False
7693,validator_3,54870485354,True,80815001,913110,81728111,True
7694,validator_30,82933669630,True,102252000,2533290,104785290,False
7695,validator_30,83005462760,True,70358000,1435130,71793130,False
7696,validator_17,189749713171,True,115168000,982020,116150020,True
7697,validator_20,49349856282,True,159200997,402600,159603597,True
7698,validator_1,86094680628,True,174372000,19208100,193580100,True
7699,validator_18,120535012573,True,202721000,2638400,205359400,True
7700,validator_4,53062076179,True,185290999,1853640,187144639,True
7701,validator_25,46990802360,True,106106000,155820,106261820,False
7702,validator_23,52000901502,True,206917003,1324240,208241243,True
7703,validator_16,50165986507,True,175412996,1858980,177271976,True
7704,validator_35,115976820310,True,166921000,1310390,168231390,False
7705,validator_1,86224823625,True,128687997,1455000,130142997,True
7706,validator_32,49607700050,True,157468000,1462020,158930020,False
7707,validator_20,49470831684,True,120675002,300400,120975402,True
7708,validator_10,51773055175,True,132683999,2418700,135102699,True
7709,validator_3,54942157858,True,70266004,1406500,71672504,True
7710,validator_34,280998035080,True,61182000,1171400,62353400,False
7711,validator_40,49632325960,True,128010000,1706500,129716500,False
7712,validator_35,116080214040,True,100850000,2543730,103393730,False
7713,validator_47,81507718790,True,86875000,1238960,88113960,False
7714,validator_28,47558264540,True,135084000,4775100,139859100,False
7715,validator_16,50323001037,True,148638000,8376530,157014530,True
7716,validator_15,293088527294,True,176051998,5179700,181231698,True
7717,validator_30,83080459360,True,73256000,1740600,74996600,False
7718,validator_28,47609604580,True,45266000,6074040,51340040,False
7719,validator_25,47091236680,True,74710000,25724320,100434320,False
7720,validator_40,49748063060,True,114120000,1617100,115737100,False
7721,validator_3,55074034162,True,131608004,268300,131876304,True
7722,validator_29,46378783060,True,80424000,1781290,82205290,False
7723,validator_31,183671624520,True,186022000,5585640,191607640,False
7724,validator_37,81507038320,True,53016000,485800,53501800,False
7725,validator_48,180244368910,True,161628000,345580,161973580,False
7726,validator_47,81589222590,True,76055000,5448800,81503800,False
7727,validator_10,51954562677,True,181281002,226500,181507502,True
7728,validator_6,51775998206,True,182020999,2202500,184223499,True
7729,validator_49,83243185500,True,91710000,2757800,94467800,False
7730,validator_28,47802026550,True,190475000,1946970,192421970,False
7731,validator_46,114188502490,True,149125000,5577000,154702000,False
7732,validator_21,84819760831,True,239255002,476430,239731432,True
7733,validator_15,293255086890,True,163149996,3409600,166559596,True
7734,validator_38,47591364760,True,47349000,781800,48130800,False
7735,validator_4,53358886953,True,274089994,22720780,296810774,True
7736,validator_19,88404897679,True,174964004,1504140,176468144,True
7737,validator_48,180302119410,True,56158000,1592500,57750500,False
7738,validator_6,51881857341,True,104057005,1802130,105859135,True
7739,validator_22,84786722594,True,137365999,19232920,156598919,True
7740,validator_6,52078006744,True,195566003,583400,196149403,True
7741,validator_3,55180813348,True,105929006,850180,106779186,True
7742,validator_3,55341122747,True,159455999,853400,160309399,True
7743,validator_34,281154770260,True,156124000,611180,156735180,False
7744,validator_8,52880305700,True,173326004,509600,173835604,True
7745,validator_18,120709871672,True,171846999,3012100,174859099,True
7746,validator_6,52243519113,True,164827999,684370,165512369,True
7747,validator_12,119485689514,True,120369001,1147900,121516901,True
7748,validator_36,114967821950,True,161182000,1180920,162362920,False
7749,validator_34,281218494660,True,62624000,1100400,63724400,False
7750,validator_2,54215585813,True,87772999,224800,87997799,True
7751,validator_34,281373622220,True,149718000,5409560,155127560,False
7752,validator_18,120826784673,True,115228001,1685000,116913001,True
7753,validator_24,50044475579,True,82663000,1347200,84010200,True
7754,validator_29,46435628860,True,55948000,897800,56845800,False
7755,validator_32,49764943060,True,156609000,634010,157243010,False
7756,validator_24,50187515979,True,132910000,10130400,143040400,True
7757,validator_1,86417748464,True,190478999,2445840,192924839,True
7758,validator_42,49083886140,True,159901000,1293500,161194500,False
7759,validator_43,80180915260,True,152955000,2034380,154989380,False
7760,validator_33,45932907660,True,43652000,410030,44062030,False
7761,validator_15,293330224032,True,74308002,829140,75137142,True
7762,validator_6,52388574281,True,143941998,1113170,145055168,True
7763,validator_41,83736377980,True,145339000,790250,146129250,False
7764,validator_17,189892515664,True,141124993,1677500,142802493,True
7765,validator_3,55670718249,True,323476002,6119500,329595502,True
7766,validator_24,50308281881,True,101135992,19629910,120765902,True
7767,validator_21,84997040930,True,175643999,1636100,177280099,True
7768,validator_14,121935339431,True,217316003,4930090,222246093,True
7769,validator_18,120920859740,True,92718997,1356070,94075067,True
7770,validator_5,86098894639,True,103433000,1723830,105156830,True
7771,validator_28,47909395150,True,107139000,229600,107368600,False
7772,validator_34,281557899520,True,182637000,1640300,184277300,False
7773,validator_0,52248289307,True,235670997,13432500,249103497,True
7774,validator_19,88467655364,True,61567005,1190680,62757685,True
7775,validator_35,116224013360,True,142503000,1296320,143799320,False
7776,validator_15,293448588463,True,100198001,18166430,118364431,True
7777,validator_49,83325916100,True,81452000,1278600,82730600,False
7778,validator_33,46016162360,True,82001000,1253700,83254700,False
7779,validator_4,53536102692,True,175295999,1919740,177215739,True
7780,validator_24,50574951545,True,247883004,18786660,266669664,True
7781,validator_32,49893925290,True,128750000,232230,128982230,False
7782,validator_9,53319101382,True,220451005,3689400,224140405,True
7783,validator_9,53476637482,True,156964000,572100,157536100,True
7784,validator_5,86239724387,True,139469008,1360740,140829748,True
7785,validator_24,50666558047,True,86882002,4724500,91606502,True
7786,validator_2,54271528216,True,53479003,2463400,55942403,True
7787,validator_47,81727845230,True,136952000,1670640,138622640,False
7788,validator_13,49563750561,True,98874997,18311530,117186527,True
7789,validator_35,116398586760,True,155200000,19373400,174573400,False
7790,validator_48,180349640210,True,47020000,500800,47520800,False
7791,validator_42,49225512670,True,141288000,338530,141626530,False
7792,validator_2,54384483618,True,112124002,831400,112955402,True
7793,validator_6,52474805014,True,85776003,454730,86230733,True
7794,validator_11,52900877386,True,193872004,1621590,195493594,True
7795,validator_15,293579672771,True,129958008,1126300,131084308,True
7796,validator_30,83178785460,True,97648000,678100,98326100,False
7797,validator_8,53062547096,True,176916996,5324400,182241396,True
7798,validator_0,52337431623,True,87976996,1165320,89142316,True
7799,validator_8,53300308278,True,237223002,538180,237761182,True
7800,validator_14,122144237674,True,202778003,6120240,208898243,True
7801,validator_41,83876398550,True,139269000,751570,140020570,False
7802,validator_1,86630832864,True,210980000,2104400,213084400,True
7803,validator_48,180482485010,True,131289000,1555800,132844800,False
7804,validator_41,83950386650,True,73232000,756100,73988100,False
7805,validator_28,48081444630,True,170088000,1961480,172049480,False
7806,validator_36,115074266530,True,101734000,4710580,106444580,False
7807,validator_15,293759054277,True,177915006,1466500,179381506,True
7808,validator_48,180586730790,True,101172000,3073780,104245780,False
7809,validator_33,46099702360,True,83112000,428000,83540000,False
7810,validator_5,86372957891,True,132351004,882500,133233504,True
7811,validator_2,54520553714,True,133007996,3062100,136070096,True
7812,validator_19,88642795367,True,170000003,5140000,175140003,True
7813,validator_35,116537119160,True,137012000,1520400,138532400,False
7814,validator_45,46926961280,True,94718000,2439700,97157700,False
7815,validator_5,86482861693,True,109490002,413800,109903802,True
7816,validator_24,50730583743,True,62296996,1728700,64025696,True
7817,validator_11,52979302283,True,77722997,701900,78424897,True
7818,validator_9,53580978608,True,103457996,883130,104341126,True
7819,validator_20,49624145019,True,144176995,9136340,153313335,True
7820,validator_14,122458022804,True,312170000,1615130,313785130,True
7821,validator_12,119653849634,True,159899000,8261120,168160120,True
7822,validator_49,83397209100,True,62275000,9018000,71293000,False
7823,validator_3,55834220190,True,163020001,481940,163501941,True
7824,validator_12,119778393031,True,122956997,1586400,124543397,True
7825,validator_41,84001544750,True,49620000,1538100,51158100,False
7826,validator_15,293814489078,True,54777001,657800,55434801,True
7827,validator_8,53503247577,True,201856999,1082300,202939299,True
7828,validator_14,122589220742,True,129143998,2053940,131197938,True
7829,validator_28,48201270280,True,101649000,18176650,119825650,False
7830,validator_41,84114804430,True,108538000,4721680,113259680,False
7831,validator_44,116425345500,True,92304000,1252830,93556830,False
7832,validator_30,83313463190,True,132066000,2611730,134677730,False
7833,validator_44,116539560480,True,113126000,1088980,114214980,False
7834,validator_36,115190093350,True,115032000,794820,115826820,False
7835,validator_20,49706795916,True,81322997,1327900,82650897,True
7836,validator_3,55973205687,True,111814997,27170500,138985497,True
7837,validator_37,81601648420,True,93857000,753100,94610100,False
7838,validator_47,81952261630,True,218258000,6158400,224416400,False
7839,validator_9,53679812337,True,96031999,2801730,98833729,True
7840,validator_24,50796911943,True,46102000,20226200,66328200,True
7841,validator_31,183797766020,True,124216000,1925500,126141500,False
7842,validator_1,86775530044,True,143980000,717180,144697180,True
7843,validator_12,119898018114,True,110211003,9414080,119625083,True
7844,validator_5,86676918898,True,193016005,1041200,194057205,True
7845,validator_42,49373964380,True,146141000,2310710,148451710,False
7846,validator_34,281609586220,True,51134000,552700,51686700,False
7847,validator_28,48231819680,True,29405000,1144400,30549400,False
7848,validator_8,53623246506,True,115090999,4907930,119998929,True
7849,validator_45,47097668320,True,169605000,1102040,170707040,False
7850,validator_44,116655164380,True,114301000,1302900,115603900,False
7851,validator_12,119990185954,True,91416000,751840,92167840,True
7852,validator_12,120147848034,True,156262000,1400080,157662080,True
7853,validator_19,88725229266,True,81112999,1320900,82433899,True
7854,validator_5,86773388840,True,96358002,111940,96469942,True
7855,validator_17,190082445810,True,188994996,935150,189930146,True
7856,validator_39,51462134710,True,228512000,18585200,247097200,False
7857,validator_43,80294897660,True,113836000,146400,113982400,False
7858,validator_9,53828126917,True,147687000,627580,148314580,True
7859,validator_0,52501582923,True,163328000,823300,164151300,True
7860,validator_1,86886125875,True,104701001,5894830,110595831,True
7861,validator_16,50377658038,True,53586001,1071000,54657001,True
7862,validator_40,49817378650,True,67818000,1497590,69315590,False
7863,validator_12,120266517233,True,118149999,519200,118669199,True
7864,validator_48,180634529810,True,45535000,2264020,47799020,False
7865,validator_26,50376631160,True,220744000,1341900,222085900,False
7866,validator_1,86937556178,True,50377003,1053300,51430303,True
7867,validator_24,50938768753,True,141000000,856810,141856810,True
7868,validator_9,54010776054,True,181404997,1244140,182649137,True
7869,validator_31,183925238920,True,126056000,1416900,127472900,False
7870,validator_30,83448649190,True,133314000,1872000,135186000,False
7871,validator_45,47290501050,True,191304000,1528730,192832730,False
7872,validator_18,120996649186,True,62639006,13150440,75789446,True
7873,validator_16,50491874960,True,112656002,1560920,114216922,True
7874,validator_25,47228492680,True,136891000,365000,137256000,False
7875,validator_42,49588277280,True,213325000,987900,214312900,False
7876,validator_46,114275750520,True,85928000,1320030,87248030,False
7877,validator_28,48313988380,True,80235000,1933700,82168700,False
7878,validator_38,47740848460,True,126409000,23074700,149483700,False
7879,validator_39,51656855210,True,192091000,2629500,194720500,False
7880,validator_47,82039951690,True,85743000,1947060,87690060,False
7881,validator_21,85134984930,True,136154000,1790000,137944000,True
7882,validator_35,116756973260,True,219403000,451100,219854100,False
7883,validator_42,49705470780,True,116565000,628500,117193500,False
7884,validator_29,46539484560,True,101907000,1948700,103855700,False
7885,validator_42,49777424180,True,70072000,1881400,71953400,False
7886,validator_9,54232511149,True,182292995,39442100,221735095,True
7887,validator_6,52679628114,True,203105000,1718100,204823100,True
7888,validator_31,183990030520,True,58593000,6198600,64791600,False
7889,validator_7,88428459067,True,143806998,2316600,146123598,True
7890,validator_4,53693964248,True,148764006,9097550,157861556,True
7891,validator_17,190163071868,True,75291998,5334060,80626058,True
7892,validator_22,84843974741,True,55660997,1591150,57252147,True
7893,validator_1,87148578009,True,208851001,2170830,211021831,True
7894,validator_19,88860629264,True,126993998,8406000,135399998,True
7895,validator_39,51826065810,True,168592000,618600,169210600,False
7896,validator_5,86824078967,True,49989997,700130,50690127,True
7897,validator_27,117584279080,True,193764000,7998600,201762600,False
7898,validator_7,88532529167,True,102829000,1241100,104070100,True
7899,validator_25,47373925380,True,127007000,18425700,145432700,False
7900,validator_46,114392942160,True,116009000,1182640,117191640,False
7901,validator_3,56027220629,True,53939002,75940,54014942,True
7902,validator_8,53731695286,True,107451000,997780,108448780,True
7903,validator_31,184088244520,True,85520000,12694000,98214000,False
7904,validator_33,46269938880,True,164957000,5279520,170236520,False
7905,validator_14,122686782687,True,96680005,881940,97561945,True
7906,validator_40,49968279650,True,149417000,1484000,150901000,False
7907,validator_38,47812709180,True,53664000,18196720,71860720,False
7908,validator_2,54603378510,True,80952996,1871800,82824796,True
7909,validator_37,81735056220,True,131873000,1534800,133407800,False
7910,validator_38,47899827820,True,86250000,868640,87118640,False
7911,validator_4,53835757848,True,141367000,426600,141793600,True
7912,validator_49,83498086430,True,100672000,205330,100877330,False
7913,validator_43,80393718250,True,90719000,8101590,98820590,False
7914,validator_36,115322549020,True,131783000,672670,132455670,False
7915,validator_3,56086547925,True,57755996,1571300,59327296,True
7916,validator_42,50025471620,True,245809000,2238440,248047440,False
7917,validator_48,180688438410,True,53788000,120600,53908600,False
7918,validator_19,88925131294,True,63113000,1389030,64502030,True
7919,validator_13,49870828641,True,304087000,2991080,307078080,True
7920,validator_43,80545665390,True,150841000,1106140,151947140,False
7921,validator_38,47975990690,True,69956000,6206870,76162870,False
7922,validator_39,51958240010,True,113247000,18927200,132174200,False
7923,validator_10,52083468074,True,128019997,885400,128905397,True
7924,validator_39,52064889010,True,105205000,1444000,106649000,False
7925,validator_9,54325426256,True,91940007,975100,92915107,True
7926,validator_42,50090443660,True,63545000,1427040,64972040,False
7927,validator_24,51092450489,True,152674006,1007730,153681736,True
7928,validator_3,56246174332,True,157874007,1752400,159626407,True
7929,validator_49,83545032030,True,45935000,1010600,46945600,False
7930,validator_18,121183318035,True,168366999,18301850,186668849,True
7931,validator_41,84218644630,True,102902000,938200,103840200,False
7932,validator_13,50232076941,True,342107000,19141300,361248300,True
7933,validator_41,84435875330,True,217045000,185700,217230700,False
7934,validator_13,50383646855,True,148932004,2637910,151569914,True
7935,validator_40,50127317590,True,157688000,1349940,159037940,False
7936,validator_33,46410891920,True,139975000,978040,140953040,False
7937,validator_38,48098254820,True,119219000,3045130,122264130,False
7938,validator_19,89027856890,True,102082996,642600,102725596,True
7939,validator_32,49983620690,True,81928000,7767400,89695400,False
7940,validator_48,180790499710,True,97372000,4689300,102061300,False
7941,validator_48,180926661210,True,134271000,1890500,136161500,False
7942,validator_19,89249067093,True,203312003,17898200,221210203,True
7943,validator_41,84510583050,True,74424000,283720,74707720,False
7944,validator_33,46567114960,True,147706000,8517040,156223040,False
7945,validator_35,116867134660,True,105769000,4392400,110161400,False
7946,validator_36,115409170770,True,84060000,2561750,86621750,False
7947,validator_10,52365250073,True,275702999,6079000,281781999,True
7948,validator_18,121366157033,True,180992998,1846000,182838998,True
7949,validator_23,52070768201,True,60789989,9076710,69866699,True
7950,validator_15,294073332495,True,253200997,5642420,258843417,True
7951,validator_18,121475576904,True,108956001,463870,109419871,True
7952,validator_41,84671157780,True,141750000,18824730,160574730,False
7953,validator_16,50595763762,True,98103002,5785800,103888802,True
7954,validator_30,83572647790,True,123219000,779600,123998600,False
7955,validator_44,116735238480,True,76569000,3505100,80074100,False
7956,validator_3,56348832832,True,93847000,8811500,102658500,True
7957,validator_38,48145580420,True,46182000,1143600,47325600,False
7958,validator_33,46612470160,True,40362000,4993200,45355200,False
7959,validator_30,83665427290,True,91513000,1266500,92779500,False
7960,validator_14,122776371631,True,88371004,1217940,89588944,True
7961,validator_44,116876427980,True,123101000,18088500,141189500,False
7962,validator_24,51139233693,True,46367004,416200,46783204,True
7963,validator_8,53866394669,True,132830003,1869380,134699383,True
7964,validator_46,114500101060,True,105682000,1476900,107158900,False
7965,validator_44,117005320080,True,123165000,5727100,128892100,False
7966,validator_43,80646089790,True,80579000,19845400,100424400,False
7967,validator_49,83696056930,True,146496000,4528900,151024900,False
7968,validator_28,48422773580,True,106676000,2109200,108785200,False
7969,validator_12,120374603115,True,88870002,19215880,108085882,True
7970,validator_30,83799903390,True,114485000,19991100,134476100,False
7971,validator_45,47386569940,True,77929000,18139890,96068890,False
7972,validator_2,54811615687,True,205610997,2626180,208237177,True
7973,validator_25,47541803110,True,165029000,2848730,167877730,False
7974,validator_32,50009505310,True,25210000,674620,25884620,False
7975,validator_31,184242669040,True,153795000,629520,154424520,False
7976,validator_12,120535866249,True,160306004,957130,161263134,True
7977,validator_42,50215578660,True,124250000,885000,125135000,False
7978,validator_0,52649771983,True,146669000,1520060,148189060,True
7979,validator_30,83848498090,True,45828000,2766700,48594700,False
7980,validator_11,53197078983,True,216108000,1668700,217776700,True
7981,validator_46,114594300880,True,93413000,786820,94199820,False
7982,validator_31,184334629380,True,91264000,696340,91960340,False
7983,validator_25,47712365310,True,170179000,383200,170562200,False
7984,validator_49,83753400030,True,56544000,799100,57343100,False
7985,validator_33,46733867660,True,116537000,4860500,121397500,False
7986,validator_49,83867003160,True,103619000,9984130,113603130,False
7987,validator_44,117088040460,True,81513000,1207380,82720380,False
7988,validator_11,53351232011,True,152055998,2097030,154153028,True
7989,validator_17,190341105983,True,177258995,775120,178034115,True
7990,validator_28,48580489380,True,139595000,18120800,157715800,False
7991,validator_10,52642672252,True,268337999,9084180,277422179,True
7992,validator_16,50702674457,True,100499995,6410700,106910695,True
7993,validator_48,181019985110,True,93057000,266900,93323900,False
7994,validator_14,122854252774,True,57480003,20401140,77881143,True
7995,validator_36,115518489630,True,109209000,109860,109318860,False
7996,validator_37,81900177420,True,147050000,18071200,165121200,False
7997,validator_31,184427889020,True,92476000,783640,93259640,False
7998,validator_36,115570743310,True,50911000,1342680,52253680,False
7999,validator_12,120640894247,True,104062998,965000,105027998,True
8000,validator_34,281700285930,True,89844000,855710,90699710,False
8001,validator_4,53961738026,True,106195998,19784180,125980178,True
8002,validator_7,88766737875,True,233304998,903710,234208708,True
8003,validator_20,49979502358,True,270447002,2259440,272706442,True
8004,validator_5,86930534468,True,98804001,7651500,106455501,True
8005,validator_47,82165259490,True,105837000,19470800,125307800,False
8006,validator_46,114706871720,True,112300000,270840,112570840,False
8007,validator_26,50548060790,True,169283000,2146630,171429630,False
8008,validator_15,294250117493,True,174272998,2512000,176784998,True
8009,validator_13,50542939322,True,158013997,1278470,159292467,True
8010,validator_46,114749222240,True,40812000,1538520,42350520,False
8011,validator_9,54629569333,True,303910997,232080,304143077,True
8012,validator_41,84780879060,True,108682000,1039280,109721280,False
8013,validator_40,50209623370,True,81618000,687780,82305780,False
8014,validator_46,114816591740,True,65901000,1468500,67369500,False
8015,validator_25,47866090410,True,153216000,509100,153725100,False
8016,validator_6,52749183819,True,68200005,1355700,69555705,True
8017,validator_14,122956115572,True,94296998,7565800,101862798,True
8018,validator_10,52801461140,True,158420998,367890,158788888,True
8019,validator_18,121721277419,True,245115995,584520,245700515,True
8020,validator_38,48251294120,True,104372000,1341700,105713700,False
8021,validator_30,83921173270,True,71374000,1301180,72675180,False
8022,validator_12,120780114180,True,138002003,1217930,139219933,True
8023,validator_15,294368301289,True,112151996,6031800,118183796,True
8024,validator_37,82000145320,True,81179000,18788900,99967900,False
8025,validator_28,48657255410,True,76152000,614030,76766030,False
8026,validator_42,50292071990,True,68133000,8360330,76493330,False
8027,validator_13,50600180119,True,56792997,447800,57240797,True
8028,validator_31,184538629210,True,109474000,1266190,110740190,False
8029,validator_29,46704112260,True,163683000,944700,164627700,False
8030,validator_22,85056342170,True,193041999,19325430,212367429,True
8031,validator_30,83967393270,True,27645000,18575000,46220000,False
8032,validator_30,84066956270,True,99164000,399000,99563000,False
8033,validator_47,82281245910,True,109307000,6679420,115986420,False
8034,validator_38,48460816320,True,191212000,18310200,209522200,False
8035,validator_8,53995534941,True,128688002,452270,129140272,True
8036,validator_42,50386713290,True,94008000,633300,94641300,False
8037,validator_38,48582034600,True,119750000,1468280,121218280,False
8038,validator_21,85398859604,True,262235004,1639670,263874674,True
8039,validator_15,294451072490,True,80893001,1878200,82771201,True
8040,validator_21,85564032331,True,163176997,1995730,165172727,True
8041,validator_37,82168930320,True,150457000,18328000,168785000,False
8042,validator_49,83992534200,True,116429000,9102040,125531040,False
8043,validator_35,117026624250,True,157736000,1753590,159489590,False
8044,validator_32,50282859430,True,272540000,814120,273354120,False
8045,validator_46,114949053340,True,109475000,22986600,132461600,False
8046,validator_45,47435077040,True,47892000,615100,48507100,False
8047,validator_0,52817026488,True,165920995,1333510,167254505,True
8048,validator_1,87365056501,True,215696002,782490,216478492,True
8049,validator_25,47973145840,True,98910000,8145430,107055430,False
8050,validator_37,82275188170,True,93903000,12354850,106257850,False
8051,validator_33,46877835060,True,142878000,1089400,143967400,False
8052,validator_8,54110546580,True,114421999,589640,115011639,True
8053,validator_42,50481175690,True,93502000,960400,94462400,False
8054,validator_12,120833693682,True,52064002,1515500,53579502,True
8055,validator_44,117280343460,True,182630000,9673000,192303000,False
8056,validator_34,281822582330,True,120847000,1449400,122296400,False
8057,validator_26,50655767490,True,107160000,546700,107706700,False
8058,validator_4,54111238667,True,147571001,1929640,149500641,True
8059,validator_14,123094820172,True,136965000,1739600,138704600,True
8060,validator_14,123190032576,True,93994004,1218400,95212404,True
8061,validator_2,54931294189,True,118175002,1503500,119678502,True
8062,validator_43,80710327890,True,62761000,1477100,64238100,False
8063,validator_29,46771704560,True,67101000,491300,67592300,False
8064,validator_49,84140150100,True,146412000,1203900,147615900,False
8065,validator_31,184583907010,True,44135000,1142800,45277800,False
8066,validator_42,50583570760,True,81102000,21293070,102395070,False
8067,validator_34,281972619030,True,148669000,1367700,150036700,False
8068,validator_39,52145109810,True,79968000,252800,80220800,False
8069,validator_15,294533613641,True,81298001,1243150,82541151,True
8070,validator_37,82472832790,True,196688000,956620,197644620,False
8071,validator_46,115083155340,True,115309000,18793000,134102000,False
8072,validator_14,123381865378,True,190113002,1719800,191832802,True
8073,validator_48,181101259590,True,79367000,1907480,81274480,False
8074,validator_31,184694908190,True,110373000,628180,111001180,False
8075,validator_25,48203186540,True,219274000,10766700,230040700,False
8076,validator_41,84909417610,True,128284000,254550,128538550,False
8077,validator_46,115258775670,True,175181000,439330,175620330,False
8078,validator_14,123512105379,True,112440001,17800000,130240001,True
8079,validator_42,50624003210,True,39112000,1320450,40432450,False
8080,validator_20,50114733760,True,134478002,753400,135231402,True
8081,validator_9,54748410036,True,116476003,2364700,118840703,True
8082,validator_42,50702296410,True,77989000,304200,78293200,False
8083,validator_36,115629771430,True,56370000,2658120,59028120,False
8084,validator_42,50816223010,True,105964000,7962600,113926600,False
8085,validator_42,50938742190,True,116307000,6212180,122519180,False
8086,validator_26,50693003490,True,36263000,973000,37236000,False
8087,validator_48,181138979860,True,35857000,1863270,37720270,False
8088,validator_25,48254409930,True,50776000,447390,51223390,False
8089,validator_26,50809849190,True,96978000,19867700,116845700,False
8090,validator_31,184813633030,True,100172000,18552840,118724840,False
8091,validator_4,54254595367,True,142209000,1147700,143356700,True
8092,validator_43,80789279700,True,76975000,1976810,78951810,False
8093,validator_44,117350326050,True,64765000,5217590,69982590,False
8094,validator_22,85217741811,True,155354001,6045640,161399641,True
8095,validator_46,115426982070,True,167271000,935400,168206400,False
8096,validator_22,85317450311,True,62817000,36891500,99708500,True
8097,validator_49,84286944250,True,145718000,1076150,146794150,False
8098,validator_30,84248241210,True,173133000,8151940,181284940,False
8099,validator_43,80873575400,True,83423000,872700,84295700,False
8100,validator_46,115557458650,True,129900000,576580,130476580,False
8101,validator_11,53527382709,True,170901998,5248700,176150698,True
8102,validator_20,50241015397,True,124258997,2022640,126281637,True
8103,validator_18,121843047822,True,102295003,19475400,121770403,True
8104,validator_25,48299038160,True,42540000,2088230,44628230,False
8105,validator_29,46854684960,True,74651000,8329400,82980400,False
8106,validator_37,82575054020,True,101047000,1174230,102221230,False
8107,validator_47,82370928310,True,88344000,1338400,89682400,False
8108,validator_4,54345224066,True,88262999,2365700,90628699,True
8109,validator_30,84387294710,True,137738000,1315500,139053500,False
8110,validator_7,88915067414,True,124733999,23595540,148329539,True
8111,validator_34,282087475930,True,104440000,10416900,114856900,False
8112,validator_9,54865138173,True,115111997,1616140,116728137,True
8113,validator_26,50931407390,True,116915000,4643200,121558200,False
8114,validator_21,85772742974,True,206629003,2081640,208710643,True
8115,validator_33,46978441700,True,100250000,356640,100606640,False
8116,validator_3,56439505724,True,81280002,9392890,90672892,True
8117,validator_17,190466311462,True,124661999,543480,125205479,True
8118,validator_30,84490356710,True,101280000,1782000,103062000,False
8119,validator_49,84402672790,True,89044000,26684540,115728540,False
8120,validator_10,52886842567,True,80489997,4891430,85381427,True
8121,validator_48,181261347880,True,103252000,19116020,122368020,False
8122,validator_38,48711678280,True,128284000,1359680,129643680,False
8123,validator_10,53059416164,True,162991997,9581600,172573597,True
8124,validator_21,85957096172,True,183220998,1132200,184353198,True
8125,validator_23,52155875834,True,84363003,744630,85107633,True
8126,validator_25,48424083090,True,124791000,253930,125044930,False
8127,validator_26,50974613530,True,41836000,1370140,43206140,False
8128,validator_26,51067159930,True,91976000,570400,92546400,False
8129,validator_48,181368912080,True,84090000,23474200,107564200,False
8130,validator_12,120961935279,True,127795997,445600,128241597,True
8131,validator_31,184905085030,True,89732000,1720000,91452000,False
8132,validator_47,82469970350,True,98296000,746040,99042040,False
8133,validator_38,48892338080,True,180059000,600800,180659800,False
8134,validator_11,53613054408,True,84988999,682700,85671699,True
8135,validator_40,50306413570,True,96137000,653200,96790200,False
8136,validator_15,294617852836,True,82402995,1836200,84239195,True
8137,validator_43,80924426900,True,49478000,1373500,50851500,False
8138,validator_46,115615498740,True,56378000,1662090,58040090,False
8139,validator_46,115746605240,True,130670000,436500,131106500,False
8140,validator_35,117064688650,True,36827000,1237400,38064400,False
8141,validator_11,53802326410,True,181993002,7279000,189272002,True
8142,validator_36,115783965650,True,135960000,18234220,154194220,False
8143,validator_19,89539933696,True,289935003,931600,290866603,True
8144,validator_44,117524739720,True,169571000,4842670,174413670,False
8145,validator_36,115948830150,True,162874000,1990500,164864500,False
8146,validator_33,47065707960,True,86609000,657260,87266260,False
8147,validator_22,85485504947,True,148897006,19157630,168054636,True
8148,validator_2,55017862099,True,84121010,2446900,86567910,True
8149,validator_21,86108590173,True,133497001,17997000,151494001,True
8150,validator_48,181496783380,True,126703000,1168300,127871300,False
8151,validator_11,53940175409,True,127394999,10454000,137848999,True
8152,validator_36,116068582350,True,109843000,9909200,119752200,False
8153,validator_24,51251195096,True,111061003,900400,111961403,True
8154,validator_7,88964905595,True,48788001,1050180,49838181,True
8155,validator_46,115849752050,True,101701000,1445810,103146810,False
8156,validator_35,117348751870,True,265096000,18967220,284063220,False
8157,validator_47,82629764480,True,139277000,20517130,159794130,False
8158,validator_10,53318742458,True,251234994,8091300,259326294,True
8159,validator_19,89592883594,True,52486998,462900,52949898,True
8160,validator_23,52279003773,True,104173999,18953940,123127939,True
8161,validator_2,55204556822,True,186212003,482720,186694723,True
8162,validator_45,47507131940,True,70879000,1175900,72054900,False
8163,validator_20,50310409617,True,69186000,208220,69394220,True
8164,validator_33,47172344660,True,102141000,4495700,106636700,False
8165,validator_41,85085622210,True,153282000,22922600,176204600,False
8166,validator_9,55021438933,True,154818000,1482760,156300760,True
8167,validator_26,51177400930,True,92398000,17843000,110241000,False
8168,validator_13,50653191418,True,51202999,1808300,53011299,True
8169,validator_1,87464232030,True,94488999,4686530,99175529,True
8170,validator_17,190697389554,True,223452002,7626090,231078092,True
8171,validator_0,52928807149,True,109111001,2669660,111780661,True
8172,validator_48,181708941660,True,211957000,201280,212158280,False
8173,validator_12,121089003279,True,125354000,1714000,127068000,True
8174,validator_31,184959071720,True,52641000,1345690,53986690,False
8175,validator_5,87140682364,True,207804996,2342900,210147896,True
8176,validator_12,121192413083,True,102588004,821800,103409804,True
8177,validator_33,47338242040,True,147019000,18878380,165897380,False
8178,validator_26,51343318050,True,161190000,4727120,165917120,False
8179,validator_22,85692734949,True,205233002,1997000,207230002,True
8180,validator_20,50447560545,True,135908998,1241930,137150928,True
8181,validator_16,50753315756,True,49493999,1147300,50641299,True
8182,validator_11,54076497116,True,134194007,2127700,136321707,True
8183,validator_19,89742992596,True,148942002,1167000,150109002,True
8184,validator_34,282176166030,True,87211000,1479100,88690100,False
8185,validator_18,122057969220,True,214268998,652400,214921398,True
8186,validator_24,51427027575,True,175076999,755480,175832479,True
8187,validator_14,123644886259,True,132122000,658880,132780880,True
8188,validator_21,86204003315,True,94182002,1231140,95413142,True
8189,validator_18,122178163520,True,119663000,531300,120194300,True
8190,validator_22,85797455885,True,85785996,18934940,104720936,True
8191,validator_30,84581384840,True,89708000,1320130,91028130,False
8192,validator_15,294736755133,True,117909997,992300,118902297,True
8193,validator_47,82707220380,True,76743000,712900,77455900,False
8194,validator_33,47415944930,True,76975000,727890,77702890,False
8195,validator_31,185012308420,True,35157000,18079700,53236700,False
8196,validator_13,50708408313,True,53705995,1510900,55216895,True
8197,validator_2,55365737486,True,159494004,1686660,161180664,True
8198,validator_32,50416697660,True,132140000,1698230,133838230,False
8199,validator_25,48540563590,True,116152000,328500,116480500,False
8200,validator_37,82705087420,True,129260000,773400,130033400,False
8201,validator_42,51045929680,True,106808000,379490,107187490,False
8202,validator_22,86128535779,True,329973004,1106890,331079894,True
8203,validator_36,116217040950,True,128720000,19738600,148458600,False
8204,validator_49,84494217650,True,87218000,4326860,91544860,False
8205,validator_30,84730273680,True,142338000,6550840,148888840,False
8206,validator_33,47589500950,True,171484000,2072020,173556020,False
8207,validator_27,117660240660,True,75501000,460580,75961580,False
8208,validator_29,46959072790,True,104091000,296830,104387830,False
8209,validator_34,282398820350,True,221515000,1139320,222654320,False
8210,validator_29,47056153790,True,88804000,8277000,97081000,False
8211,validator_29,47090348520,True,32549000,1645730,34194730,False
8212,validator_20,50740958844,True,291091999,2306300,293398299,True
8213,validator_17,190901703367,True,203858003,455810,204313813,True
8214,validator_37,82803014200,True,78870000,19056780,97926780,False
8215,validator_24,51580518378,True,152973003,517800,153490803,True
8216,validator_46,115989758750,True,136872000,3134700,140006700,False
8217,validator_27,117829766970,True,142415000,27111310,169526310,False
8218,validator_34,282564504330,True,145639000,20044980,165683980,False
8219,validator_16,50993820557,True,238425001,2079800,240504801,True
8220,validator_27,117924769570,True,90157000,4845600,95002600,False
8221,validator_19,89885027921,True,140947005,1088320,142035325,True
8222,validator_21,86350015121,True,145152006,859800,146011806,True
8223,validator_22,86277558496,True,130263997,18758720,149022717,True
8224,validator_15,294883701229,True,144392996,2553100,146946096,True
8225,validator_35,117493866660,True,144835000,279790,145114790,False
8226,validator_3,56583275755,True,140779001,2991030,143770031,True
8227,validator_4,54547880793,True,200565997,2090730,202656727,True
8228,validator_22,86483342418,True,204245002,1538920,205783922,True
8229,validator_15,295151461283,True,267484004,276050,267760054,True
8230,validator_18,122454058051,True,274152001,1742530,275894531,True
8231,validator_20,50840662374,True,99382000,321530,99703530,True
8232,validator_28,48716568740,True,58714000,599330,59313330,False
8233,validator_42,51107951460,True,60421000,1600780,62021780,False
8234,validator_24,51744093079,True,161132001,2442700,163574701,True
8235,validator_48,181840700400,True,113198000,18560740,131758740,False
8236,validator_29,47156548220,True,64471000,1728700,66199700,False
8237,validator_20,50912437506,True,69875002,1900130,71775132,True
8238,validator_30,84801628180,True,69973000,1381500,71354500,False
8239,validator_5,87216466583,True,73896999,1887220,75784219,True
8240,validator_10,53551631960,True,225083002,7806500,232889502,True
8241,validator_45,47590505440,True,83181000,192500,83373500,False
8242,validator_0,53145663249,True,204184000,12672100,216856100,True
8243,validator_21,86467811317,True,117227996,568200,117796196,True
8244,validator_35,117578924960,True,84468000,590300,85058300,False
8245,validator_30,84874578680,True,65027000,7923500,72950500,False
8246,validator_43,80981478430,True,48872000,8179530,57051530,False
8247,validator_23,52454576815,True,174173002,1400040,175573042,True
8248,validator_20,51084993605,True,154004999,18551100,172556099,True
8249,validator_27,118076421170,True,149907000,1744600,151651600,False
8250,validator_45,47652322940,True,55876000,5941500,61817500,False
8251,validator_32,50504399800,True,79256000,8446140,87702140,False
8252,validator_9,55191517623,True,150750000,19328690,170078690,True
8253,validator_49,84639965580,True,143743000,2004930,145747930,False
8254,validator_20,51290588086,True,197156001,8438480,205594481,True
8255,validator_43,81088484620,True,82787000,24219190,107006190,False
8256,validator_49,84730318310,True,83618000,6734730,90352730,False
8257,validator_11,54232331817,True,154660001,1174700,155834701,True
8258,validator_17,190998468268,True,91875001,4889900,96764901,True
8259,validator_44,117646043700,True,119957000,1346980,121303980,False
8260,validator_13,50835775269,True,108839996,18526960,127366956,True
8261,validator_27,118156611270,True,78026000,2164100,80190100,False
8262,validator_9,55343848148,True,151014005,1316520,152330525,True
8263,validator_46,116176501840,True,165937000,20806090,186743090,False
8264,validator_39,52215806710,True,69936000,760900,70696900,False
8265,validator_15,295298363080,True,146240997,660800,146901797,True
8266,validator_6,52804629315,True,54234996,1210500,55445496,True
8267,validator_10,53620609084,True,61952004,7025120,68977124,True
8268,validator_18,122667983782,True,213168991,756740,213925731,True
8269,validator_39,52254000810,True,36894000,1300100,38194100,False
8270,validator_13,50947548900,True,111163001,610630,111773631,True
8271,validator_30,84947169710,True,58156000,14435030,72591030,False
8272,validator_22,86574137071,True,85376003,5418650,90794653,True
8273,validator_4,54738281721,True,189975998,424930,190400928,True
8274,validator_33,47681905350,True,91955000,449400,92404400,False
8275,validator_34,282678106780,True,113420000,182450,113602450,False
8276,validator_21,86644813236,True,176106999,894920,177001919,True
8277,validator_19,90068566722,True,181113001,2425800,183538801,True
8278,validator_15,295387065476,True,87018996,1683400,88702396,True
8279,validator_13,51019317897,True,70846997,922000,71768997,True
8280,validator_34,282759340280,True,80372000,861500,81233500,False
8281,validator_11,54459891257,True,226830000,729440,227559440,True
8282,validator_46,116393973040,True,215933000,1538200,217471200,False
8283,validator_29,47276854620,True,119698000,608400,120306400,False
8284,validator_15,295556454066,True,167292000,2096590,169388590,True
8285,validator_23,52625251162,True,163177997,7496350,170674347,True
8286,validator_18,122818220184,True,148823002,1413400,150236402,True
8287,validator_18,122999572389,True,179174005,2178200,181352205,True
8288,validator_15,295628511790,True,69396994,2660730,72057724,True
8289,validator_7,89071551997,True,105219002,1427400,106646402,True
8290,validator_25,48685999690,True,143610000,1826100,145436100,False
8291,validator_9,55512716144,True,165929996,2938000,168867996,True
8292,validator_15,295779251912,True,148031992,2708130,150740122,True
8293,validator_47,82854474080,True,146517000,736700,147253700,False
8294,validator_16,51319044999,True,318028002,7196440,325224442,True
8295,validator_42,51213190590,True,103821000,1418130,105239130,False
8296,validator_12,121286812885,True,91933002,2466800,94399802,True
8297,validator_30,84995659000,True,47143000,1346290,48489290,False
8298,validator_31,185189324520,True,176601000,415100,177016100,False
8299,validator_3,56663882559,True,72441004,8165800,80606804,True
8300,validator_6,52900371486,True,95140001,602170,95742171,True
8301,validator_0,53433987227,True,287248998,1074980,288323978,True
8302,validator_49,84797198010,True,66343000,536700,66879700,False
8303,validator_25,48882836320,True,191751000,5085630,196836630,False
8304,validator_31,185384929520,True,177805000,17800000,195605000,False
8305,validator_40,50384641710,True,77675000,553140,78228140,False
8306,validator_36,116387822550,True,169556000,1225600,170781600,False
8307,validator_22,86652073165,True,75912994,2023100,77936094,True
8308,validator_1,87608291033,True,143154003,905000,144059003,True
8309,validator_1,87723833037,True,113886004,1656000,115542004,True
8310,validator_35,117657080200,True,76245000,1910240,78155240,False
8311,validator_43,81206642300,True,99729000,18428680,118157680,False
8312,validator_46,116480591630,True,85769000,849590,86618590,False
8313,validator_38,48978629880,True,84704000,1587800,86291800,False
8314,validator_0,53653954867,True,219274000,693640,219967640,True
8315,validator_29,47411285260,True,128682000,5748640,134430640,False
8316,validator_2,55493340367,True,109015001,18587880,127602881,True
8317,validator_2,55539684566,True,44836999,1507200,46344199,True
8318,validator_45,47823707840,True,171242000,142900,171384900,False
8319,validator_10,53749570689,True,123540005,5421600,128961605,True
8320,validator_19,90211917323,True,141018001,2332600,143350601,True
8321,validator_19,90321367422,True,108136999,1313100,109450099,True
8322,validator_37,83001692230,True,179317000,19361030,198678030,False
8323,validator_32,50550885900,True,45994000,492100,46486100,False
8324,validator_22,86810021969,True,155791004,2157800,157948804,True
8325,validator_14,123802724662,True,156781003,1057400,157838403,True
8326,validator_18,123225760786,True,225264997,923400,226188397,True
8327,validator_36,116461528050,True,72930000,775500,73705500,False
8328,validator_31,185507288850,True,105576000,16783330,122359330,False
8329,validator_12,121412452085,True,116029000,9610200,125639200,True
8330,validator_37,83114733030,True,112046000,994800,113040800,False
8331,validator_0,53802063606,True,146568999,1539740,148108739,True
8332,validator_19,90405803326,True,84063004,372900,84435904,True
8333,validator_23,52855862188,True,227665996,2945030,230611026,True
8334,validator_19,90501579829,True,95213003,563500,95776503,True
8335,validator_8,54253962779,True,134647999,8768200,143416199,True
8336,validator_22,86923918970,True,112507001,1390000,113897001,True
8337,validator_9,55627920542,True,110052998,5151400,115204398,True
8338,validator_31,185698152340,True,189725000,1138490,190863490,False
8339,validator_38,49146158480,True,165742000,1786600,167528600,False
8340,validator_44,117767888000,True,117927000,3917300,121844300,False
8341,validator_26,51502807650,True,159387000,102600,159489600,False
8342,validator_5,87370320682,True,133699999,20154100,153854099,True
8343,validator_35,117829778780,True,172581000,117580,172698580,False
8344,validator_4,54853186917,True,112093996,2811200,114905196,True
8345,validator_26,51590979780,True,86887000,1285130,88172130,False
8346,validator_36,116539546830,True,73073000,4945780,78018780,False
8347,validator_22,87102899972,True,178665002,316000,178981002,True
8348,validator_17,191129351098,True,126201000,4681830,130882830,True
8349,validator_11,54736733789,True,275766002,1076530,276842532,True
8350,validator_46,116557350420,True,75230000,1528790,76758790,False
8351,validator_25,49015041850,True,126890000,5315530,132205530,False
8352,validator_22,87164660003,True,60045001,1715030,61760031,True
8353,validator_39,52318779910,True,64184000,595100,64779100,False
8354,validator_36,116629006130,True,76797000,12662300,89459300,False
8355,validator_29,47545435680,True,132487000,1663420,134150420,False
8356,validator_47,82937641490,True,82278000,889410,83167410,False
8357,validator_44,117877320360,True,108504000,928360,109432360,False
8358,validator_40,50465539040,True,80257000,640330,80897330,False
8359,validator_30,85072517600,True,74700000,2158600,76858600,False
8360,validator_20,51518134679,True,219592993,7953600,227546593,True
8361,validator_27,118275723770,True,112588000,6524500,119112500,False
8362,validator_38,49224110380,True,51698000,26253900,77951900,False
8363,validator_29,47599116660,True,53451000,229980,53680980,False
8364,validator_29,47696667250,True,89238000,8312590,97550590,False
8365,validator_36,116813741400,True,184413000,322270,184735270,False
8366,validator_30,85166441100,True,93359000,564500,93923500,False
8367,validator_17,191237423101,True,107931003,141000,108072003,True
8368,validator_12,121601367185,True,187778000,1137100,188915100,True
8369,validator_23,52938238188,True,80761000,1615000,82376000,True
8370,validator_4,55004848109,True,150960992,700200,151661192,True
8371,validator_34,282813465160,True,53923000,201880,54124880,False
8372,validator_43,81330140600,True,123195000,303300,123498300,False
8373,validator_43,81485989790,True,135773000,20076190,155849190,False
8374,validator_9,55687177420,True,58745998,510880,59256878,True
8375,validator_1,87814009638,True,82635001,7541600,90176601,True
8376,validator_34,282885419260,True,70526000,1428100,71954100,False
8377,validator_45,47941515240,True,115957000,1850400,117807400,False
8378,validator_36,116870504840,True,55316000,1447440,56763440,False
8379,validator_18,123343954220,True,117009994,1183440,118193434,True
8380,validator_47,83067943890,True,129274000,1028400,130302400,False
8381,validator_9,55801962122,True,114054002,730700,114784702,True
8382,validator_27,118404083470,True,125689000,2670700,128359700,False
8383,validator_38,49343771500,True,118198000,1463120,119661120,False
8384,validator_21,86735012732,True,88699996,1499500,90199496,True
8385,validator_11,54916646949,True,177646000,2267160,179913160,True
8386,validator_49,84850356610,True,34815000,18343600,53158600,False
8387,validator_11,54986517952,True,68410003,1461000,69871003,True
8388,validator_48,181978799490,True,136850000,1249090,138099090,False
8389,validator_34,283125104260,True,238355000,1330000,239685000,False
8390,validator_12,121712531464,True,103330999,7833280,111164279,True
8391,validator_20,51673800524,True,147825005,7840840,155665845,True
8392,validator_10,53884122533,True,133601004,950840,134551844,True
8393,validator_47,83137374820,True,67272000,2158930,69430930,False
8394,validator_23,53162585907,True,223129999,1217720,224347719,True
8395,validator_38,49517927190,True,168188000,5967690,174155690,False
8396,validator_35,117940937830,True,110681000,478050,111159050,False
8397,validator_37,83213116830,True,95898000,2485800,98383800,False
8398,validator_47,83217573320,True,75407000,4791500,80198500,False
8399,validator_36,117080830340,True,200338000,9987500,210325500,False
8400,validator_34,283232979660,True,88740000,19135400,107875400,False
8401,validator_5,87421367619,True,50040997,1005940,51046937,True
8402,validator_44,117991448160,True,113177000,950800,114127800,False
8403,validator_14,123905771608,True,100815996,2230950,103046946,True
8404,validator_39,52458743090,True,138923000,1040180,139963180,False
8405,validator_33,47869954150,True,180558000,7490800,188048800,False
8406,validator_15,295923143211,True,135272999,8618300,143891299,True
8407,validator_22,87397442944,True,232356001,426940,232782941,True
8408,validator_41,85167144510,True,80101000,1421300,81522300,False
8409,validator_38,49653613510,True,133732000,1954320,135686320,False
8410,validator_0,53913288998,True,110637002,588390,111225392,True
8411,validator_11,55107944649,True,120873997,552700,121426697,True
8412,validator_13,51167054199,True,147443002,293300,147736302,True
8413,validator_4,55071216207,True,65281998,1086100,66368098,True
8414,validator_41,85212834750,True,45402000,288240,45690240,False
8415,validator_5,87612402719,True,190752000,283100,191035100,True
8416,validator_36,117222080640,True,133326000,7924300,141250300,False
8417,validator_7,89218178633,True,145570996,1055640,146626636,True
8418,validator_11,55254657357,True,128129998,18582710,146712708,True
8419,validator_40,50515518370,True,49145000,834330,49979330,False
8420,validator_10,54011334750,True,122236997,4975220,127212217,True
8421,validator_25,49122936850,True,99653000,8242000,107895000,False
8422,validator_6,53064778185,True,163554999,851700,164406699,True
8423,validator_15,296035200953,True,111328002,729740,112057742,True
8424,validator_8,54320608481,True,64259002,2386700,66645702,True
8425,validator_41,85257470050,True,42919000,1716300,44635300,False
8426,validator_31,185747252940,True,48220000,880600,49100600,False
8427,validator_47,83263196410,True,45021000,602090,45623090,False
8428,validator_30,85336928300,True,152471000,18016200,170487200,False
8429,validator_23,53283174988,True,119628001,961080,120589081,True
8430,validator_21,86858044134,True,121451002,1580400,123031402,True
8431,validator_3,56815106264,True,148892005,2331700,151223705,True
8432,validator_42,51317239300,True,102034000,2014710,104048710,False
8433,validator_1,88003702188,True,189372000,320550,189692550,True
8434,validator_6,53189668870,True,124092995,797690,124890685,True
8435,validator_7,89311327130,True,91997997,1150500,93148497,True
8436,validator_25,49187968350,True,46560000,18471500,65031500,False
8437,validator_1,88263831892,True,257444004,2685700,260129704,True
8438,validator_11,55376624194,True,121625997,340840,121966837,True
8439,validator_34,283411999560,True,135710000,43309900,179019900,False
8440,validator_15,296265526747,True,210848994,19476800,230325794,True
8441,validator_10,54148869315,True,136394995,1139570,137534565,True
8442,validator_39,52645456720,True,185642000,1071630,186713630,False
8443,validator_14,124060030435,True,152978997,1279830,154258827,True
8444,validator_47,83329723130,True,60337000,6189720,66526720,False
8445,validator_25,49325020450,True,134315000,2737100,137052100,False
8446,validator_37,83333868070,True,120332000,419240,120751240,False
8447,validator_21,87041895199,True,164118005,19733060,183851065,True
8448,validator_10,54392023316,True,241885001,1269000,243154001,True
8449,validator_9,55883687757,True,81505995,219640,81725635,True
8450,validator_31,185831120240,True,83320000,547300,83867300,False
8451,validator_35,118124855030,True,182324000,1593200,183917200,False
8452,validator_27,118552345890,True,148179000,83420,148262420,False
8453,validator_27,118747314930,True,194147000,822040,194969040,False
8454,validator_4,55198717509,True,127355002,146300,127501302,True
8455,validator_9,55953563746,True,68962999,912990,69875989,True
8456,validator_38,49809715640,True,155236000,866130,156102130,False
8457,validator_10,54463885591,True,70571995,1290280,71862275,True
8458,validator_47,83450319320,True,119292000,1304190,120596190,False
8459,validator_8,54358437878,True,36730997,1098400,37829397,True
8460,validator_20,51757744523,True,71152999,12791000,83943999,True
8461,validator_39,52718145490,True,70357000,2331770,72688770,False
8462,validator_17,191362331384,True,123966003,942280,124908283,True
8463,validator_45,48086497440,True,144238000,744200,144982200,False
8464,validator_16,51489381801,True,165091002,5245800,170336802,True
8465,validator_12,121844408261,True,130426997,1449800,131876797,True
8466,validator_13,51356912803,True,188387004,1471600,189858604,True
8467,validator_46,116740687720,True,174972000,8365300,183337300,False
8468,validator_38,49888765440,True,78186000,863800,79049800,False
8469,validator_15,296454600049,True,187655002,1418300,189073302,True
8470,validator_1,88388709716,True,123739004,1138820,124877824,True
8471,validator_47,83545275550,True,92864000,2092230,94956230,False
8472,validator_24,51962599580,True,217768001,738500,218506501,True
8473,validator_33,47988853730,True,99741000,19158580,118899580,False
8474,validator_11,55689071536,True,304716002,7731340,312447342,True
8475,validator_31,185959796660,True,120213000,8463420,128676420,False
8476,validator_28,48883915040,True,148977000,18369300,167346300,False
8477,validator_46,116833939680,True,73212000,20039960,93251960,False
8478,validator_2,55721856000,True,174317004,7854430,182171434,True
8479,validator_18,123510079620,True,165058000,1067400,166125400,True
8480,validator_47,83645186700,True,98625000,1286150,99911150,False
8481,validator_43,81651716190,True,165113000,613400,165726400,False
8482,validator_7,89462541012,True,141753002,9460880,151213882,True
8483,validator_10,54619286209,True,153317998,2082620,155400618,True
8484,validator_42,51363211920,True,45267000,705620,45972620,False
8485,validator_25,49374724190,True,42006000,7697740,49703740,False
8486,validator_15,296672670895,True,202849996,15220850,218070846,True
8487,validator_16,51595012801,True,105387000,244000,105631000,True
8488,validator_40,50651801570,True,135439000,844200,136283200,False
8489,validator_20,51824015264,True,66027001,243740,66270741,True
8490,validator_15,296746115596,True,72846001,598700,73444701,True
8491,validator_18,123597415981,True,85737001,1599360,87336361,True
8492,validator_32,50710544000,True,158355000,1303100,159658100,False
8493,validator_31,186066717160,True,105062000,1858500,106920500,False
8494,validator_25,49455648990,True,80841000,83800,80924800,False
8495,validator_40,50812432350,True,158547000,2083780,160630780,False
8496,validator_29,47847346870,True,148451000,2228620,150679620,False
8497,validator_30,85490982030,True,153158000,895730,154053730,False
8498,validator_40,50908952150,True,86942000,9577800,96519800,False
8499,validator_3,56934274064,True,118154000,1013800,119167800,True
8500,validator_15,296870994823,True,123546007,1333220,124879227,True
8501,validator_32,50926140100,True,210996000,4600100,215596100,False
8502,validator_5,87708993750,True,95398001,1193030,96591031,True
8503,validator_8,54483823381,True,106192003,19193500,125385503,True
8504,validator_30,85637632130,True,138326000,8324100,146650100,False
8505,validator_4,55284762835,True,85825996,219330,86045326,True
8506,validator_36,117416251740,True,191408000,2763100,194171100,False
8507,validator_41,85388179780,True,128316000,2393730,130709730,False
8508,validator_30,85762129730,True,105375000,19122600,124497600,False
8509,validator_18,123786770582,True,188012001,1342600,189354601,True
8510,validator_38,50052797160,True,126661000,37370720,164031720,False
8511,validator_12,122012421998,True,140958997,27054740,168013737,True
8512,validator_15,296984217623,True,113036000,186800,113222800,True
8513,validator_48,182077882790,True,97465000,1618300,99083300,False
8514,validator_25,49609221580,True,152229000,1343590,153572590,False
8515,validator_5,87841496749,True,128742999,3760000,132502999,True
8516,validator_21,87279353491,True,229172002,8286290,237458292,True
8517,validator_45,48210739800,True,122005000,2237360,124242360,False
8518,validator_25,49702853000,True,92713000,918420,93631420,False
8519,validator_13,51543480024,True,184638001,1929220,186567221,True
8520,validator_1,88491004347,True,101586001,708630,102294631,True
8521,validator_14,124153746732,True,92079997,1636300,93716297,True
8522,validator_1,88667026783,True,174018996,2003440,176022436,True
8523,validator_23,53479675588,True,178121000,18379600,196500600,True
8524,validator_34,283558423060,True,138650000,7773500,146423500,False
8525,validator_1,88753498883,True,84603000,1869100,86472100,True
8526,validator_28,48981696070,True,97279000,502030,97781030,False
8527,validator_49,85014716940,True,163528000,832330,164360330,False
8528,validator_14,124205320935,True,49807003,1767200,51574203,True
8529,validator_42,51524374420,True,160278000,884500,161162500,False
8530,validator_8,54666430311,True,174926000,7680930,182606930,True
8531,validator_6,53258595470,True,67733000,1193600,68926600,True
8532,validator_1,88918297484,True,163545001,1253600,164798601,True
8533,validator_12,122088000100,True,56682002,18896100,75578102,True
8534,validator_20,51936874566,True,111083002,1776300,112859302,True
8535,validator_23,53667680388,True,187091000,913800,188004800,True
8536,validator_18,123894889083,True,108075001,43500,108118501,True
8537,validator_44,118148809350,True,156425000,936190,157361190,False
8538,validator_7,89626876954,True,155871002,8464940,164335942,True
8539,validator_36,117517572320,True,100458000,862580,101320580,False
8540,validator_25,49856074100,True,151460000,1761100,153221100,False
8541,validator_32,51007122500,True,80421000,561400,80982400,False
8542,validator_24,52093486682,True,129180002,1707100,130887102,True
8543,validator_28,49087616400,True,100923000,4997330,105920330,False
8544,validator_3,57172428276,True,237164002,990210,238154212,True
8545,validator_44,118347606150,True,198192000,604800,198796800,False
8546,validator_41,85430305880,True,41005000,1121100,42126100,False
8547,validator_48,182300787690,True,213286000,9618900,222904900,False
8548,validator_28,49231763100,True,142335000,1811700,144146700,False
8549,validator_12,122203658799,True,82916999,32741700,115658699,True
8550,validator_19,90631698123,True,111758994,18359300,130118294,True
8551,validator_8,54901868406,True,234032995,1405100,235438095,True
8552,validator_22,87576700285,True,172798001,6459340,179257341,True
8553,validator_26,51675652980,True,82244000,2429200,84673200,False
8554,validator_17,191530698010,True,162666996,5699630,168366626,True
8555,validator_5,87958112251,True,115832002,783500,116615502,True
8556,validator_15,297070357653,True,85486000,654030,86140030,True
8557,validator_32,51190285400,True,182873000,289900,183162900,False
8558,validator_12,122291346235,True,85580006,2107430,87687436,True
8559,validator_39,52799444590,True,80988000,311100,81299100,False
8560,validator_28,49357141830,True,125086000,292730,125378730,False
8561,validator_2,55904881144,True,181693004,1332140,183025144,True
8562,validator_20,52042359761,True,100414995,5070200,105485195,True
8563,validator_44,118518598580,True,169292000,1700430,170992430,False
8564,validator_0,54066879941,True,151918003,1672940,153590943,True
8565,validator_45,48383176200,True,171981000,455400,172436400,False
8566,validator_15,297169920154,True,98401001,1161500,99562501,True
8567,validator_31,186138519360,True,63756000,8046200,71802200,False
8568,validator_15,297342626557,True,154470003,18236400,172706403,True
8569,validator_0,54196153651,True,128837000,436710,129273710,True
8570,validator_12,122439870235,True,146497000,2027000,148524000,True
8571,validator_40,51070193250,True,157390000,3851100,161241100,False
8572,validator_24,52327414249,True,223785997,10141570,233927567,True
8573,validator_42,51599445920,True,73140000,1931500,75071500,False
8574,validator_27,118850602830,True,88580000,14707900,103287900,False
8575,validator_6,53376675731,True,99507001,18573260,118080261,True
8576,validator_19,90720215522,True,85296999,3220400,88517399,True
8577,validator_36,117643931520,True,123877000,2482200,126359200,False
8578,validator_35,118206064520,True,80357000,852490,81209490,False
8579,validator_25,49955005380,True,96028000,2903280,98931280,False
8580,validator_11,55796558237,True,96648001,10838700,107486701,True
8581,validator_30,85825498930,True,62397000,972200,63369200,False
8582,validator_36,117735282420,True,86201000,5149900,91350900,False
8583,validator_21,87364352590,True,77158999,7840100,84999099,True
8584,validator_40,51162959450,True,90807000,1959200,92766200,False
8585,validator_46,117029003080,True,192674000,2389400,195063400,False
8586,validator_25,50048766110,True,92246000,1514730,93760730,False
8587,validator_48,182433672410,True,132665000,219720,132884720,False
8588,validator_6,53552914731,True,174623000,1616000,176239000,True
8589,validator_30,85930244330,True,102821000,1924400,104745400,False
8590,validator_38,50285598260,True,195934000,36867100,232801100,False
8591,validator_36,117850731640,True,114755000,694220,115449220,False
8592,validator_21,87476600791,True,106508001,5740200,112248201,True
8593,validator_32,51297989500,True,106179000,1525100,107704100,False
8594,validator_45,48498794000,True,96554000,19063800,115617800,False
8595,validator_34,283601119660,True,42322000,374600,42696600,False
8596,validator_14,124264362161,True,57417996,1623230,59041226,True
8597,validator_10,54685642705,True,65881996,474500,66356496,True
8598,validator_23,53792807790,True,123622002,1505400,125127402,True
8599,validator_30,86023653630,True,90784000,2625300,93409300,False
8600,validator_10,54803438708,True,117394003,402000,117796003,True
8601,validator_16,51744253200,True,147742999,1497400,149240399,True
8602,validator_12,122508420592,True,67035997,1514360,68550357,True
8603,validator_8,55019745900,True,117261994,615500,117877494,True
8604,validator_47,83796433800,True,146308000,4939100,151247100,False
8605,validator_6,53619484530,True,65249999,1319800,66569799,True
8606,validator_5,88158176148,True,198319997,1743900,200063897,True
8607,validator_11,55904862142,True,105930005,2373900,108303905,True
8608,validator_10,54890219093,True,85657005,1123380,86780385,True
8609,validator_40,51268001830,True,103676000,1366380,105042380,False
8610,validator_16,51808139779,True,62249999,1636580,63886579,True
8611,validator_19,90947637551,True,226903999,518030,227422029,True
8612,validator_22,87760418692,True,183287007,431400,183718407,True
8613,validator_0,54399057518,True,201586997,1316870,202903867,True
8614,validator_39,52920910490,True,102959000,18506900,121465900,False
8615,validator_48,182615766410,True,179250000,2844000,182094000,False
8616,validator_13,51580752222,True,35261998,2010200,37272198,True
8617,validator_38,50379875960,True,93152000,1125700,94277700,False
8618,validator_31,186228210530,True,89316000,375170,89691170,False
8619,validator_41,85551373840,True,113468000,7599960,121067960,False
8620,validator_28,49467403760,True,109073000,1188930,110261930,False
8621,validator_46,117069358580,True,38378000,1977500,40355500,False
8622,validator_32,51391667660,True,92631000,1047160,93678160,False
8623,validator_47,83919244120,True,119953000,2857320,122810320,False
8624,validator_41,85724989940,True,173212000,404100,173616100,False
8625,validator_35,118281612880,True,75316000,232360,75548360,False
8626,validator_28,49594401280,True,125171000,1826520,126997520,False
8627,validator_31,186269052530,True,37734000,3108000,40842000,False
8628,validator_46,117120259380,True,49103000,1797800,50900800,False
8629,validator_16,51883731875,True,73057996,2534100,75592096,True
8630,validator_7,89715829092,True,87756998,1195140,88952138,True
8631,validator_31,186395597030,True,124562000,1982500,126544500,False
8632,validator_38,50558341950,True,177304000,1161990,178465990,False
8633,validator_20,52256529202,True,213945001,224440,214169441,True
8634,validator_40,51310204050,True,39201000,3001220,42202220,False
8635,validator_45,48585675430,True,81930000,4951430,86881430,False
8636,validator_13,51727297920,True,144493998,2051700,146545698,True
8637,validator_27,118928763950,True,76694000,1467120,78161120,False
8638,validator_9,56026237026,True,72455000,218280,72673280,True
8639,validator_25,50191765740,True,141930000,1069630,142999630,False
8640,validator_26,51790874380,True,114004000,1217400,115221400,False
8641,validator_18,124039070179,True,142882996,1298100,144181096,True
8642,validator_9,56137960026,True,109407000,2316000,111723000,True
8643,validator_36,117915341580,True,55318000,9291940,64609940,False
8644,validator_46,117234693200,True,102684000,11749820,114433820,False
8645,validator_6,53706538723,True,86318003,736190,87054193,True
8646,validator_19,91108429256,True,158832005,1959700,160791705,True
8647,validator_17,191596741237,True,64465997,1577230,66043227,True
8648,validator_36,118011561310,True,94632000,1587730,96219730,False
8649,validator_41,85809052860,True,82363000,1699920,84062920,False
8650,validator_33,48049809680,True,60239000,716950,60955950,False
8651,validator_16,52083606061,True,199396996,477190,199874186,True
8652,validator_47,84073344950,True,134869000,19231830,154100830,False
8653,validator_42,51679653620,True,78733000,1474700,80207700,False
8654,validator_3,57277960673,True,104400997,1131400,105532397,True
8655,validator_46,117396803870,True,160798000,1312670,162110670,False
8656,validator_9,56246551262,True,107305996,1285240,108591236,True
8657,validator_9,56377237863,True,128668001,2018600,130686601,True
8658,validator_49,85090109080,True,75080000,312140,75392140,False
8659,validator_27,119047047950,True,110826000,7458000,118284000,False
8660,validator_2,56019380547,True,113792003,707400,114499403,True
8661,validator_41,85905387760,True,94353000,1981900,96334900,False
8662,validator_32,51550404880,True,157346000,1391220,158737220,False
8663,validator_48,182742522990,True,107750000,19006580,126756580,False
8664,validator_11,56019707644,True,112767002,2078500,114845502,True
8665,validator_26,51899596580,True,105288000,3434200,108722200,False
8666,validator_20,52313778432,True,50727000,6522230,57249230,True
8667,validator_33,48123298660,True,66037000,7451980,73488980,False
8668,validator_43,81798767320,True,145764000,1287130,147051130,False
8669,validator_30,86133181430,True,91974000,17553800,109527800,False
8670,validator_45,48753977260,True,150399000,17902830,168301830,False
8671,validator_29,47986342810,True,137510000,1485940,138995940,False
8672,validator_45,48828128130,True,73844000,306870,74150870,False
8673,validator_1,89096535424,True,177593000,644940,178237940,True
8674,validator_3,57385390614,True,106936001,493940,107429941,True
8675,validator_29,48106560010,True,114685000,5532200,120217200,False
8676,validator_17,191668520833,True,69789996,1989600,71779596,True
8677,validator_32,51648216930,True,92792000,5020050,97812050,False
8678,validator_46,117440740510,True,42034000,1902640,43936640,False
8679,validator_3,57521807753,True,136143999,273140,136417139,True
8680,validator_37,83474438970,True,139201000,1369900,140570900,False
8681,validator_16,52254699148,True,169667997,1425090,171093087,True
8682,validator_7,89792503395,True,76043003,631300,76674303,True
8683,validator_41,85970269790,True,46674000,18208030,64882030,False
8684,validator_40,51359456750,True,49067000,185700,49252700,False
8685,validator_3,57616359650,True,93027997,1523900,94551897,True
8686,validator_9,56422908968,True,45180005,491100,45671105,True
8687,validator_24,52408664379,True,80699000,551130,81250130,True
8688,validator_27,119189612150,True,139779000,2785200,142564200,False
8689,validator_40,51508324870,True,147912000,956120,148868120,False
8690,validator_22,87939272688,True,176195996,2658000,178853996,True
8691,validator_25,50293822870,True,100654000,1403130,102057130,False
8692,validator_44,118614633420,True,94196000,1838840,96034840,False
8693,validator_48,182928492990,True,165044000,20926000,185970000,False
8694,validator_48,183065360290,True,136570000,297300,136867300,False
8695,validator_16,52454942876,True,199451998,791730,200243728,True
8696,validator_49,85316556220,True,190558000,35889140,226447140,False
8697,validator_31,186462071430,True,65068000,1406400,66474400,False
8698,validator_18,124190323520,True,146126001,5127340,151253341,True
8699,validator_18,124357776515,True,166896995,556000,167452995,True
8700,validator_24,52504460578,True,93693999,2102200,95796199,True
8701,validator_17,191830822536,True,161999003,302700,162301703,True
8702,validator_32,51775500230,True,126226000,1057300,127283300,False
8703,validator_45,49031043580,True,197195000,5720450,202915450,False
8704,validator_0,54552100321,True,152413003,629800,153042803,True
8705,validator_20,52439077001,True,106268999,19029570,125298569,True
8706,validator_34,283699164560,True,97178000,866900,98044900,False
8707,validator_33,48198945500,True,56688000,18958840,75646840,False
8708,validator_12,122563960088,True,52763996,2775500,55539496,True
8709,validator_37,83655013530,True,180310000,264560,180574560,False
8710,validator_39,53120438220,True,198684000,843730,199527730,False
8711,validator_30,86283704750,True,148737000,1786320,150523320,False
8712,validator_15,297522257813,True,178477996,1153260,179631256,True
8713,validator_9,56504327719,True,76026001,5392750,81418751,True
8714,validator_39,53315202880,True,192997000,1767660,194764660,False
8715,validator_14,124433150864,True,165628003,3160700,168788703,True
8716,validator_31,186526936050,True,62994000,1870620,64864620,False
8717,validator_46,117487956100,True,44618000,2597590,47215590,False
8718,validator_44,118844150100,True,227078000,2438680,229516680,False
8719,validator_44,118937662400,True,92018000,1494300,93512300,False
8720,validator_38,50674850310,True,116058000,450360,116508360,False
8721,validator_30,86377805890,True,91550000,2551140,94101140,False
8722,validator_34,283816979350,True,116922000,892790,117814790,False
8723,validator_18,124447863351,True,84089996,5996840,90086836,True
8724,validator_39,53446877580,True,111786000,19888700,131674700,False
8725,validator_43,81953488600,True,149539000,5182280,154721280,False
8726,validator_37,83736846420,True,75712000,6120890,81832890,False
8727,validator_35,118363609980,True,80381000,1616100,81997100,False
8728,validator_49,85457337620,True,139899000,882400,140781400,False
8729,validator_15,297679488445,True,154876002,2354630,157230632,True
8730,validator_7,90017125445,True,223432000,1190050,224622050,True
8731,validator_33,48273992030,True,67103000,7943530,75046530,False
8732,validator_34,283856667350,True,39333000,355000,39688000,False
8733,validator_28,49753097590,True,150863000,7833310,158696310,False
8734,validator_17,191990781937,True,159527001,432400,159959401,True
8735,validator_32,51891149930,True,107861000,7788700,115649700,False
8736,validator_44,119035036330,True,93618000,3755930,97373930,False
8737,validator_37,83822818850,True,85550000,422430,85972430,False
8738,validator_48,183129233890,True,63035000,838600,63873600,False
8739,validator_24,52557564404,True,51413996,1689830,53103826,True
8740,validator_23,53927060229,True,132303999,1948440,134252439,True
8741,validator_29,48205886410,True,98885000,441400,99326400,False
8742,validator_36,118047254110,True,33743000,1949800,35692800,False
8743,validator_9,56716338542,True,205456003,6554820,212010823,True
8744,validator_22,88080337568,True,135750000,5314880,141064880,True
8745,validator_6,53915594719,True,206980996,2075000,209055996,True
8746,validator_44,119155979930,True,112817000,8126600,120943600,False
8747,validator_22,88260749668,True,171972000,8440100,180412100,True
8748,validator_36,118250706100,True,201650000,1801990,203451990,False
8749,validator_17,192139688633,True,148475996,430700,148906696,True
8750,validator_29,48271918210,True,64797000,1234800,66031800,False
8751,validator_21,87643263876,True,166397995,265090,166663085,True
8752,validator_36,118473294750,True,206842000,15746650,222588650,False
8753,validator_30,86464152190,True,83484000,2862300,86346300,False
8754,validator_34,283916944460,True,58957000,1320110,60277110,False
8755,validator_9,56805081953,True,83006001,5737410,88743411,True
8756,validator_41,86072772790,True,100157000,2346000,102503000,False
8757,validator_40,51669477500,True,138156000,22996630,161152630,False
8758,validator_6,54022966146,True,104310997,3060430,107371427,True
8759,validator_26,52004134080,True,96416000,8121500,104537500,False
8760,validator_33,48484710870,True,209823000,895840,210718840,False
8761,validator_31,186627505750,True,99681000,888700,100569700,False
8762,validator_27,119353430650,True,158829000,4989500,163818500,False
8763,validator_12,122613420587,True,47354999,2105500,49460499,True
8764,validator_3,57728719250,True,110727000,1632600,112359600,True
8765,validator_29,48462976430,True,188420000,2638220,191058220,False
8766,validator_40,51719032600,True,46790000,2765100,49555100,False
8767,validator_27,119412755350,True,57753000,1571700,59324700,False
8768,validator_43,82073457100,True,118316000,1652500,119968500,False
8769,validator_47,84187810450,True,106756000,7709500,114465500,False
8770,validator_38,50757924110,True,82646000,427800,83073800,False
8771,validator_31,186746952250,True,112436000,7010500,119446500,False
8772,validator_40,51841111200,True,121027000,1051600,122078600,False
8773,validator_41,86256374990,True,175560000,8042200,183602200,False
8774,validator_1,89433372491,True,334821997,2015070,336837067,True
8775,validator_19,91287336661,True,173907005,5000400,178907405,True
8776,validator_49,85598265240,True,140484000,443620,140927620,False
8777,validator_14,124582022996,True,147673992,1198140,148872132,True
8778,validator_11,56119955043,True,80543999,19703400,100247399,True
8779,validator_12,122692732631,True,77976004,1336040,79312044,True
8780,validator_14,124702097696,True,118822000,1252700,120074700,True
8781,validator_46,117690435000,True,197435000,5043900,202478900,False
8782,validator_40,51996304500,True,153770000,1423300,155193300,False
8783,validator_6,54276173678,True,251753002,1454530,253207532,True
8784,validator_16,52538569075,True,76330999,7295200,83626199,True
8785,validator_26,52187735880,True,182315000,1286800,183601800,False
8786,validator_43,82247725300,True,150956000,23312200,174268200,False
8787,validator_17,192277330229,True,135902996,1738600,137641596,True
8788,validator_31,186845137450,True,95647000,2538200,98185200,False
8789,validator_4,55361492533,True,74516998,2212700,76729698,True
8790,validator_33,48586878300,True,101457000,710430,102167430,False
8791,validator_17,192383547929,True,98275000,7942700,106217700,True
8792,validator_30,86563285010,True,90760000,8372820,99132820,False
8793,validator_38,50952308140,True,185536000,8848030,194384030,False
8794,validator_10,54944539992,True,53083999,1236900,54320899,True
8795,validator_35,118490628980,True,126635000,384000,127019000,False
8796,validator_13,51964098620,True,235403000,1397700,236800700,True
8797,validator_22,88315536566,True,53575998,1210900,54786898,True
8798,validator_43,82402351100,True,153997000,628800,154625800,False
8799,validator_15,297812044906,True,122311001,10245460,132556461,True
8800,validator_49,85758046740,True,135445000,24336500,159781500,False
8801,validator_24,52735839402,True,176428998,1846000,178274998,True
8802,validator_33,48665975120,True,77858000,1238820,79096820,False
8803,validator_34,284074228190,True,155722000,1561730,157283730,False
8804,validator_31,187026421180,True,180400000,883730,181283730,False
8805,validator_19,91371533858,True,82899997,1297200,84197197,True
8806,validator_18,124724484478,True,257567997,19053130,276621127,True
8807,validator_44,119227341090,True,53008000,18353160,71361160,False
8808,validator_15,298013615309,True,200913003,657400,201570403,True
8809,validator_40,52267414430,True,270561000,548930,271109930,False
8810,validator_11,56258833843,True,137720000,1158800,138878800,True
8811,validator_48,183383690230,True,250798000,3658340,254456340,False
8812,validator_37,83884100080,True,59736000,1545230,61281230,False
8813,validator_39,53561926980,True,95947000,19102400,115049400,False
8814,validator_46,117776895950,True,85580000,880950,86460950,False
8815,validator_22,88472546722,True,155940006,1070150,157010156,True
8816,validator_39,53682487460,True,112936000,7624480,120560480,False
8817,validator_31,187141870260,True,107787000,7662080,115449080,False
8818,validator_7,90129872526,True,111880001,867080,112747081,True
8819,validator_46,117918388730,True,139791000,1701780,141492780,False
8820,validator_4,55408475929,True,46794996,188400,46983396,True
8821,validator_31,187274725100,True,127799000,5055840,132854840,False
8822,validator_12,122844163025,True,133287994,18142400,151430394,True
8823,validator_37,83907583470,True,23194000,289390,23483390,False
8824,validator_44,119402103930,True,172780000,1982840,174762840,False
8825,validator_2,56224153346,True,204236999,535800,204772799,True
8826,validator_18,124968837932,True,236383004,7970450,244353454,True
8827,validator_5,88303470552,True,135679004,9615400,145294404,True
8828,validator_39,53777234440,True,89893000,4853980,94746980,False
8829,validator_7,90247786492,True,113027006,4886960,117913966,True
8830,validator_49,85806531580,True,47871000,613840,48484840,False
8831,validator_0,54613152721,True,60211000,841400,61052400,True
8832,validator_35,118575605680,True,84651000,325700,84976700,False
8833,validator_10,55172101509,True,225175997,2385520,227561517,True
8834,validator_11,56595911460,True,332492997,4584620,337077617,True
8835,validator_2,56405951988,True,180334002,1464640,181798642,True
8836,validator_25,50385875870,True,86043000,6010000,92053000,False
8837,validator_48,183570423920,True,183999000,2734690,186733690,False
8838,validator_9,56948497963,True,142727000,689010,143416010,True
8839,validator_4,55523827167,True,113862998,1488240,115351238,True
8840,validator_11,56757123086,True,159982996,1228630,161211626,True
8841,validator_35,118666950170,True,90372000,972490,91344490,False
8842,validator_15,298106248605,True,91594996,1038300,92633296,True
8843,validator_21,87731264719,True,87104003,896840,88000843,True
8844,validator_3,57783104051,True,53100001,1284800,54384801,True
8845,validator_45,49156749400,True,124361000,1344820,125705820,False
8846,validator_35,118720315600,True,51511000,1854430,53365430,False
8847,validator_8,55146022236,True,124583006,1693330,126276336,True
8848,validator_17,192483216658,True,99180999,487730,99668729,True
8849,validator_13,52122324153,True,156851003,1374530,158225533,True
8850,validator_4,55677874297,True,152697000,1350130,154047130,True
8851,validator_45,49261786650,True,96256000,8781250,105037250,False
8852,validator_37,84005253210,True,96410000,1259740,97669740,False
8853,validator_14,124967078325,True,257351999,7628630,264980629,True
8854,validator_20,52631783298,True,192475997,230300,192706297,True
8855,validator_10,55310927498,True,137132999,1692990,138825989,True
8856,validator_9,57012241364,True,62895001,848400,63743401,True
8857,validator_8,55292579236,True,144745000,1812000,146557000,True
8858,validator_26,52259066180,True,70938000,392300,71330300,False
8859,validator_47,84255673050,True,67078000,784600,67862600,False
8860,validator_39,53855918440,True,59573000,19111000,78684000,False
8861,validator_43,82449403670,True,45957000,1095570,47052570,False
8862,validator_27,119552613530,True,139587000,271180,139858180,False
8863,validator_25,50484497800,True,97304000,1317930,98621930,False
8864,validator_7,90304777888,True,56833996,157400,56991396,True
8865,validator_26,52411597680,True,149104000,3427500,152531500,False
8866,validator_1,89581722782,True,125738001,22612290,148350291,True
8867,validator_16,52609311613,True,69396008,1346530,70742538,True
8868,validator_14,125074487422,True,105609997,1799100,107409097,True
8869,validator_16,52660339912,True,49483999,1544300,51028299,True
8870,validator_40,52460413830,True,173336000,19663400,192999400,False
8871,validator_2,56455260524,True,47235996,2072540,49308536,True
8872,validator_1,89682521166,True,99406994,1391390,100798384,True
8873,validator_40,52613406290,True,151117000,1875460,152992460,False
8874,validator_15,298331697939,True,205567994,19881340,225449334,True
8875,validator_43,82591492490,True,121157000,20931820,142088820,False
8876,validator_14,125123940926,True,48713004,740500,49453504,True
8877,validator_7,90578841008,True,254923000,19140120,274063120,True
8878,validator_1,89831778164,True,147476998,1780000,149256998,True
8879,validator_10,55369145301,True,56377003,1840800,58217803,True
8880,validator_7,90703178192,True,124134004,203180,124337184,True
8881,validator_28,49954422900,True,200348000,977310,201325310,False
8882,validator_42,51852903850,True,171853000,1397230,173250230,False
8883,validator_33,48818106950,True,151745000,386830,152131830,False
8884,validator_2,56568820228,True,111779004,1780700,113559704,True
8885,validator_1,90033037789,True,159321005,41938620,201259625,True
8886,validator_47,84404541550,True,141821000,7047500,148868500,False
8887,validator_18,125108378632,True,138809000,731700,139540700,True
8888,validator_4,55958254463,True,271439006,8941160,280380166,True
8889,validator_11,56878200366,True,117642000,3435280,121077280,True
8890,validator_6,54407847181,True,130510003,1163500,131673503,True
8891,validator_49,85941224320,True,132747000,1945740,134692740,False
8892,validator_49,86117711110,True,167232000,9254790,176486790,False
8893,validator_8,55498360935,True,185536999,20244700,205781699,True
8894,validator_36,118563606870,True,85716000,4596120,90312120,False
8895,validator_36,118617330470,True,52697000,1026600,53723600,False
8896,validator_48,183681729360,True,101629000,9676440,111305440,False
8897,validator_45,49446720480,True,183205000,1728830,184933830,False
8898,validator_14,125227699668,True,103117002,641740,103758742,True
8899,validator_36,118750562170,True,131495000,1736700,133231700,False
8900,validator_47,84601922780,True,194857000,2524230,197381230,False
8901,validator_0,54764600413,True,140784992,10662700,151447692,True
8902,validator_4,56124502961,True,157040998,9207500,166248498,True
8903,validator_11,56981239188,True,102289002,749820,103038822,True
8904,validator_8,55593563124,True,93965999,1236190,95202189,True
8905,validator_48,183872584460,True,189467000,1388100,190855100,False
8906,validator_32,52067906430,True,175106000,1650500,176756500,False
8907,validator_41,86375835490,True,111804000,7656500,119460500,False
8908,validator_1,90149993515,True,114980996,1974730,116955726,True
8909,validator_8,55664132806,True,52190002,18379680,70569682,True
8910,validator_17,192645338855,True,160604997,1517200,162122197,True
8911,validator_48,183984427940,True,110001000,1842480,111843480,False
8912,validator_4,56234673028,True,100607997,9562070,110170067,True
8913,validator_16,52873047931,True,185563999,27144020,212708019,True
8914,validator_17,192689195918,True,42902003,955060,43857063,True
8915,validator_25,50537989740,True,34521000,18970940,53491940,False
8916,validator_1,90369310745,True,218989000,328230,219317230,True
8917,validator_12,123029455121,True,182286996,3005100,185292096,True
8918,validator_42,51968282350,True,99822000,15556500,115378500,False
8919,validator_39,53934959740,True,60235000,18806300,79041300,False
8920,validator_6,54478313478,True,68363007,2103290,70466297,True
8921,validator_8,55777648588,True,113150002,365780,113515782,True
8922,validator_11,57056250334,True,73982996,1028150,75011146,True
8923,validator_42,52114484650,True,128084000,18118300,146202300,False
8924,validator_1,90512480750,True,124693005,18477000,143170005,True
8925,validator_35,118873817930,True,152419000,1083330,153502330,False
8926,validator_33,48877351670,True,57270000,1974720,59244720,False
8927,validator_19,91475282075,True,103322997,425220,103748217,True
8928,validator_7,90807261786,True,95320004,8763590,104083594,True
8929,validator_20,52782937828,True,144868000,6286530,151154530,True
8930,validator_1,90671671454,True,157629004,1561700,159190704,True
8931,validator_20,52865638211,True,81623993,1076390,82700383,True
8932,validator_42,52284620480,True,168357000,1778830,170135830,False
8933,validator_11,57164271233,True,102706999,5313900,108020899,True
8934,validator_14,125361634300,True,133288002,646630,133934632,True
8935,validator_20,53056935911,True,189376000,1921700,191297700,True
8936,validator_45,49505525780,True,53808000,4997300,58805300,False
8937,validator_17,192894757310,True,204663992,897400,205561392,True
8938,validator_20,53258482073,True,197313002,4233160,201546162,True
8939,validator_30,86625298320,True,61099000,914310,62013310,False
8940,validator_27,119665247570,True,110897000,1737040,112634040,False
8941,validator_22,88622906623,True,147975001,2384900,150359901,True
8942,validator_46,118024407830,True,104646000,1373100,106019100,False
8943,validator_13,52193839129,True,69452996,2061980,71514976,True
8944,validator_34,284110904890,True,34549000,2127700,36676700,False
8945,validator_21,87862435919,True,129375000,1796200,131171200,True
8946,validator_49,86233672710,True,109874000,6087600,115961600,False
8947,validator_41,86490280700,True,114056000,389210,114445210,False
8948,validator_43,82863833890,True,252660000,19681400,272341400,False
8949,validator_48,184193801940,True,189500000,19874000,209374000,False
8950,validator_26,52573147880,True,156663000,4887200,161550200,False
8951,validator_13,52380476630,True,184517001,2120500,186637501,True
8952,validator_18,125277048677,True,167050995,1619050,168670045,True
8953,validator_31,187321590200,True,45057000,1808100,46865100,False
8954,validator_46,118207665130,True,181720000,1537300,183257300,False
8955,validator_1,90852948752,True,181043998,233300,181277298,True
8956,validator_27,119773553510,True,105863000,2442940,108305940,False
8957,validator_1,91050935911,True,189765999,8221160,197987159,True
8958,validator_31,187459775040,True,128586000,9598840,138184840,False
8959,validator_39,54013216340,True,76674000,1582600,78256600,False
8960,validator_40,52714007680,True,99318000,1283390,100601390,False
8961,validator_36,118914524170,True,163559000,403000,163962000,False
8962,validator_36,119015083170,True,98204000,2355000,100559000,False
8963,validator_45,49589503770,True,82843000,1134990,83977990,False
8964,validator_46,118412266430,True,203029000,1572300,204601300,False
8965,validator_26,52667520120,True,92643000,1729240,94372240,False
8966,validator_14,125555218801,True,174391001,19193500,193584501,True
8967,validator_13,52579508953,True,175800003,23232320,199032323,True
8968,validator_4,56321307131,True,85833003,801100,86634103,True
8969,validator_6,54583021071,True,103516003,1191590,104707593,True
8970,validator_5,88428344981,True,117014999,7859430,124874429,True
8971,validator_27,119870952010,True,96859000,539500,97398500,False
8972,validator_33,48937997010,True,42129000,18516340,60645340,False
8973,validator_19,91530648777,True,53929002,1437700,55366702,True
8974,validator_31,187544360130,True,83237000,1348090,84585090,False
8975,validator_2,56733154961,True,158691003,5643730,164334733,True
8976,validator_12,123098883922,True,68415001,1013800,69428801,True
8977,validator_32,52173792830,True,105118000,768400,105886400,False
8978,validator_20,53360149871,True,101282998,384800,101667798,True
8979,validator_9,57123473761,True,110058997,1173400,111232397,True
8980,validator_47,84695944320,True,39122000,54899540,94021540,False
8981,validator_35,118987142070,True,110875000,2449140,113324140,False
8982,validator_44,119528066690,True,124977000,985760,125962760,False
8983,validator_27,120077993330,True,205609000,1432320,207041320,False
8984,validator_16,52978542122,True,102891001,2603190,105494191,True
8985,validator_41,86640697640,True,131654000,18762940,150416940,False
8986,validator_7,90944670591,True,136174005,1234800,137408805,True
8987,validator_40,52860039180,True,127221000,18810500,146031500,False
8988,validator_19,91573503854,True,42229997,625080,42855077,True
8989,validator_47,84726548020,True,30052000,551700,30603700,False
8990,validator_22,88758352764,True,112343001,23103140,135446141,True
8991,validator_37,84224685940,True,218931000,501730,219432730,False
8992,validator_12,123267194025,True,166729003,1581100,168310103,True
8993,validator_9,57397259387,True,271325006,2460620,273785626,True
8994,validator_31,187606598230,True,54111000,8127100,62238100,False
8995,validator_41,86774252620,True,131560000,1994980,133554980,False
8996,validator_24,52847527795,True,109474993,2213400,111688393,True
8997,validator_45,49651981170,True,62028000,449400,62477400,False
8998,validator_28,50100549100,True,144412000,1714200,146126200,False
8999,validator_19,91737139479,True,161656995,1978630,163635625,True
9000,validator_15,298470973542,True,137634003,1641600,139275603,True
9001,validator_29,48641008930,True,170286000,7746500,178032500,False
9002,validator_11,57387704738,True,222126005,1307500,223433505,True
9003,validator_35,119120195370,True,123003000,10050300,133053300,False
9004,validator_15,298577017843,True,103797001,2247300,106044301,True
9005,validator_32,52231396730,True,56331000,1272900,57603900,False
9006,validator_1,91164043512,True,106811001,6296600,113107601,True
9007,validator_16,53147199124,True,167666002,991000,168657002,True
9008,validator_34,284250207290,True,137955000,1347400,139302400,False
9009,validator_7,91051168992,True,105732001,766400,106498401,True
9010,validator_12,123424334011,True,155707006,1432980,157139986,True
9011,validator_26,52769413300,True,101416000,477180,101893180,False
9012,validator_25,50712354540,True,172554000,1810800,174364800,False
9013,validator_4,56427649474,True,106209003,133340,106342343,True
9014,validator_7,91168914018,True,107090006,10655020,117745026,True
9015,validator_22,88844244279,True,84334005,1557510,85891515,True
9016,validator_13,52743627674,True,162316001,1802720,164118721,True
9017,validator_42,52371077280,True,85623000,833800,86456800,False
9018,validator_32,52267728100,True,34710000,1621370,36331370,False
9019,validator_2,56828738911,True,94043000,1540950,95583950,True
9020,validator_18,125496900376,True,219323999,527700,219851699,True
9021,validator_46,118547636260,True,134358000,1011830,135369830,False
9022,validator_30,86762180040,True,136006000,875720,136881720,False
9023,validator_41,86908475220,True,133456000,766600,134222600,False
9024,validator_34,284416566390,True,141967000,24392100,166359100,False
9025,validator_35,119223776800,True,102784000,797430,103581430,False
9026,validator_18,125588395060,True,89728994,1765690,91494684,True
9027,validator_37,84432667780,True,188751000,19230840,207981840,False
9028,validator_15,298737716840,True,157701997,2997000,160698997,True
9029,validator_32,52383676800,True,113210000,2738700,115948700,False
9030,validator_15,298823811328,True,84528998,1565490,86094488,True
9031,validator_40,52983363300,True,104570000,18754120,123324120,False
9032,validator_46,118612988460,True,57941000,7411200,65352200,False
9033,validator_48,184330843920,True,136107000,934980,137041980,False
9034,validator_24,53025028897,True,176676002,825100,177501102,True
9035,validator_23,54017147960,True,88671001,1416730,90087731,True
9036,validator_24,53116288622,True,90050005,1209720,91259725,True
9037,validator_35,119273904370,True,44003000,6124570,50127570,False
9038,validator_14,125719004099,True,145349998,18435300,163785298,True
9039,validator_19,91852990855,True,114578006,1273370,115851376,True
9040,validator_32,52499928000,True,114515000,1736200,116251200,False
9041,validator_45,49773186370,True,115215000,5990200,121205200,False
9042,validator_40,53156498400,True,169443000,3692100,173135100,False
9043,validator_25,50812432070,True,87475000,12602530,100077530,False
9044,validator_38,51014567470,True,60723000,1536330,62259330,False
9045,validator_23,54079244779,True,60086999,2009820,62096819,True
9046,validator_48,184499284750,True,166935000,1505830,168440830,False
9047,validator_21,87993294948,True,125829999,5029030,130859029,True
9048,validator_0,54903223614,True,137014001,1609200,138623201,True
9049,validator_3,57883381353,True,99457002,820300,100277302,True
9050,validator_8,55819768831,True,41473003,647240,42120243,True
9051,validator_8,55875400026,True,55293995,337200,55631195,True
9052,validator_14,125852628581,True,117739002,15885480,133624482,True
9053,validator_16,53307847925,True,159330001,1318800,160648801,True
9054,validator_32,52530011030,True,29147000,936030,30083030,False
9055,validator_3,58028133578,True,126031995,18720230,144752225,True
9056,validator_18,125717598382,True,128747002,456320,129203322,True
9057,validator_6,54654704270,True,70044999,1638200,71683199,True
9058,validator_15,298957608323,True,132673995,1123000,133796995,True
9059,validator_30,86902461540,True,137893000,2388500,140281500,False
9060,validator_40,53248455290,True,91101000,855890,91956890,False
9061,validator_25,50903381210,True,88711000,2238140,90949140,False
9062,validator_32,52721846480,True,181970000,9865450,191835450,False
9063,validator_13,52873394375,True,127146001,2620700,129766701,True
9064,validator_19,91953518353,True,99765998,761500,100527498,True
9065,validator_42,52489580310,True,116724000,1779030,118503030,False
9066,validator_22,88931871781,True,86334002,1293500,87627502,True
9067,validator_40,53355062250,True,105473000,1133960,106606960,False
9068,validator_44,119594490390,True,65065000,1358700,66423700,False
9069,validator_13,53031049180,True,152723005,4931800,157654805,True
9070,validator_6,54885284567,True,210827997,19752300,230580297,True
9071,validator_29,48724701830,True,82263000,1429900,83692900,False
9072,validator_24,53206517242,True,88342000,1886620,90228620,True
9073,validator_37,84492257480,True,58753000,836700,59589700,False
9074,validator_0,54981312012,True,77362998,725400,78088398,True
9075,validator_9,57677328276,True,279686999,381890,280068889,True
9076,validator_9,57824077675,True,145990999,758400,146749399,True
9077,validator_19,92087623255,True,129706002,4398900,134104902,True
9078,validator_26,52825020700,True,54299000,1308400,55607400,False
9079,validator_10,55498449397,True,128699996,604100,129304096,True
9080,validator_24,53279540481,True,72482999,540240,73023239,True
9081,validator_9,57982505818,True,157598003,830140,158428143,True
9082,validator_15,299125473926,True,165614003,2251600,167865603,True
9083,validator_18,125927640012,True,208494000,1547630,210041630,True
9084,validator_31,187755421220,True,147767000,1055990,148822990,False
9085,validator_44,119671502590,True,75843000,1169200,77012200,False
9086,validator_41,86957340650,True,47349000,1516430,48865430,False
9087,validator_46,118689969660,True,76066000,915200,76981200,False
9088,validator_0,55159571902,True,176618000,1641890,178259890,True
9089,validator_32,52827634480,True,105155000,633000,105788000,False
9090,validator_43,82958656120,True,93382000,1440230,94822230,False
9091,validator_2,57054940014,True,222211003,3990100,226201103,True
9092,validator_0,55379865924,True,210017002,10277020,220294022,True
9093,validator_9,58067480572,True,84048994,925760,84974754,True
9094,validator_0,55541136622,True,156037998,5232700,161270698,True
9095,validator_13,53289623871,True,240147001,18427690,258574691,True
9096,validator_16,53527994911,True,219487996,658990,220146986,True
9097,validator_22,89052955606,True,119593005,1490820,121083825,True
9098,validator_41,87074184870,True,115696000,1148220,116844220,False
9099,validator_45,49892309670,True,116479000,2644300,119123300,False
9100,validator_11,57507355651,True,118694003,956910,119650913,True
9101,validator_13,53363998270,True,65318999,9055400,74374399,True
9102,validator_12,123561480313,True,134810002,2336300,137146302,True
9103,validator_34,284472923780,True,55922000,435390,56357390,False
9104,validator_19,92137024732,True,47474997,1926480,49401477,True
9105,validator_19,92257421834,True,119265002,1132100,120397102,True
9106,validator_38,51105781570,True,90005000,1209100,91214100,False
9107,validator_26,52954667000,True,121167000,8479300,129646300,False
9108,validator_15,299336290148,True,208829002,1987220,210816222,True
9109,validator_34,284519405680,True,45589000,892900,46481900,False
9110,validator_48,184679035920,True,160881000,18870170,179751170,False
9111,validator_25,51072931840,True,168057000,1493630,169550630,False
9112,validator_19,92561908158,True,294800994,9685330,304486324,True
9113,validator_34,284613868180,True,93618000,844500,94462500,False
9114,validator_18,126012994746,True,82329994,3024740,85354734,True
9115,validator_6,54989576167,True,96175000,8116600,104291600,True
9116,validator_48,184797935720,True,115559000,3340800,118899800,False
9117,validator_4,56531904116,True,103382002,872640,104254642,True
9118,validator_14,125934202910,True,81471999,102330,81574329,True
9119,validator_3,58202966175,True,174631997,200600,174832597,True
9120,validator_37,84683990100,True,172892000,18840620,191732620,False
9121,validator_22,89136295011,True,81663005,1676400,83339405,True
9122,validator_44,119814176490,True,118679000,23994900,142673900,False
9123,validator_31,187977049820,True,220033000,1595600,221628600,False
9124,validator_29,48841007830,True,114911000,1395000,116306000,False
9125,validator_12,123649763514,True,87671001,612200,88283201,True
9126,validator_2,57226342654,True,170150000,1252640,171402640,True
9127,validator_1,91269449310,True,68516998,36888800,105405798,True
9128,validator_30,87117001540,True,212985000,1555000,214540000,False
9129,validator_48,184912680540,True,112858000,1886820,114744820,False
9130,validator_12,123889304097,True,239061003,479580,239540583,True
9131,validator_10,55771325800,True,266335003,6541400,272876403,True
9132,validator_40,53390763250,True,34465000,1236000,35701000,False
9133,validator_16,53665529908,True,134970997,2564000,137534997,True
9134,validator_26,53040313110,True,80619000,5027110,85646110,False
9135,validator_41,87214186770,True,135443000,4558900,140001900,False
9136,validator_36,119129299670,True,113453000,763500,114216500,False
9137,validator_6,55163482073,True,170985006,2920900,173905906,True
9138,validator_17,193124669605,True,228328995,1583300,229912295,True
9139,validator_46,118897314280,True,187480000,19864620,207344620,False
9140,validator_10,55837652612,True,65005002,1321810,66326812,True
9141,validator_36,119207316290,True,77652000,364620,78016620,False
9142,validator_10,55992871066,True,153447994,1770460,155218454,True
9143,validator_48,185063300960,True,149840000,780420,150620420,False
9144,validator_21,88126003046,True,131959998,748100,132708098,True
9145,validator_31,188180734450,True,202054000,1630630,203684630,False
9146,validator_42,52594283040,True,103282000,1420730,104702730,False
9147,validator_42,52706308940,True,110138000,1887900,112025900,False
9148,validator_48,185136857500,True,72776000,780540,73556540,False
9149,validator_45,50005461260,True,104206000,8945590,113151590,False
9150,validator_1,91430823306,True,142748996,18625000,161373996,True
9151,validator_34,284809145280,True,192896000,2381100,195277100,False
9152,validator_44,119910123410,True,83123000,12823920,95946920,False
9153,validator_37,84779337300,True,93700000,1647200,95347200,False
9154,validator_24,53446857099,True,165824998,1491620,167316618,True
9155,validator_44,119972833350,True,60958000,1751940,62709940,False
9156,validator_34,284957631980,True,123655000,24831700,148486700,False
9157,validator_27,120226039310,True,146224000,1821980,148045980,False
9158,validator_26,53098240030,True,57280000,646920,57926920,False
9159,validator_16,53754073101,True,87477003,1066190,88543193,True
9160,validator_26,53222573970,True,124011000,322940,124333940,False
9161,validator_28,50291943030,True,190589000,804930,191393930,False
9162,validator_37,84859637700,True,72334000,7966400,80300400,False
9163,validator_34,285041046780,True,83012000,402800,83414800,False
9164,validator_46,119009943910,True,112094000,535630,112629630,False
9165,validator_16,53941763306,True,183826005,3864200,187690205,True
9166,validator_10,56143429660,True,139789994,10768600,150558594,True
9167,validator_4,56734827818,True,184892002,18031700,202923702,True
9168,validator_8,56033204595,True,149015999,8788570,157804569,True
9169,validator_4,56914412910,True,170080992,9504100,179585092,True
9170,validator_39,54140602800,True,126089000,1297460,127386460,False
9171,validator_35,119338677200,True,64362000,410830,64772830,False
9172,validator_48,185419527900,True,280809000,1861400,282670400,False
9173,validator_25,51255998160,True,163690000,19376320,183066320,False
9174,validator_2,57638436054,True,391497000,20596400,412093400,True
9175,validator_8,56109193691,True,75268996,720100,75989096,True
9176,validator_40,53518887580,True,125117000,3007330,128124330,False
9177,validator_22,89367132509,True,230184998,652500,230837498,True
9178,validator_12,124012968926,True,122910999,753830,123664829,True
9179,validator_29,48980137720,True,136738000,2391890,139129890,False
9180,validator_28,50342707530,True,49574000,1190500,50764500,False
9181,validator_28,50459801530,True,116738000,356000,117094000,False
9182,validator_20,53504345201,True,142194000,2001330,144195330,True
9183,validator_5,88527791883,True,98854002,592900,99446902,True
9184,validator_16,54054417604,True,111846998,807300,112654298,True
9185,validator_42,52771066640,True,63859000,898700,64757700,False
9186,validator_13,53662478175,True,296919005,1560900,298479905,True
9187,validator_42,52875190140,True,103734000,389500,104123500,False
9188,validator_19,92661725715,True,99398997,418560,99817557,True
9189,validator_2,57784745953,True,121805999,24503900,146309899,True
9190,validator_18,126186306582,True,171702006,1609830,173311836,True
9191,validator_12,124220707264,True,201709998,6028340,207738338,True
9192,validator_8,56205100693,True,95223002,684000,95907002,True
9193,validator_18,126387114580,True,199058998,1749000,200807998,True
9194,validator_29,49122687420,True,123896000,18653700,142549700,False
9195,validator_10,56206949159,True,60681999,2837500,63519499,True
9196,validator_11,57695797694,True,170578003,17864040,188442043,True
9197,validator_36,119283120990,True,55565000,20239700,75804700,False
9198,validator_12,124289993094,True,67192000,2093830,69285830,True
9199,validator_12,124373183231,True,83139997,50140,83190137,True
9200,validator_46,119091866910,True,81523000,400000,81923000,False
9201,validator_35,119518319900,True,160776000,18866700,179642700,False
9202,validator_45,50244437960,True,237814000,1162700,238976700,False
9203,validator_23,54173916360,True,89330001,5341580,94671581,True
9204,validator_25,51400635990,True,143884000,753830,144637830,False
9205,validator_30,87210704230,True,92524000,1178690,93702690,False
9206,validator_44,120035989850,True,62432000,724500,63156500,False
9207,validator_46,119169707810,True,77511000,329900,77840900,False
9208,validator_27,120312643710,True,85114000,1490400,86604400,False
9209,validator_27,120395746530,True,80151000,2951820,83102820,False
9210,validator_34,285100179100,True,58265000,867320,59132320,False
9211,validator_21,88266501845,True,137479999,3018800,140498799,True
9212,validator_48,185576588400,True,155407000,1653500,157060500,False
9213,validator_14,126129914714,True,193462004,2249800,195711804,True
9214,validator_16,54172077807,True,108629003,9031200,117660203,True
9215,validator_8,56374668400,True,166812007,2755700,169567707,True
9216,validator_23,54314045297,True,138640997,1487940,140128937,True
9217,validator_44,120197932950,True,161605000,338100,161943100,False
9218,validator_4,57032229107,True,99749997,18066200,117816197,True
9219,validator_6,55240425864,True,75118001,1825790,76943791,True
9220,validator_18,126473542040,True,85220000,1207460,86427460,True
9221,validator_2,57910662814,True,119466001,6450860,125916861,True
9222,validator_20,53631634341,True,125882000,1407140,127289140,True
9223,validator_27,120562981630,True,147570000,19665100,167235100,False
9224,validator_40,53565359010,True,46117000,354430,46471430,False
9225,validator_10,56288055255,True,62553996,18552100,81106096,True
9226,validator_11,57817296333,True,116099999,5398640,121498639,True
9227,validator_37,84931321300,True,69799000,1884600,71683600,False
9228,validator_29,49279753520,True,154896000,2170100,157066100,False
9229,validator_18,126645066595,True,170538995,985560,171524555,True
9230,validator_48,185751567980,True,172161000,2818580,174979580,False
9231,validator_17,193229098403,True,103385998,1042800,104428798,True
9232,validator_17,193358485874,True,120761001,8626470,129387471,True
9233,validator_48,185815852180,True,63284000,1000200,64284200,False
9234,validator_8,56578832986,True,202431996,1732590,204164586,True
9235,validator_43,83106385700,True,145452000,2277580,147729580,False
9236,validator_11,57914496285,True,95859992,1339960,97199952,True
9237,validator_36,119378729690,True,94467000,1141700,95608700,False
9238,validator_36,119483042590,True,102531000,1781900,104312900,False
9239,validator_23,54405234599,True,68355002,22834300,91189302,True
9240,validator_3,58315390776,True,111401001,1023600,112424601,True
9241,validator_46,119318095310,True,136120000,12267500,148387500,False
9242,validator_17,193422556192,True,61836998,2233320,64070318,True
9243,validator_30,87317187230,True,105973000,510000,106483000,False
9244,validator_19,92814016256,True,149347001,2943540,152290541,True
9245,validator_37,84974735920,True,43046000,368620,43414620,False
9246,validator_15,299609367245,True,272683997,393100,273077097,True
9247,validator_37,85083956550,True,108828000,392630,109220630,False
9248,validator_11,58055957703,True,141275998,185420,141461418,True
9249,validator_37,85193366430,True,90166000,19243880,109409880,False
9250,validator_15,299764441286,True,153751001,1323040,155074041,True
9251,validator_3,58437014554,True,119785998,1837780,121623778,True
9252,validator_40,53685750310,True,119403000,988300,120391300,False
9253,validator_0,55633598715,True,90564003,1898090,92462093,True
9254,validator_19,92927852060,True,111778004,2057800,113835804,True
9255,validator_17,193499011489,True,76171997,283300,76455297,True
9256,validator_6,55443084303,True,196969999,5688440,202658439,True
9257,validator_35,119658688930,True,135378000,4991030,140369030,False
9258,validator_19,93038827958,True,102356998,8618900,110975898,True
9259,validator_13,53829135877,True,153318002,13339700,166657702,True
9260,validator_35,119805105790,True,144489000,1927860,146416860,False
9261,validator_25,51573040020,True,170894000,1510030,172404030,False
9262,validator_41,87327449700,True,97751000,15511930,113262930,False
9263,validator_5,88759207885,True,229603002,1813000,231416002,True
9264,validator_13,53885604274,True,55474997,993400,56468397,True
9265,validator_12,124550863199,True,169496998,8182970,177679968,True
9266,validator_42,53031750480,True,154320000,2240340,156560340,False
9267,validator_12,124649936939,True,93265000,5808740,99073740,True
9268,validator_9,58181421980,True,113383008,558400,113941408,True
9269,validator_27,120712011180,True,148760000,269550,149029550,False
9270,validator_20,53732295840,True,99186999,1474500,100661499,True
9271,validator_22,89417566049,True,49638000,795540,50433540,True
9272,validator_17,193781107473,True,280065994,2029990,282095984,True
9273,validator_48,185938678880,True,122250000,576700,122826700,False
9274,validator_45,50393846980,True,148101000,1308020,149409020,False
9275,validator_26,53383794400,True,159856000,1364430,161220430,False
9276,validator_27,120805429600,True,92694000,724420,93418420,False
9277,validator_28,50590887030,True,128595000,2490500,131085500,False
9278,validator_14,126289824816,True,134253002,25657100,159910102,True
9279,validator_24,53666000727,True,217491998,1651630,219143628,True
9280,validator_37,85331239510,True,136932000,941080,137873080,False
9281,validator_8,56682094049,True,99707003,3554060,103261063,True
9282,validator_24,53815653726,True,148899999,753000,149652999,True
9283,validator_25,51677341320,True,103260000,1041300,104301300,False
9284,validator_11,58151871795,True,75279002,20635090,95914092,True
9285,validator_7,91283614860,True,113182002,1518840,114700842,True
9286,validator_44,120264078230,True,64824000,1321280,66145280,False
9287,validator_1,91546836510,True,96736004,19277200,116013204,True
9288,validator_10,56378824103,True,89197998,1570850,90768848,True
9289,validator_5,88808609583,True,41764998,7636700,49401698,True
9290,validator_45,50513156880,True,118324000,985900,119309900,False
9291,validator_26,53528932100,True,126318000,18819700,145137700,False
9292,validator_28,50647811060,True,55908000,1016030,56924030,False
9293,validator_43,83157446790,True,50354000,707090,51061090,False
9294,validator_34,285273703040,True,171649000,1874940,173523940,False
9295,validator_2,57982071912,True,70625998,783100,71409098,True
9296,validator_34,285314739140,True,40574000,462100,41036100,False
9297,validator_49,86309312700,True,74138000,1501990,75639990,False
9298,validator_2,58117642610,True,134602998,967700,135570698,True
9299,validator_11,58283140936,True,128568001,2701140,131269141,True
9300,validator_44,120371378530,True,105482000,1818300,107300300,False
9301,validator_21,88446308913,True,178703998,1103070,179807068,True
9302,validator_44,120429648600,True,57205000,1065070,58270070,False
9303,validator_3,58570521823,True,130569999,2937270,133507269,True
9304,validator_35,119939549390,True,133637000,806600,134443600,False
9305,validator_19,93149728237,True,109333999,1566280,110900279,True
9306,validator_49,86410665000,True,92228000,9124300,101352300,False
9307,validator_20,53887900362,True,143874002,11730520,155604522,True
9308,validator_45,50590821880,True,76446000,1219000,77665000,False
9309,validator_33,49077609710,True,133566000,6046700,139612700,False
9310,validator_14,126426996516,True,136783000,388700,137171700,True
9311,validator_18,126816418906,True,169727001,1625310,171352311,True
9312,validator_8,56818997427,True,136144998,758380,136903378,True
9313,validator_23,54672554526,True,262766997,4552930,267319927,True
9314,validator_11,58360897201,True,69461005,8295260,77756265,True
9315,validator_11,58607036340,True,220799999,25339140,246139139,True
9316,validator_24,53934478324,True,118576998,247600,118824598,True
9317,validator_5,88900108082,True,90230999,1267500,91498499,True
9318,validator_48,186046622600,True,107775000,168720,107943720,False
9319,validator_37,85462391010,True,130133000,1018500,131151500,False
9320,validator_4,57156981607,True,124244000,508500,124752500,True
9321,validator_16,54353595499,True,180252002,1265690,181517692,True
9322,validator_25,51740717320,True,61810000,1566000,63376000,False
9323,validator_45,50701030210,True,108874000,1334330,110208330,False
9324,validator_20,54159429160,True,269049998,2478800,271528798,True
9325,validator_34,285534124640,True,213310000,6075500,219385500,False
9326,validator_5,89059730114,True,122263002,37359030,159622032,True
9327,validator_14,126556156012,True,126229996,2929500,129159496,True
9328,validator_3,58672509519,True,101268996,718700,101987696,True
9329,validator_0,55824464013,True,189459998,1405300,190865298,True
9330,validator_15,299830866068,True,66153002,271780,66424782,True
9331,validator_30,87493557160,True,170877000,5492930,176369930,False
9332,validator_14,126739691695,True,182214003,1321680,183535683,True
9333,validator_22,89534561852,True,116078003,917800,116995803,True
9334,validator_47,84837782010,True,109129000,2104990,111233990,False
9335,validator_21,88532940310,True,68416997,18214400,86631397,True
9336,validator_9,58397556483,True,214269003,1865500,216134503,True
9337,validator_46,119585426650,True,247590000,19741340,267331340,False
9338,validator_18,126899359244,True,81116998,1823340,82940338,True
9339,validator_15,299958898386,True,125278998,2753320,128032318,True
9340,validator_27,120919326200,True,109868000,4028600,113896600,False
9341,validator_19,93202962808,True,52723001,511570,53234571,True
9342,validator_41,87409340860,True,73551000,8340160,81891160,False
9343,validator_33,49197009690,True,116339000,3060980,119399980,False
9344,validator_40,53739613530,True,48315000,5548220,53863220,False
9345,validator_35,120064504390,True,123084000,1871000,124955000,False
9346,validator_2,58333499112,True,215264002,592500,215856502,True
9347,validator_33,49373642470,True,170119000,6513780,176632780,False
9348,validator_15,300125774179,True,159334003,7541790,166875793,True
9349,validator_11,58712139737,True,103010997,2092400,105103397,True
9350,validator_36,119605260320,True,122045000,172730,122217730,False
9351,validator_35,120142145510,True,77176000,465120,77641120,False
9352,validator_17,193854932921,True,73531998,293450,73825448,True
9353,validator_32,53001270600,True,173071000,565120,173636120,False
9354,validator_13,54065416569,True,178432995,1379300,179812295,True
9355,validator_9,58606872780,True,208547997,768300,209316297,True
9356,validator_3,58792725938,True,113198999,7017420,120216419,True
9357,validator_30,87634943960,True,122526000,18860800,141386800,False
9358,validator_19,93364290204,True,159599996,1727400,161327396,True
9359,validator_5,89295970612,True,233222998,3017500,236240498,True
9360,validator_22,89636964781,True,101598999,803930,102402929,True
9361,validator_35,120208170140,True,64931000,1093630,66024630,False
9362,validator_41,87501326860,True,83560000,8426000,91986000,False
9363,validator_18,127004973446,True,103593002,2021200,105614202,True
9364,validator_36,119736715090,True,121255000,10199770,131454770,False
9365,validator_42,53142563280,True,109309000,1503800,110812800,False
9366,validator_40,53863673230,True,115930000,8129700,124059700,False
9367,validator_28,50703852130,True,55316000,725070,56041070,False
9368,validator_39,54261647300,True,116051000,4993500,121044500,False
9369,validator_28,50835578190,True,131443000,283060,131726060,False
9370,validator_21,88651253938,True,113688998,4624630,118313628,True
9371,validator_8,56902793010,True,82795003,1000580,83795583,True
9372,validator_16,54474425297,True,119423998,1405800,120829798,True
9373,validator_44,120534179580,True,100914000,3616980,104530980,False
9374,validator_49,86625835800,True,213958000,1212800,215170800,False
9375,validator_18,127192335289,True,187006003,355840,187361843,True
9376,validator_24,54056335268,True,120973004,883940,121856944,True
9377,validator_2,58549134605,True,214852993,782500,215635493,True
9378,validator_18,127335992790,True,140535001,3122500,143657501,True
9379,validator_48,186080987150,True,32134000,2230550,34364550,False
9380,validator_46,119692119050,True,100264000,6428400,106692400,False
9381,validator_3,58868272065,True,66714997,8831130,75546127,True
9382,validator_34,285592242940,True,57560000,558300,58118300,False
9383,validator_18,127396506713,True,60399003,114920,60513923,True
9384,validator_7,91366633659,True,82731999,286800,83018799,True
9385,validator_27,121055841000,True,134944000,1570800,136514800,False
9386,validator_44,120614735710,True,79432000,1124130,80556130,False
9387,validator_14,126960932993,True,184711998,36529300,221241298,True
9388,validator_15,300293733777,True,166979998,979600,167959598,True
9389,validator_34,285759283720,True,162127000,4913780,167040780,False
9390,validator_26,53665789800,True,135734000,1123700,136857700,False
9391,validator_26,53776805920,True,104598000,6418120,111016120,False
9392,validator_41,87606590720,True,104057000,1206860,105263860,False
9393,validator_32,53110676400,True,108901000,504800,109405800,False
9394,validator_19,93500357507,True,118063003,18004300,136067303,True
9395,validator_19,93695296227,True,194048000,890720,194938720,True
9396,validator_44,120843727830,True,227949000,1043120,228992120,False
9397,validator_14,127097401771,True,134827998,1640780,136468778,True
9398,validator_10,56460521823,True,80415000,1282720,81697720,True
9399,validator_39,54307965720,True,44740000,1578420,46318420,False
9400,validator_5,89425793512,True,128676000,1146900,129822900,True
9401,validator_6,55602672602,True,157094999,2493300,159588299,True
9402,validator_45,50822999870,True,120042000,1927660,121969660,False
9403,validator_20,54300485238,True,139863998,1192080,141056078,True
9404,validator_21,88773309441,True,121146003,909500,122055503,True
9405,validator_8,57032591542,True,99572002,30226530,129798532,True
9406,validator_8,57131746183,True,96973001,2181640,99154641,True
9407,validator_41,87724578720,True,117247000,741000,117988000,False
9408,validator_4,57270535307,True,110598000,2955700,113553700,True
9409,validator_46,119810643970,True,113673000,4851920,118524920,False
9410,validator_48,186137648270,True,55774000,887120,56661120,False
9411,validator_15,300483239216,True,169704999,19800440,189505439,True
9412,validator_36,119835640990,True,96938000,1987900,98925900,False
9413,validator_25,51933362420,True,156693000,35952100,192645100,False
9414,validator_30,87739823260,True,82821000,22058300,104879300,False
9415,validator_7,91481297340,True,114197001,466680,114663681,True
9416,validator_19,93854953518,True,159249001,408290,159657291,True
9417,validator_44,120986853630,True,142083000,1042800,143125800,False
9418,validator_12,124912873636,True,258290997,4645700,262936697,True
9419,validator_24,54152372308,True,91338000,4699040,96037040,True
9420,validator_19,94087617220,True,231385002,1278700,232663702,True
9421,validator_48,186219108140,True,80976000,483870,81459870,False
9422,validator_10,56561362619,True,99846996,993800,100840796,True
9423,validator_0,56013718242,True,188746999,507230,189254229,True
9424,validator_27,121178448400,True,120643000,1964400,122607400,False
9425,validator_8,57269220984,True,131058001,6416800,137474801,True
9426,validator_45,50892826390,True,62145000,7681520,69826520,False
9427,validator_9,58848663476,True,240698006,1092690,241790696,True
9428,validator_17,194027165950,True,169897999,2335030,172233029,True
9429,validator_32,53268631480,True,157481000,474080,157955080,False
9430,validator_18,127578425495,True,180845002,1073780,181918782,True
9431,validator_34,285883567350,True,120428000,3855630,124283630,False
9432,validator_15,300621323217,True,134106001,3978000,138084001,True
9433,validator_46,119900812970,True,89971000,198000,90169000,False
9434,validator_0,56159833446,True,140787004,5328200,146115204,True
9435,validator_4,57314846306,True,44162999,148000,44310999,True
9436,validator_32,53353196880,True,83874000,691400,84565400,False
9437,validator_0,56325900242,True,160939996,5126800,166066796,True
9438,validator_23,54751931426,True,77643000,1733900,79376900,True
9439,validator_14,127152558175,True,49836004,5320400,55156404,True
9440,validator_38,51265394710,True,156395000,3218140,159613140,False
9441,validator_7,91632248544,True,150471004,480200,150951204,True
9442,validator_17,194197213681,True,168619001,1428730,170047731,True
9443,validator_6,55752239308,True,149033006,533700,149566706,True
9444,validator_29,49398207500,True,117471000,982980,118453980,False
9445,validator_43,83430790050,True,264160000,9183260,273343260,False
9446,validator_17,194431408078,True,229807997,4386400,234194397,True
9447,validator_39,54467545310,True,153704000,5875590,159579590,False
9448,validator_42,53232449680,True,81952000,7934400,89886400,False
9449,validator_13,54249081868,True,182420999,1244300,183665299,True
9450,validator_35,120381639360,True,171602000,1867220,173469220,False
9451,validator_5,89618474516,True,191169004,1512000,192681004,True
9452,validator_40,54081196430,True,216181000,1342200,217523200,False
9453,validator_34,285956220450,True,72475000,178100,72653100,False
9454,validator_20,54374423342,True,72782004,1156100,73938104,True
9455,validator_33,49440874850,True,66516000,716380,67232380,False
9456,validator_32,53421152220,True,59228000,8727340,67955340,False
9457,validator_21,88957289331,True,175736000,8243890,183979890,True
9458,validator_6,55955826806,True,200898998,2688500,203587498,True
9459,validator_22,89774198465,True,136142004,1091680,137233684,True
9460,validator_13,54514113160,True,263320002,1711290,265031292,True
9461,validator_28,50933216090,True,96605000,1032900,97637900,False
9462,validator_45,50945175130,True,52063000,285740,52348740,False
9463,validator_28,51053687300,True,84409000,36062210,120471210,False
9464,validator_44,121112995770,True,124021000,2121140,126142140,False
9465,validator_46,120037353690,True,136388000,152720,136540720,False
9466,validator_38,51390838610,True,123757000,1686900,125443900,False
9467,validator_49,86701600500,True,72082000,3682700,75764700,False
9468,validator_33,49543134350,True,100925000,1334500,102259500,False
9469,validator_39,54677947010,True,201599000,8802700,210401700,False
9470,validator_7,91756662274,True,123262000,1151730,124413730,True
9471,validator_21,89215558864,True,257722003,547530,258269533,True
9472,validator_16,54665802582,True,190020995,1356290,191377285,True
9473,validator_9,58933740078,True,84565002,511600,85076602,True
9474,validator_15,300682922719,True,60572002,1027500,61599502,True
9475,validator_43,83586172850,True,143695000,11687800,155382800,False
9476,validator_29,49563976500,True,164550000,1219000,165769000,False
9477,validator_4,57516706155,True,188212999,13646850,201859849,True
9478,validator_32,53587329140,True,164273000,1903920,166176920,False
9479,validator_42,53330044680,True,96741000,854000,97595000,False
9480,validator_14,127284982176,True,130359001,2065000,132424001,True
9481,validator_28,51218896800,True,146872000,18337500,165209500,False
9482,validator_11,58885477182,True,171768005,1569440,173337445,True
9483,validator_39,54855726410,True,175946000,1833400,177779400,False
9484,validator_41,87787035240,True,61900000,556520,62456520,False
9485,validator_40,54196570060,True,113945000,1428630,115373630,False
9486,validator_4,57629315959,True,111493004,1116800,112609804,True
9487,validator_34,286062030580,True,104140000,1670130,105810130,False
9488,validator_49,86808462800,True,104355000,2507300,106862300,False
9489,validator_34,286186008320,True,122737000,1240740,123977740,False
9490,validator_8,57448145378,True,178100994,823400,178924394,True
9491,validator_23,54971222901,True,217052995,2238480,219291475,True
9492,validator_43,83707312550,True,113306000,7833700,121139700,False
9493,validator_19,94244529118,True,149081998,7829900,156911898,True
9494,validator_23,55079613501,True,107506000,884600,108390600,True
9495,validator_34,286288312060,True,101214000,1089740,102303740,False
9496,validator_3,59007365860,True,137853995,1239800,139093795,True
9497,validator_34,286341889350,True,51817000,1760290,53577290,False
9498,validator_45,51173911770,True,227584000,1152640,228736640,False
9499,validator_13,54715561077,True,200864997,582920,201447917,True
9500,validator_31,188359645790,True,159218000,19693340,178911340,False
9501,validator_35,120431956170,True,49292000,1024810,50316810,False
9502,validator_13,54988693080,True,270516003,2616000,273132003,True
9503,validator_46,120144362890,True,106752000,257200,107009200,False
9504,validator_25,52161011720,True,227149000,500300,227649300,False
9505,validator_31,188464681230,True,102893000,2142440,105035440,False
9506,validator_27,121234806060,True,51154000,5203660,56357660,False
9507,validator_0,56395011944,True,50595002,18516700,69111702,True
9508,validator_30,87840419260,True,98333000,2263000,100596000,False
9509,validator_29,49745588800,True,178835000,2777300,181612300,False
9510,validator_15,300824509936,True,140885997,701220,141587217,True
9511,validator_22,89838101865,True,62229000,1674400,63903400,True
9512,validator_22,90009456367,True,152331002,19023500,171354502,True
9513,validator_12,124983749768,True,70603002,273130,70876132,True
9514,validator_23,55263025180,True,182409999,1001680,183411679,True
9515,validator_12,125101393166,True,117518998,124400,117643398,True
9516,validator_2,58671446522,True,103603997,18707920,122311917,True
9517,validator_28,51416081040,True,194108000,3076240,197184240,False
9518,validator_4,57791821694,True,161936995,568740,162505735,True
9519,validator_39,54973600300,True,113329000,4544890,117873890,False
9520,validator_9,59191445087,True,256729999,975010,257705009,True
9521,validator_24,54292240409,True,134353001,5515100,139868101,True
9522,validator_15,300948434036,True,123433000,491100,123924100,True
9523,validator_28,51507061460,True,84201000,6779420,90980420,False
9524,validator_1,91703649509,True,155709999,1103000,156812999,True
9525,validator_15,301028945640,True,75121004,5390600,80511604,True
9526,validator_29,49852592600,True,105405000,1598800,107003800,False
9527,validator_1,91812818446,True,108455997,712940,109168937,True
9528,validator_40,54249527060,True,50920000,2037000,52957000,False
9529,validator_31,188591918370,True,118345000,8892140,127237140,False
9530,validator_31,188742223780,True,149180000,1125410,150305410,False
9531,validator_4,57919684012,True,126986998,875320,127862318,True
9532,validator_11,59058617978,True,172405996,734800,173140796,True
9533,validator_0,56568179976,True,168400002,4768030,173168032,True
9534,validator_12,125340364664,True,230451998,8519500,238971498,True
9535,validator_25,52208782040,True,46051000,1719320,47770320,False
9536,validator_17,194504863477,True,73159999,295400,73455399,True
9537,validator_33,49637047450,True,92550000,1363100,93913100,False
9538,validator_41,87990309200,True,201900000,1373960,203273960,False
9539,validator_40,54317167560,True,61808000,5832500,67640500,False
9540,validator_47,84971492210,True,128054000,5656200,133710200,False
9541,validator_40,54506487760,True,170116000,19204200,189320200,False
9542,validator_26,53897664860,True,120250000,608940,120858940,False
9543,validator_14,127375100928,True,82540002,7578750,90118752,True
9544,validator_37,85625240290,True,160982000,1867280,162849280,False
9545,validator_1,91916857986,True,102709000,1330540,104039540,True
9546,validator_42,53407585430,True,76212000,1328750,77540750,False
9547,validator_24,54537823408,True,244611999,971000,245582999,True
9548,validator_45,51268731470,True,93106000,1713700,94819700,False
9549,validator_41,88072709370,True,74233000,8167170,82400170,False
9550,validator_45,51399191570,True,130096000,364100,130460100,False
9551,validator_1,92082380986,True,157270000,8253000,165523000,True
9552,validator_42,53462331430,True,53529000,1217000,54746000,False
9553,validator_33,49745619580,True,107553000,1019130,108572130,False
9554,validator_44,121154554790,True,40804000,755020,41559020,False
9555,validator_22,90130372593,True,119756996,1159230,120916226,True
9556,validator_5,89765803545,True,138849999,8479030,147329029,True
9557,validator_20,54453487886,True,77791004,1273540,79064544,True
9558,validator_3,59139111560,True,131107000,638700,131745700,True
9559,validator_30,87931068560,True,88526000,2123300,90649300,False
9560,validator_34,286567025390,True,223711000,1425040,225136040,False
9561,validator_40,54562760960,True,54688000,1585200,56273200,False
9562,validator_0,56684255954,True,113454998,2620980,116075978,True
9563,validator_35,120684169030,True,249683000,2529860,252212860,False
9564,validator_43,83773536750,True,63240000,2984200,66224200,False
9565,validator_46,120335608180,True,190153000,1092290,191245290,False
9566,validator_9,59305951589,True,114127002,379500,114506502,True
9567,validator_37,85793955690,True,167253000,1462400,168715400,False
9568,validator_15,301117148770,True,88136000,67130,88203130,True
9569,validator_39,55045854380,True,70879000,1375080,72254080,False
9570,validator_18,127781992643,True,202039998,1527150,203567148,True
9571,validator_17,194592985250,True,86408003,1713770,88121773,True
9572,validator_11,59134378574,True,74049996,1710600,75760596,True
9573,validator_33,49790937280,True,45048000,269700,45317700,False
9574,validator_16,54734765585,True,67754003,1209000,68963003,True
9575,validator_49,86843151000,True,33297000,1391200,34688200,False
9576,validator_15,301400753449,True,282284999,1319680,283604679,True
9577,validator_12,125447617594,True,106983000,269930,107252930,True
9578,validator_9,59383465004,True,76478995,1034420,77513415,True
9579,validator_41,88171985400,True,97962000,1314030,99276030,False
9580,validator_43,83878789280,True,102860000,2392530,105252530,False
9581,validator_36,119931199260,True,76335000,19223270,95558270,False
9582,validator_5,89831628045,True,64859000,965500,65824500,True
9583,validator_8,57636257983,True,158029005,30083600,188112605,True
9584,validator_39,55210302180,True,162871000,1576800,164447800,False
9585,validator_20,54622958009,True,161408003,8062120,169470123,True
9586,validator_5,89922967441,True,72310006,19029390,91339396,True
9587,validator_41,88357873300,True,185027000,860900,185887900,False
9588,validator_5,90101981564,True,178503003,511120,179014123,True
9589,validator_44,121287001030,True,124871000,7575240,132446240,False
9590,validator_34,286688664820,True,118866000,2773430,121639430,False
9591,validator_0,56794031255,True,109491001,284300,109775301,True
9592,validator_41,88533091930,True,172982000,2236630,175218630,False
9593,validator_29,50050263620,True,197251000,420020,197671020,False
9594,validator_20,54707865109,True,84027000,880100,84907100,True
9595,validator_30,87998782780,True,66500000,1214220,67714220,False
9596,validator_22,90212060234,True,80821001,866640,81687641,True
9597,validator_36,120079367790,True,141513000,6655530,148168530,False
9598,validator_11,59333247878,True,186294004,12575300,198869304,True
9599,validator_4,58107238413,True,186059001,1495400,187554401,True
9600,validator_19,94326662016,True,81156998,975900,82132898,True
9601,validator_36,120223809290,True,121602000,22839500,144441500,False
9602,validator_25,52357176140,True,147257000,1137100,148394100,False
9603,validator_4,58241889512,True,127222999,7428100,134651099,True
9604,validator_30,88085767730,True,85539000,1445950,86984950,False
9605,validator_36,120417748590,True,192902000,1037300,193939300,False
9606,validator_15,301687223752,True,286104003,366300,286470303,True
9607,validator_1,92224419714,True,140545998,1492730,142038728,True
9608,validator_16,54873687687,True,138063002,859100,138922102,True
9609,validator_20,54766553210,True,58158001,530100,58688101,True
9610,validator_41,88694212760,True,160796000,324830,161120830,False
9611,validator_46,120461923080,True,124671000,1643900,126314900,False
9612,validator_10,56738853591,True,174221002,3269970,177490972,True
9613,validator_46,120601327980,True,138168000,1236900,139404900,False
9614,validator_21,89371901368,True,154961004,1381500,156342504,True
9615,validator_12,125593867624,True,141603000,4647030,146250030,True
9616,validator_49,86990437400,True,145148000,2138400,147286400,False
9617,validator_30,88188893070,True,102526000,599340,103125340,False
9618,validator_48,186338274140,True,116716000,2450000,119166000,False
9619,validator_31,188853392260,True,108927000,2241480,111168480,False
9620,validator_43,84039140580,True,159011000,1340300,160351300,False
9621,validator_13,55195054507,True,196253997,10107430,206361427,True
9622,validator_38,51512090910,True,119813000,1439300,121252300,False
9623,validator_7,91828513506,True,70341002,1510230,71851232,True
9624,validator_26,54045095840,True,142862000,4568980,147430980,False
9625,validator_11,59510197872,True,173834994,3115000,176949994,True
9626,validator_36,120555405750,True,117816000,19841160,137657160,False
9627,validator_11,59640154010,True,111731998,18224140,129956138,True
9628,validator_20,54959472169,True,185049999,7868960,192918959,True
9629,validator_48,186408177040,True,68317000,1585900,69902900,False
9630,validator_14,127479495808,True,103499000,895880,104394880,True
9631,validator_15,301883137553,True,187358001,8555800,195913801,True
9632,validator_7,92062759292,True,231194006,3051780,234245786,True
9633,validator_35,120804924420,True,120324000,431390,120755390,False
9634,validator_10,56839673790,True,99085999,1734200,100820199,True
9635,validator_35,121030375650,True,207451000,18000230,225451230,False
9636,validator_32,53705980440,True,117381000,1270300,118651300,False
9637,validator_46,120714258860,True,107885000,5045880,112930880,False
9638,validator_5,90511691767,True,404307003,5403200,409710203,True
9639,validator_7,92158263214,True,93686002,1817920,95503922,True
9640,validator_44,121369911450,True,82100000,810420,82910420,False
9641,validator_23,55374820865,True,110328005,1467680,111795685,True
9642,validator_30,88239588550,True,48472000,2223480,50695480,False
9643,validator_40,54670231560,True,105268000,2202600,107470600,False
9644,validator_2,58726543225,True,52478003,2618700,55096703,True
9645,validator_28,51587204780,True,72339000,7804320,80143320,False
9646,validator_25,52432011220,True,69911000,4924080,74835080,False
9647,validator_32,53750807740,True,39260000,5567300,44827300,False
9648,validator_40,54758319660,True,87118000,970100,88088100,False
9649,validator_21,89545189396,True,154009998,19278030,173288028,True
9650,validator_33,49896154380,True,103333000,1884100,105217100,False
9651,validator_26,54209455640,True,158079000,6280800,164359800,False
9652,validator_17,194654301940,True,60724000,592690,61316690,True
9653,validator_44,121412750250,True,40202000,2636800,42838800,False
9654,validator_4,58397616036,True,154455994,1270530,155726524,True
9655,validator_4,58574416161,True,175490995,1309130,176800125,True
9656,validator_38,51613353440,True,95171000,6091530,101262530,False
9657,validator_24,54616428907,True,76478999,2126500,78605499,True
9658,validator_31,188940741300,True,86626000,723040,87349040,False
9659,validator_39,55338004160,True,125181000,2520980,127701980,False
9660,validator_8,57750862821,True,112459998,2144840,114604838,True
9661,validator_3,59193789659,True,46921999,7756100,54678099,True
9662,validator_1,92278138915,True,53296001,423200,53719201,True
9663,validator_13,55407619010,True,211523003,1041500,212564503,True
9664,validator_29,50113520820,True,60587000,2670200,63257200,False
9665,validator_13,55599558706,True,189612996,2326700,191939696,True
9666,validator_23,55441590392,True,48025997,18743530,66769527,True
9667,validator_49,87122215100,True,130879000,898700,131777700,False
9668,validator_41,88828928800,True,134272000,444040,134716040,False
9669,validator_37,86058252220,True,255469000,8827530,264296530,False
9670,validator_24,54698447554,True,73176997,8841650,82018647,True
9671,validator_24,54804864956,True,105587002,830400,106417402,True
9672,validator_21,89694361930,True,147781994,1390540,149172534,True
9673,validator_19,94422301646,True,86782000,8857630,95639630,True
9674,validator_24,54924223157,True,117019001,2339200,119358201,True
9675,validator_18,128098784854,True,314813001,1979210,316792211,True
9676,validator_36,120704726350,True,140364000,8956600,149320600,False
9677,validator_1,92373344246,True,68819001,26386330,95205331,True
9678,validator_15,301937917894,True,53497001,1283340,54780341,True
9679,validator_41,89002962640,True,173477000,556840,174033840,False
9680,validator_31,189109200900,True,167797000,662600,168459600,False
9681,validator_19,94587323050,True,160117004,4904400,165021404,True
9682,validator_18,128263063782,True,163629998,648930,164278928,True
9683,validator_18,128540032778,True,257409996,19559000,276968996,True
9684,validator_15,302060227373,True,120797999,1511480,122309479,True
9685,validator_41,89207433640,True,203655000,816000,204471000,False
9686,validator_21,89783270434,True,87933004,975500,88908504,True
9687,validator_0,56971983354,True,177285999,666100,177952099,True
9688,validator_5,90607428103,True,93288996,2447340,95736336,True
9689,validator_27,121349803770,True,113019000,1978710,114997710,False
9690,validator_34,286764794450,True,74043000,2086630,76129630,False
9691,validator_39,55411758900,True,70677000,3077740,73754740,False
9692,validator_0,57140202313,True,166931999,1286960,168218959,True
9693,validator_3,59388636087,True,193243998,1602430,194846428,True
9694,validator_25,52619425090,True,186674000,739870,187413870,False
9695,validator_31,189293059100,True,181611000,2247200,183858200,False
9696,validator_49,87342921950,True,218618000,2088850,220706850,False
9697,validator_4,58727331143,True,151106002,1808980,152914982,True
9698,validator_14,127564108005,True,84088997,523200,84612197,True
9699,validator_9,59489198535,True,104555001,1178530,105733531,True
9700,validator_23,55538415792,True,94814000,2011400,96825400,True
9701,validator_18,128607866419,True,66433001,1400640,67833641,True
9702,validator_46,120861005460,True,138812000,7934600,146746600,False
9703,validator_9,59640703876,True,148892001,2613340,151505341,True
9704,validator_34,286850110450,True,84411000,905000,85316000,False
9705,validator_36,120806206470,True,100754000,726120,101480120,False
9706,validator_28,51738208590,True,141259000,9744810,151003810,False
9707,validator_1,92643846972,True,270077996,424730,270502726,True
9708,validator_23,55722911022,True,175166000,9329230,184495230,True
9709,validator_49,87475168850,True,131436000,810900,132246900,False
9710,validator_9,59740437080,True,94917004,4816200,99733204,True
9711,validator_34,287007945290,True,145110000,12724840,157834840,False
9712,validator_11,59874078111,True,213566001,20358100,233924101,True
9713,validator_20,55110297049,True,149791000,1033880,150824880,True
9714,validator_6,56087037906,True,112637000,18574100,131211100,True
9715,validator_32,53853577970,True,84288000,18482230,102770230,False
9716,validator_33,49976160470,True,78352000,1654090,80006090,False
9717,validator_5,90821295432,True,213584999,282330,213867329,True
9718,validator_23,55885265060,True,117124998,45229040,162354038,True
9719,validator_36,120847351970,True,36344000,4801500,41145500,False
9720,validator_37,86288156930,True,222730000,7174710,229904710,False
9721,validator_33,50093567470,True,109501000,7906000,117407000,False
9722,validator_18,128772981422,True,144893003,20222000,165115003,True
9723,validator_1,92873047963,True,226856001,2344990,229200991,True
9724,validator_18,128868643159,True,95214997,446740,95661737,True
9725,validator_45,51515384690,True,110660000,5533120,116193120,False
9726,validator_5,90978827286,True,142858994,14672860,157531854,True
9727,validator_33,50190343770,True,90496000,6280300,96776300,False
9728,validator_39,55608671100,True,194468000,2444200,196912200,False
9729,validator_46,120939146180,True,77120000,1020720,78140720,False
9730,validator_49,87561176840,True,85482000,525990,86007990,False
9731,validator_28,51973564090,True,233956000,1399500,235355500,False
9732,validator_16,55062121421,True,169260994,19172740,188433734,True
9733,validator_20,55256104151,True,143922002,1885100,145807102,True
9734,validator_3,59485966887,True,96138000,1192800,97330800,True
9735,validator_1,93033680307,True,159342004,1290340,160632344,True
9736,validator_21,89954829237,True,164691003,6867800,171558803,True
9737,validator_32,53919066810,True,64881000,607840,65488840,False
9738,validator_34,287183716760,True,175471000,300470,175771470,False
9739,validator_7,92253163519,True,92861005,2039300,94900305,True
9740,validator_49,87623833770,True,61934000,722930,62656930,False
9741,validator_33,50275210170,True,83831000,1035400,84866400,False
9742,validator_11,60030341710,True,152222999,4040600,156263599,True
9743,validator_7,92484965310,True,230731001,1070790,231801791,True
9744,validator_28,52069893650,True,88202000,8127560,96329560,False
9745,validator_36,121016900470,True,168988000,560500,169548500,False
9746,validator_43,84142344020,True,94634000,8569440,103203440,False
9747,validator_25,52694239590,True,74423000,391500,74814500,False
9748,validator_16,55216715923,True,153209002,1385500,154594502,True
9749,validator_29,50203169020,True,70834000,18814200,89648200,False
9750,validator_44,121477185370,True,63406000,1029120,64435120,False
9751,validator_48,186488812940,True,79441000,1194900,80635900,False
9752,validator_48,186570296040,True,80427000,1056100,81483100,False
9753,validator_7,92771300973,True,279864993,6470670,286335663,True
9754,validator_39,55654785730,True,42538000,3576630,46114630,False
9755,validator_29,50347339720,True,141760000,2410700,144170700,False
9756,validator_5,91090786680,True,110514004,1445390,111959394,True
9757,validator_12,125653019330,True,58059006,1092700,59151706,True
9758,validator_12,125879544345,True,218325005,8200010,226525015,True
9759,validator_15,302186338061,True,125137998,972690,126110688,True
9760,validator_16,55359955023,True,142045000,1194100,143239100,True
9761,validator_0,57439550968,True,286784995,12563660,299348655,True
9762,validator_46,121077410520,True,136501000,1763340,138264340,False
9763,validator_19,94705089272,True,115627002,2139220,117766222,True
9764,validator_49,87722980070,True,98624000,522300,99146300,False
9765,validator_33,50403418070,True,125902000,2305900,128207900,False
9766,validator_4,58850061845,True,117856002,4874700,122730702,True
9767,validator_6,56219432366,True,130156990,2237470,132394460,True
9768,validator_16,55549021855,True,187198002,1868830,189066832,True
9769,validator_12,125920408143,True,40628998,234800,40863798,True
9770,validator_14,127749182543,True,182427998,2646540,185074538,True
9771,validator_21,90088886743,True,133425006,632500,134057506,True
9772,validator_17,194844022032,True,188034002,1686090,189720092,True
9773,validator_29,50642491020,True,293736000,1415300,295151300,False
9774,validator_4,59189452975,True,338172000,1219130,339391130,True
9775,validator_14,127973068474,True,217986001,5899930,223885931,True
9776,validator_29,50706246120,True,61651000,2104100,63755100,False
9777,validator_23,56103137670,True,199454000,18418610,217872610,True
9778,validator_32,53971993910,True,52201000,726100,52927100,False
9779,validator_31,189534348300,True,239164000,2125200,241289200,False
9780,validator_43,84256458860,True,113189000,925840,114114840,False
9781,validator_13,55780269150,True,179363004,1347440,180710444,True
9782,validator_29,50835277040,True,128175000,855920,129030920,False
9783,validator_46,121254126100,True,157337000,19378580,176715580,False
9784,validator_2,58976825861,True,248229006,2053630,250282636,True
9785,validator_1,93174767908,True,140922001,165600,141087601,True
9786,validator_40,54928763260,True,161849000,8594600,170443600,False
9787,validator_37,86471963100,True,182372000,1434170,183806170,False
9788,validator_31,189620344280,True,68367000,17628980,85995980,False
9789,validator_15,302389355944,True,201454993,1562890,203017883,True
9790,validator_8,57814402725,True,62801004,738900,63539904,True
9791,validator_40,54999677960,True,70100000,814700,70914700,False
9792,validator_21,90280726784,True,183206001,8634040,191840041,True
9793,validator_9,59899476980,True,139357000,19682900,159039900,True
9794,validator_46,121326173840,True,71080000,967740,72047740,False
9795,validator_15,302448201244,True,57058000,1787300,58845300,True
9796,validator_18,129048463738,True,178680999,1139580,179820579,True
9797,validator_40,55050195960,True,48637000,1881000,50518000,False
9798,validator_7,92861234371,True,88314998,1618400,89933398,True
9799,validator_36,121176997710,True,158226000,1871240,160097240,False
9800,validator_5,91189066089,True,95918009,2361400,98279409,True
9801,validator_34,287273267360,True,87992000,1558600,89550600,False
9802,validator_8,57935249249,True,119994004,852520,120846524,True
9803,validator_20,55311803154,True,55251003,448000,55699003,True
9804,validator_37,86535713030,True,62715000,1034930,63749930,False
9805,validator_20,55362369604,True,49845000,721450,50566450,True
9806,validator_23,56200731559,True,78973999,18619890,97593889,True
9807,validator_25,52751821390,True,51403000,6178800,57581800,False
9808,validator_15,302628769125,True,180161001,406880,180567881,True
9809,validator_10,56986180589,True,145389999,1116800,146506799,True
9810,validator_43,84434020780,True,175321000,2240920,177561920,False
9811,validator_10,57152936115,True,161204996,5550530,166755526,True
9812,validator_0,57545006163,True,103840995,1614200,105455195,True
9813,validator_37,86679383170,True,137914000,5756140,143670140,False
9814,validator_18,129139286901,True,90153003,670160,90823163,True
9815,validator_26,54337665440,True,126509000,1700800,128209800,False
9816,validator_3,59626281487,True,138427000,1887600,140314600,True
9817,validator_37,86755100670,True,74785000,932500,75717500,False
9818,validator_4,59353391576,True,154508001,9430600,163938601,True
9819,validator_12,126186366510,True,258259997,7698370,265958367,True
9820,validator_26,54466109880,True,127475000,969440,128444440,False
9821,validator_14,128052392779,True,77444005,1880300,79324305,True
9822,validator_26,54672322380,True,187535000,18677500,206212500,False
9823,validator_26,54835785210,True,162124000,1338830,163462830,False
9824,validator_24,55038241658,True,112646001,1372500,114018501,True
9825,validator_16,55646894601,True,92864006,5008740,97872746,True
9826,validator_24,55248364881,True,209696993,426230,210123223,True
9827,validator_49,87826225100,True,97458000,5787030,103245030,False
9828,validator_48,186689882240,True,110929000,8657200,119586200,False
9829,validator_3,59793411782,True,166615995,514300,167130295,True
9830,validator_9,60020307182,True,101339002,19491200,120830202,True
9831,validator_43,84571450280,True,136001000,1428500,137429500,False
9832,validator_41,89357331240,True,148710000,1187600,149897600,False
9833,validator_9,60134842311,True,108751999,5783130,114535129,True
9834,validator_2,59169386589,True,191905998,654730,192560728,True
9835,validator_15,302704434630,True,72966005,2699500,75665505,True
9836,validator_47,85072084630,True,99165000,1427420,100592420,False
9837,validator_23,56303356458,True,100925999,1698900,102624899,True
9838,validator_10,57261707155,True,107876000,895040,108771040,True
9839,validator_6,56307489170,True,79160004,8896800,88056804,True
9840,validator_27,121410438470,True,53190000,7444700,60634700,False
9841,validator_44,121572662770,True,86192000,9285400,95477400,False
9842,validator_42,53535765960,True,73136000,298530,73434530,False
9843,validator_45,51674993120,True,140541000,19067430,159608430,False
9844,validator_15,302778031844,True,71278994,2318220,73597214,True
9845,validator_3,59918701682,True,118400000,6889900,125289900,True
9846,validator_35,121170094750,True,138692000,1027100,139719100,False
9847,validator_30,88378174220,True,137151000,1434670,138585670,False
9848,validator_15,302867435971,True,84049997,5354130,89404127,True
9849,validator_31,189695159880,True,73757000,1058600,74815600,False
9850,validator_19,94845721402,True,138807000,1825130,140632130,True
9851,validator_14,128200238776,True,146207997,1638000,147845997,True
9852,validator_23,56431014457,True,108904999,18753000,127657999,True
9853,validator_29,50882327020,True,42156000,4893980,47049980,False
9854,validator_36,121316638810,True,136459000,3182100,139641100,False
9855,validator_11,60185925641,True,153808001,1775930,155583931,True
9856,validator_43,84606346980,True,33816000,1080700,34896700,False
9857,validator_44,121631940670,True,53646000,5631900,59277900,False
9858,validator_17,194973774752,True,129151000,601720,129752720,True
9859,validator_28,52185454090,True,114704000,856440,115560440,False
9860,validator_17,195068025351,True,93710999,539600,94250599,True
9861,validator_3,60048400383,True,120725001,8973700,129698701,True
9862,validator_14,128328069995,True,109109999,18721220,127831219,True
9863,validator_30,88491155740,True,107974000,5007520,112981520,False
9864,validator_48,186752693440,True,61282000,1529200,62811200,False
9865,validator_40,55200807580,True,131827000,18784620,150611620,False
9866,validator_31,189766975380,True,60690000,11125500,71815500,False
9867,validator_38,51679181000,True,64926000,901560,65827560,False
9868,validator_27,121521081870,True,109954000,689400,110643400,False
9869,validator_13,55911876748,True,125296998,6310600,131607598,True
9870,validator_20,55564367802,True,201341998,656200,201998198,True
9871,validator_22,90443498332,True,224111998,7326100,231438098,True
9872,validator_0,57875468157,True,328337994,2124000,330461994,True
9873,validator_24,55309466280,True,60768999,332400,61101399,True
9874,validator_41,89476422060,True,118479000,611820,119090820,False
9875,validator_29,50981812360,True,99123000,362340,99485340,False
9876,validator_13,56025815154,True,112918996,1019410,113938406,True
9877,validator_3,60195696881,True,145522998,1773500,147296498,True
9878,validator_48,186862720480,True,109025000,1002040,110027040,False
9879,validator_38,51776609700,True,97118000,310700,97428700,False
9880,validator_44,121708470370,True,75540000,989700,76529700,False
9881,validator_36,121400578800,True,81723000,2216990,83939990,False
9882,validator_15,303030191667,True,160897996,1857700,162755696,True
9883,validator_22,90558132669,True,113651997,982340,114634337,True
9884,validator_49,87992075740,True,157458000,8392640,165850640,False
9885,validator_37,86900606570,True,138142000,7363900,145505900,False
9886,validator_8,58153781151,True,200228002,18303900,218531902,True
9887,validator_42,53620627710,True,83360000,1501750,84861750,False
9888,validator_37,87023399770,True,117730000,5063200,122793200,False
9889,validator_21,90384475184,True,100222000,3526400,103748400,True
9890,validator_2,59258863531,True,70391002,19085940,89476942,True
9891,validator_25,52873172790,True,119189000,2162400,121351400,False
9892,validator_19,94989814004,True,143238002,854600,144092602,True
9893,validator_7,92948592415,True,85315004,2043040,87358044,True
9894,validator_35,121226987850,True,45989000,10904100,56893100,False
9895,validator_3,60281219177,True,84709996,812300,85522296,True
9896,validator_18,129336412699,True,195305998,1819800,197125798,True
9897,validator_42,53779112550,True,149885000,8599840,158484840,False
9898,validator_25,52973192090,True,98405000,1614300,100019300,False
9899,validator_33,50489522970,True,85839000,265900,86104900,False
9900,validator_49,88146105630,True,135202000,18827890,154029890,False
9901,validator_1,93417042265,True,241819997,454360,242274357,True
9902,validator_23,56551701961,True,120232004,455500,120687504,True
9903,validator_43,84785440180,True,177186000,1907200,179093200,False
9904,validator_12,126328319309,True,140968999,983800,141952799,True
9905,validator_34,287340532190,True,58810000,8454830,67264830,False
9906,validator_48,186949999880,True,68523000,18756400,87279400,False
9907,validator_7,93123527918,True,173017003,1918500,174935503,True
9908,validator_21,90479289717,True,92536003,2278530,94814533,True
9909,validator_8,58313917827,True,158033996,2102680,160136676,True
9910,validator_44,121844863370,True,131565000,4828000,136393000,False
9911,validator_39,55762541030,True,106522000,1233300,107755300,False
9912,validator_31,189918473380,True,150712000,786000,151498000,False
9913,validator_12,126521311111,True,190922002,2069800,192991802,True
9914,validator_26,54978223610,True,141396000,1042400,142438400,False
9915,validator_37,87113523560,True,89480000,643790,90123790,False
9916,validator_11,60406308541,True,200855000,19527900,220382900,True
9917,validator_6,56398323968,True,89876998,957800,90834798,True
9918,validator_44,121941112970,True,95668000,581600,96249600,False
9919,validator_49,88214072670,True,66157000,1810040,67967040,False
9920,validator_8,58502218169,True,184680002,3620340,188300342,True
9921,validator_38,51960752000,True,181720000,2422300,184142300,False
9922,validator_3,60381020576,True,98790999,1010400,99801399,True
9923,validator_32,54099141350,True,126927000,220440,127147440,False
9924,validator_46,121436105520,True,107626000,2305680,109931680,False
9925,validator_4,59537984880,True,183419004,1174300,184593304,True
9926,validator_12,126593956526,True,72378995,266420,72645415,True
9927,validator_20,55618572282,True,49004000,5200480,54204480,True
9928,validator_40,55351928270,True,150439000,681690,151120690,False
9929,validator_18,129513951000,True,176485001,1053300,177538301,True
9930,validator_32,54280568470,True,180791000,636120,181427120,False
9931,validator_22,90645550698,True,85776999,1641030,87418029,True
9932,validator_36,121452734800,True,51187000,969000,52156000,False
9933,validator_42,53853449450,True,73159000,1177900,74336900,False
9934,validator_28,52220937800,True,33824000,1659710,35483710,False
9935,validator_23,56688638402,True,136407001,529440,136936441,True
9936,validator_1,93595190811,True,175458006,2690540,178148546,True
9937,validator_44,122051119110,True,102380000,7626140,110006140,False
9938,validator_34,287477995080,True,136489000,973890,137462890,False
9939,validator_49,88281225570,True,64506000,2646900,67152900,False
9940,validator_14,128593005906,True,261401001,3534910,264935911,True
9941,validator_9,60257758453,True,107811002,15105140,122916142,True
9942,validator_4,59813743107,True,274518997,1239230,275758227,True
9943,validator_9,60403875395,True,141196002,4920940,146116942,True
9944,validator_12,126672701624,True,76630998,2114100,78745098,True
9945,validator_31,190035148310,True,111478000,5196930,116674930,False
9946,validator_27,121614296920,True,87790000,5425050,93215050,False
9947,validator_15,303170470968,True,138765001,1514300,140279301,True
9948,validator_40,55439728270,True,85848000,1952000,87800000,False
9949,validator_3,60508010552,True,125575006,1414970,126989976,True
9950,validator_44,122198955510,True,146980000,856400,147836400,False
9951,validator_1,93817491493,True,220560002,1740680,222300682,True
9952,validator_17,195212181334,True,142706003,1449980,144155983,True
9953,validator_8,58544965852,True,41262003,1485680,42747683,True
9954,validator_35,121324153580,True,96053000,1112730,97165730,False
9955,validator_16,55717915606,True,70280005,741000,71021005,True
9956,validator_18,129653357101,True,137371001,2035100,139406101,True
9957,validator_37,87228535580,True,103673000,11339020,115012020,False
9958,validator_22,90713281758,True,57905000,9826060,67731060,True
9959,validator_49,88362947690,True,72636000,9086120,81722120,False
9960,validator_26,55068332810,True,88999000,1110200,90109200,False
9961,validator_9,60599359397,True,190143002,5341000,195484002,True
9962,validator_31,190149125250,True,101644000,12332940,113976940,False
9963,validator_31,190294494450,True,143211000,2158200,145369200,False
9964,validator_4,60058969738,True,229915001,15311630,245226631,True
9965,validator_40,55536603890,True,96318000,557620,96875620,False
9966,validator_11,60607891135,True,198730994,2851600,201582594,True
9967,validator_23,56925326398,True,228318996,8369000,236687996,True
9968,validator_44,122295741060,True,94965000,1820550,96785550,False
9969,validator_8,58645394652,True,99528000,900800,100428800,True
9970,validator_14,128643151010,True,40738004,9407100,50145104,True
9971,validator_16,55913406401,True,193856995,1633800,195490795,True
9972,validator_41,89576523890,True,99742000,359830,100101830,False
9973,validator_32,54348770300,True,66928000,1273830,68201830,False
9974,validator_49,88460301010,True,96701000,652320,97353320,False
9975,validator_11,60734141652,True,125984997,265520,126250517,True
9976,validator_19,95118589446,True,103034002,25741440,128775442,True
9977,validator_23,57007608101,True,81725003,556700,82281703,True
9978,validator_15,303246559608,True,75472000,616640,76088640,True
9979,validator_17,195398971512,True,176529998,10260180,186790178,True
9980,validator_2,59338902159,True,72267998,7770630,80038628,True
9981,validator_47,85284279530,True,211692000,502900,212194900,False
9982,validator_28,52315706990,True,93510000,1259190,94769190,False
9983,validator_8,58779974648,True,132701996,1878000,134579996,True
9984,validator_33,50560884410,True,70083000,1278440,71361440,False
9985,validator_10,57579995059,True,304981004,13306900,318287904,True
9986,validator_0,58032821456,True,156604999,748300,157353299,True
9987,validator_49,88589703130,True,127368000,2034120,129402120,False
9988,validator_26,55230392590,True,153317000,8742780,162059780,False
9989,validator_38,52058563340,True,96007000,1804340,97811340,False
9990,validator_0,58104091977,True,67889001,3381520,71270521,True
9991,validator_41,89663755890,True,86923000,309000,87232000,False
9992,validator_32,54398245890,True,47852000,1623590,49475590,False
9993,validator_27,121778108080,True,163074000,737160,163811160,False
9994,validator_22,90866241960,True,133734002,19226200,152960202,True
9995,validator_43,84935061010,True,148759000,861830,149620830,False
9996,validator_6,56663514206,True,264045998,1144240,265190238,True
9997,validator_18,129778105272,True,123475001,1273170,124748171,True
9998,validator_33,50687896710,True,125197000,1815300,127012300,False
9999,validator_40,55711489890,True,171711000,3175000,174886000,False
