block_num,validator_id,validator_capital,validator_restaking_factor,total_gas_fee,total_mev_available,block_reward,is_attacker,num_validator_nodes
0,validator_4,96624932770,True,617380000,7552770,624932770,True,3
1,validator_8,32856942959,True,842139999,14802960,856942959,True,1
2,validator_34,32450001900,True,447500000,2501900,450001900,False,1
3,validator_26,32731467666,True,711419996,20047670,731467666,True,1
4,validator_16,32679378879,True,636623999,42754880,679378879,True,1
5,validator_2,160717320060,True,711458000,5862060,717320060,True,5
6,validator_45,32728542220,True,727600000,942220,728542220,False,1
7,validator_21,32683972302,True,677000002,6972300,683972302,True,1
8,validator_40,32620399310,True,612600000,7799310,620399310,False,1
9,validator_33,32629595630,True,628600000,995630,629595630,False,1
10,validator_14,32745839817,True,719659997,26179820,745839817,True,1
11,validator_1,256654273420,True,647600000,6673420,654273420,False,8
12,validator_38,32835309080,True,832600000,2709080,835309080,False,1
13,validator_45,33270721970,True,531600000,10579750,542179750,False,1
14,validator_48,32515311190,True,512900000,2411190,515311190,False,1
15,validator_0,256800397399,True,795999999,4397400,800397399,True,8
16,validator_17,32946499760,True,917220000,29279760,946499760,True,1
17,validator_38,33486259720,True,646800000,4150640,650950640,False,1
18,validator_0,257380545001,True,561620002,18527600,580147602,True,8
19,validator_1,257284620690,True,624000000,6347270,630347270,False,8
20,validator_2,161466539015,True,740320005,8898950,749218955,True,5
21,validator_9,32779883203,True,758900003,20983200,779883203,True,1
22,validator_0,258478187320,True,1090539999,7102320,1097642319,True,8
23,validator_30,32775192900,True,773300000,1892900,775192900,False,1
24,validator_38,34091744420,True,604400000,1084700,605484700,False,1
25,validator_44,32541840900,True,536200000,5640900,541840900,False,1
26,validator_43,32479166560,True,477500000,1666560,479166560,False,1
27,validator_22,32600336801,True,599300001,1036800,600336801,True,1
28,validator_10,32545229111,True,521720001,23509110,545229111,True,1
29,validator_38,34589109540,True,493300000,4065120,497365120,False,1
30,validator_6,64574895259,True,571079999,3815260,574895259,True,2
31,validator_13,33026955360,True,971240000,55715360,1026955360,True,1
32,validator_18,32649615040,True,640540000,9075040,649615040,True,1
33,validator_0,259134592519,True,639099999,17305200,656405199,True,8
34,validator_0,259801340314,True,644740005,22007790,666747795,True,8
35,validator_3,160739736730,True,726200000,13536730,739736730,False,5
36,validator_30,33331765580,True,555300000,1272680,556572680,False,1
37,validator_48,33227058250,True,709700000,2047060,711747060,False,1
38,validator_36,32489761000,True,487100000,2661000,489761000,False,1
39,validator_10,33343613136,True,755199995,43184030,798384025,True,1
40,validator_25,32891650716,True,865399996,26250720,891650716,True,1
41,validator_3,161306638960,True,547500000,19402230,566902230,False,5
42,validator_2,162150635850,True,648899995,35196840,684096835,True,5
43,validator_1,257837710930,True,550300000,2790240,553090240,False,8
44,validator_22,33307173906,True,689436005,17401100,706837105,True,1
45,validator_3,162070078450,True,743000000,20439490,763439490,False,5
46,validator_7,64528215440,True,507670000,20545440,528215440,False,2
47,validator_1,258283785120,True,440200000,5874190,446074190,False,8
48,validator_24,32650295201,True,613220001,37075200,650295201,True,1
49,validator_42,32546133890,True,544300000,1833890,546133890,False,1
50,validator_48,33906224970,True,668800000,10366720,679166720,False,1
51,validator_26,33432834763,True,696139997,5227100,701367097,True,1
52,validator_40,33251400340,True,623000000,8001030,631001030,False,1
53,validator_48,34491701760,True,582700000,2776790,585476790,False,1
54,validator_15,32901477870,True,852700000,48777870,901477870,True,1
55,validator_2,162970377230,True,804300000,15441380,819741380,True,5
56,validator_16,33351449427,True,652295998,19774550,672070548,True,1
57,validator_26,34025682078,True,580039995,12807320,592847315,True,1
58,validator_7,65374674580,True,837900000,8559140,846459140,False,2
59,validator_13,33658583388,True,582319998,49308030,631628028,True,1
60,validator_0,260493953206,True,662600002,30012890,692612892,True,8
61,validator_31,32608675390,True,607100000,1575390,608675390,False,1
62,validator_5,96497934120,True,486600000,11334120,497934120,False,3
63,validator_0,260976782399,True,474539993,8289200,482829193,True,8
64,validator_4,97405844023,True,757400003,23511250,780911253,True,3
65,validator_23,32636770534,True,616729994,20040540,636770534,True,1
66,validator_33,33400026170,True,768200000,2230540,770430540,False,1
67,validator_3,162727080450,True,653800000,3202000,657002000,False,5
68,validator_48,35109867100,True,617500000,665340,618165340,False,1
69,validator_1,258916876120,True,625800000,7291000,633091000,False,8
70,validator_1,259328932770,True,407800000,4256650,412056650,False,8
71,validator_2,163619427273,True,609560003,39490040,649050043,True,5
72,validator_1,259836654710,True,496100000,11621940,507721940,False,8
73,validator_44,33102837680,True,550900000,10096780,560996780,False,1
74,validator_14,33503557003,True,749039996,8677190,757717186,True,1
75,validator_38,35107712000,True,518100000,502460,518602460,False,1
76,validator_46,32522681100,True,521000000,1681100,522681100,False,1
77,validator_5,97036491820,True,536100000,2457700,538557700,False,3
78,validator_6,65278023658,True,678739999,24388400,703128399,True,2
79,validator_38,35707922620,True,580400000,19810620,600210620,False,1
80,validator_3,163458222850,True,729400000,1742400,731142400,False,5
81,validator_23,33473185423,True,784479999,51934890,836414889,True,1
82,validator_20,32941878397,True,929339997,12538400,941878397,True,1
83,validator_7,65877477470,True,495300000,7502890,502802890,False,2
84,validator_5,97757096320,True,707800000,12804500,720604500,False,3
85,validator_0,261503683799,True,518140010,8761390,526901400,True,8
86,validator_40,34029934250,True,777400000,1133910,778533910,False,1
87,validator_1,260514076090,True,641200000,36221380,677421380,False,8
88,validator_3,164105199850,True,644800000,2177000,646977000,False,5
89,validator_29,32699182270,True,696900000,2282270,699182270,False,1
90,validator_38,36236117020,True,517800000,10394400,528194400,False,1
91,validator_1,261024294050,True,506400000,3817960,510217960,False,8
92,validator_47,32498138260,True,469700000,28438260,498138260,False,1
93,validator_5,98246496140,True,485670000,3729820,489399820,False,3
94,validator_49,32706033760,True,686300000,19733760,706033760,False,1
95,validator_0,262090113099,True,555086000,31343300,586429300,True,8
96,validator_44,33648616410,True,537200000,8578730,545778730,False,1
97,validator_48,35780057460,True,649700000,20490360,670190360,False,1
98,validator_3,164585309970,True,476800000,3310120,480110120,False,5
99,validator_49,33254546890,True,546300000,2213130,548513130,False,1
100,validator_0,262730567841,True,612040002,28414740,640454742,True,8
101,validator_4,98174350252,True,764999989,3506240,768506229,True,3
102,validator_32,32550821300,True,531500000,19321300,550821300,False,1
103,validator_1,261737082650,True,689900000,22888600,712788600,False,8
104,validator_47,33079212860,True,580200000,874600,581074600,False,1
105,validator_31,33389552620,True,779400000,1477230,780877230,False,1
106,validator_22,33894603708,True,555620002,31809800,587429802,True,1
107,validator_28,32519302714,True,516700004,2602710,519302714,True,1
108,validator_6,66024178688,True,741140000,5015030,746155030,True,2
109,validator_48,36429148460,True,645900000,3191000,649091000,False,1
110,validator_41,32654809200,True,635100000,19709200,654809200,False,1
111,validator_0,263598934731,True,861100010,7266880,868366890,True,8
112,validator_0,264234984920,True,623639999,12410190,636050189,True,8
113,validator_1,262252066030,True,511200000,3783380,514983380,False,8
114,validator_27,32940315707,True,932700007,7615700,940315707,True,1
115,validator_2,164250545878,True,591440005,39678600,631118605,True,5
116,validator_3,165220905890,True,632800000,2795920,635595920,False,5
117,validator_0,264747570186,True,491199996,21385270,512585266,True,8
118,validator_22,34746347592,True,837706004,14037880,851743884,True,1
119,validator_43,33053153360,True,553400000,20586800,573986800,False,1
120,validator_9,33674285002,True,827515999,66885800,894401799,True,1
121,validator_1,262854491830,True,593200000,9225800,602425800,False,8
122,validator_0,265533341782,True,760257996,25513600,785771596,True,8
123,validator_34,33006036480,True,546200000,9834580,556034580,False,1
124,validator_35,32787734170,True,777000000,10734170,787734170,False,1
125,validator_0,266260943086,True,692639994,34961310,727601304,True,8
126,validator_22,35335193571,True,574679999,14165980,588845979,True,1
127,validator_2,164931014877,True,649119999,31349000,680468999,True,5
128,validator_5,98907699740,True,659000000,2203600,661203600,False,3
129,validator_4,99006652648,True,818499996,13802400,832302396,True,3
130,validator_3,165841802790,True,618600000,2296900,620896900,False,5
131,validator_1,263464309570,True,606400000,3417740,609817740,False,8
132,validator_32,33188977440,True,637000000,1156140,638156140,False,1
133,validator_10,34114337972,True,760853996,9870840,770724836,True,1
134,validator_3,166485098090,True,641800000,1495300,643295300,False,5
135,validator_1,264001444340,True,534400000,2734770,537134770,False,8
136,validator_5,99468207530,True,556000000,4507790,560507790,False,3
137,validator_4,99799939877,True,791099999,2187230,793287229,True,3
138,validator_4,100614805136,True,783059999,31805260,814865259,True,3
139,validator_15,33688036375,True,760340005,26218500,786558505,True,1
140,validator_0,267077907022,True,814100006,2863930,816963936,True,8
141,validator_24,33511343289,True,819083998,41964090,861048088,True,1
142,validator_0,267786717219,True,645779997,63030200,708810197,True,8
143,validator_27,33511611022,True,543780005,27515310,571295315,True,1
144,validator_15,34530430908,True,822799993,19594540,842394533,True,1
145,validator_3,167100833300,True,607300000,8435210,615735210,False,5
146,validator_1,264462281600,True,456100000,4737260,460837260,False,8
147,validator_43,33480699550,True,423470000,4076190,427546190,False,1
148,validator_6,66953110262,True,896046004,32885570,928931574,True,2
149,validator_44,34257647770,True,607100000,1931360,609031360,False,1
150,validator_45,33774365670,True,480500000,23143700,503643700,False,1
151,validator_1,265204847000,True,734700000,7865400,742565400,False,8
152,validator_2,165633389294,True,667299997,35074420,702374417,True,5
153,validator_49,33826672890,True,569300000,2826000,572126000,False,1
154,validator_42,33336057830,True,745000000,44923940,789923940,False,1
155,validator_28,33252734009,True,693567995,39863300,733431295,True,1
156,validator_0,268539295312,True,746465993,6112100,752578093,True,8
157,validator_15,35112449616,True,579500008,2518700,582018708,True,1
158,validator_4,101306540167,True,685840001,5895030,691735031,True,3
159,validator_40,34634421460,True,601200000,3287210,604487210,False,1
160,validator_21,33255760718,True,562039996,9748420,571788416,True,1
161,validator_4,101852214528,True,542620001,3054360,545674361,True,3
162,validator_48,36996867560,True,565700000,2019100,567719100,False,1
163,validator_0,269166800117,True,619460005,8044800,627504805,True,8
164,validator_12,32796146432,True,789120002,7026430,796146432,True,1
165,validator_18,33397704441,True,727600001,20489400,748089401,True,1
166,validator_4,102653867356,True,784399998,17252830,801652828,True,3
167,validator_22,36016510037,True,642054006,39262460,681316466,True,1
168,validator_7,66625842260,True,741000000,7364790,748364790,False,2
169,validator_42,33862734130,True,518100000,8576300,526676300,False,1
170,validator_40,35048208460,True,404700000,9087000,413787000,False,1
171,validator_9,34205288997,True,502599995,28404000,531003995,True,1
172,validator_20,33601352026,True,629299999,30173630,659473629,True,1
173,validator_21,33780707818,True,482140000,42807100,524947100,True,1
174,validator_33,33859165270,True,452200000,6939100,459139100,False,1
175,validator_36,33037149670,True,545100000,2288670,547388670,False,1
176,validator_42,34655951660,True,780800000,12417530,793217530,False,1
177,validator_8,33457451200,True,593240001,7268240,600508241,True,1
178,validator_42,35062448490,True,405040000,1456830,406496830,False,1
179,validator_2,166490285875,True,836920001,19976580,856896581,True,5
180,validator_2,167369761307,True,876700002,2775430,879475432,True,5
181,validator_43,34013978140,True,531500000,1778590,533278590,False,1
182,validator_3,167832297790,True,725700000,5764490,731464490,False,5
183,validator_5,99995204130,True,521100000,5896600,526996600,False,3
184,validator_4,103112495344,True,413059998,45567990,458627988,True,3
185,validator_1,265693962300,True,488000000,1115300,489115300,False,8
186,validator_1,266136358010,True,439100000,3295710,442395710,False,8
187,validator_0,269691168685,True,515739998,8628570,524368568,True,8
188,validator_3,168570274800,True,731800000,6177010,737977010,False,5
189,validator_1,266875337710,True,713800000,25179700,738979700,False,8
190,validator_5,100657800190,True,652100000,10496060,662596060,False,3
191,validator_46,33143706800,True,601000000,20025700,621025700,False,1
192,validator_0,270168900707,True,475399992,2332030,477732022,True,8
193,validator_6,67602194035,True,639700003,9383770,649083773,True,2
194,validator_18,34110636138,True,685759997,27171700,712931697,True,1
195,validator_1,267427044260,True,548600000,3106550,551706550,False,8
196,validator_41,33515707000,True,846400000,14497800,860897800,False,1
197,validator_35,33520269990,True,726200000,6335820,732535820,False,1
198,validator_0,270956177434,True,742707997,44568730,787276727,True,8
199,validator_12,33453926062,True,633680000,24099630,657779630,True,1
200,validator_7,67144377300,True,486300000,32235040,518535040,False,2
201,validator_24,34217077887,True,679359998,26374600,705734598,True,1
202,validator_49,34361742510,True,532100000,2969620,535069620,False,1
203,validator_6,68237153333,True,613639998,21319300,634959298,True,2
204,validator_2,167814414595,True,442219998,2433290,444653288,True,5
205,validator_1,268019803360,True,590500000,2259100,592759100,False,8
206,validator_11,32921968802,True,909500002,12468800,921968802,True,1
207,validator_27,34364775253,True,843240001,9924230,853164231,True,1
208,validator_0,271675140119,True,680996005,37966680,718962685,True,8
209,validator_48,37634176200,True,617200000,20108640,637308640,False,1
210,validator_4,104035625526,True,922100002,1030180,923130182,True,3
211,validator_48,38265230620,True,629500000,1554420,631054420,False,1
212,validator_28,33870875444,True,594640005,23501430,618141435,True,1
213,validator_5,101227850310,True,564900000,5150120,570050120,False,3
214,validator_9,34645385094,True,421599997,18496100,440096097,True,1
215,validator_1,268576434600,True,555000000,1631240,556631240,False,8
216,validator_3,169269483500,True,697700000,1508700,699208700,False,5
217,validator_40,35578276010,True,526200000,3867550,530067550,False,1
218,validator_7,67831800930,True,684800000,2623630,687423630,False,2
219,validator_10,34798571370,True,672399998,11833400,684233398,True,1
220,validator_37,32781659530,True,779600000,2059530,781659530,False,1
221,validator_8,34173982833,True,706420003,10111630,716531633,True,1
222,validator_19,32818787275,True,798639995,20147280,818787275,True,1
223,validator_33,34503282670,True,639700000,4417400,644117400,False,1
224,validator_46,33670585400,True,505400000,21478600,526878600,False,1
225,validator_0,272313621110,True,614968001,23512990,638480991,True,8
226,validator_26,34602467280,True,556100002,20685200,576785202,True,1
227,validator_40,36027256410,True,446800000,2180400,448980400,False,1
228,validator_3,169836400830,True,564700000,2217330,566917330,False,5
229,validator_26,35484201911,True,857459991,24274640,881734631,True,1
230,validator_47,33734375690,True,652100000,3062830,655162830,False,1
231,validator_11,33445234301,True,520699999,2565500,523265499,True,1
232,validator_11,34167822902,True,684966001,37622600,722588601,True,1
233,validator_21,34286062982,True,449139994,56215170,505355164,True,1
234,validator_6,69128481690,True,853599997,37728360,891328357,True,2
235,validator_19,33443445714,True,597579999,27078440,624658439,True,1
236,validator_2,168788118020,True,954796005,18907420,973703425,True,5
237,validator_0,272906158407,True,552739997,39797300,592537297,True,8
238,validator_1,269115618580,True,537300000,1883980,539183980,False,8
239,validator_0,273679440849,True,765440002,7842440,773282442,True,8
240,validator_48,38918423020,True,652000000,1192400,653192400,False,1
241,validator_12,34108152164,True,629920002,24306100,654226102,True,1
242,validator_6,69620674826,True,464120006,28073130,492193136,True,2
243,validator_13,34267637978,True,583600000,25454590,609054590,True,1
244,validator_29,33407684370,True,704800000,3702100,708502100,False,1
245,validator_6,70173747103,True,533310007,19762270,553072277,True,2
246,validator_12,34829229769,True,713320005,7757600,721077605,True,1
247,validator_25,33355235436,True,439660000,23924720,463584720,True,1
248,validator_43,34696714830,True,680700000,2036690,682736690,False,1
249,validator_22,36674511415,True,638899998,19101380,658001378,True,1
250,validator_5,101757774560,True,526600000,3324250,529924250,False,3
251,validator_48,39553834760,True,625900000,9511740,635411740,False,1
252,validator_28,34427203100,True,538259996,18067660,556327656,True,1
253,validator_1,269761446580,True,626300000,19528000,645828000,False,8
254,validator_44,34909218890,True,606800000,44771120,651571120,False,1
255,validator_2,169393424222,True,592600012,12706190,605306202,True,5
256,validator_31,33852575530,True,455100000,7922910,463022910,False,1
257,validator_20,34072756328,True,458700002,12704300,471404302,True,1
258,validator_25,33995623476,True,627900000,12488040,640388040,True,1
259,validator_7,68412573520,True,571300000,9472590,580772590,False,2
260,validator_9,35308525037,True,621898003,41241940,663139943,True,1
261,validator_19,33946208310,True,482219996,20542600,502762596,True,1
262,validator_3,170338066300,True,499900000,1765470,501665470,False,5
263,validator_0,274450029339,True,738574000,32014490,770588490,True,8
264,validator_9,35856947235,True,532179998,16242200,548422198,True,1
265,validator_2,170213639324,True,789800002,30415100,820215102,True,5
266,validator_5,102285389090,True,521500000,6114530,527614530,False,3
267,validator_34,33460634050,True,430800000,23797570,454597570,False,1
268,validator_27,35039652809,True,666540006,8337550,674877556,True,1
269,validator_33,35133231000,True,626900000,3048330,629948330,False,1
270,validator_4,104788453828,True,716600002,36228300,752828302,True,3
271,validator_3,170716456730,True,357800000,20590430,378390430,False,5
272,validator_7,68923798620,True,509900000,1325100,511225100,False,2
273,validator_4,105658977769,True,861160001,9363940,870523941,True,3
274,validator_35,34169127690,True,638500000,10357700,648857700,False,1
275,validator_23,34431603743,True,954900000,3518320,958418320,True,1
276,validator_35,34622317620,True,432400000,20789930,453189930,False,1
277,validator_20,34909768284,True,785719996,51291960,837011956,True,1
278,validator_0,275312472006,True,842639997,19802670,862442667,True,8
279,validator_2,171071155641,True,855139997,2376320,857516317,True,5
280,validator_3,171381451730,True,660600000,4395000,664995000,False,5
281,validator_41,33936989750,True,420300000,982750,421282750,False,1
282,validator_22,37328789856,True,648500001,5778440,654278441,True,1
283,validator_7,69573603780,True,629700000,20105160,649805160,False,2
284,validator_2,171632570332,True,520680001,40734690,561414691,True,5
285,validator_10,35478051588,True,650173998,29306220,679480218,True,1
286,validator_2,172448340161,True,813899999,1869830,815769829,True,5
287,validator_47,34285013910,True,539700000,10938220,550638220,False,1
288,validator_1,270450177620,True,682900000,5831040,688731040,False,8
289,validator_36,33666004510,True,626000000,2854840,628854840,False,1
290,validator_29,34121792200,True,711400000,2707830,714107830,False,1
291,validator_29,34715849100,True,585700000,8356900,594056900,False,1
292,validator_35,35264627900,True,639800000,2510280,642310280,False,1
293,validator_0,276182320912,True,844954006,24894900,869848906,True,8
294,validator_34,33962018220,True,500300000,1084170,501384170,False,1
295,validator_0,276659529802,True,476300000,908890,477208890,True,8
296,validator_34,34625811150,True,647600000,16192930,663792930,False,1
297,validator_0,277194281334,True,508120002,26631530,534751532,True,8
298,validator_30,33848918180,True,514700000,2452600,517152600,False,1
299,validator_0,277823863858,True,606120004,23462520,629582524,True,8
300,validator_6,70892231524,True,709100001,9384420,718484421,True,2
301,validator_1,271290411990,True,834000000,6234370,840234370,False,8
302,validator_5,102831725580,True,543700000,2636490,546336490,False,3
303,validator_17,33646265296,True,696099996,3665540,699765536,True,1
304,validator_48,40297891520,True,730700000,13356760,744056760,False,1
305,validator_3,171941315330,True,559100000,763600,559863600,False,5
306,validator_14,34246874004,True,724600001,18717000,743317001,True,1
307,validator_2,173161805490,True,694179999,19285330,713465329,True,5
308,validator_29,35338057230,True,620500000,1708130,622208130,False,1
309,validator_30,34527367670,True,669200000,9249490,678449490,False,1
310,validator_38,36787031050,True,549100000,1814030,550914030,False,1
311,validator_2,173859377194,True,668600004,28971700,697571704,True,5
312,validator_38,37497343640,True,708700000,1612590,710312590,False,1
313,validator_24,34791663514,True,570799997,3785630,574585627,True,1
314,validator_2,174437558296,True,546234002,31947100,578181102,True,5
315,validator_49,34862603370,True,493900000,6960860,500860860,False,1
316,validator_11,34734254507,True,528220005,38211600,566431605,True,1
317,validator_0,278618147082,True,789920004,4363220,794283224,True,8
318,validator_18,34845986480,True,715480002,19870340,735350342,True,1
319,validator_7,70045914550,True,470200000,2110770,472310770,False,2
320,validator_15,35952237142,True,797259996,42527530,839787526,True,1
321,validator_4,106482920306,True,821200007,2742530,823942537,True,3
322,validator_46,34256299600,True,582800000,2914200,585714200,False,1
323,validator_29,35957332970,True,615920000,3355740,619275740,False,1
324,validator_45,34409522900,True,630900000,4257230,635157230,False,1
325,validator_3,172461696250,True,499300000,21080920,520380920,False,5
326,validator_3,173196362700,True,707300000,27366450,734666450,False,5
327,validator_35,35799287820,True,528700000,5959920,534659920,False,1
328,validator_17,34369628728,True,714319992,9043440,723363432,True,1
329,validator_0,279213918365,True,576200003,19571280,595771283,True,8
330,validator_0,280076734893,True,840139998,22676530,862816528,True,8
331,validator_11,35730175181,True,989439994,6480680,995920674,True,1
332,validator_45,34837344300,True,424300000,3521400,427821400,False,1
333,validator_2,175348951766,True,847920000,63473470,911393470,True,5
334,validator_38,38027881440,True,528700000,1837800,530537800,False,1
335,validator_20,35656491612,True,745299998,1423330,746723328,True,1
336,validator_15,36713816432,True,730236000,31343290,761579290,True,1
337,validator_39,32635213060,True,615700000,19513060,635213060,False,1
338,validator_32,33690944160,True,482900000,19066720,501966720,False,1
339,validator_35,36424902000,True,606700000,18914180,625614180,False,1
340,validator_0,280773470888,True,653499995,43236000,696735995,True,8
341,validator_11,36423290681,True,681700000,11415500,693115500,True,1
342,validator_49,35437468070,True,573300000,1564700,574864700,False,1
343,validator_45,35383754530,True,540200000,6210230,546410230,False,1
344,validator_12,35309713502,True,469840003,10643730,480483733,True,1
345,validator_0,281572225293,True,772858005,25896400,798754405,True,8
346,validator_5,103476562960,True,640600000,4237380,644837380,False,3
347,validator_12,36227169992,True,905839990,11616500,917456490,True,1
348,validator_0,282364331675,True,761440002,30666380,792106382,True,8
349,validator_2,176249690012,True,873959996,26778250,900738246,True,5
350,validator_33,35861482990,True,725000000,3251990,728251990,False,1
351,validator_46,34866951880,True,604700000,5952280,610652280,False,1
352,validator_22,38096222556,True,728590000,38842700,767432700,True,1
353,validator_46,35502349150,True,626700000,8697270,635397270,False,1
354,validator_35,37059352000,True,623300000,11150000,634450000,False,1
355,validator_32,34383688180,True,691100000,1644020,692744020,False,1
356,validator_0,282954686074,True,580629999,9724400,590354399,True,8
357,validator_0,283840330699,True,864399995,21244630,885644625,True,8
358,validator_16,34035566162,True,652700005,31416730,684116735,True,1
359,validator_1,271831628710,True,527600000,13616720,541216720,False,8
360,validator_0,284457444996,True,582279997,34834300,617114297,True,8
361,validator_0,284995950168,True,535400002,3105170,538505172,True,8
362,validator_5,104030035940,True,544600000,8872980,553472980,False,3
363,validator_10,36254810688,True,757800000,18959100,776759100,True,1
364,validator_7,70837435930,True,748100000,43421380,791521380,False,2
365,validator_6,71875942955,True,940745991,42965440,983711431,True,2
366,validator_2,176757454528,True,473940006,33824510,507764516,True,5
367,validator_3,173729046660,True,530800000,1883960,532683960,False,5
368,validator_10,36869989183,True,602820005,12358490,615178495,True,1
369,validator_7,71477390080,True,607800000,32154150,639954150,False,2
370,validator_3,174334994260,True,601600000,4347600,605947600,False,5
371,validator_13,35208663876,True,917559998,23465900,941025898,True,1
372,validator_4,107180653385,True,668409999,29323080,697733079,True,3
373,validator_1,272474690410,True,641100000,1961700,643061700,False,8
374,validator_18,35402548620,True,527739990,28822150,556562140,True,1
375,validator_28,35122241936,True,649653996,45384840,695038836,True,1
376,validator_2,177292248949,True,533600001,1194420,534794421,True,5
377,validator_6,72488394825,True,563540000,48911870,612451870,True,2
378,validator_2,178070608469,True,758400000,19959520,778359520,True,5
379,validator_12,36943979431,True,711360009,5449430,716809439,True,1
380,validator_3,175002355200,True,662300000,5060940,667360940,False,5
381,validator_1,272978099310,True,490600000,12808900,503408900,False,8
382,validator_21,35270283804,True,960820002,23400820,984220822,True,1
383,validator_37,33379100610,True,590900000,6541080,597441080,False,1
384,validator_43,35435849430,True,735800000,3334600,739134600,False,1
385,validator_3,175714208330,True,707400000,4453130,711853130,False,5
386,validator_5,104459719430,True,428630000,1053490,429683490,False,3
387,validator_1,273539717300,True,558600000,3017990,561617990,False,8
388,validator_1,274199746020,True,659300000,728720,660028720,False,8
389,validator_0,285539119671,True,534100003,9069500,543169503,True,8
390,validator_12,37366324858,True,419099997,3245430,422345427,True,1
391,validator_5,104985950290,True,507100000,19130860,526230860,False,3
392,validator_0,286142983368,True,585159997,18703700,603863697,True,8
393,validator_1,274803660020,True,601150000,2764000,603914000,False,8
394,validator_49,35934637850,True,494600000,2569780,497169780,False,1
395,validator_26,36287552076,True,779040005,24310160,803350165,True,1
396,validator_0,286587866291,True,438000003,6882920,444882923,True,8
397,validator_19,34566428310,True,600240000,19980000,620220000,True,1
398,validator_41,34491147040,True,522000000,32157290,554157290,False,1
399,validator_39,32947008760,True,309250000,2545700,311795700,False,1
400,validator_7,71904366780,True,423900000,3076700,426976700,False,2
401,validator_0,287074015029,True,432499998,53648740,486148738,True,8
402,validator_6,73170888429,True,674500004,7993600,682493604,True,2
403,validator_28,35905670298,True,740440002,42988360,783428362,True,1
404,validator_2,178677215790,True,594940001,11667320,606607321,True,5
405,validator_5,105730941590,True,736400000,8591300,744991300,False,3
406,validator_11,37135734140,True,684099999,28343460,712443459,True,1
407,validator_35,37701961540,True,639700000,2909540,642609540,False,1
408,validator_22,38865630775,True,756753999,12654220,769408219,True,1
409,validator_7,72543147480,True,635800000,2980700,638780700,False,2
410,validator_40,36597015800,True,566900000,2859390,569759390,False,1
411,validator_42,35756215680,True,691800000,1967190,693767190,False,1
412,validator_19,35190966417,True,592940007,31598100,624538107,True,1
413,validator_44,35439689990,True,521700000,8771100,530471100,False,1
414,validator_3,176204735760,True,484400000,6127430,490527430,False,5
415,validator_14,34893631905,True,632840001,13917900,646757901,True,1
416,validator_3,176804747840,True,598700000,1312080,600012080,False,5
417,validator_47,35088441850,True,801700000,1727940,803427940,False,1
418,validator_0,287740658113,True,631739994,34903090,666643084,True,8
419,validator_6,73734683602,True,552840003,10955170,563795173,True,2
420,validator_46,36086879160,True,576700000,7830010,584530010,False,1
421,validator_17,35157866167,True,759599999,28637440,788237439,True,1
422,validator_4,107835205112,True,638159997,16391730,654551727,True,3
423,validator_25,34760210513,True,762499997,2087040,764587037,True,1
424,validator_29,36615420250,True,655400000,2687280,658087280,False,1
425,validator_5,106392968580,True,653200000,8826990,662026990,False,3
426,validator_0,288513408548,True,769699995,3050440,772750435,True,9
427,validator_19,36128436689,True,911080002,26390270,937470272,True,1
428,validator_22,39573617605,True,678740000,29246830,707986830,True,1
429,validator_0,289288088253,True,765800005,8879700,774679705,True,9
430,validator_22,40428741807,True,845320002,9804200,855124202,True,1
431,validator_8,34999905059,True,792959996,32962230,825922226,True,1
432,validator_0,290024213286,True,731299993,4825040,736125033,True,9
433,validator_2,179476368146,True,769785996,29366360,799152356,True,5
434,validator_0,290667871179,True,637199993,6457900,643657893,True,9
435,validator_6,74418167915,True,660039993,23444320,683484313,True,2
436,validator_1,275219171500,True,412900000,2611480,415511480,False,8
437,validator_5,107113985650,True,697500000,23517070,721017070,False,3
438,validator_1,276025243120,True,783500000,22571620,806071620,False,8
439,validator_21,36107365127,True,805139993,31941330,837081323,True,1
440,validator_2,180221910642,True,720179996,25362500,745542496,True,5
441,validator_1,276661839120,True,632100000,4496000,636596000,False,8
442,validator_0,291324915783,True,654600004,2444600,657044604,True,9
443,validator_36,34242940920,True,568300000,8636410,576936410,False,1
444,validator_0,291856556269,True,521719996,9920490,531640486,True,9
445,validator_2,180905565239,True,652239997,31414600,683654597,True,5
446,validator_44,35949365290,True,505800000,3875300,509675300,False,1
447,validator_19,36708121778,True,508679999,71005090,579685089,True,1
448,validator_13,35878967904,True,657680008,12624020,670304028,True,1
449,validator_36,34953444770,True,699600000,10903850,710503850,False,1
450,validator_1,277334232920,True,651700000,20693800,672393800,False,8
451,validator_22,41243255546,True,786097999,28415740,814513739,True,1
452,validator_1,278130446120,True,792500000,3713200,796213200,False,8
453,validator_5,107593125010,True,453000000,26139360,479139360,False,3
454,validator_17,35867738362,True,686479995,23392200,709872195,True,1
455,validator_7,73052294590,True,501300000,7847110,509147110,False,2
456,validator_38,38656160240,True,625300000,2978800,628278800,False,1
457,validator_0,292763074949,True,874000000,32518680,906518680,True,9
458,validator_27,36172159012,True,1110300003,22206200,1132506203,True,1
459,validator_11,37657385640,True,510600000,11051500,521651500,True,1
460,validator_0,293774610686,True,991599997,19935740,1011535737,True,9
461,validator_6,75070379993,True,610959998,41252080,652212078,True,2
462,validator_3,177463596820,True,656000000,2848980,658848980,False,5
463,validator_2,181540497835,True,590299996,44632600,634932596,True,5
464,validator_47,35581255330,True,492200000,613480,492813480,False,1
465,validator_0,294663191098,True,831658002,56922410,888580412,True,9
466,validator_24,35444617374,True,595834000,57119860,652953860,True,1
467,validator_18,36378542849,True,956499999,19494230,975994229,True,1
468,validator_1,278760325210,True,620300000,9579090,629879090,False,8
469,validator_14,35554523153,True,641419998,19471250,660891248,True,1
470,validator_0,295289553319,True,619300001,7062220,626362221,True,9
471,validator_10,37593152419,True,649179996,73983240,723163236,True,1
472,validator_9,36637238140,True,778440005,1850900,780290905,True,1
473,validator_13,36598832732,True,693713998,26150830,719864828,True,1
474,validator_2,182418234176,True,868100001,9636340,877736341,True,5
475,validator_5,108258271930,True,645800000,19346920,665146920,False,3
476,validator_47,36092433930,True,510300000,878600,511178600,False,1
477,validator_25,35606220218,True,840700005,5309700,846009705,True,1
478,validator_22,41971864776,True,720340000,8269230,728609230,True,1
479,validator_0,295956094715,True,639839996,26701400,666541396,True,9
480,validator_0,296648322641,True,684799996,7427930,692227926,True,9
481,validator_46,36879351160,True,771900000,20572000,792472000,False,1
482,validator_29,37079599080,True,461900000,2278830,464178830,False,1
483,validator_43,35948513650,True,509800000,2864220,512664220,False,1
484,validator_45,36127528560,True,728700000,15074030,743774030,False,1
485,validator_32,34961460540,True,571700000,6072360,577772360,False,1
486,validator_6,75802337598,True,717700005,14257600,731957605,True,2
487,validator_20,36278154935,True,611160003,10503320,621663323,True,1
488,validator_0,297285808152,True,627819991,9665520,637485511,True,9
489,validator_33,36396495770,True,525100000,9912780,535012780,False,1
490,validator_3,178034482250,True,550200000,20685430,570885430,False,5
491,validator_32,35510923980,True,546500000,2963440,549463440,False,1
492,validator_1,279326597520,True,559600000,6672310,566272310,False,8
493,validator_4,108391884355,True,525480003,31199240,556679243,True,3
494,validator_6,76711513404,True,896320006,12855800,909175806,True,2
495,validator_26,37039021705,True,720419999,31049630,751469629,True,1
496,validator_25,36287025419,True,679100001,1705200,680805201,True,1
497,validator_49,36426353330,True,489700000,2015480,491715480,False,1
498,validator_0,297946431108,True,628879996,31742960,660622956,True,9
499,validator_3,178446090700,True,411000000,608450,411608450,False,5
500,validator_8,35608232475,True,571473996,36853420,608327416,True,1
501,validator_24,36068471681,True,619400007,4454300,623854307,True,1
502,validator_0,298656116246,True,678159998,31525140,709685138,True,9
503,validator_45,36729885620,True,598300000,4057060,602357060,False,1
504,validator_42,36479805190,True,720100000,3489510,723589510,False,1
505,validator_40,37158884760,True,524600000,37268960,561868960,False,1
506,validator_1,279923770720,True,574900000,22273200,597173200,False,8
507,validator_4,109070874747,True,650639992,28350400,678990392,True,3
508,validator_7,73553233620,True,495200000,5739030,500939030,False,2
509,validator_2,182943840302,True,494979996,30626130,525606126,True,5
510,validator_28,36440623331,True,533100003,1853030,534953033,True,1
511,validator_6,77339716816,True,625400002,2803410,628203412,True,2
512,validator_24,36784712082,True,707440001,8800400,716240401,True,1
513,validator_16,34690907545,True,607726003,47615380,655341383,True,1
514,validator_5,109069267770,True,799200000,11795840,810995840,False,3
515,validator_43,36733401080,True,775500000,9387430,784887430,False,1
516,validator_2,183544498737,True,581320005,19338430,600658435,True,5
517,validator_48,40671825160,True,371000000,2933640,373933640,False,1
518,validator_33,36886379020,True,481400000,8483250,489883250,False,1
519,validator_40,37754055520,True,591900000,3270760,595170760,False,1
520,validator_46,37507992340,True,622200000,6441180,628641180,False,1
521,validator_14,36240677048,True,672199995,13953900,686153895,True,1
522,validator_35,38355457800,True,647700000,5796260,653496260,False,1
523,validator_45,37187410520,True,453600000,3924900,457524900,False,1
524,validator_8,36302139366,True,678200001,15706890,693906891,True,1
525,validator_0,299159170947,True,490200001,12854700,503054701,True,9
526,validator_6,78014390100,True,651313994,23359290,674673284,True,2
527,validator_2,184156623273,True,610000006,2124530,612124536,True,5
528,validator_1,280469980830,True,542900000,3310110,546210110,False,8
529,validator_1,281096697270,True,624400000,2316440,626716440,False,8
530,validator_9,37188266847,True,520106007,30922700,551028707,True,1
531,validator_2,185221048514,True,1026679991,37745250,1064425241,True,5
532,validator_46,38138625450,True,615000000,15633110,630633110,False,1
533,validator_15,37417944546,True,690800004,13328110,704128114,True,1
534,validator_0,299899104767,True,694120000,45813820,739933820,True,9
535,validator_39,33564602980,True,580900000,36694220,617594220,False,1
536,validator_24,37546139470,True,740439998,20987390,761427388,True,1
537,validator_2,186041261333,True,789699999,30512820,820212819,True,5
538,validator_5,109642183670,True,571300000,1615900,572915900,False,3
539,validator_1,281751821900,True,643400000,11724630,655124630,False,8
540,validator_3,179058493000,True,606900000,5502300,612402300,False,5
541,validator_11,38644063532,True,983100002,3577890,986677892,True,1
542,validator_37,34028128280,True,647800000,1227670,649027670,False,1
543,validator_22,42685059279,True,646730003,66464500,713194503,True,1
544,validator_48,41065956480,True,389200000,4931320,394131320,False,1
545,validator_10,38372103817,True,761819998,17131400,778951398,True,1
546,validator_2,186893475010,True,832489997,19723680,852213677,True,5
547,validator_6,78927292903,True,897140003,15762800,912902803,True,2
548,validator_1,282258393830,True,504400000,2171930,506571930,False,8
549,validator_6,79556580581,True,583679998,45607680,629287678,True,2
550,validator_46,38712254350,True,553400000,20228900,573628900,False,1
551,validator_1,282922975280,True,661800000,2781450,664581450,False,8
552,validator_3,179519606740,True,457700000,3413740,461113740,False,5
553,validator_0,300460081171,True,540760004,20216400,560976404,True,9
554,validator_6,79968716777,True,391898006,20238190,412136196,True,2
555,validator_6,80935892277,True,945204000,21971500,967175500,True,2
556,validator_39,34277914100,True,704100000,9211120,713311120,False,1
557,validator_0,301217576769,True,729979998,27515600,757495598,True,9
558,validator_21,36756641829,True,639800002,9476700,649276702,True,1
559,validator_1,283516207440,True,583800000,9432160,593232160,False,8
560,validator_3,180142618280,True,614000000,9011540,623011540,False,5
561,validator_46,39211667880,True,478700000,20713530,499413530,False,1
562,validator_14,37054644050,True,783864002,30103000,813967002,True,1
563,validator_36,35639205670,True,683200000,2560900,685760900,False,1
564,validator_1,284353702040,True,835100000,2394600,837494600,False,8
565,validator_27,36775429885,True,592400003,10870870,603270873,True,1
566,validator_40,38348415060,True,588400000,5959540,594359540,False,1
567,validator_2,187595420732,True,674700002,27245720,701945722,True,5
568,validator_2,188371872803,True,719599991,56852080,776452071,True,5
569,validator_3,180731703880,True,568100000,20985600,589085600,False,5
570,validator_0,301812176550,True,591300001,3299780,594599781,True,9
571,validator_0,302431305551,True,607576001,11553000,619129001,True,9
572,validator_3,181191676680,True,457300000,2672800,459972800,False,5
573,validator_36,36145558800,True,502300000,4053130,506353130,False,1
574,validator_1,285141157270,True,776200000,11255230,787455230,False,8
575,validator_36,36756021350,True,606100000,4362550,610462550,False,1
576,validator_31,34457538710,True,601300000,3663180,604963180,False,1
577,validator_1,285779845850,True,637200000,1488580,638688580,False,8
578,validator_3,181772195880,True,545600000,34919200,580519200,False,5
579,validator_21,37704367695,True,915424006,32301860,947725866,True,1
580,validator_4,109833969164,True,759300007,3794410,763094417,True,3
581,validator_35,39030385940,True,671900000,3028140,674928140,False,1
582,validator_0,303089261082,True,638700011,19255520,657955531,True,9
583,validator_21,38435667276,True,714980001,16319580,731299581,True,1
584,validator_29,37843844490,True,757400000,6845410,764245410,False,1
585,validator_48,41632503550,True,564740000,1807070,566547070,False,1
586,validator_20,36912804935,True,593380000,41270000,634650000,True,1
587,validator_38,39215984580,True,547100000,12724340,559824340,False,1
588,validator_5,110253253640,True,599000000,12069970,611069970,False,3
589,validator_0,303715722383,True,584340001,42121300,626461301,True,9
590,validator_41,35047466140,True,554700000,1619100,556319100,False,1
591,validator_0,304469905034,True,724780001,29402650,754182651,True,9
592,validator_3,182411465330,True,636400000,2869450,639269450,False,5
593,validator_30,34917863670,True,387500000,2996000,390496000,False,1
594,validator_26,37686296202,True,622877997,24396500,647274497,True,1
595,validator_43,37301471060,True,557700000,10369980,568069980,False,1
596,validator_29,38345415440,True,498400000,3170950,501570950,False,1
597,validator_1,286478356260,True,690300000,8210410,698510410,False,8
598,validator_18,37110619838,True,729850009,2226980,732076989,True,1
599,validator_41,35602042540,True,551500000,3076400,554576400,False,1
600,validator_49,36972430570,True,543700000,2377240,546077240,False,1
601,validator_44,36527965320,True,557800000,20800030,578600030,False,1
602,validator_16,35364731635,True,630898000,42926090,673824090,True,1
603,validator_25,36808159549,True,491840000,29294130,521134130,True,1
604,validator_30,35475520770,True,554500000,3157100,557657100,False,1
605,validator_1,287045644260,True,565400000,1888000,567288000,False,8
606,validator_43,37880776270,True,577100000,2205210,579305210,False,1
607,validator_1,287839080570,True,789700000,3736310,793436310,False,8
608,validator_42,37237322160,True,749100000,8416970,757516970,False,1
609,validator_1,288301547970,True,460500000,1967400,462467400,False,9
610,validator_5,110958757390,True,702500000,3003750,705503750,False,3
611,validator_1,288871388410,True,565400000,4440440,569840440,False,9
612,validator_26,38498795492,True,804200000,8299290,812499290,True,1
613,validator_34,35492943750,True,858800000,8332600,867132600,False,1
614,validator_47,36868210230,True,774300000,1476300,775776300,False,1
615,validator_15,38129711050,True,689800004,21966500,711766504,True,1
616,validator_41,36231842340,True,626100000,3699800,629799800,False,1
617,validator_14,37959859080,True,881754000,23461030,905215030,True,1
618,validator_1,289465906520,True,580400000,14118110,594518110,False,9
619,validator_17,36700357105,True,771400003,61218740,832618743,True,1
620,validator_32,36296186420,True,763100000,22162440,785262440,False,1
621,validator_19,37359260262,True,620500004,30638480,651138484,True,1
622,validator_26,39131483496,True,612200004,20488000,632688004,True,1
623,validator_1,290164782690,True,697700000,1176170,698876170,False,9
624,validator_0,305337226073,True,842459999,24861040,867321039,True,9
625,validator_0,306032837072,True,673519999,22091000,695610999,True,9
626,validator_4,110421317824,True,564900000,22448660,587348660,True,3
627,validator_1,290590150210,True,423300000,2067520,425367520,False,9
628,validator_43,38475962830,True,586700000,8486560,595186560,False,1
629,validator_42,37791968860,True,545700000,8946700,554646700,False,1
630,validator_0,306796112562,True,760200000,3075490,763275490,True,9
631,validator_1,291134267250,True,523100000,21017040,544117040,False,9
632,validator_48,42137289880,True,502500000,2286330,504786330,False,1
633,validator_1,291679484190,True,534430000,10786940,545216940,False,9
634,validator_15,39054367257,True,916099997,8556210,924656207,True,1
635,validator_7,74150817950,True,588100000,9484330,597584330,False,2
636,validator_2,189067454482,True,655019999,40561680,695581679,True,5
637,validator_36,37257520880,True,499900000,1599530,501499530,False,1
638,validator_0,307562965367,True,703840005,63012800,766852805,True,9
639,validator_0,308168099047,True,577640000,27493680,605133680,True,9
640,validator_4,111256438824,True,806400000,28721000,835121000,True,3
641,validator_37,34656625380,True,599600000,28897100,628497100,False,1
642,validator_37,35218051220,True,542200000,19225840,561425840,False,1
643,validator_0,308665095419,True,472000002,24996370,496996372,True,9
644,validator_1,292573915820,True,884000000,10431630,894431630,False,9
645,validator_1,293205286030,True,629100000,2270210,631370210,False,9
646,validator_20,37578306131,True,662899996,2601200,665501196,True,1
647,validator_3,183206447130,True,794000000,981800,794981800,False,5
648,validator_5,111621566590,True,657600000,5209200,662809200,False,3
649,validator_1,293853476200,True,634100000,14090170,648190170,False,9
650,validator_18,37978087252,True,856959994,10507420,867467414,True,1
651,validator_3,183678301960,True,467900000,3954830,471854830,False,5
652,validator_7,74812030130,True,658800000,2412180,661212180,False,2
653,validator_6,81464348658,True,483240001,45216380,528456381,True,2
654,validator_6,82075497716,True,584640008,26509050,611149058,True,2
655,validator_27,37498008469,True,692199994,30378590,722578584,True,1
656,validator_2,189768986583,True,680440001,21092100,701532101,True,5
657,validator_0,309366497117,True,690399998,11001700,701401698,True,9
658,validator_4,111809824109,True,532560005,20825280,553385285,True,3
659,validator_18,38803108015,True,783219993,41800770,825020763,True,1
660,validator_0,309951344045,True,583699998,1146930,584846928,True,9
661,validator_5,112191094990,True,561700000,7828400,569528400,False,3
662,validator_6,82588863736,True,494844000,18522020,513366020,True,2
663,validator_4,112468764000,True,637606001,21333890,658939891,True,3
664,validator_16,36030521409,True,662200004,3589770,665789774,True,1
665,validator_14,38792455802,True,794253992,38342730,832596722,True,1
666,validator_28,37267277334,True,795840003,30814000,826654003,True,1
667,validator_29,38859349100,True,510400000,3533660,513933660,False,1
668,validator_3,184381861960,True,698900000,4660000,703560000,False,5
669,validator_15,39966376099,True,901900002,10108840,912008842,True,1
670,validator_0,310655849849,True,671862004,32643800,704505804,True,9
671,validator_1,294309721370,True,443300000,12945170,456245170,False,9
672,validator_3,185141947960,True,738100000,21986000,760086000,False,5
673,validator_48,42659710580,True,520700000,1720700,522420700,False,1
674,validator_2,190490093276,True,677020003,44086690,721106693,True,5
675,validator_11,39271284554,True,588120002,39101020,627221022,True,1
676,validator_8,36918387388,True,578279992,37968030,616248022,True,1
677,validator_2,191186047877,True,652020001,43934600,695954601,True,5
678,validator_20,38309958492,True,728900001,2752360,731652361,True,1
679,validator_23,35113159547,True,621984004,59571800,681555804,True,1
680,validator_5,112779700620,True,586000000,2605630,588605630,False,3
681,validator_6,83416275319,True,768099993,59311590,827411583,True,2
682,validator_39,34587345460,True,307500000,1931360,309431360,False,1
683,validator_1,294957945340,True,640100000,8123970,648223970,False,9
684,validator_1,295580589040,True,620900000,1743700,622643700,False,9
685,validator_4,113079993246,True,598316006,12913240,611229246,True,3
686,validator_2,191903812764,True,697039997,20724890,717764887,True,5
687,validator_13,37236219034,True,608819992,28566310,637386302,True,1
688,validator_38,39780031110,True,562500000,1546530,564046530,False,1
689,validator_2,192698720146,True,746509992,48397390,794907382,True,6
690,validator_23,35791147046,True,641635999,36351500,677987499,True,1
691,validator_27,38151594000,True,602660001,50925530,653585531,True,1
692,validator_10,39371628898,True,996700001,2825080,999525081,True,1
693,validator_0,311149932525,True,491459996,2622680,494082676,True,9
694,validator_0,311523463324,True,370519999,3010800,373530799,True,9
695,validator_39,35154888440,True,566400000,1142980,567542980,False,1
696,validator_7,75382356630,True,567900000,2426500,570326500,False,2
697,validator_4,113721495275,True,621179999,20322030,641502029,True,3
698,validator_2,193243276604,True,535839998,8716460,544556458,True,6
699,validator_18,39486469512,True,656239997,27121500,683361497,True,1
700,validator_5,113303770920,True,516200000,7870300,524070300,False,3
701,validator_6,84140447522,True,704154003,20018200,724172203,True,2
702,validator_30,36119698430,True,640700000,3477660,644177660,False,1
703,validator_19,38032245783,True,641840001,31145520,672985521,True,1
704,validator_2,193892873807,True,624040003,25557200,649597203,True,6
705,validator_3,186005016780,True,853600000,9468820,863068820,False,5
706,validator_10,39938966675,True,565159997,2177780,567337777,True,1
707,validator_28,38042698838,True,770219994,5201510,775421504,True,1
708,validator_20,38980266091,True,643189999,27117600,670307599,True,1
709,validator_0,312063012619,True,519753995,19795300,539549295,True,9
710,validator_4,114387861683,True,609860008,56506400,666366408,True,3
711,validator_4,114926093660,True,531419997,6811980,538231977,True,3
712,validator_0,312837621358,True,760999999,13608740,774608739,True,9
713,validator_44,37071556230,True,519900000,23690910,543590910,False,1
714,validator_36,38008366810,True,742400000,8445930,750845930,False,1
715,validator_17,37398440244,True,666521999,31561140,698083139,True,1
716,validator_1,296325203040,True,742500000,2114000,744614000,False,9
717,validator_18,40158674037,True,615120005,57084520,672204525,True,1
718,validator_1,296822050880,True,492200000,4647840,496847840,False,9
719,validator_3,186738165170,True,730900000,2248390,733148390,False,5
720,validator_3,187144411470,True,405000000,1246300,406246300,False,5
721,validator_7,75964259370,True,572500000,9402740,581902740,False,2
722,validator_36,38391562410,True,380340000,2855600,383195600,False,1
723,validator_1,297460500650,True,636200000,2249770,638449770,False,9
724,validator_4,115568000567,True,619219997,22686910,641906907,True,3
725,validator_9,37810973396,True,602119999,20586550,622706549,True,1
726,validator_0,313621662759,True,760980001,23061400,784041401,True,9
727,validator_1,297959793070,True,482400000,16892420,499292420,False,9
728,validator_1,298592011200,True,630200000,2018130,632218130,False,9
729,validator_3,187835633090,True,686900000,4321620,691221620,False,5
730,validator_37,35846426560,True,622900000,5475340,628375340,False,1
731,validator_0,314604567956,True,962679997,20225200,982905197,True,9
732,validator_1,299257997400,True,662400000,3586200,665986200,False,9
733,validator_1,299694944580,True,429500000,7447180,436947180,False,9
734,validator_17,38116020937,True,697699993,19880700,717580693,True,1
735,validator_1,300269279710,True,535400000,38935130,574335130,False,9
736,validator_21,39037245523,True,599400007,2178240,601578247,True,1
737,validator_10,40780320404,True,798779999,42573730,841353729,True,1
738,validator_5,113876949020,True,570100000,3078100,573178100,False,3
739,validator_48,43277099450,True,615000000,2388870,617388870,False,1
740,validator_7,76535197260,True,569400000,1537890,570937890,False,2
741,validator_1,300860669210,True,577900000,13489500,591389500,False,9
742,validator_3,188381148520,True,543400000,2115430,545515430,False,5
743,validator_10,41412621065,True,620120001,12180660,632300661,True,1
744,validator_3,189159420920,True,774600000,3672400,778272400,False,5
745,validator_2,194656654008,True,743520001,20260200,763780201,True,6
746,validator_1,301447334470,True,583800000,2865260,586665260,False,9
747,validator_5,114439698150,True,560300000,2449130,562749130,False,3
748,validator_3,189798426350,True,637600000,1405430,639005430,False,5
749,validator_0,315373908895,True,694929999,74410940,769340939,True,9
750,validator_33,37498467080,True,592700000,19388060,612088060,False,1
751,validator_17,39028728835,True,873379998,39327900,912707898,True,1
752,validator_0,315988897578,True,590300003,24688680,614988683,True,9
753,validator_2,195333295815,True,669300007,7341800,676641807,True,6
754,validator_1,301930405970,True,461600000,21471500,483071500,False,9
755,validator_7,77166969560,True,614600000,17172300,631772300,False,2
756,validator_0,316705648682,True,685539994,31211110,716751104,True,9
757,validator_1,302537980370,True,606000000,1574400,607574400,False,9
758,validator_16,36741838801,True,686804002,24513390,711317392,True,1
759,validator_1,303354593900,True,793300000,23313530,816613530,False,9
760,validator_32,36938572630,True,623000000,19386210,642386210,False,1
761,validator_6,84896269065,True,752500003,3321540,755821543,True,2
762,validator_46,39777946220,True,564900000,1378340,566278340,False,1
763,validator_7,77750970220,True,581800000,2200660,584000660,False,2
764,validator_39,35678870340,True,517500000,6481900,523981900,False,1
765,validator_46,40401073650,True,621500000,1627430,623127430,False,1
766,validator_1,304022110000,True,657000000,10516100,667516100,False,9
767,validator_1,304721607800,True,696400000,3097800,699497800,False,9
768,validator_2,196024888408,True,670319993,21272600,691592593,True,6
769,validator_47,37532863410,True,658800000,5853180,664653180,False,1
770,validator_28,38698785524,True,636099996,19986690,656086686,True,1
771,validator_29,39545087670,True,677300000,8438570,685738570,False,1
772,validator_5,115147917350,True,700300000,7919200,708219200,False,3
773,validator_4,116152615743,True,528793996,55821180,584615176,True,3
774,validator_36,39036867510,True,644200000,1105100,645305100,False,1
775,validator_3,190417782550,True,617300000,2056200,619356200,False,5
776,validator_3,190952839110,True,531200000,3856560,535056560,False,5
777,validator_0,317311404479,True,601299997,4455800,605755797,True,9
778,validator_9,38401963558,True,563839992,27150170,590990162,True,1
779,validator_2,196549518288,True,521900000,2729880,524629880,True,6
780,validator_6,85714502228,True,767120003,51113160,818233163,True,2
781,validator_8,37704151867,True,745599999,40164480,785764479,True,1
782,validator_33,38105194120,True,605000000,1727040,606727040,False,1
783,validator_5,115716326900,True,557000000,11409550,568409550,False,3
784,validator_8,38682767166,True,945099999,33515300,978615299,True,1
785,validator_28,39267064727,True,547320003,20959200,568279203,True,1
786,validator_48,43841057330,True,561200000,2757880,563957880,False,1
787,validator_0,318133605154,True,818099995,4100680,822200675,True,9
788,validator_42,38500011400,True,705800000,2242540,708042540,False,1
789,validator_0,319043714960,True,883940006,26169800,910109806,True,9
790,validator_28,39929983017,True,660620000,2298290,662918290,True,1
791,validator_2,197182087611,True,624320003,8249320,632569323,True,6
792,validator_46,41284784850,True,874300000,9411200,883711200,False,1
793,validator_16,37347684173,True,599500002,6345370,605845372,True,1
794,validator_35,39752417950,True,719500000,2532010,722032010,False,1
795,validator_29,40071912270,True,524200000,2624600,526824600,False,1
796,validator_4,117041752343,True,880100000,9036600,889136600,True,3
797,validator_9,39275324960,True,870540002,2821400,873361402,True,1
798,validator_33,38672594110,True,543700000,23699990,567399990,False,1
799,validator_1,305277188400,True,552600000,2980600,555580600,False,9
800,validator_47,37989864350,True,455800000,1200940,457000940,False,1
801,validator_33,39135696850,True,457900000,5202740,463102740,False,1
802,validator_2,197914321505,True,728999994,3233900,732233894,True,6
803,validator_0,319926572322,True,849840002,33017360,882857362,True,9
804,validator_28,40594354914,True,636259997,28111900,664371897,True,1
805,validator_37,36699627760,True,852700000,501200,853201200,False,1
806,validator_0,320568407217,True,610303995,31530900,641834895,True,10
807,validator_2,198436766314,True,499619999,22824810,522444809,True,6
808,validator_0,321247404975,True,635839998,43157760,678997758,True,10
809,validator_40,38925672070,True,567900000,9357010,577257010,False,1
810,validator_49,37561603300,True,584900000,4272730,589172730,False,1
811,validator_12,38197326056,True,788979998,42021200,831001198,True,1
812,validator_1,305833156600,True,553400000,2568200,555968200,False,9
813,validator_0,321798983076,True,523020001,28558100,551578101,True,10
814,validator_0,322557170369,True,730479993,27707300,758187293,True,10
815,validator_22,43553822983,True,834780004,33983700,868763704,True,1
816,validator_30,36647079460,True,524200000,3181030,527381030,False,1
817,validator_5,116431465800,True,712600000,2538900,715138900,False,3
818,validator_4,117913009171,True,852159998,19096830,871256828,True,3
819,validator_2,199155891350,True,688459996,30665040,719125036,True,6
820,validator_10,41950517067,True,496920002,40976000,537896002,True,1
821,validator_3,191572692230,True,612400000,7453120,619853120,False,5
822,validator_2,200347817175,True,1163883995,28041830,1191925825,True,6
823,validator_2,201135073448,True,749800003,37456270,787256273,True,6
824,validator_4,118641019914,True,668948003,59062740,728010743,True,3
825,validator_31,35232487910,True,746600000,28349200,774949200,False,1
826,validator_12,38820764416,True,620500000,2938360,623438360,True,1
827,validator_3,192085833910,True,511900000,1241680,513141680,False,6
828,validator_2,201900823699,True,728320001,37430250,765750251,True,6
829,validator_27,38706962702,True,537040002,18328700,555368702,True,1
830,validator_31,35896668130,True,653300000,10880220,664180220,False,1
831,validator_2,202571041191,True,668499992,1717500,670217492,True,6
832,validator_0,323275101665,True,717399996,531300,717931296,True,10
833,validator_0,323925938091,True,610869996,39966430,650836426,True,10
834,validator_41,36758337230,True,524300000,2194890,526494890,False,1
835,validator_13,38003627232,True,758799998,8608200,767408198,True,1
836,validator_2,203289517685,True,690087994,28388500,718476494,True,6
837,validator_39,36311362950,True,629400000,3092610,632492610,False,1
838,validator_45,37995570260,True,800000000,8159740,808159740,False,1
839,validator_12,39531507959,True,668400003,42343540,710743543,True,1
840,validator_27,39230724088,True,512003996,11757390,523761386,True,1
841,validator_47,38570849480,True,577000000,3985130,580985130,False,1
842,validator_23,36410553901,True,605499995,13906860,619406855,True,1
843,validator_16,38153206038,True,794919995,10601870,805521865,True,1
844,validator_46,41940795110,True,645600000,10410260,656010260,False,1
845,validator_28,41302942805,True,680900001,27687890,708587891,True,1
846,validator_3,192727869670,True,640400000,1635760,642035760,False,6
847,validator_20,39632745329,True,631419998,21059240,652479238,True,1
848,validator_29,40564381370,True,491600000,869100,492469100,False,1
849,validator_43,39203948710,True,724300000,3685880,727985880,False,1
850,validator_22,44135757806,True,539720003,42214820,581934823,True,1
851,validator_0,324619036691,True,669100000,23998600,693098600,True,10
852,validator_2,203943640516,True,629500001,24622830,654122831,True,6
853,validator_1,306421485150,True,580600000,7728550,588328550,False,9
854,validator_19,38714192812,True,643599999,38347030,681947029,True,1
855,validator_28,41862880698,True,534379993,25557900,559937893,True,1
856,validator_3,193203216290,True,473500000,1846620,475346620,False,6
857,validator_0,325084603547,True,427628006,37938850,465566856,True,10
858,validator_17,39836106762,True,805699997,1677930,807377927,True,1
859,validator_2,204762304189,True,807900003,10763670,818663673,True,6
860,validator_42,39009636320,True,504210000,5414920,509624920,False,1
861,validator_0,325828134129,True,717284002,26246580,743530582,True,10
862,validator_0,326429329094,True,565475995,35718970,601194965,True,10
863,validator_37,37337861330,True,634900000,3333570,638233570,False,1
864,validator_33,39818150850,True,662300000,20154000,682454000,False,1
865,validator_23,37041746311,True,585624000,45568410,631192410,True,1
866,validator_14,39485295146,True,662120004,30719340,692839344,True,1
867,validator_49,38306701210,True,725800000,19297910,745097910,False,1
868,validator_42,39646391880,True,634200000,2555560,636755560,False,1
869,validator_6,86487995429,True,757196001,16297200,773493201,True,2
870,validator_0,327083769023,True,617200009,37239920,654439929,True,10
871,validator_46,42436301740,True,493000000,2506630,495506630,False,1
872,validator_30,37433414860,True,779500000,6835400,786335400,False,1
873,validator_35,40318450280,True,564100000,1932330,566032330,False,1
874,validator_5,116977425900,True,522300000,23660100,545960100,False,3
875,validator_45,38685709200,True,684900000,5238940,690138940,False,1
876,validator_2,205389117551,True,616600002,10213360,626813362,True,6
877,validator_29,41364501170,True,768700000,31419800,800119800,False,1
878,validator_47,39189490120,True,615500000,3140640,618640640,False,1
879,validator_6,87258245033,True,741340004,28909600,770249604,True,2
880,validator_0,327709207992,True,587359999,38078970,625438969,True,10
881,validator_3,193807610690,True,595600000,8794400,604394400,False,6
882,validator_7,78422723830,True,668500000,3253610,671753610,False,2
883,validator_35,40826937710,True,501800000,6687430,508487430,False,1
884,validator_1,307153262930,True,730400000,1377780,731777780,False,9
885,validator_19,39422483633,True,666560001,41730820,708290821,True,1
886,validator_2,206341198900,True,886133999,65947350,952081349,True,6
887,validator_13,38760218727,True,735199995,21391500,756591495,True,1
888,validator_40,39501062620,True,573700000,1690550,575390550,False,1
889,validator_22,44764239208,True,608440002,20041400,628481402,True,1
890,validator_1,307680279420,True,505000000,22016490,527016490,False,9
891,validator_7,78992829920,True,568100000,2006090,570106090,False,2
892,validator_2,207097916402,True,721380002,35337500,756717502,True,6
893,validator_28,42415479299,True,550200001,2398600,552598601,True,1
894,validator_0,328417767489,True,707099997,1459500,708559497,True,10
895,validator_2,207837948001,True,734199999,5831600,740031599,True,6
896,validator_3,194526783720,True,710100000,9073030,719173030,False,6
897,validator_42,40305252790,True,649800000,9060910,658860910,False,1
898,validator_20,40358271736,True,704540007,20986400,725526407,True,1
899,validator_22,45327550587,True,542479999,20831380,563311379,True,1
900,validator_33,40346914710,True,518400000,10363860,528763860,False,1
901,validator_9,39732484388,True,437579998,19579430,457159428,True,1
902,validator_42,40859908770,True,547100000,7555980,554655980,False,1
903,validator_11,40119145269,True,812332005,35528710,847860715,True,1
904,validator_35,41548458070,True,693700000,27820360,721520360,False,1
905,validator_0,329215968796,True,781714007,16487300,798201307,True,10
906,validator_38,40511948310,True,721400000,10517200,731917200,False,1
907,validator_5,117768436140,True,769600000,21410240,791010240,False,3
908,validator_18,40906350332,True,672679995,74996300,747676295,True,1
909,validator_6,87848391328,True,572939995,17206300,590146295,True,2
910,validator_13,39338141576,True,572900009,5022840,577922849,True,1
911,validator_5,118485888450,True,713400000,4052310,717452310,False,3
912,validator_19,40051485971,True,608157998,20844340,629002338,True,1
913,validator_17,40664495993,True,793140001,35249230,828389231,True,1
914,validator_0,330059451999,True,809746003,33737200,843483203,True,10
915,validator_1,308262420570,True,577900000,4241150,582141150,False,9
916,validator_48,44473996130,True,611400000,21538800,632938800,False,1
917,validator_16,38887252627,True,723357999,10688590,734046589,True,1
918,validator_7,79552066010,True,556600000,2636090,559236090,False,2
919,validator_35,42122081330,True,554380000,19243260,573623260,False,1
920,validator_1,308933559410,True,659800000,11338840,671138840,False,9
921,validator_0,330891572221,True,831300002,820220,832120222,True,10
922,validator_46,42952990270,True,514900000,1788530,516688530,False,1
923,validator_33,41017372250,True,667700000,2757540,670457540,False,1
924,validator_31,36419313660,True,505000000,17645530,522645530,False,1
925,validator_2,208582820699,True,735599998,9272700,744872698,True,6
926,validator_1,309624785040,True,662100000,29125630,691225630,False,9
927,validator_1,310283756170,True,656900000,2071130,658971130,False,9
928,validator_40,40255162040,True,746900000,7199420,754099420,False,1
929,validator_20,40999907729,True,621059993,20576000,641635993,True,1
930,validator_4,119461544776,True,804239992,16284870,820524862,True,3
931,validator_0,331647008921,True,745440000,9996700,755436700,True,10
932,validator_22,46097156481,True,726239994,43365900,769605894,True,1
933,validator_33,41698509750,True,680700000,437500,681137500,False,1
934,validator_17,41342246036,True,642960003,34790040,677750043,True,1
935,validator_0,332371090016,True,702839995,21241100,724081095,True,10
936,validator_0,333088805897,True,706300001,11415880,717715881,True,10
937,validator_32,37576153190,True,634200000,3380560,637580560,False,1
938,validator_44,37948534930,True,868600000,8378700,876978700,False,1
939,validator_48,45155866430,True,679900000,1970300,681870300,False,1
940,validator_23,38022490450,True,950939999,29804140,980744139,True,1
941,validator_47,39901414240,True,708300000,3624120,711924120,False,1
942,validator_20,41818939428,True,804699999,14331700,819031699,True,1
943,validator_23,38754255656,True,721000006,10765200,731765206,True,1
944,validator_0,333733131177,True,643500000,825280,644325280,True,10
945,validator_36,39635675480,True,572600000,26207970,598807970,False,1
946,validator_35,42729162530,True,583000000,24081200,607081200,False,1
947,validator_2,209486912225,True,881439996,22651530,904091526,True,6
948,validator_27,39817316217,True,563239999,23352130,586592129,True,1
949,validator_5,119120684580,True,624600000,10196130,634796130,False,3
950,validator_35,43150369430,True,419600000,1606900,421206900,False,1
951,validator_7,80068906640,True,507000000,9840630,516840630,False,2
952,validator_35,43792027400,True,639700000,1957970,641657970,False,1
953,validator_21,39663783551,True,580879998,45658030,626538028,True,1
954,validator_5,119664131380,True,540700000,2746800,543446800,False,3
955,validator_1,310855593630,True,569400000,2437460,571837460,False,9
956,validator_13,40070811104,True,712019998,20649530,732669528,True,1
957,validator_7,80788324060,True,686700000,32717420,719417420,False,2
958,validator_23,39410488431,True,636739995,19492780,656232775,True,1
959,validator_33,42401096060,True,700100000,2486310,702586310,False,1
960,validator_1,311373593670,True,491800000,26200040,518000040,False,9
961,validator_3,195040027480,True,510900000,2343760,513243760,False,6
962,validator_20,42645819584,True,799079996,27800160,826880156,True,1
963,validator_21,40557986459,True,845979998,48222910,894202908,True,1
964,validator_44,38504019920,True,554400000,1084990,555484990,False,1
965,validator_31,36978161960,True,539200000,19648300,558848300,False,1
966,validator_1,311946829490,True,571300000,1935820,573235820,False,9
967,validator_37,37863124310,True,523500000,1762980,525262980,False,1
968,validator_1,312444550790,True,495500000,2221300,497721300,False,9
969,validator_16,39473812432,True,584200005,2359800,586559805,True,1
970,validator_3,195636442280,True,593400000,3014800,596414800,False,6
971,validator_48,45805220520,True,628200000,21154090,649354090,False,1
972,validator_7,81420263380,True,610900000,21039320,631939320,False,2
973,validator_37,38324807810,True,458100000,3583500,461683500,False,1
974,validator_4,119932321449,True,462419993,8356680,470776673,True,3
975,validator_3,196283123080,True,640100000,6580800,646680800,False,6
976,validator_0,334381133009,True,620720002,27281830,648001832,True,10
977,validator_30,38043972360,True,601200000,9357500,610557500,False,1
978,validator_11,40694942617,True,559840008,15957340,575797348,True,1
979,validator_0,334940392944,True,558099995,1159940,559259935,True,10
980,validator_0,335603380067,True,642519993,20467130,662987123,True,10
981,validator_3,196795759780,True,471800000,40836700,512636700,False,6
982,validator_0,336310919166,True,694159999,13379100,707539099,True,10
983,validator_45,39301802000,True,613700000,2392800,616092800,False,1
984,validator_29,41984966770,True,618800000,1665600,620465600,False,1
985,validator_6,88556788114,True,700799996,7596790,708396786,True,2
986,validator_44,39376046320,True,834000000,38026400,872026400,False,1
987,validator_0,336838085745,True,506419999,20746580,527166579,True,10
988,validator_9,40459528097,True,708085999,18957710,727043709,True,1
989,validator_24,38304013407,True,732799997,25073940,757873937,True,1
990,validator_44,40072749020,True,676700000,20002700,696702700,False,1
991,validator_13,40691594770,True,617399996,3383670,620783666,True,1
992,validator_45,39979146630,True,669300000,8044630,677344630,False,1
993,validator_4,120534447851,True,596620002,5506400,602126402,True,3
994,validator_1,313129310970,True,677000000,7760180,684760180,False,9
995,validator_24,38946660532,True,634099995,8547130,642647125,True,1
996,validator_18,41466936867,True,541100005,19486530,560586535,True,1
997,validator_19,40583369228,True,518043997,13839260,531883257,True,1
998,validator_2,210272241731,True,768200006,17129500,785329506,True,6
999,validator_21,41122331328,True,523859999,40484870,564344869,True,1
1000,validator_1,313773159710,True,642600000,1248740,643848740,False,9
1001,validator_1,314276721310,True,500110000,3451600,503561600,False,9
1002,validator_0,337438828348,True,597100003,3642600,600742603,True,10
1003,validator_2,211063305108,True,781959997,9103380,791063377,True,6
1004,validator_22,46707873709,True,602399998,8317230,610717228,True,1
1005,validator_4,121038567846,True,493999995,10120000,504119995,True,3
1006,validator_2,211790991506,True,724819998,2866400,727686398,True,6
1007,validator_41,37303952730,True,543600000,2015500,545615500,False,1
1008,validator_47,40522807070,True,612300000,9092830,621392830,False,1
1009,validator_6,89162129696,True,595820002,9521580,605341582,True,2
1010,validator_3,197222967380,True,423810000,3397600,427207600,False,6
1011,validator_18,42040939756,True,552959999,21042890,574002889,True,1
1012,validator_1,314927681310,True,623800000,27160000,650960000,False,9
1013,validator_0,338066856651,True,601520003,26508300,628028303,True,10
1014,validator_15,40785262471,True,763236002,55650370,818886372,True,1
1015,validator_0,339021024279,True,915259998,38907630,954167628,True,10
1016,validator_3,197846241330,True,596600000,26673950,623273950,False,6
1017,validator_31,37559450660,True,578800000,2488700,581288700,False,1
1018,validator_3,198582366020,True,726200000,9924690,736124690,False,6
1019,validator_1,315685741210,True,755600000,2459900,758059900,False,9
1020,validator_26,39591306553,True,425993997,33829060,459823057,True,1
1021,validator_26,40310176565,True,700259992,18610020,718870012,True,1
1022,validator_1,316216163840,True,511100000,19322630,530422630,False,9
1023,validator_17,42035810178,True,654340002,39224140,693564142,True,1
1024,validator_46,43385759520,True,424400000,8369250,432769250,False,1
1025,validator_32,38148276100,True,565000000,7122910,572122910,False,1
1026,validator_0,339589816585,True,527920006,40872300,568792306,True,10
1027,validator_23,39990930733,True,567900002,12542300,580442302,True,1
1028,validator_32,38753442980,True,592200000,12966880,605166880,False,1
1029,validator_0,340337965930,True,742400005,5749340,748149345,True,10
1030,validator_48,46558665020,True,750200000,3244500,753444500,False,1
1031,validator_1,316833176900,True,614100000,2913060,617013060,False,9
1032,validator_1,317564162790,True,712600000,18385890,730985890,False,9
1033,validator_7,82109898530,True,686300000,3335150,689635150,False,2
1034,validator_32,39403604150,True,629600000,20561170,650161170,False,1
1035,validator_0,341102065142,True,760700002,3399210,764099212,True,10
1036,validator_0,341869676944,True,741400002,26211800,767611802,True,10
1037,validator_9,41219185103,True,739159996,20497010,759657006,True,1
1038,validator_37,38886455250,True,541600000,20047440,561647440,False,1
1039,validator_2,212449009786,True,633399990,24618290,658018280,True,6
1040,validator_10,42824051424,True,836380007,37154350,873534357,True,1
1041,validator_0,342535202677,True,657420003,8105730,665525733,True,10
1042,validator_0,343025027212,True,448880005,40944530,489824535,True,10
1043,validator_0,343608588700,True,576260008,7301480,583561488,True,10
1044,validator_44,40840642590,True,766300000,1593570,767893570,False,1
1045,validator_18,42634352456,True,589600000,3812700,593412700,True,1
1046,validator_34,36165476730,True,670300000,2232980,672532980,False,1
1047,validator_44,41456543850,True,613800000,2101260,615901260,False,1
1048,validator_2,213252732282,True,782399996,21322500,803722496,True,6
1049,validator_18,43276681155,True,598179999,44148700,642328699,True,1
1050,validator_16,40148192799,True,655199997,19180370,674380367,True,1
1051,validator_1,318172544280,True,604400000,3981490,608381490,False,9
1052,validator_44,41925912330,True,467600000,1768480,469368480,False,1
1053,validator_42,41352989210,True,490470000,2610440,493080440,False,1
1054,validator_5,120165413970,True,496900000,4382590,501282590,False,3
1055,validator_16,40675107121,True,516600002,10314320,526914322,True,1
1056,validator_2,213948145704,True,670539992,24873430,695413422,True,6
1057,validator_5,120808110580,True,632200000,10496610,642696610,False,3
1058,validator_1,318736553550,True,560400000,3609270,564009270,False,9
1059,validator_4,121747431941,True,706599995,2264100,708864095,True,3
1060,validator_47,41233369710,True,686000000,24562640,710562640,False,1
1061,validator_33,43083518120,True,673300000,9122060,682422060,False,1
1062,validator_46,43922911820,True,531600000,5552300,537152300,False,1
1063,validator_1,319288116690,True,548900000,2663140,551563140,False,9
1064,validator_1,320021604000,True,727700000,5787310,733487310,False,10
1065,validator_10,43319914064,True,492800000,3062640,495862640,True,1
1066,validator_47,41837414640,True,601200000,2844930,604044930,False,1
1067,validator_0,343990684103,True,377300003,4795400,382095403,True,10
1068,validator_38,41179013040,True,664900000,2164730,667064730,False,1
1069,validator_18,43974023246,True,672678001,24664090,697342091,True,1
1070,validator_7,82734314280,True,622800000,1615750,624415750,False,2
1071,validator_18,44717696442,True,725119996,18553200,743673196,True,1
1072,validator_33,43750714860,True,662600000,4596740,667196740,False,1
1073,validator_7,83381748410,True,645300000,2134130,647434130,False,2
1074,validator_7,83853739740,True,451500000,20491330,471991330,False,2
1075,validator_7,84380309000,True,523200000,3369260,526569260,False,2
1076,validator_46,44544594060,True,617300000,4382240,621682240,False,1
1077,validator_15,41364299941,True,551700000,27337470,579037470,True,1
1078,validator_0,344539559104,True,521040001,27835000,548875001,True,10
1079,validator_18,45308376983,True,589000001,1680540,590680541,True,1
1080,validator_1,320598154800,True,573100000,3450800,576550800,False,10
1081,validator_0,345273165493,True,724440009,9166380,733606389,True,10
1082,validator_9,41622205943,True,377900000,25120840,403020840,True,1
1083,validator_38,41793663720,True,612000000,2650680,614650680,False,1
1084,validator_7,84969521940,True,586000000,3212940,589212940,False,2
1085,validator_27,40643540613,True,804699996,21524400,826224396,True,1
1086,validator_2,214667004001,True,693599997,25258300,718858297,True,6
1087,validator_36,40195175380,True,557300000,2199900,559499900,False,1
1088,validator_23,40732155047,True,733440004,7784310,741224314,True,1
1089,validator_1,321259801720,True,657600000,4046920,661646920,False,10
1090,validator_9,42384924466,True,755800003,6918520,762718523,True,1
1091,validator_1,321976426620,True,713600000,3024900,716624900,False,10
1092,validator_39,36834873480,True,514500000,9010530,523510530,False,1
1093,validator_27,41191025809,True,505845996,41639200,547485196,True,1
1094,validator_32,40189152430,True,783300000,2248280,785548280,False,1
1095,validator_20,43488622951,True,789760007,53043360,842803367,True,1
1096,validator_1,322596710620,True,601200000,19084000,620284000,False,10
1097,validator_3,199309616120,True,706100000,21150100,727250100,False,6
1098,validator_7,85514654440,True,535700000,9432500,545132500,False,2
1099,validator_46,45270880160,True,725400000,886100,726286100,False,1
1100,validator_2,215177057036,True,486960005,23093030,510053035,True,6
1101,validator_45,40519068070,True,537000000,2921440,539921440,False,1
1102,validator_35,44263944900,True,467900000,4017500,471917500,False,1
1103,validator_5,121291882180,True,481100000,2671600,483771600,False,3
1104,validator_0,346014520613,True,714160000,27195120,741355120,True,10
1105,validator_43,39609478630,True,398380000,7149920,405529920,False,1
1106,validator_1,323209035140,True,610000000,2324520,612324520,False,10
1107,validator_33,44443360890,True,688700000,3946030,692646030,False,1
1108,validator_0,346589041605,True,553999992,20521000,574520992,True,10
1109,validator_7,86319453200,True,802900000,1898760,804798760,False,2
1110,validator_13,41367288709,True,671599999,4093940,675693939,True,1
1111,validator_7,86906883340,True,577500000,9930140,587430140,False,2
1112,validator_3,200060599800,True,741500000,9483680,750983680,False,6
1113,validator_2,216097422117,True,902760001,17605080,920365081,True,6
1114,validator_45,41098726620,True,576400000,3258550,579658550,False,1
1115,validator_2,216834351515,True,727979998,8949400,736929398,True,6
1116,validator_9,42995086063,True,595539997,14621600,610161597,True,1
1117,validator_18,46105079481,True,786393998,10308500,796702498,True,1
1118,validator_27,41745645304,True,552299995,2319500,554619495,True,1
1119,validator_7,87624046280,True,701400000,15762940,717162940,False,2
1120,validator_39,37563218950,True,707600000,20745470,728345470,False,1
1121,validator_1,323778045150,True,561500000,7510010,569010010,False,10
1122,validator_18,46917696283,True,778520002,34096800,812616802,True,1
1123,validator_0,347360752209,True,745540004,26170600,771710604,True,10
1124,validator_24,39507751837,True,558600005,2491300,561091305,True,1
1125,validator_28,43052526605,True,610900006,26147300,637047306,True,1
1126,validator_7,88298546030,True,655700000,18799750,674499750,False,2
1127,validator_3,200750745120,True,689100000,1045320,690145320,False,6
1128,validator_23,41388322393,True,631994006,24173340,656167346,True,1
1129,validator_0,348201590406,True,829239997,11598200,840838197,True,10
1130,validator_3,201296955620,True,543300000,2910500,546210500,False,6
1131,validator_17,42693514350,True,629059992,28644180,657704172,True,1
1132,validator_0,348745376503,True,520119997,23666100,543786097,True,10
1133,validator_44,42549201370,True,619300000,3989040,623289040,False,1
1134,validator_25,37489931315,True,636606006,45165760,681771766,True,1
1135,validator_25,38197555015,True,686300000,21323700,707623700,True,1
1136,validator_1,324546981450,True,765900000,3036300,768936300,False,10
1137,validator_12,40111853557,True,551979998,28365600,580345598,True,1
1138,validator_36,40764958120,True,565900000,3882740,569782740,False,1
1139,validator_3,201815600850,True,515300000,3345230,518645230,False,6
1140,validator_5,121979422310,True,677900000,9640130,687540130,False,3
1141,validator_33,45163833450,True,713000000,7472560,720472560,False,1
1142,validator_25,38807249987,True,599040002,10654970,609694972,True,1
1143,validator_36,41379614320,True,611100000,3556200,614656200,False,1
1144,validator_43,40090177330,True,471300000,9398700,480698700,False,1
1145,validator_3,202519299250,True,697400000,6298400,703698400,False,6
1146,validator_42,42275378710,True,918500000,3889500,922389500,False,1
1147,validator_6,89784044398,True,613400002,8514700,621914702,True,2
1148,validator_43,40731314750,True,612800000,28337420,641137420,False,1
1149,validator_21,41643788353,True,501920005,19537020,521457025,True,1
1150,validator_22,47563641690,True,827720001,28047980,855767981,True,1
1151,validator_3,203329998000,True,808800000,1898750,810698750,False,6
1152,validator_35,44820108890,True,544500000,11663990,556163990,False,1
1153,validator_0,349489251912,True,741199999,2675410,743875409,True,10
1154,validator_48,47152694840,True,592700000,1329820,594029820,False,1
1155,validator_4,122297254644,True,519060003,30762700,549822703,True,3
1156,validator_7,88906417420,True,605200000,2671390,607871390,False,2
1157,validator_44,43181394700,True,629300000,2893330,632193330,False,1
1158,validator_1,325105053290,True,541500000,16571840,558071840,False,10
1159,validator_22,48188961361,True,598916001,26403670,625319671,True,1
1160,validator_46,45748063000,True,475900000,1282840,477182840,False,1
1161,validator_15,41930846144,True,501780003,64766200,566546203,True,1
1162,validator_2,217600050634,True,756099999,9599120,765699119,True,6
1163,validator_0,350175676511,True,625767999,60656600,686424599,True,10
1164,validator_2,218454425642,True,843279998,11095010,854375008,True,6
1165,validator_6,90271181526,True,466699998,20437130,487137128,True,2
1166,validator_3,203985871500,True,652500000,3373500,655873500,False,6
1167,validator_35,45370959130,True,529200000,21650240,550850240,False,1
1168,validator_1,325733072150,True,625400000,2618860,628018860,False,10
1169,validator_4,123117422527,True,794654003,25513880,820167883,True,3
1170,validator_6,91150838037,True,828882001,50774510,879656511,True,2
1171,validator_12,40671883335,True,549239998,10789780,560029778,True,1
1172,validator_37,39529298780,True,638600000,4243530,642843530,False,1
1173,validator_2,219206246953,True,745240001,6581310,751821311,True,6
1174,validator_6,91879611676,True,711159999,17613640,728773639,True,2
1175,validator_1,326250499350,True,516200000,1227200,517427200,False,10
1176,validator_26,41109040565,True,790820000,8044000,798864000,True,1
1177,validator_45,41770432120,True,670200000,1505500,671705500,False,1
1178,validator_4,123783908664,True,644039997,22446140,666486137,True,3
1179,validator_42,43108274650,True,826500000,6395940,832895940,False,1
1180,validator_4,124192347160,True,393199996,15238500,408438496,True,3
1181,validator_3,204569590940,True,572700000,11019440,583719440,False,6
1182,validator_2,219899609958,True,675094005,18269000,693363005,True,6
1183,validator_3,205041676740,True,471200000,885800,472085800,False,6
1184,validator_1,326670561840,True,410200000,9862490,420062490,False,10
1185,validator_1,327281605800,True,609700000,1343960,611043960,False,10
1186,validator_33,45723569570,True,557800000,1936120,559736120,False,1
1187,validator_39,38058039220,True,492700000,2120270,494820270,False,1
1188,validator_1,327943797400,True,644600000,17591600,662191600,False,10
1189,validator_3,205533465400,True,466440000,25348660,491788660,False,6
1190,validator_41,37884984900,True,562200000,18832170,581032170,False,1
1191,validator_0,350959388812,True,756040001,27672300,783712301,True,10
1192,validator_49,38879600210,True,570200000,2699000,572899000,False,1
1193,validator_44,43663700710,True,480200000,2106010,482306010,False,1
1194,validator_48,47700097290,True,527100000,20302450,547402450,False,1
1195,validator_28,43776060778,True,685740003,37794170,723534173,True,1
1196,validator_21,42608724442,True,890799999,74136090,964936089,True,1
1197,validator_5,122652785630,True,671700000,1663320,673363320,False,3
1198,validator_4,124995629161,True,771620001,31662000,803282001,True,3
1199,validator_9,43708653388,True,688959995,24607330,713567325,True,1
1200,validator_34,36748421390,True,579700000,3244660,582944660,False,1
1201,validator_8,39230988370,True,539000004,9221200,548221204,True,1
1202,validator_1,328630607820,True,684700000,2110420,686810420,False,10
1203,validator_1,329006542780,True,372600000,3334960,375934960,False,10
1204,validator_34,37356915780,True,606900000,1594390,608494390,False,1
1205,validator_39,38569622500,True,509100000,2483280,511583280,False,1
1206,validator_26,41927142566,True,813360001,4742000,818102001,True,1
1207,validator_5,123153603260,True,492700000,8117630,500817630,False,3
1208,validator_18,47776630305,True,851353992,7580030,858934022,True,1
1209,validator_2,220670320856,True,767759998,2950900,770710898,True,6
1210,validator_2,221456447762,True,766939996,19186910,786126906,True,6
1211,validator_8,39696272789,True,432459999,32824420,465284419,True,1
1212,validator_1,329623401500,True,608500000,8358720,616858720,False,10
1213,validator_38,42347151820,True,551500000,1988100,553488100,False,1
1214,validator_4,125581998227,True,559100006,27269060,586369066,True,3
1215,validator_0,351867850831,True,892699999,15762020,908462019,True,10
1216,validator_3,206176118760,True,615300000,27353360,642653360,False,6
1217,validator_5,123627593930,True,467000000,6990670,473990670,False,3
1218,validator_39,39068345940,True,470000000,28723440,498723440,False,1
1219,validator_15,42612739171,True,658459997,23433030,681893027,True,1
1220,validator_0,352565298855,True,691740004,5708020,697448024,True,11
1221,validator_21,43112111644,True,453520002,49867200,503387202,True,1
1222,validator_4,126250755774,True,651920007,16837540,668757547,True,3
1223,validator_0,353088386835,True,516180000,6907980,523087980,True,11
1224,validator_2,221960338544,True,483720002,20170780,503890782,True,6
1225,validator_0,353718759235,True,626800000,3572400,630372400,True,11
1226,validator_25,39397096113,True,554025996,35820130,589846126,True,1
1227,validator_2,222604311474,True,641600000,2372930,643972930,True,6
1228,validator_1,330346993600,True,716900000,6692100,723592100,False,10
1229,validator_7,89459956430,True,551800000,1739010,553539010,False,2
1230,validator_0,354375315951,True,620079996,36476720,656556716,True,11
1231,validator_10,43746411703,True,420199999,6297640,426497639,True,1
1232,validator_9,44280339467,True,569599999,2086080,571686079,True,1
1233,validator_2,223136349374,True,527220000,4817900,532037900,True,6
1234,validator_23,42101649494,True,705160001,8167100,713327101,True,1
1235,validator_5,124246219910,True,609400000,9225980,618625980,False,3
1236,validator_39,39698654370,True,620700000,9608430,630308430,False,1
1237,validator_5,124913242050,True,657500000,9522140,667022140,False,3
1238,validator_3,206899790670,True,704900000,18771910,723671910,False,6
1239,validator_9,45151210099,True,857800002,13070630,870870632,True,1
1240,validator_0,355150838592,True,771700001,3822640,775522641,True,11
1241,validator_7,90087384520,True,623400000,4028090,627428090,False,2
1242,validator_31,37925893960,True,345600000,20843300,366443300,False,1
1243,validator_1,330949458500,True,599400000,3064900,602464900,False,10
1244,validator_7,90947747160,True,857700000,2662640,860362640,False,2
1245,validator_9,45840044701,True,664300002,24534600,688834602,True,1
1246,validator_1,331528722200,True,576300000,2963700,579263700,False,10
1247,validator_3,207531373840,True,629700000,1883170,631583170,False,6
1248,validator_3,208012471960,True,442700000,38398120,481098120,False,6
1249,validator_22,49059524897,True,859940006,10623530,870563536,True,1
1250,validator_1,332225813210,True,696400000,691010,697091010,False,10
1251,validator_7,91439905170,True,471600000,20558010,492158010,False,2
1252,validator_0,355897599799,True,723039997,23721210,746761207,True,11
1253,validator_17,43412714094,True,681060004,38139740,719199744,True,1
1254,validator_37,40037531040,True,487800000,20432260,508232260,False,1
1255,validator_1,332903842000,True,674500000,3528790,678028790,False,10
1256,validator_44,44204320300,True,537900000,2719590,540619590,False,1
1257,validator_1,333447833600,True,532000000,11991600,543991600,False,10
1258,validator_19,41229035234,True,582230006,63436000,645666006,True,1
1259,validator_0,356549620439,True,642400000,9620640,652020640,True,11
1260,validator_5,125405994990,True,474600000,18152940,492752940,False,3
1261,validator_41,38599861540,True,693300000,21576640,714876640,False,1
1262,validator_1,333856520300,True,405300000,3386700,408686700,False,10
1263,validator_18,48677245047,True,844900002,55714740,900614742,True,1
1264,validator_2,224078296901,True,923400007,18547520,941947527,True,7
1265,validator_1,334415933550,True,557300000,2113250,559413250,False,10
1266,validator_45,42285650720,True,512500000,2718600,515218600,False,1
1267,validator_15,43261607258,True,628340007,20528080,648868087,True,1
1268,validator_32,40630050160,True,420500000,20397730,440897730,False,1
1269,validator_22,49516954557,True,433820000,23609660,457429660,True,1
1270,validator_0,357259759715,True,701839996,8299280,710139276,True,11
1271,validator_20,44154887582,True,643339991,22924640,666264631,True,1
1272,validator_12,41398963408,True,677400003,49680070,727080073,True,1
1273,validator_6,92498089982,True,597939996,20538310,618478306,True,2
1274,validator_32,41111617600,True,479700000,1867440,481567440,False,1
1275,validator_41,39146461440,True,541000000,5599900,546599900,False,1
1276,validator_26,42776359064,True,830439998,18776500,849216498,True,1
1277,validator_16,41264063860,True,583979999,4976740,588956739,True,1
1278,validator_2,224784314619,True,675139998,30877720,706017718,True,7
1279,validator_4,126704179120,True,443400006,10023340,453423346,True,3
1280,validator_49,39609207630,True,727300000,2307420,729607420,False,1
1281,validator_20,44834624600,True,663359998,16377020,679737018,True,1
1282,validator_43,41343163700,True,610400000,1448950,611848950,False,1
1283,validator_42,43834067490,True,721500000,4292840,725792840,False,1
1284,validator_1,335038194170,True,620600000,1660620,622260620,False,10
1285,validator_0,358163408014,True,869179999,34468300,903648299,True,11
1286,validator_3,208456877100,True,426300000,18105140,444405140,False,6
1287,validator_34,37883632810,True,519100000,7617030,526717030,False,1
1288,validator_2,225574466633,True,741740004,48412010,790152014,True,7
1289,validator_15,43926518893,True,637419995,27491640,664911635,True,1
1290,validator_1,335583190040,True,543100000,1895870,544995870,False,10
1291,validator_45,42789968420,True,497900000,6417700,504317700,False,1
1292,validator_18,49564073693,True,866040006,20788640,886828646,True,1
1293,validator_2,226597367284,True,993799991,29100660,1022900651,True,7
1294,validator_44,44869952960,True,652400000,13232660,665632660,False,1
1295,validator_16,42133854859,True,838759999,31031000,869790999,True,1
1296,validator_5,125939731790,True,531940000,1796800,533736800,False,3
1297,validator_34,38557279780,True,669500000,4146970,673646970,False,1
1298,validator_2,227457902570,True,850899996,9635290,860535286,True,7
1299,validator_6,93485385574,True,979040002,8255590,987295592,True,2
1300,validator_3,209089623880,True,630200000,2546780,632746780,False,6
1301,validator_2,228015906235,True,516507995,41495670,558003665,True,7
1302,validator_12,42031395715,True,602394007,30038300,632432307,True,1
1303,validator_5,126575819690,True,623100000,12987900,636087900,False,3
1304,validator_4,127556343167,True,835059997,17104050,852164047,True,3
1305,validator_5,127145440920,True,567800000,1821230,569621230,False,3
1306,validator_3,209595798980,True,503600000,2575100,506175100,False,6
1307,validator_22,50185231454,True,658159997,10116900,668276897,True,1
1308,validator_1,336087289220,True,498500000,5599180,504099180,False,10
1309,validator_3,210359468870,True,750200000,13469890,763669890,False,6
1310,validator_1,336725126340,True,636700000,1137120,637837120,False,10
1311,validator_17,44192632093,True,772399999,7518000,779917999,True,1
1312,validator_22,51014764876,True,820300002,9233420,829533422,True,1
1313,validator_47,42396388840,True,556600000,2374200,558974200,False,1
1314,validator_9,46782357141,True,922780000,19532440,942312440,True,1
1315,validator_42,44446033500,True,596500000,15466010,611966010,False,1
1316,validator_3,210871970570,True,510000000,2501700,512501700,False,6
1317,validator_4,128232480567,True,651280000,24857400,676137400,True,4
1318,validator_42,45144642500,True,696700000,1909000,698609000,False,1
1319,validator_2,228757375309,True,728699994,12769080,741469074,True,7
1320,validator_46,46407131880,True,639900000,19168880,659068880,False,1
1321,validator_37,40656133220,True,611500000,7102180,618602180,False,1
1322,validator_4,128999307621,True,751799994,15027060,766827054,True,4
1323,validator_40,40783931530,True,525800000,2969490,528769490,False,1
1324,validator_45,43209410790,True,412500000,6942370,419442370,False,1
1325,validator_0,359203497708,True,1011220004,28869690,1040089694,True,11
1326,validator_45,43938413990,True,709800000,19203200,729003200,False,1
1327,validator_5,127916872180,True,752400000,19031260,771431260,False,3
1328,validator_34,39209409920,True,648100000,4030140,652130140,False,1
1329,validator_28,44731967903,True,929459995,26447130,955907125,True,1
1330,validator_8,40189140624,True,476519995,16347840,492867835,True,1
1331,validator_0,360213298182,True,988740004,21060470,1009800474,True,11
1332,validator_6,94188569931,True,695799997,7384360,703184357,True,2
1333,validator_6,95067141428,True,870999997,7571500,878571497,True,2
1334,validator_0,360913895760,True,666019998,34577580,700597578,True,11
1335,validator_45,44676312030,True,735800000,2098040,737898040,False,1
1336,validator_5,128383068480,True,447200000,18996300,466196300,False,4
1337,validator_17,44802479992,True,604099999,5747900,609847899,True,1
1338,validator_7,91884656750,True,439700000,5051580,444751580,False,2
1339,validator_21,43906418043,True,783639999,10666400,794306399,True,1
1340,validator_47,42902034940,True,478100000,27546100,505646100,False,1
1341,validator_25,40237233928,True,812089995,28047820,840137815,True,1
1342,validator_49,40390222310,True,774700000,6314680,781014680,False,1
1343,validator_37,41426195540,True,763400000,6662320,770062320,False,1
1344,validator_3,211319517460,True,420870000,26676890,447546890,False,6
1345,validator_1,337364799020,True,637200000,2472680,639672680,False,10
1346,validator_10,44470631132,True,694879999,29339430,724219429,True,1
1347,validator_28,45518066918,True,777339995,8759020,786099015,True,1
1348,validator_21,44521826570,True,588553997,26854530,615408527,True,1
1349,validator_2,229429060368,True,669799999,1885060,671685059,True,7
1350,validator_31,38607901550,True,680100000,1907590,682007590,False,1
1351,validator_2,230084566571,True,650040003,5466200,655506203,True,7
1352,validator_26,43404685443,True,626799999,1526380,628326379,True,1
1353,validator_49,40988971790,True,591700000,7049480,598749480,False,1
1354,validator_3,212006546800,True,686700000,329340,687029340,False,6
1355,validator_1,338039700920,True,664100000,10801900,674901900,False,10
1356,validator_13,41894884700,True,485400001,42195990,527595991,True,1
1357,validator_9,47477131741,True,688600000,6174600,694774600,True,1
1358,validator_18,50232915192,True,664799999,4041500,668841499,True,1
1359,validator_43,41913556550,True,562600000,7792850,570392850,False,1
1360,validator_15,44733982711,True,771899998,35563820,807463818,True,1
1361,validator_1,338677630310,True,622600000,15329390,637929390,False,10
1362,validator_0,361796954138,True,867739998,15318380,883058378,True,11
1363,validator_1,339448576640,True,748600000,22346330,770946330,False,10
1364,validator_2,230903902135,True,806900004,12435560,819335564,True,7
1365,validator_2,231577321078,True,662500003,10918940,673418943,True,7
1366,validator_37,42001898910,True,554400000,21303370,575703370,False,1
1367,validator_30,38686967560,True,640800000,2195200,642995200,False,1
1368,validator_36,41910045320,True,520600000,9831000,530431000,False,1
1369,validator_24,40266643189,True,714940002,43951350,758891352,True,1
1370,validator_8,40929070327,True,690390003,49539700,739929703,True,1
1371,validator_2,232364548874,True,780699996,6527800,787227796,True,7
1372,validator_9,48285339021,True,792600010,15607270,808207280,True,1
1373,validator_14,40379204755,True,883685999,10223610,893909609,True,1
1374,validator_23,43094209298,True,971040004,21519800,992559804,True,1
1375,validator_0,362625238804,True,801799996,26484670,828284666,True,11
1376,validator_3,212339483760,True,328800000,4136960,332936960,False,6
1377,validator_4,129583368608,True,582699997,1360990,584060987,True,4
1378,validator_33,46470040490,True,743600000,2870920,746470920,False,1
1379,validator_2,233138995574,True,747240000,27206700,774446700,True,7
1380,validator_1,339973124260,True,519000000,5547620,524547620,False,10
1381,validator_36,42700086600,True,789300000,741280,790041280,False,1
1382,validator_4,130037051660,True,449800002,3883050,453683052,True,4
1383,validator_17,45442761566,True,620440004,19841570,640281574,True,1
1384,validator_0,363495244803,True,857089999,12916000,870005999,True,11
1385,validator_1,340579877420,True,603400000,3353160,606753160,False,10
1386,validator_32,41689988120,True,569300000,9070520,578370520,False,1
1387,validator_4,130741214285,True,695499995,8662630,704162625,True,4
1388,validator_0,364237490777,True,731100004,11145970,742245974,True,11
1389,validator_13,42554903560,True,635600000,24418860,660018860,True,1
1390,validator_6,95768994171,True,688640003,13212740,701852743,True,2
1391,validator_34,39751923650,True,518500000,24013730,542513730,False,1
1392,validator_1,341185613720,True,603100000,2636300,605736300,False,10
1393,validator_7,92389867560,True,495260000,9950810,505210810,False,2
1394,validator_30,39233184280,True,544200000,2016720,546216720,False,1
1395,validator_6,96382070069,True,586160008,26915890,613075898,True,3
1396,validator_0,365036495805,True,757239998,41765030,799005028,True,11
1397,validator_2,233719656969,True,561160005,19501390,580661395,True,7
1398,validator_4,131308229766,True,510400001,56615480,567015481,True,4
1399,validator_0,365713093935,True,670796000,5802130,676598130,True,11
1400,validator_4,131856496563,True,507799997,40466800,548266797,True,4
1401,validator_37,42563933030,True,557900000,4134120,562034120,False,1
1402,validator_34,40557302520,True,801300000,4078870,805378870,False,1
1403,validator_2,234380992800,True,650980001,10355830,661335831,True,7
1404,validator_33,47029309390,True,539000000,20268900,559268900,False,1
1405,validator_37,43172134810,True,584800000,23401780,608201780,False,1
1406,validator_2,234889702383,True,484680003,24029580,508709583,True,7
1407,validator_15,45669696386,True,908519995,27193680,935713675,True,1
1408,validator_0,366447817215,True,696940000,37783280,734723280,True,11
1409,validator_8,41740866627,True,773326000,38470300,811796300,True,1
1410,validator_41,39996359000,True,829900000,19997560,849897560,False,1
1411,validator_1,341791455920,True,594400000,11442200,605842200,False,10
1412,validator_1,342703900740,True,894000000,18444820,912444820,False,10
1413,validator_20,45580175553,True,737700003,7850950,745550953,True,1
1414,validator_5,128920825720,True,533900000,3857240,537757240,False,4
1415,validator_27,42532168342,True,759839998,26683040,786523038,True,1
1416,validator_2,235879229211,True,958899998,30626830,989526828,True,7
1417,validator_2,236443934213,True,540170002,24535000,564705002,True,7
1418,validator_2,237260571947,True,807720004,8917730,816637734,True,7
1419,validator_4,132320293104,True,446840001,16956540,463796541,True,4
1420,validator_1,343287456700,True,582240000,1315960,583555960,False,10
1421,validator_48,48181396850,True,479900000,1399560,481299560,False,1
1422,validator_33,47659597110,True,609100000,21187720,630287720,False,1
1423,validator_3,212845309360,True,503900000,1925600,505825600,False,6
1424,validator_1,343749686240,True,449000000,13229540,462229540,False,10
1425,validator_1,344316142680,True,546640000,19816440,566456440,False,10
1426,validator_25,41038932953,True,777060005,24639020,801699025,True,1
1427,validator_11,41508120906,True,784159999,29018290,813178289,True,1
1428,validator_3,213389106540,True,534900000,8897180,543797180,False,6
1429,validator_2,238097159321,True,826467994,10119380,836587374,True,7
1430,validator_0,367161353661,True,700419996,13116450,713536446,True,11
1431,validator_3,214084952630,True,681100000,14746090,695846090,False,6
1432,validator_37,43729185340,True,555300000,1750530,557050530,False,1
1433,validator_6,97403154559,True,1019600010,1484480,1021084490,True,3
1434,validator_1,344820072520,True,502500000,1429840,503929840,False,10
1435,validator_2,239009999220,True,875040009,37799890,912839899,True,7
1436,validator_0,367860979055,True,672579994,27045400,699625394,True,11
1437,validator_46,47227073250,True,811100000,8841370,819941370,False,1
1438,validator_6,98150860651,True,700680002,47026090,747706092,True,3
1439,validator_0,368467125274,True,586799999,19346220,606146219,True,11
1440,validator_2,239841468309,True,808053999,23415090,831469089,True,7
1441,validator_3,214743188810,True,655800000,2436180,658236180,False,6
1442,validator_41,40500312580,True,500000000,3953580,503953580,False,1
1443,validator_1,345512826650,True,688300000,4454130,692754130,False,10
1444,validator_2,240472096012,True,627900003,2727700,630627703,True,7
1445,validator_0,369330348874,True,841920000,21303600,863223600,True,11
1446,validator_47,43536670740,True,629600000,5035800,634635800,False,1
1447,validator_43,42452345170,True,511800000,26988620,538788620,False,1
1448,validator_32,42409449650,True,717500000,1961530,719461530,False,1
1449,validator_1,346108585510,True,576700000,19058860,595758860,False,10
1450,validator_1,346677314110,True,559700000,9028600,568728600,False,10
1451,validator_8,42406038928,True,646520001,18652300,665172301,True,1
1452,validator_4,133025669808,True,678780004,26596700,705376704,True,4
1453,validator_23,43803607595,True,654373997,55024300,709398297,True,1
1454,validator_3,215265009610,True,520300000,1520800,521820800,False,6
1455,validator_1,347474481070,True,790600000,6566960,797166960,False,10
1456,validator_2,241144088160,True,637085998,34906150,671992148,True,7
1457,validator_1,348179649830,True,698400000,6768760,705168760,False,10
1458,validator_26,43986778749,True,540480006,41613300,582093306,True,1
1459,validator_35,45916159770,True,525100000,20100640,545200640,False,1
1460,validator_17,46147116535,True,668519999,35834970,704354969,True,1
1461,validator_4,133799944230,True,772000002,2274420,774274422,True,4
1462,validator_7,93195777740,True,795500000,10410180,805910180,False,2
1463,validator_34,41084143760,True,524600000,2241240,526841240,False,1
1464,validator_3,215942947400,True,676700000,1237790,677937790,False,6
1465,validator_45,45218896920,True,539200000,3384890,542584890,False,1
1466,validator_2,241815080541,True,644120001,26872380,670992381,True,7
1467,validator_45,45829450550,True,590100000,20453630,610553630,False,1
1468,validator_0,370078109370,True,732799996,14960500,747760496,True,11
1469,validator_14,41175432511,True,788599996,7627760,796227756,True,1
1470,validator_2,242514730138,True,692839997,6809600,699649597,True,7
1471,validator_20,46286919296,True,687458003,19285740,706743743,True,1
1472,validator_2,243402481069,True,862118001,25632930,887750931,True,7
1473,validator_14,42117226701,True,916700000,25094190,941794190,True,1
1474,validator_12,42604714555,True,564500000,8818840,573318840,True,1
1475,validator_40,41357526230,True,570600000,2994700,573594700,False,1
1476,validator_20,46944757981,True,630968005,26870680,657838685,True,1
1477,validator_35,46440066310,True,518000000,5906540,523906540,False,1
1478,validator_34,41551734260,True,464400000,3190500,467590500,False,1
1479,validator_19,42039271612,True,803099998,7136380,810236378,True,1
1480,validator_0,370863962671,True,749220001,36633300,785853301,True,11
1481,validator_5,129416599220,True,493700000,2073500,495773500,False,4
1482,validator_0,371718581671,True,831074000,23545000,854619000,True,11
1483,validator_3,216613292720,True,667400000,2945320,670345320,False,6
1484,validator_34,42242813290,True,688500000,2579030,691079030,False,1
1485,validator_1,348766168060,True,583900000,2618230,586518230,False,10
1486,validator_25,41718852819,True,676600006,3319860,679919866,True,1
1487,validator_43,43168479780,True,713600000,2534610,716134610,False,1
1488,validator_0,372514249217,True,754440006,41227540,795667546,True,11
1489,validator_40,42187915570,True,821100000,9289340,830389340,False,1
1490,validator_22,51733435460,True,693799994,24870590,718670584,True,1
1491,validator_3,217289313460,True,668400000,7620740,676020740,False,6
1492,validator_29,42348229010,True,360010000,3252240,363262240,False,1
1493,validator_0,373436488812,True,918899995,3339600,922239595,True,11
1494,validator_0,373890967411,True,452999999,1478600,454478599,True,11
1495,validator_2,243902747066,True,473160007,27105990,500265997,True,7
1496,validator_35,46931435430,True,489340000,2029120,491369120,False,1
1497,validator_6,98847994573,True,694140002,2993920,697133922,True,3
1498,validator_20,47616557460,True,625079999,46719480,671799479,True,1
1499,validator_2,244602476556,True,697699990,2029500,699729490,True,7
1500,validator_14,42952032109,True,825199998,9605410,834805408,True,1
1501,validator_30,40006974200,True,769500000,4289920,773789920,False,1
1502,validator_0,374793978694,True,848979993,54031290,903011283,True,11
1503,validator_2,245037827158,True,421160002,14190600,435350602,True,7
1504,validator_3,217957858320,True,666900000,1644860,668544860,False,6
1505,validator_0,375481719227,True,649739993,38000540,687740533,True,11
1506,validator_19,42676856674,True,611220002,26365060,637585062,True,1
1507,validator_35,47476059260,True,524700000,19923830,544623830,False,1
1508,validator_0,376180456471,True,696700004,2037240,698737244,True,11
1509,validator_42,45838758900,True,674500000,19616400,694116400,False,1
1510,validator_13,43193884464,True,629220004,9760900,638980904,True,1
1511,validator_45,46381601190,True,550000000,2150640,552150640,False,1
1512,validator_9,49153342961,True,839820000,28183940,868003940,True,1
1513,validator_1,349585400720,True,799000000,20232660,819232660,False,10
1514,validator_2,245704074690,True,646380002,19867530,666247532,True,7
1515,validator_6,99615217575,True,718826002,48397000,767223002,True,3
1516,validator_1,350211753910,True,605900000,20453190,626353190,False,10
1517,validator_46,47898355520,True,644600000,26682270,671282270,False,1
1518,validator_1,350969703010,True,748000000,9949100,757949100,False,10
1519,validator_3,218451027820,True,484660000,8509500,493169500,False,6
1520,validator_5,130007431820,True,587800000,3032600,590832600,False,4
1521,validator_0,376823346203,True,614080002,28809730,642889732,True,11
1522,validator_21,45385959878,True,862700008,1433300,864133308,True,1
1523,validator_27,43110212671,True,558159999,19884330,578044329,True,1
1524,validator_35,48143947040,True,665000000,2887780,667887780,False,1
1525,validator_0,377543576139,True,701764006,18465930,720229936,True,11
1526,validator_6,100278372278,True,655260003,7894700,663154703,True,3
1527,validator_3,219100760480,True,646800000,2932660,649732660,False,6
1528,validator_39,40289319770,True,586800000,3865400,590665400,False,1
1529,validator_38,43095480460,True,741400000,6928640,748328640,False,1
1530,validator_0,378290542044,True,708840005,38125900,746965905,True,11
1531,validator_40,42834246020,True,644500000,1830450,646330450,False,1
1532,validator_28,46287488506,True,739259998,30161590,769421588,True,1
1533,validator_1,351627055740,True,653500000,3852730,657352730,False,10
1534,validator_34,42856870990,True,598100000,15957700,614057700,False,1
1535,validator_8,42991821423,True,565874005,19908490,585782495,True,1
1536,validator_3,219651337220,True,540800000,9776740,550576740,False,6
1537,validator_6,100801370675,True,495919997,27078400,522998397,True,3
1538,validator_1,352200123620,True,570700000,2367880,573067880,False,11
1539,validator_49,41443226940,True,433700000,20555150,454255150,False,1
1540,validator_11,42221915014,True,703800008,9994100,713794108,True,1
1541,validator_0,379417700081,True,1124300007,2858030,1127158037,True,11
1542,validator_3,220324916890,True,671000000,2579670,673579670,False,6
1543,validator_0,380305648078,True,880139997,7808000,887947997,True,11
1544,validator_1,352798626780,True,591000000,7503160,598503160,False,11
1545,validator_17,46867169559,True,710540004,9513020,720053024,True,1
1546,validator_5,130732165950,True,720300000,4434130,724734130,False,4
1547,validator_44,45542271260,True,645400000,26918300,672318300,False,1
1548,validator_0,381032165304,True,723699996,2817230,726517226,True,11
1549,validator_3,220889435000,True,562100000,2418110,564518110,False,6
1550,validator_16,42651256360,True,513260001,4141500,517401501,True,1
1551,validator_6,101480364479,True,669240004,9753800,678993804,True,3
1552,validator_1,353469835890,True,669300000,1909110,671209110,False,11
1553,validator_0,381564338002,True,526119998,6052700,532172698,True,11
1554,validator_25,42377622576,True,634479997,24289760,658769757,True,1
1555,validator_12,43298856498,True,690100003,4041940,694141943,True,1
1556,validator_37,44349674270,True,619000000,1488930,620488930,False,1
1557,validator_46,48278096020,True,373400000,6340500,379740500,False,1
1558,validator_25,43256076275,True,831299999,47153700,878453699,True,1
1559,validator_47,44384250470,True,823600000,23979730,847579730,False,1
1560,validator_2,246402579668,True,674299998,24204980,698504978,True,7
1561,validator_3,221362580320,True,459000000,14145320,473145320,False,6
1562,validator_0,382273381408,True,707199996,1843410,709043406,True,11
1563,validator_23,44488819577,True,671054002,14157980,685211982,True,1
1564,validator_1,354148575190,True,677000000,1739300,678739300,False,11
1565,validator_32,42906331630,True,492000000,4881980,496881980,False,1
1566,validator_20,48337305458,True,693207998,27540000,720747998,True,1
1567,validator_2,246823988581,True,401340003,20068910,421408913,True,7
1568,validator_36,43346299560,True,643300000,2912960,646212960,False,1
1569,validator_40,43469528820,True,632900000,2382800,635282800,False,1
1570,validator_1,354773569470,True,622400000,2594280,624994280,False,11
1571,validator_0,382941750246,True,666499998,1868840,668368838,True,11
1572,validator_1,355619104310,True,819400000,26134840,845534840,False,11
1573,validator_1,356072818510,True,427000000,26714200,453714200,False,11
1574,validator_1,356818996790,True,742800000,3378280,746178280,False,11
1575,validator_7,93743583420,True,546400000,1405680,547805680,False,2
1576,validator_0,383822951449,True,822704003,58497200,881201203,True,11
1577,validator_32,43511008470,True,598000000,6676840,604676840,False,1
1578,validator_2,247356851678,True,511803997,21059100,532863097,True,7
1579,validator_34,43416970730,True,540800000,19299740,560099740,False,1
1580,validator_1,357446280390,True,624200000,3083600,627283600,False,11
1581,validator_19,43378452762,True,669179998,32416090,701596088,True,1
1582,validator_7,94449573960,True,694400000,11590540,705990540,False,2
1583,validator_2,247862158859,True,490696001,14611180,505307181,True,7
1584,validator_39,40906254510,True,602800000,14134740,616934740,False,1
1585,validator_11,42892086991,True,647439997,22731980,670171977,True,1
1586,validator_34,43936862320,True,513900000,5991590,519891590,False,1
1587,validator_5,131332918650,True,599100000,1652700,600752700,False,4
1588,validator_1,358176219490,True,727100000,2839100,729939100,False,11
1589,validator_0,384456147648,True,622539999,10656200,633196199,True,12
1590,validator_1,358728231300,True,549900000,2111810,552011810,False,11
1591,validator_33,48276601610,True,613600000,3404500,617004500,False,1
1592,validator_2,248584168864,True,675699995,46310010,722010005,True,7
1593,validator_5,131886639600,True,551000000,2720950,553720950,False,4
1594,validator_1,359543453260,True,794600000,20621960,815221960,False,11
1595,validator_0,385193733327,True,701179999,36405680,737585679,True,12
1596,validator_33,49018424240,True,733600000,8222630,741822630,False,1
1597,validator_14,43804423012,True,829520003,22870900,852390903,True,1
1598,validator_1,360307375790,True,755500000,8422530,763922530,False,11
1599,validator_4,134636409029,True,806339999,30124800,836464799,True,4
1600,validator_2,249468027850,True,831520006,52338980,883858986,True,7
1601,validator_2,250291899615,True,815320005,8551760,823871765,True,7
1602,validator_3,221984417810,True,611800000,10037490,621837490,False,6
1603,validator_22,52651151414,True,880860004,36855950,917715954,True,1
1604,validator_5,132424097020,True,533600000,3857420,537457420,False,4
1605,validator_19,44164620268,True,780499996,5667510,786167506,True,1
1606,validator_24,40898966328,True,606299999,26023140,632323139,True,1
1607,validator_6,102234884419,True,735464000,19055940,754519940,True,3
1608,validator_3,222697771230,True,698500000,14853420,713353420,False,6
1609,validator_3,223228150230,True,490100000,40279000,530379000,False,6
1610,validator_23,45248443184,True,712580007,47043600,759623607,True,1
1611,validator_36,44043140740,True,673500000,23341180,696841180,False,1
1612,validator_5,133022451250,True,587800000,10554230,598354230,False,4
1613,validator_6,103120020106,True,858699997,26435690,885135687,True,3
1614,validator_2,250992670029,True,666263994,34506420,700770414,True,7
1615,validator_18,50702552651,True,412439999,57197460,469637459,True,1
1616,validator_5,133573944880,True,543200000,8293630,551493630,False,4
1617,validator_3,224026522430,True,796400000,1972200,798372200,False,7
1618,validator_0,385809861509,True,605100002,11028180,616128182,True,12
1619,validator_1,360785104650,True,451700000,26028860,477728860,False,11
1620,validator_10,45094613595,True,608180003,15802460,623982463,True,1
1621,validator_21,46185887309,True,779940001,19987430,799927431,True,1
1622,validator_1,361463050470,True,668100000,9845820,677945820,False,11
1623,validator_18,51260588457,True,557100006,935800,558035806,True,1
1624,validator_2,251610475274,True,603720005,14085240,617805245,True,7
1625,validator_42,46407550640,True,560100000,8691740,568791740,False,1
1626,validator_2,252435978964,True,795673990,29829700,825503690,True,7
1627,validator_43,43942313120,True,770100000,3733340,773833340,False,1
1628,validator_37,45000436200,True,630500000,20261930,650761930,False,1
1629,validator_38,43702956920,True,604300000,3176460,607476460,False,1
1630,validator_0,386517478159,True,675280000,32336650,707616650,True,12
1631,validator_4,135305631345,True,645039996,24182320,669222316,True,4
1632,validator_40,43933769150,True,460600000,3640330,464240330,False,1
1633,validator_47,45097172330,True,710500000,2421860,712921860,False,1
1634,validator_2,253054057637,True,603154003,14924670,618078673,True,7
1635,validator_2,253674626006,True,617499999,3068370,620568369,True,7
1636,validator_0,387247919499,True,706220000,24221340,730441340,True,12
1637,validator_0,388026539622,True,751339993,27280130,778620123,True,12
1638,validator_1,362126507550,True,646700000,16757080,663457080,False,11
1639,validator_0,388681786160,True,628339998,26906540,655246538,True,12
1640,validator_28,46921978511,True,619086005,15404000,634490005,True,1
1641,validator_10,46011834378,True,895600003,21620780,917220783,True,1
1642,validator_3,224695020590,True,631500000,36998160,668498160,False,7
1643,validator_22,53351439880,True,694100006,6188460,700288466,True,1
1644,validator_36,44444478210,True,398100000,3237470,401337470,False,1
1645,validator_1,362801516230,True,673100000,1908680,675008680,False,11
1646,validator_31,39078531130,True,468500000,2129580,470629580,False,1
1647,validator_0,389413388140,True,710200000,21401980,731601980,True,12
1648,validator_5,134355167510,True,753300000,27922630,781222630,False,4
1649,validator_16,43467218400,True,806200000,9762040,815962040,True,1
1650,validator_29,42913198090,True,558270000,6699080,564969080,False,1
1651,validator_1,363387119460,True,583200000,2403230,585603230,False,11
1652,validator_3,225269921090,True,570500000,4400500,574900500,False,7
1653,validator_0,390285751185,True,834700005,37663040,872363045,True,12
1654,validator_29,43474825680,True,552100000,9527590,561627590,False,1
1655,validator_22,54163586810,True,805960000,6186930,812146930,True,1
1656,validator_11,43621131258,True,713339997,15704270,729044267,True,1
1657,validator_27,43816523193,True,697840002,8470520,706310522,True,1
1658,validator_25,43994996298,True,717910003,21010020,738920023,True,1
1659,validator_26,44850827119,True,861300000,2748370,864048370,True,1
1660,validator_0,391051489314,True,721023999,44714130,765738129,True,12
1661,validator_40,44489365650,True,536300000,19296500,555596500,False,1
1662,validator_48,48839097330,True,657000000,700480,657700480,False,1
1663,validator_2,254424532694,True,743059998,6846690,749906688,True,7
1664,validator_4,135922665548,True,597899993,19134210,617034203,True,4
1665,validator_1,364123709090,True,729500000,7089630,736589630,False,11
1666,validator_47,45650959570,True,550300000,3487240,553787240,False,1
1667,validator_45,47035376390,True,647400000,6375200,653775200,False,1
1668,validator_5,135055105140,True,696500000,3437630,699937630,False,4
1669,validator_1,364718958300,True,592900000,2349210,595249210,False,11
1670,validator_5,135591874830,True,498700000,38069690,536769690,False,4
1671,validator_5,136289590170,True,694700000,3015340,697715340,False,4
1672,validator_1,365200307700,True,476200000,5149400,481349400,False,11
1673,validator_33,49724836330,True,705300000,1112090,706412090,False,1
1674,validator_19,44721127965,True,553579997,2927700,556507697,True,1
1675,validator_0,391883811645,True,776100001,56222330,832322331,True,12
1676,validator_6,103910128445,True,783919999,6188340,790108339,True,3
1677,validator_0,392422793246,True,534600001,4381600,538981601,True,12
1678,validator_18,51837180374,True,566079997,10511920,576591917,True,1
1679,validator_32,44006825650,True,493400000,2417180,495817180,False,1
1680,validator_2,255264317521,True,836699997,3084830,839784827,True,7
1681,validator_6,104882019250,True,942266005,29624800,971890805,True,3
1682,validator_0,393187072334,True,732879998,31399090,764279088,True,12
1683,validator_43,44421428910,True,459120000,19995790,479115790,False,1
1684,validator_22,55127681813,True,943260003,20835000,964095003,True,1
1685,validator_22,55765839780,True,618795997,19361970,638157967,True,1
1686,validator_29,44205762380,True,711700000,19236700,730936700,False,1
1687,validator_35,48713550110,True,558800000,10803070,569603070,False,1
1688,validator_6,105536366737,True,650599997,3747490,654347487,True,3
1689,validator_3,225813100490,True,541900000,1279400,543179400,False,7
1690,validator_0,393921115140,True,724140006,9902800,734042806,True,12
1691,validator_1,365927232000,True,724600000,2324300,726924300,False,11
1692,validator_0,394738634699,True,801800009,15719550,817519559,True,12
1693,validator_7,95172345090,True,721700000,1071130,722771130,False,2
1694,validator_1,366650474330,True,703600000,19642330,723242330,False,11
1695,validator_5,136849125870,True,557100000,2435700,559535700,False,4
1696,validator_8,43869233936,True,863499993,13912520,877412513,True,1
1697,validator_17,47398194059,True,480940000,50084500,531024500,True,1
1698,validator_8,44696038081,True,796137995,30666150,826804145,True,1
1699,validator_21,46996521756,True,772880007,37754440,810634447,True,1
1700,validator_1,367261746330,True,608600000,2672000,611272000,False,11
1701,validator_36,45035084910,True,587500000,3106700,590606700,False,1
1702,validator_31,39540967630,True,460200000,2236500,462436500,False,1
1703,validator_32,44490546750,True,473500000,10221100,483721100,False,1
1704,validator_32,45110485850,True,601000000,18939100,619939100,False,1
1705,validator_29,44699796640,True,491300000,2734260,494034260,False,1
1706,validator_5,137435192770,True,566600000,19466900,586066900,False,4
1707,validator_7,95813480730,True,639100000,2035640,641135640,False,2
1708,validator_2,255920759840,True,626079999,30362320,656442319,True,7
1709,validator_1,367978236730,True,714300000,2190400,716490400,False,11
1710,validator_1,368403490010,True,411900000,13353280,425253280,False,11
1711,validator_1,369003541490,True,597000000,3051480,600051480,False,11
1712,validator_4,136544687050,True,585374002,36647500,622021502,True,4
1713,validator_49,42104424860,True,659700000,1497920,661197920,False,1
1714,validator_44,46208481570,True,639700000,26510310,666210310,False,1
1715,validator_39,41588948560,True,658600000,24094050,682694050,False,1
1716,validator_3,226554263790,True,738000000,3163300,741163300,False,7
1717,validator_21,48031008427,True,1026200001,8286670,1034486671,True,1
1718,validator_1,369734148060,True,725300000,5306570,730606570,False,11
1719,validator_1,370267165860,True,518100000,14917800,533017800,False,11
1720,validator_0,395591894110,True,817339991,35919420,853259411,True,12
1721,validator_2,256629578246,True,678099996,30718410,708818406,True,8
1722,validator_5,137948149690,True,511800000,1156920,512956920,False,4
1723,validator_0,396470845916,True,829128006,49823800,878951806,True,12
1724,validator_28,47686788213,True,755720002,9089700,764809702,True,1
1725,validator_0,397334360279,True,846470003,17044360,863514363,True,12
1726,validator_4,137466381568,True,876779998,44914520,921694518,True,4
1727,validator_12,43889191290,True,565320002,25014790,590334792,True,1
1728,validator_6,106352419383,True,796139996,19912650,816052646,True,3
1729,validator_29,45469146640,True,765000000,4350000,769350000,False,1
1730,validator_1,370874051810,True,596200000,10685950,606885950,False,11
1731,validator_45,47757639630,True,715600000,6663240,722263240,False,1
1732,validator_26,45624206151,True,763400002,9979030,773379032,True,1
1733,validator_48,49487501150,True,628700000,19703820,648403820,False,1
1734,validator_5,138529910350,True,578600000,3160660,581760660,False,4
1735,validator_2,257415679047,True,783200001,2900800,786100801,True,8
1736,validator_0,397940161858,True,564519999,41281580,605801579,True,12
1737,validator_6,107092927132,True,697719989,42787760,740507749,True,3
1738,validator_0,398548659328,True,606900010,1597460,608497470,True,12
1739,validator_3,227170849780,True,597000000,19585990,616585990,False,7
1740,validator_5,139089681610,True,543400000,16371260,559771260,False,4
1741,validator_1,371422933530,True,547500000,1381720,548881720,False,11
1742,validator_1,371982062000,True,552400000,6728470,559128470,False,11
1743,validator_2,258166634541,True,723399994,27555500,750955494,True,8
1744,validator_2,258808995942,True,635200001,7161400,642361401,True,8
1745,validator_47,46176714440,True,499600000,26154870,525754870,False,1
1746,validator_17,48290869480,True,866000001,26675420,892675421,True,1
1747,validator_6,107840698624,True,737820002,9951490,747771492,True,3
1748,validator_35,49306647440,True,589200000,3897330,593097330,False,1
1749,validator_2,259453672743,True,619308001,25368800,644676801,True,8
1750,validator_49,42765545950,True,641300000,19821090,661121090,False,1
1751,validator_2,260260183060,True,753439997,53070320,806510317,True,8
1752,validator_7,96485951270,True,669800000,2670540,672470540,False,3
1753,validator_1,372402283200,True,399100000,21121200,420221200,False,11
1754,validator_22,56382294574,True,590639994,25814800,616454794,True,1
1755,validator_24,41642873903,True,739069995,4837580,743907575,True,1
1756,validator_3,227724231380,True,546500000,6881600,553381600,False,7
1757,validator_5,139734196640,True,642800000,1715030,644515030,False,4
1758,validator_29,45956242420,True,483800000,3295780,487095780,False,1
1759,validator_4,138244554961,True,769339993,8833400,778173393,True,4
1760,validator_3,228113872310,True,387800000,1840930,389640930,False,7
1761,validator_29,46588131790,True,606100000,25789370,631889370,False,1
1762,validator_42,46997832110,True,584400000,5881470,590281470,False,1
1763,validator_24,42428944000,True,759339997,26730100,786070097,True,1
1764,validator_33,50194427630,True,467200000,2391300,469591300,False,1
1765,validator_5,140273285300,True,518300000,20788660,539088660,False,4
1766,validator_1,372968489560,True,564800000,1406360,566206360,False,11
1767,validator_1,373535269510,True,547600000,19179950,566779950,False,11
1768,validator_3,228655502840,True,539900000,1730530,541630530,False,7
1769,validator_6,108619594677,True,777000003,1896050,778896053,True,3
1770,validator_2,260727520267,True,464300007,3037200,467337207,True,8
1771,validator_10,46583228018,True,557120000,14273640,571393640,True,1
1772,validator_23,45926046882,True,635479998,42123700,677603698,True,1
1773,validator_0,399338692524,True,755285996,34747200,790033196,True,12
1774,validator_0,399901318635,True,550200001,12426110,562626111,True,12
1775,validator_30,40680265290,True,649600000,23691090,673291090,False,1
1776,validator_0,400575396725,True,664500000,9578090,674078090,True,12
1777,validator_37,45587023690,True,584200000,2387490,586587490,False,1
1778,validator_3,229195957900,True,519100000,21355060,540455060,False,7
1779,validator_0,401263080132,True,686000007,1683400,687683407,True,12
1780,validator_7,97016869000,True,527900000,3017730,530917730,False,3
1781,validator_36,45713939940,True,666700000,12155030,678855030,False,1
1782,validator_3,230049997220,True,841200000,12839320,854039320,False,7
1783,validator_22,56956215664,True,563700010,10221080,573921090,True,1
1784,validator_5,140680191210,True,404800000,2105910,406905910,False,4
1785,validator_2,261227907913,True,481799996,18587650,500387646,True,8
1786,validator_5,141277844210,True,595600000,2053000,597653000,False,4
1787,validator_39,42187057080,True,594900000,3208520,598108520,False,1
1788,validator_1,374057330910,True,497700000,24361400,522061400,False,11
1789,validator_28,48202962629,True,495039996,21134420,516174416,True,1
1790,validator_1,374504885150,True,438900000,8654240,447554240,False,11
1791,validator_4,139048252419,True,795699998,7997460,803697458,True,4
1792,validator_23,46501469685,True,554760003,20662800,575422803,True,1
1793,validator_12,44726815312,True,832499992,5124030,837624022,True,1
1794,validator_2,261914980330,True,643999997,43072420,687072417,True,8
1795,validator_4,139623474918,True,538640009,36582490,575222499,True,4
1796,validator_7,97662686080,True,644300000,1517080,645817080,False,3
1797,validator_45,48287979450,True,528600000,1739820,530339820,False,1
1798,validator_0,401890124030,True,617299998,9743900,627043898,True,12
1799,validator_18,52760166947,True,901799993,21186580,922986573,True,1
1800,validator_8,45395484980,True,683099999,16346900,699446899,True,1
1801,validator_17,49077952565,True,780340005,6743080,787083085,True,1
1802,validator_1,375106678010,True,593900000,7892860,601792860,False,11
1803,validator_0,402741320755,True,834880005,16316720,851196725,True,12
1804,validator_40,45014578260,True,523600000,1612610,525212610,False,1
1805,validator_0,403246404348,True,502400003,2683590,505083593,True,12
1806,validator_2,262878656488,True,957599998,6076160,963676158,True,8
1807,validator_14,44532090889,True,725399997,2267880,727667877,True,1
1808,validator_47,46716531060,True,533300000,6516620,539816620,False,1
1809,validator_4,140073020076,True,435579998,13965160,449545158,True,4
1810,validator_15,46293956985,True,611999999,12260600,624260599,True,1
1811,validator_25,44528640536,True,506759998,26884240,533644238,True,1
1812,validator_28,48896026746,True,668459997,24604120,693064117,True,1
1813,validator_5,141919881770,True,622000000,20037560,642037560,False,4
1814,validator_14,45667365055,True,1132099996,3174170,1135274166,True,1
1815,validator_18,53451340169,True,688220002,2953220,691173222,True,1
1816,validator_1,375679369260,True,569000000,3691250,572691250,False,11
1817,validator_0,403978238235,True,707515997,24317890,731833887,True,12
1818,validator_3,230627208440,True,565200000,12011220,577211220,False,7
1819,validator_18,54134896752,True,650880003,32676580,683556583,True,1
1820,validator_31,40190512030,True,641100000,8444400,649544400,False,1
1821,validator_3,231175052960,True,529200000,18644520,547844520,False,7
1822,validator_4,140689285472,True,571079996,45185400,616265396,True,4
1823,validator_2,263541346714,True,653919996,8770230,662690226,True,8
1824,validator_0,404788744823,True,778500008,32006580,810506588,True,12
1825,validator_35,49928577070,True,618700000,3229630,621929630,False,1
1826,validator_0,405665576548,True,852219995,24611730,876831725,True,12
1827,validator_5,142630501370,True,697500000,13119600,710619600,False,4
1828,validator_13,43847959771,True,644900007,9175300,654075307,True,1
1829,validator_4,141370579353,True,680300001,993880,681293881,True,4
1830,validator_38,44432795520,True,723800000,6038600,729838600,False,1
1831,validator_38,45160970910,True,726600000,1575390,728175390,False,1
1832,validator_31,40822372070,True,629500000,2360040,631860040,False,1
1833,validator_12,45367392491,True,613899999,26677180,640577179,True,1
1834,validator_10,47252662436,True,640719998,28714420,669434418,True,1
1835,validator_27,44547934797,True,722020004,9391600,731411604,True,1
1836,validator_1,376129297390,True,447170000,2758130,449928130,False,11
1837,validator_0,406431904472,True,758939994,7387930,766327924,True,12
1838,validator_1,376811541850,True,662300000,19944460,682244460,False,11
1839,validator_7,98470946910,True,805400000,2860830,808260830,False,3
1840,validator_0,407257720170,True,823699998,2115700,825815698,True,12
1841,validator_0,407918839134,True,652799994,8318970,661118964,True,12
1842,validator_5,143241905740,True,591900000,19504370,611404370,False,4
1843,validator_31,41493146910,True,669200000,1574840,670774840,False,1
1844,validator_45,48859244890,True,562800000,8465440,571265440,False,1
1845,validator_1,377442285160,True,627300000,3443310,630743310,False,11
1846,validator_34,44528367410,True,589100000,2405090,591505090,False,1
1847,validator_35,50502637970,True,571300000,2760900,574060900,False,1
1848,validator_16,44038580074,True,569400004,1961670,571361674,True,1
1849,validator_7,98989708230,True,516700000,2061320,518761320,False,3
1850,validator_18,54625776250,True,445699998,45179500,490879498,True,1
1851,validator_10,47948713217,True,682054001,13996780,696050781,True,1
1852,validator_5,143858369740,True,616000000,464000,616464000,False,4
1853,validator_0,408673320315,True,728820001,25661180,754481181,True,12
1854,validator_2,264315759320,True,771500006,2912600,774412606,True,8
1855,validator_9,49617478306,True,460400005,3735340,464135345,True,1
1856,validator_1,378095986860,True,640400000,13301700,653701700,False,11
1857,validator_1,378554154760,True,457800000,367900,458167900,False,11
1858,validator_0,409545633992,True,870699997,1613680,872313677,True,12
1859,validator_1,379153244360,True,596900000,2189600,599089600,False,11
1860,validator_30,41321275790,True,623500000,17510500,641010500,False,1
1861,validator_1,379798262660,True,642100000,2918300,645018300,False,11
1862,validator_7,99724912710,True,733100000,2104480,735204480,False,3
1863,validator_16,44685601955,True,637600001,9421880,647021881,True,1
1864,validator_0,410133608354,True,578560002,9414360,587974362,True,12
1865,validator_11,44405465165,True,765420007,18913900,784333907,True,1
1866,validator_3,231818900460,True,641700000,2147500,643847500,False,7
1867,validator_4,141987931381,True,601858008,15494020,617352028,True,4
1868,validator_18,55307607471,True,677700001,4131220,681831221,True,1
1869,validator_20,49041545253,True,677939995,26299800,704239795,True,1
1870,validator_2,265188418998,True,842019998,30639680,872659678,True,8
1871,validator_21,48699962164,True,666899997,2053740,668953737,True,1
1872,validator_25,45168664551,True,614379995,25644020,640024015,True,1
1873,validator_1,380473184080,True,655600000,19321420,674921420,False,11
1874,validator_1,381266481450,True,771400000,21897370,793297370,False,11
1875,validator_7,100331057690,True,604300000,1844980,606144980,False,3
1876,validator_24,43278865298,True,829119998,20801300,849921298,True,1
1877,validator_48,50055212630,True,554200000,13511480,567711480,False,1
1878,validator_7,100775505330,True,442400000,2047640,444447640,False,3
1879,validator_1,381769568560,True,495300000,7787110,503087110,False,11
1880,validator_4,142552452010,True,562699999,1820630,564520629,True,4
1881,validator_0,410831400538,True,667260004,30532180,697792184,True,12
1882,validator_2,265992492370,True,762554002,41519370,804073372,True,8
1883,validator_2,266604303477,True,583060007,28751100,611811107,True,8
1884,validator_3,232480442850,True,641500000,20042390,661542390,False,7
1885,validator_23,47421420943,True,907900008,12051250,919951258,True,1
1886,validator_14,46398760599,True,696460004,34935540,731395544,True,1
1887,validator_3,233217201170,True,733900000,2858320,736758320,False,7
1888,validator_17,49660183682,True,523259997,58971120,582231117,True,1
1889,validator_36,46431049720,True,709100000,8009780,717109780,False,1
1890,validator_2,267317413046,True,701999999,11109570,713109569,True,8
1891,validator_35,51014645970,True,510200000,1808000,512008000,False,1
1892,validator_7,101312729250,True,532900000,4323920,537223920,False,3
1893,validator_5,144360179780,True,498700000,3110040,501810040,False,4
1894,validator_0,411575294668,True,699465990,44428140,743894130,True,12
1895,validator_1,382384028030,True,612500000,1959470,614459470,False,11
1896,validator_3,233738303820,True,519400000,1702650,521102650,False,7
1897,validator_6,109339134901,True,717200004,2340220,719540224,True,3
1898,validator_7,101928454870,True,614400000,1325620,615725620,False,3
1899,validator_5,144924011840,True,559900000,3932060,563832060,False,4
1900,validator_24,43980686447,True,690021999,11799150,701821149,True,1
1901,validator_15,46868960957,True,540180002,34823970,575003972,True,1
1902,validator_2,267997346938,True,653700002,26233890,679933892,True,8
1903,validator_36,46988822340,True,554800000,2972620,557772620,False,1
1904,validator_0,412207220200,True,596719992,35205540,631925532,True,12
1905,validator_20,49898941887,True,827999994,29396640,857396634,True,1
1906,validator_8,46397296505,True,982980005,18831520,1001811525,True,1
1907,validator_0,413055899701,True,825240001,23439500,848679501,True,12
1908,validator_21,49503128492,True,796539998,6626330,803166328,True,1
1909,validator_33,50844334650,True,642900000,7007020,649907020,False,1
1910,validator_2,268879754781,True,849120003,33287840,882407843,True,8
1911,validator_26,46410907219,True,762520008,24181060,786701068,True,1
1912,validator_0,413812675272,True,719700001,37075570,756775571,True,12
1913,validator_3,234430076350,True,683100000,8672530,691772530,False,7
1914,validator_11,45108336495,True,693240000,9631330,702871330,True,1
1915,validator_5,145666979480,True,740800000,2167640,742967640,False,4
1916,validator_48,50543530100,True,485800000,2517470,488317470,False,1
1917,validator_4,143185361874,True,622300004,10609860,632909864,True,4
1918,validator_24,44556525482,True,573199995,2639040,575839035,True,1
1919,validator_19,45430181701,True,694809996,14243740,709053736,True,1
1920,validator_28,49719298040,True,805299994,17971300,823271294,True,1
1921,validator_2,269456388318,True,558299997,18333540,576633537,True,8
1922,validator_31,42078467760,True,555000000,30320850,585320850,False,1
1923,validator_1,383013574830,True,623100000,6446800,629546800,False,11
1924,validator_5,146264912140,True,596000000,1932660,597932660,False,4
1925,validator_0,414409923276,True,578860004,18388000,597248004,True,12
1926,validator_3,235248688440,True,811200000,7412090,818612090,False,7
1927,validator_44,46717386530,True,498900000,10004960,508904960,False,1
1928,validator_17,50534945447,True,866099995,8661770,874761765,True,1
1929,validator_49,43394254350,True,626200000,2508400,628708400,False,1
1930,validator_23,48173566757,True,732400004,19745810,752145814,True,1
1931,validator_0,415065903547,True,633080001,22900270,655980271,True,12
1932,validator_30,41984687030,True,661600000,1811240,663411240,False,1
1933,validator_48,51188683960,True,642700000,2453860,645153860,False,1
1934,validator_2,270108407926,True,644019998,7999610,652019608,True,8
1935,validator_48,51979524480,True,787400000,3440520,790840520,False,1
1936,validator_20,50685804402,True,755199995,31662520,786862515,True,1
1937,validator_3,235981716270,True,709100000,23927830,733027830,False,7
1938,validator_21,50187662815,True,658564003,25970320,684534323,True,1
1939,validator_7,102589987410,True,655300000,6232540,661532540,False,3
1940,validator_3,236591115400,True,582500000,26899130,609399130,False,7
1941,validator_13,44495711467,True,636719996,11031700,647751696,True,1
1942,validator_1,383647193860,True,632400000,1219030,633619030,False,11
1943,validator_2,270870993397,True,754340001,8245470,762585471,True,8
1944,validator_3,237156031050,True,547000000,17915650,564915650,False,7
1945,validator_1,384137233190,True,487970000,2069330,490039330,False,12
1946,validator_45,49455164440,True,588900000,7019550,595919550,False,1
1947,validator_14,46988972174,True,587099995,3111580,590211575,True,1
1948,validator_1,384578734230,True,439700000,1801040,441501040,False,12
1949,validator_18,56004660455,True,688168004,8884980,697052984,True,1
1950,validator_49,44123763850,True,719900000,9609500,729509500,False,1
1951,validator_0,415618432347,True,536100000,16428800,552528800,True,12
1952,validator_45,50269185540,True,812700000,1321100,814021100,False,1
1953,validator_2,271525459533,True,644039996,10426140,654466136,True,8
1954,validator_1,385415033960,True,834800000,1499730,836299730,False,12
1955,validator_2,272369350672,True,841899999,1991140,843891139,True,8
1956,validator_14,47916545090,True,856993996,70578920,927572916,True,1
1957,validator_28,50351124300,True,628600000,3226260,631826260,True,1
1958,validator_44,47396303530,True,668500000,10417000,678917000,False,1
1959,validator_16,45717647161,True,1030400006,1645200,1032045206,True,1
1960,validator_46,49066219420,True,786900000,1223400,788123400,False,1
1961,validator_5,147061343540,True,768200000,28231400,796431400,False,4
1962,validator_0,416432852846,True,789799999,24620500,814420499,True,13
1963,validator_44,47969567200,True,559900000,13363670,573263670,False,1
1964,validator_23,48808802568,True,628420001,6815810,635235811,True,1
1965,validator_17,51231502517,True,669398000,27159070,696557070,True,1
1966,validator_2,272892317560,True,471983998,50982890,522966888,True,8
1967,validator_3,237754351630,True,595800000,2520580,598320580,False,7
1968,validator_34,45305384510,True,755100000,21917100,777017100,False,1
1969,validator_1,386145678310,True,722700000,7944350,730644350,False,12
1970,validator_12,45967355085,True,567499994,32462600,599962594,True,1
1971,validator_28,50835858315,True,463420005,21314010,484734015,True,1
1972,validator_5,147732898140,True,645200000,26354600,671554600,False,4
1973,validator_8,47040015108,True,613220003,29498600,642718603,True,1
1974,validator_0,417227164272,True,791099996,3211430,794311426,True,13
1975,validator_5,148315479640,True,580500000,2081500,582581500,False,4
1976,validator_0,417822602057,True,588800005,6637780,595437785,True,13
1977,validator_24,45237653776,True,657539994,23588300,681128294,True,1
1978,validator_1,386671286550,True,519500000,6108240,525608240,False,12
1979,validator_24,46105200581,True,854720005,12826800,867546805,True,1
1980,validator_37,46127224930,True,538600000,1601240,540201240,False,1
1981,validator_44,48417319520,True,427040000,20712320,447752320,False,1
1982,validator_6,110111135330,True,722679999,49320430,772000429,True,3
1983,validator_15,47529128352,True,657899995,2267400,660167395,True,1
1984,validator_36,47479477020,True,482000000,8654680,490654680,False,1
1985,validator_11,45841153021,True,702299996,30516530,732816526,True,1
1986,validator_38,45919809840,True,741600000,17238930,758838930,False,1
1987,validator_18,56657293344,True,627819999,24812890,652632889,True,1
1988,validator_7,103097006190,True,486400000,20618780,507018780,False,3
1989,validator_1,387230015250,True,557500000,1228700,558728700,False,12
1990,validator_11,46402196121,True,536860000,24183100,561043100,True,1
1991,validator_0,418582739745,True,723139998,36997690,760137688,True,13
1992,validator_1,387914656830,True,656500000,28141580,684641580,False,12
1993,validator_2,273327550616,True,413640006,21593050,435233056,True,8
1994,validator_5,149128170140,True,808500000,4190500,812690500,False,4
1995,validator_3,238514654870,True,751300000,9003240,760303240,False,7
1996,validator_1,388337542470,True,419800000,3085640,422885640,False,12
1997,validator_2,273913826101,True,556746005,29529480,586275485,True,8
1998,validator_1,388843194130,True,504200000,1451660,505651660,False,12
1999,validator_5,149692165140,True,558100000,5895000,563995000,False,4
2000,validator_6,110683069722,True,546960002,24974390,571934392,True,3
2001,validator_1,389488875580,True,624700000,20981450,645681450,False,12
2002,validator_5,150353128970,True,636800000,24163830,660963830,False,4
2003,validator_15,48301924955,True,753400003,19396600,772796603,True,1
2004,validator_21,51005802629,True,784720004,33419810,818139814,True,1
2005,validator_18,57328768120,True,630119996,41354780,671474776,True,1
2006,validator_41,41186580380,True,684000000,2267800,686267800,False,1
2007,validator_12,46669190887,True,699900002,1935800,701835802,True,1
2008,validator_6,111281543472,True,597600000,873750,598473750,True,3
2009,validator_36,48022676350,True,518400000,24799330,543199330,False,1
2010,validator_38,46466048500,True,490300000,55938660,546238660,False,1
2011,validator_31,42714506060,True,626940000,9098300,636038300,False,1
2012,validator_10,48754490024,True,744140007,61636800,805776807,True,1
2013,validator_2,274652500729,True,686719998,51954630,738674628,True,8
2014,validator_23,49406151659,True,561019991,36329100,597349091,True,1
2015,validator_5,150936017640,True,581300000,1588670,582888670,False,4
2016,validator_2,275248920624,True,588059995,8359900,596419895,True,8
2017,validator_1,389963533270,True,464900000,9757690,474657690,False,12
2018,validator_5,151737007320,True,798100000,2889680,800989680,False,4
2019,validator_4,144046615722,True,853000008,8253840,861253848,True,4
2020,validator_1,390596106540,True,631500000,1073270,632573270,False,12
2021,validator_1,391209458170,True,593500000,19851630,613351630,False,12
2022,validator_1,391793035950,True,572290000,11287780,583577780,False,12
2023,validator_1,392357665390,True,554400000,10229440,564629440,False,12
2024,validator_25,46176697401,True,965180010,42852840,1008032850,True,1
2025,validator_18,58343138014,True,989499994,24869900,1014369894,True,1
2026,validator_44,49026100850,True,562400000,46381330,608781330,False,1
2027,validator_16,46347491084,True,618739993,11103930,629843923,True,1
2028,validator_1,392864069000,True,499800000,6603610,506403610,False,12
2029,validator_3,239107379510,True,578000000,14724640,592724640,False,7
2030,validator_0,419234937509,True,630060004,22137760,652197764,True,13
2031,validator_2,275734145988,True,462099994,23125370,485225364,True,8
2032,validator_1,393490414220,True,621100000,5245220,626345220,False,12
2033,validator_26,47198234590,True,741900001,45427370,787327371,True,1
2034,validator_1,394206653020,True,714500000,1738800,716238800,False,12
2035,validator_2,276374980893,True,616520005,24314900,640834905,True,8
2036,validator_33,51450503650,True,605500000,669000,606169000,False,1
2037,validator_37,46663877210,True,526300000,10352280,536652280,False,1
2038,validator_14,48726657325,True,789399995,20712240,810112235,True,1
2039,validator_38,47243595400,True,770900000,6646900,777546900,False,1
2040,validator_48,52466647180,True,481300000,5822700,487122700,False,1
2041,validator_28,51724287997,True,863496002,24933680,888429682,True,1
2042,validator_44,49590782030,True,563500000,1181180,564681180,False,1
2043,validator_6,112011822678,True,687840006,42439200,730279206,True,3
2044,validator_5,152463257890,True,705000000,21250570,726250570,False,4
2045,validator_0,419864185538,True,616639999,12608030,629248029,True,13
2046,validator_2,277196532795,True,800440002,21111900,821551902,True,8
2047,validator_35,51719026350,True,702800000,1580380,704380380,False,1
2048,validator_0,420701474336,True,831839998,5448800,837288798,True,13
2049,validator_5,153064545030,True,592500000,8787140,601287140,False,4
2050,validator_28,52441287183,True,709940006,7059180,716999186,True,1
2051,validator_1,394738369460,True,530000000,1716440,531716440,False,12
2052,validator_44,50230827980,True,637100000,2945950,640045950,False,1
2053,validator_1,395286868120,True,539500000,8998660,548498660,False,12
2054,validator_0,421387331034,True,663739998,22116700,685856698,True,13
2055,validator_10,49541513303,True,762499999,24523280,787023279,True,1
2056,validator_1,395811903060,True,522100000,2934940,525034940,False,12
2057,validator_1,396305168720,True,490800000,2465660,493265660,False,12
2058,validator_2,278062095205,True,841940000,23622410,865562410,True,8
2059,validator_16,47123304072,True,766499998,9312990,775812988,True,1
2060,validator_0,422068788137,True,681100003,357100,681457103,True,13
2061,validator_3,239638360770,True,528200000,2781260,530981260,False,7
2062,validator_49,44739072440,True,611400000,3908590,615308590,False,1
2063,validator_1,396947626110,True,620800000,21657390,642457390,False,12
2064,validator_11,47075205521,True,646540000,26469400,673009400,True,1
2065,validator_2,278828988307,True,746880002,20013100,766893102,True,8
2066,validator_7,103610832590,True,508470000,5356400,513826400,False,3
2067,validator_3,240227374010,True,587920000,1093240,589013240,False,7
2068,validator_10,49979321634,True,418280011,19528320,437808331,True,1
2069,validator_15,49161984759,True,835240004,24819800,860059804,True,1
2070,validator_3,240716650960,True,487500000,1776950,489276950,False,7
2071,validator_3,241250700120,True,527300000,6749160,534049160,False,7
2072,validator_1,397615244050,True,666000000,1617940,667617940,False,12
2073,validator_30,42611273360,True,602300000,24286330,626586330,False,1
2074,validator_0,422809932580,True,725939993,15204450,741144443,True,13
2075,validator_0,423367843400,True,531280000,26630820,557910820,True,13
2076,validator_20,51499155591,True,807699999,5651190,813351189,True,1
2077,validator_36,48614953180,True,582700000,9576830,592276830,False,1
2078,validator_37,47143319410,True,456800000,22642200,479442200,False,1
2079,validator_5,153664016210,True,593000000,6471180,599471180,False,4
2080,validator_11,47809281326,True,726420005,7655800,734075805,True,1
2081,validator_37,47997191810,True,847500000,6372400,853872400,False,1
2082,validator_1,398145611630,True,528800000,1567580,530367580,False,12
2083,validator_4,144683086960,True,628299998,8171240,636471238,True,4
2084,validator_17,51895617899,True,646040002,18075380,664115382,True,1
2085,validator_6,112774887095,True,756595997,6468420,763064417,True,3
2086,validator_0,424199319493,True,798400003,33076090,831476093,True,13
2087,validator_29,47260396220,True,665000000,7264430,672264430,False,1
2088,validator_12,47509170087,True,814040000,25939200,839979200,True,1
2089,validator_12,48517331992,True,998400005,9761900,1008161905,True,1
2090,validator_3,241735743320,True,474800000,10243200,485043200,False,7
2091,validator_0,425015858356,True,790640003,25898860,816538863,True,13
2092,validator_3,242193290110,True,448500000,9046790,457546790,False,7
2093,validator_6,113352918698,True,576100003,1931600,578031603,True,3
2094,validator_42,47627079020,True,608800000,20446910,629246910,False,1
2095,validator_7,104318515690,True,698200000,9483100,707683100,False,3
2096,validator_24,46775067300,True,645259999,24606720,669866719,True,1
2097,validator_26,47836954389,True,621519999,17199800,638719799,True,1
2098,validator_1,398908089330,True,742200000,20277700,762477700,False,12
2099,validator_19,45930148297,True,492559996,7406600,499966596,True,1
2100,validator_0,425853969188,True,836100002,2010830,838110832,True,13
2101,validator_7,104745301220,True,425400000,1385530,426785530,False,3
2102,validator_5,154318768640,True,631600000,23152430,654752430,False,4
2103,validator_0,426488078088,True,624980000,9128900,634108900,True,13
2104,validator_5,154980922100,True,652500000,9653460,662153460,False,4
2105,validator_43,44890580310,True,466000000,3151400,469151400,False,1
2106,validator_17,52605368131,True,669060002,40690230,709750232,True,1
2107,validator_42,48237350750,True,609000000,1271730,610271730,False,1
2108,validator_12,49258233294,True,721000002,19901300,740901302,True,1
2109,validator_7,105319774920,True,555300000,19173700,574473700,False,3
2110,validator_29,48075321540,True,808700000,6225320,814925320,False,1
2111,validator_36,49288848200,True,663600000,10295020,673895020,False,1
2112,validator_7,105937619120,True,608320000,9524200,617844200,False,3
2113,validator_2,279637947341,True,806400004,2559030,808959034,True,8
2114,validator_2,280222879604,True,576220003,8712260,584932263,True,8
2115,validator_1,399604165660,True,654100000,41976330,696076330,False,12
2116,validator_0,427019960883,True,530099995,1782800,531882795,True,13
2117,validator_13,45069672209,True,545840002,28120740,573960742,True,1
2118,validator_32,45849736420,True,735900000,3350570,739250570,False,1
2119,validator_19,46605234652,True,636839995,38246360,675086355,True,1
2120,validator_36,49760637500,True,470200000,1589300,471789300,False,1
2121,validator_23,50037854481,True,611100002,20602820,631702822,True,1
2122,validator_45,51041132070,True,769500000,2446530,771946530,False,1
2123,validator_6,114228053035,True,863739997,11394340,875134337,True,3
2124,validator_37,48643166160,True,626700000,19274350,645974350,False,1
2125,validator_22,57665060693,True,649479999,59365030,708845029,True,1
2126,validator_1,400273864860,True,667200000,2499200,669699200,False,12
2127,validator_48,53133651320,True,655700000,11304140,667004140,False,1
2128,validator_18,58850887663,True,497699999,10049650,507749649,True,1
2129,validator_7,106546797580,True,606600000,2578460,609178460,False,3
2130,validator_5,155556547330,True,560300000,15325230,575625230,False,4
2131,validator_3,242865901010,True,666100000,6510900,672610900,False,7
2132,validator_1,400904280350,True,609400000,21015490,630415490,False,12
2133,validator_0,427713908625,True,664220002,29727740,693947742,True,13
2134,validator_6,115231536337,True,991946002,11537300,1003483302,True,3
2135,validator_1,401455826340,True,543900000,7645990,551545990,False,12
2136,validator_1,401928820770,True,463400000,9594430,472994430,False,12
2137,validator_44,50711468450,True,477800000,2840470,480640470,False,1
2138,validator_6,115916892807,True,666980000,18376470,685356470,True,3
2139,validator_48,53775043780,True,632800000,8592460,641392460,False,1
2140,validator_0,428466622373,True,748999998,3713750,752713748,True,13
2141,validator_1,402477121070,True,536900000,11400300,548300300,False,12
2142,validator_22,58103098494,True,435320001,2717800,438037801,True,1
2143,validator_1,403007881260,True,529100000,1660190,530760190,False,12
2144,validator_35,52379572690,True,626700000,33846340,660546340,False,1
2145,validator_2,280802807948,True,553124004,26804340,579928344,True,8
2146,validator_2,281584752907,True,758739999,23204960,781944959,True,8
2147,validator_0,429084652410,True,604039997,13990040,618030037,True,13
2148,validator_49,45392348470,True,615400000,37876030,653276030,False,1
2149,validator_1,403645504780,True,636800000,823520,637623520,False,12
2150,validator_44,51355866960,True,641100000,3298510,644398510,False,1
2151,validator_7,107128745580,True,580300000,1648000,581948000,False,3
2152,validator_0,429773776077,True,674339997,14783670,689123667,True,13
2153,validator_1,404387654660,True,704700000,37449880,742149880,False,12
2154,validator_31,43490984290,True,773900000,2578230,776478230,False,1
2155,validator_1,405026364890,True,618700000,20010230,638710230,False,12
2156,validator_2,282287060783,True,694739996,7567880,702307876,True,8
2157,validator_0,430613192461,True,818800004,20616380,839416384,True,13
2158,validator_1,405643953250,True,614400000,3188360,617588360,False,12
2159,validator_43,45536984530,True,643300000,3104220,646404220,False,1
2160,validator_3,243428343520,True,554800000,7642510,562442510,False,7
2161,validator_2,282997023626,True,689840003,20122840,709962843,True,8
2162,validator_0,431291098365,True,662740004,15165900,677905904,True,13
2163,validator_0,432153372200,True,817399995,44873840,862273835,True,13
2164,validator_23,50724493369,True,667239998,19398890,686638888,True,1
2165,validator_5,156078506630,True,518400000,3559300,521959300,False,4
2166,validator_7,107767117080,True,636100000,2271500,638371500,False,3
2167,validator_20,52371575486,True,865239995,7179900,872419895,True,1
2168,validator_6,116537780540,True,613380003,7507730,620887733,True,3
2169,validator_0,433005386718,True,827369998,24644520,852014518,True,13
2170,validator_7,108233814580,True,464700000,1997500,466697500,False,3
2171,validator_4,145187294160,True,494220000,9987200,504207200,True,4
2172,validator_30,43199841360,True,569800000,18768000,588568000,False,1
2173,validator_2,283507543121,True,506239995,4279500,510519495,True,8
2174,validator_32,46481026320,True,629700000,1589900,631289900,False,1
2175,validator_1,406419273170,True,748500000,26819920,775319920,False,12
2176,validator_14,49296296456,True,562340001,7299130,569639131,True,1
2177,validator_48,54444461990,True,667000000,2418210,669418210,False,1
2178,validator_0,433647606841,True,633200003,9020120,642220123,True,13
2179,validator_0,434486001976,True,772120005,66275130,838395135,True,13
2180,validator_10,50710020778,True,712279994,18419150,730699144,True,1
2181,validator_0,435314979477,True,826440001,2537500,828977501,True,13
2182,validator_22,58861382497,True,725780003,32504000,758284003,True,1
2183,validator_17,53407374560,True,770039999,31966430,802006429,True,1
2184,validator_48,55090527090,True,619700000,26365100,646065100,False,1
2185,validator_3,244082635690,True,636000000,18292170,654292170,False,7
2186,validator_1,406843470560,True,420900000,3297390,424197390,False,12
2187,validator_0,436237429007,True,916300000,6149530,922449530,True,13
2188,validator_6,117364300258,True,801379998,25139720,826519718,True,3
2189,validator_25,46709787078,True,524559997,8529680,533089677,True,1
2190,validator_2,284218720772,True,696399991,14777660,711177651,True,8
2191,validator_39,42854658880,True,664800000,2801800,667601800,False,1
2192,validator_40,45738972360,True,717600000,6794100,724394100,False,1
2193,validator_36,50341335800,True,578200000,2498300,580698300,False,1
2194,validator_4,145755710803,True,548980003,19436640,568416643,True,4
2195,validator_3,244763697920,True,679700000,1362230,681062230,False,7
2196,validator_0,436896130524,True,620517997,38183520,658701517,True,13
2197,validator_0,437717668818,True,814765994,6772300,821538294,True,13
2198,validator_10,51377001679,True,641854001,25126900,666980901,True,1
2199,validator_0,438419522315,True,680139997,21713500,701853497,True,13
2200,validator_0,439050165883,True,625520008,5123560,630643568,True,13
2201,validator_1,407371559590,True,523600000,4489030,528089030,False,12
2202,validator_3,245345226360,True,555700000,25828440,581528440,False,7
2203,validator_0,439777767662,True,607063989,120537790,727601779,True,13
2204,validator_2,284786335270,True,564100008,3514490,567614498,True,8
2205,validator_2,285542133126,True,749057996,6739860,755797856,True,8
2206,validator_1,407889006700,True,514350000,3097110,517447110,False,12
2207,validator_21,51904243533,True,884740004,13700900,898440904,True,1
2208,validator_3,246021375550,True,672800000,3349190,676149190,False,7
2209,validator_2,286441286026,True,871120000,28032900,899152900,True,8
2210,validator_4,146439821989,True,653500006,30611180,684111186,True,4
2211,validator_24,47539263335,True,716199995,47996040,764196035,True,1
2212,validator_0,440233350121,True,447299999,8282460,455582459,True,13
2213,validator_4,147211898722,True,769600003,2476730,772076733,True,4
2214,validator_0,440867222920,True,623519999,10352800,633872799,True,13
2215,validator_0,441569583059,True,671829999,30530140,702360139,True,13
2216,validator_0,442158665265,True,554440006,34642200,589082206,True,13
2217,validator_0,442756101964,True,594499999,2936700,597436699,True,13
2218,validator_2,287123791726,True,640640000,41865700,682505700,True,8
2219,validator_0,443377031033,True,593599999,27329070,620929069,True,13
2220,validator_5,156721137230,True,619800000,22830600,642630600,False,4
2221,validator_3,246401366370,True,375700000,4290820,379990820,False,7
2222,validator_1,408712052810,True,812900000,10146110,823046110,False,12
2223,validator_1,409360288740,True,636400000,11835930,648235930,False,12
2224,validator_4,147669923550,True,410224008,47800820,458024828,True,4
2225,validator_2,287783571161,True,630667995,29111440,659779435,True,8
2226,validator_31,44026662570,True,515500000,20178280,535678280,False,1
2227,validator_0,444035360236,True,634600003,23729200,658329203,True,13
2228,validator_4,148354739155,True,682599995,2215610,684815605,True,4
2229,validator_23,51409687463,True,663540004,21654090,685194094,True,1
2230,validator_36,50888060230,True,528100000,18624430,546724430,False,1
2231,validator_18,59565534904,True,707620001,7027240,714647241,True,1
2232,validator_1,409880228040,True,516700000,3239300,519939300,False,12
2233,validator_37,49158390960,True,512300000,2924800,515224800,False,1
2234,validator_1,410484856040,True,602800000,1828000,604628000,False,12
2235,validator_2,288237930157,True,440411996,13947000,454358996,True,9
2236,validator_21,52746677123,True,815100000,27333590,842433590,True,1
2237,validator_0,444883542942,True,823900006,24282700,848182706,True,13
2238,validator_14,50044190477,True,746500001,1394020,747894021,True,1
2239,validator_4,149066793618,True,691599993,20454470,712054463,True,4
2240,validator_0,445661737119,True,741579997,36614180,778194177,True,13
2241,validator_5,157300537870,True,569600000,9800640,579400640,False,4
2242,validator_0,446184119154,True,454325995,68056040,522382035,True,13
2243,validator_7,108862042780,True,618200000,10028200,628228200,False,3
2244,validator_33,52258268390,True,805600000,2164740,807764740,False,1
2245,validator_0,446963386279,True,752703995,26563130,779267125,True,13
2246,validator_1,411205118240,True,715500000,4762200,720262200,False,12
2247,validator_0,447696038996,True,696019997,36632720,732652717,True,13
2248,validator_26,48624159788,True,753966009,33239390,787205399,True,1
2249,validator_2,288735613394,True,494219997,3463240,497683237,True,9
2250,validator_3,246782489150,True,360700000,20422780,381122780,False,7
2251,validator_6,118184465557,True,788339999,31825300,820165299,True,3
2252,validator_5,157896526710,True,592200000,3788840,595988840,False,4
2253,validator_18,60322492005,True,724728001,32229100,756957101,True,1
2254,validator_3,247427374690,True,620600000,24285540,644885540,False,7
2255,validator_2,289537456027,True,780345993,21496640,801842633,True,9
2256,validator_6,119003538229,True,798080002,20992670,819072672,True,3
2257,validator_16,47722607670,True,592939998,6363600,599303598,True,1
2258,validator_3,248077801120,True,641300000,9126430,650426430,False,7
2259,validator_0,448484453790,True,783099994,5314800,788414794,True,14
2260,validator_3,248624857260,True,542800000,4256140,547056140,False,7
2261,validator_1,411866103640,True,656400000,4585400,660985400,False,12
2262,validator_0,449327184234,True,834400004,8330440,842730444,True,14
2263,validator_2,290316723227,True,771340000,7927200,779267200,True,9
2264,validator_1,412411117510,True,526400000,18613870,545013870,False,12
2265,validator_2,290991660528,True,635960001,38977300,674937301,True,9
2266,validator_0,449936856820,True,576039996,33632590,609672586,True,14
2267,validator_31,44497393700,True,468700000,2031130,470731130,False,1
2268,validator_2,291599487560,True,574560002,33267030,607827032,True,9
2269,validator_14,50367226196,True,311499999,11535720,323035719,True,1
2270,validator_0,450613677649,True,649973999,26846830,676820829,True,14
2271,validator_3,249429812550,True,789400000,15555290,804955290,False,7
2272,validator_0,451603998453,True,937860004,52460800,990320804,True,14
2273,validator_1,412975311410,True,562700000,1493900,564193900,False,12
2274,validator_0,452278549780,True,669299987,5251340,674551327,True,14
2275,validator_5,158403304730,True,500700000,6078020,506778020,False,4
2276,validator_7,109610089970,True,744900000,3147190,748047190,False,3
2277,validator_1,413566037810,True,587400000,3326400,590726400,False,12
2278,validator_22,59531242624,True,636099997,33760130,669860127,True,1
2279,validator_9,50425074903,True,805499997,2096600,807596597,True,1
2280,validator_22,60062183560,True,523100006,7840930,530940936,True,1
2281,validator_1,414147294010,True,579000000,2256200,581256200,False,12
2282,validator_14,51260707338,True,873620002,19861140,893481142,True,1
2283,validator_34,45823364610,True,497400000,20580100,517980100,False,1
2284,validator_5,158949007400,True,544610000,1092670,545702670,False,4
2285,validator_23,51974842964,True,527800001,37355500,565155501,True,1
2286,validator_15,49833799279,True,664300000,7514520,671814520,True,1
2287,validator_2,292332849791,True,724800001,8562230,733362231,True,9
2288,validator_1,414724130030,True,557500000,19336020,576836020,False,12
2289,validator_2,292939273055,True,602599994,3823270,606423264,True,9
2290,validator_27,45301752819,True,742500002,11318020,753818022,True,1
2291,validator_3,250034340320,True,601200000,3327770,604527770,False,7
2292,validator_5,159447835080,True,495400000,3427680,498827680,False,4
2293,validator_32,47232526700,True,730200000,21300380,751500380,False,1
2294,validator_42,48763943150,True,490600000,35992400,526592400,False,1
2295,validator_2,293736037890,True,794120005,2644830,796764835,True,9
2296,validator_48,55746444490,True,654400000,1517400,655917400,False,1
2297,validator_0,452850413277,True,566939997,4923500,571863497,True,14
2298,validator_17,54008405692,True,591774002,9257130,601031132,True,1
2299,validator_20,53085555764,True,687119998,26860280,713980278,True,1
2300,validator_1,415233919960,True,508900000,889930,509789930,False,12
2301,validator_5,160174111570,True,704300000,21976490,726276490,False,5
2302,validator_3,250776418350,True,741000000,1078030,742078030,False,7
2303,validator_3,251443921280,True,656800000,10702930,667502930,False,7
2304,validator_3,252125861220,True,672000000,9939940,681939940,False,7
2305,validator_0,453946034371,True,1093999994,1621100,1095621094,True,14
2306,validator_34,46371304500,True,546900000,1039890,547939890,False,1
2307,validator_6,119725706431,True,675620002,46548200,722168202,True,3
2308,validator_14,52041113758,True,760620000,19786420,780406420,True,1
2309,validator_1,415923531500,True,679800000,9811540,689611540,False,12
2310,validator_45,51550546870,True,489600000,19814800,509414800,False,1
2311,validator_17,54664660208,True,654899996,1354520,656254516,True,1
2312,validator_23,52645755991,True,663539997,7373030,670913027,True,1
2313,validator_40,46219088530,True,477900000,2216170,480116170,False,1
2314,validator_47,47457376290,True,706200000,34645230,740845230,False,1
2315,validator_23,53275422593,True,600906002,28760600,629666602,True,1
2316,validator_25,47600823617,True,864757989,26278550,891036539,True,1
2317,validator_3,252856111490,True,728400000,1850270,730250270,False,7
2318,validator_3,253359991850,True,500400000,3480360,503880360,False,7
2319,validator_32,47724115800,True,489500000,2089100,491589100,False,1
2320,validator_3,253788938950,True,418700000,10247100,428947100,False,7
2321,validator_1,416464343730,True,531600000,9212230,540812230,False,13
2322,validator_35,52947640160,True,558200000,9867470,568067470,False,1
2323,validator_2,294581909518,True,808559998,37311630,845871628,True,9
2324,validator_7,110215910180,True,603500000,2320210,605820210,False,3
2325,validator_31,45158906570,True,658900000,2612870,661512870,False,1
2326,validator_18,61071457044,True,725153999,23811040,748965039,True,1
2327,validator_1,416995365040,True,528900000,2121310,531021310,False,13
2328,validator_1,417609320340,True,610570000,3385300,613955300,False,13
2329,validator_2,295348275449,True,756640001,9725930,766365931,True,9
2330,validator_1,418200216840,True,584900000,5996500,590896500,False,13
2331,validator_12,49791646493,True,510899999,22513200,533413199,True,1
2332,validator_1,418802990980,True,597100000,5674140,602774140,False,13
2333,validator_5,160874429950,True,688200000,12118380,700318380,False,5
2334,validator_0,454807637595,True,852940004,8663220,861603224,True,14
2335,validator_1,419547487410,True,741900000,2596430,744496430,False,13
2336,validator_7,110876365940,True,659000000,1455760,660455760,False,3
2337,validator_18,61927094070,True,827740006,27897020,855637026,True,1
2338,validator_0,455637430475,True,802610000,27182880,829792880,True,14
2339,validator_41,41689395310,True,501800000,1014930,502814930,False,1
2340,validator_0,456533167093,True,892599998,3136620,895736618,True,14
2341,validator_0,457274297996,True,716020003,25110900,741130903,True,14
2342,validator_36,51454225320,True,558490000,7675090,566165090,False,1
2343,validator_18,62524980779,True,536799989,61086720,597886709,True,1
2344,validator_26,49085910358,True,416990000,44760570,461750570,True,1
2345,validator_7,111313584360,True,434470000,2748420,437218420,False,3
2346,validator_0,457866923367,True,556250001,36375370,592625371,True,14
2347,validator_17,55404583299,True,701040001,38883090,739923091,True,1
2348,validator_27,45950754753,True,646399994,2601940,649001934,True,1
2349,validator_2,295881337426,True,522719997,10341980,533061977,True,9
2350,validator_38,47925375640,True,677400000,4380240,681780240,False,1
2351,validator_24,48279591276,True,729620001,10707940,740327941,True,1
2352,validator_0,458579045305,True,692099998,20021940,712121938,True,14
2353,validator_39,43472631670,True,616000000,1972790,617972790,False,1
2354,validator_38,48437340000,True,487600000,24364360,511964360,False,1
2355,validator_23,53856414286,True,563458003,17533690,580991693,True,1
2356,validator_4,149879474157,True,808599999,4080540,812680539,True,4
2357,validator_24,49149040534,True,848259998,21189260,869449258,True,1
2358,validator_0,459260466063,True,673699998,7720760,681420758,True,14
2359,validator_1,420100435870,True,532600000,20348460,552948460,False,13
2360,validator_25,48216805714,True,605939997,10042100,615982097,True,1
2361,validator_1,420652228560,True,542100000,9692690,551792690,False,13
2362,validator_15,50643537403,True,778768004,30970120,809738124,True,1
2363,validator_32,48214809900,True,488200000,2494100,490694100,False,1
2364,validator_17,56095790177,True,682499998,8706880,691206878,True,1
2365,validator_0,459921347878,True,636320005,24561810,660881815,True,14
2366,validator_47,48196094540,True,736100000,2618250,738718250,False,1
2367,validator_3,254481186020,True,686200000,6047070,692247070,False,7
2368,validator_2,296697142626,True,800500000,15305200,815805200,True,9
2369,validator_1,421395398860,True,719000000,24170300,743170300,False,13
2370,validator_23,54454061425,True,576599999,21047140,597647139,True,1
2371,validator_1,422096428090,True,672800000,28229230,701029230,False,13
2372,validator_16,48322131610,True,572800000,26723940,599523940,True,1
2373,validator_7,112225983210,True,902100000,10298850,912398850,False,3
2374,validator_2,297439014794,True,730099998,11772170,741872168,True,9
2375,validator_18,63088222023,True,554280004,8961240,563241244,True,1
2376,validator_5,161437754250,True,557100000,6224300,563324300,False,5
2377,validator_11,48751699227,True,905020001,37397900,942417901,True,1
2378,validator_1,422489282490,True,386600000,6254400,392854400,False,13
2379,validator_18,63454670199,True,363500006,2948170,366448176,True,1
2380,validator_28,53458515083,True,978620000,38607900,1017227900,True,1
2381,validator_0,460805257375,True,855357997,28551500,883909497,True,14
2382,validator_0,461464837094,True,653379999,6199720,659579719,True,14
2383,validator_1,422981664840,True,490300000,2082350,492382350,False,13
2384,validator_2,298103556012,True,653899998,10641220,664541218,True,9
2385,validator_18,64228664201,True,740420002,33574000,773994002,True,2
2386,validator_27,46756480154,True,803240001,2485400,805725401,True,1
2387,validator_15,51196913500,True,529658007,23718090,553376097,True,1
2388,validator_40,46803505320,True,577400000,7016790,584416790,False,1
2389,validator_37,49679894600,True,514600000,6903640,521503640,False,1
2390,validator_0,462187231819,True,704680005,17714720,722394725,True,14
2391,validator_0,462993524560,True,798520001,7772740,806292741,True,14
2392,validator_1,423801163810,True,798600000,20898970,819498970,False,13
2393,validator_11,49460306938,True,680210001,28397710,708607711,True,1
2394,validator_2,298939467320,True,806280008,29631300,835911308,True,9
2395,validator_0,463828305794,True,820526004,14255230,834781234,True,14
2396,validator_1,424172148910,True,327700000,43285100,370985100,False,13
2397,validator_41,42336803250,True,622400000,25007940,647407940,False,1
2398,validator_46,49775286620,True,704900000,4167200,709067200,False,1
2399,validator_48,56325549320,True,570000000,9104830,579104830,False,1
2400,validator_6,120564089401,True,821640000,16742970,838382970,True,3
2401,validator_36,52187986170,True,729600000,4160850,733760850,False,1
2402,validator_24,49883342357,True,717960003,16341820,734301823,True,1
2403,validator_4,150761208940,True,858240003,23494780,881734783,True,4
2404,validator_49,45996375670,True,599900000,4127200,604027200,False,1
2405,validator_3,255102680650,True,617600000,3894630,621494630,False,7
2406,validator_0,464495397943,True,647699999,19392150,667092149,True,14
2407,validator_31,45816729070,True,654100000,3722500,657822500,False,1
2408,validator_3,255657491730,True,549800000,5011080,554811080,False,7
2409,validator_42,49251321170,True,477100000,10278020,487378020,False,1
2410,validator_0,465348173051,True,843200008,9575100,852775108,True,14
2411,validator_4,151508134798,True,724199998,22725860,746925858,True,4
2412,validator_0,465943344457,True,549385996,45785410,595171406,True,14
2413,validator_46,50319982680,True,533700000,10996060,544696060,False,1
2414,validator_30,43689497300,True,486500000,3155940,489655940,False,1
2415,validator_36,52857056510,True,656200000,12870340,669070340,False,1
2416,validator_0,466677370957,True,732200000,1826500,734026500,True,14
2417,validator_0,467146599941,True,449805994,19422990,469228984,True,14
2418,validator_0,467880190069,True,661739998,71850130,733590128,True,14
2419,validator_1,424603129440,True,422000000,8980530,430980530,False,13
2420,validator_1,425128335570,True,521900000,3306130,525206130,False,13
2421,validator_5,161959450410,True,516100000,5596160,521696160,False,5
2422,validator_1,425691397670,True,559200000,3862100,563062100,False,13
2423,validator_13,45833708808,True,735493999,28542600,764036599,True,1
2424,validator_0,468614504967,True,688005998,46308900,734314898,True,14
2425,validator_3,256151920530,True,491900000,2528800,494428800,False,8
2426,validator_0,469518859100,True,900900003,3454130,904354133,True,14
2427,validator_1,426155914470,True,463300000,1216800,464516800,False,13
2428,validator_27,47546692375,True,758000001,32212220,790212221,True,1
2429,validator_41,42909376350,True,569900000,2673100,572573100,False,1
2430,validator_39,44041805540,True,563400000,5773870,569173870,False,1
2431,validator_3,256540334750,True,387000000,1414220,388414220,False,8
2432,validator_33,52890560410,True,629900000,2392020,632292020,False,1
2433,validator_10,52213966312,True,821040003,15924630,836964633,True,1
2434,validator_1,426726214190,True,560600000,9699720,570299720,False,13
2435,validator_1,427179724920,True,432000000,21510730,453510730,False,13
2436,validator_31,46391785370,True,550900000,24156300,575056300,False,1
2437,validator_3,257248647480,True,706100000,2212730,708312730,False,8
2438,validator_39,44733331960,True,681400000,10126420,691526420,False,1
2439,validator_43,46164247440,True,608500000,18762910,627262910,False,1
2440,validator_2,299489250326,True,529020006,20763000,549783006,True,9
2441,validator_4,152176008099,True,645700001,22173300,667873301,True,4
2442,validator_37,50377901400,True,695500000,2506800,698006800,False,1
2443,validator_3,257786061520,True,535000000,2414040,537414040,False,8
2444,validator_30,44361448980,True,670700000,1251680,671951680,False,1
2445,validator_0,470249572332,True,711200002,19513230,730713232,True,14
2446,validator_3,258459573210,True,671300000,2211690,673511690,False,8
2447,validator_25,48718971842,True,491299998,10866130,502166128,True,1
2448,validator_0,470867569627,True,608899995,9097300,617997295,True,14
2449,validator_1,427851569620,True,664300000,7544700,671844700,False,13
2450,validator_3,258940007740,True,471100000,9334530,480434530,False,8
2451,validator_15,51867870197,True,640679997,30276700,670956697,True,1
2452,validator_5,162700168880,True,735000000,5718470,740718470,False,5
2453,validator_3,259560417540,True,596100000,24309800,620409800,False,8
2454,validator_14,52693357857,True,639699999,12544100,652244099,True,1
2455,validator_21,53422180452,True,640379999,35123330,675503329,True,1
2456,validator_33,53445539630,True,548200000,6779220,554979220,False,1
2457,validator_3,259979399340,True,415500000,3481800,418981800,False,8
2458,validator_2,300199087855,True,645219999,64617530,709837529,True,9
2459,validator_5,163206898900,True,496400000,10330020,506730020,False,5
2460,validator_42,50046495130,True,774800000,20373960,795173960,False,1
2461,validator_47,49116980980,True,917400000,3486440,920886440,False,1
2462,validator_10,52742548534,True,508500002,20082220,528582222,True,1
2463,validator_0,471501176052,True,630600005,3006420,633606425,True,14
2464,validator_32,48770484350,True,553200000,2474450,555674450,False,1
2465,validator_43,46679467140,True,511100000,4119700,515219700,False,1
2466,validator_3,260435086760,True,452600000,3087420,455687420,False,8
2467,validator_3,260860078790,True,423800000,1192030,424992030,False,8
2468,validator_48,57106627060,True,778500000,2577740,781077740,False,1
2469,validator_3,261413693090,True,549200000,4414300,553614300,False,8
2470,validator_43,47161214060,True,470900000,10846920,481746920,False,1
2471,validator_27,48128647408,True,570539993,11415040,581955033,True,1
2472,validator_39,45248628940,True,508600000,6696980,515296980,False,1
2473,validator_1,428773551450,True,915800000,6181830,921981830,False,13
2474,validator_46,50842242400,True,510600000,11659720,522259720,False,1
2475,validator_5,163770320120,True,561300000,2121220,563421220,False,5
2476,validator_6,121175051005,True,597100004,13861600,610961604,True,3
2477,validator_2,300663157157,True,439240002,24829300,464069302,True,9
2478,validator_5,164434395920,True,659700000,4375800,664075800,False,5
2479,validator_0,472198348702,True,687400000,9772650,697172650,True,14
2480,validator_19,47256648550,True,624739998,26673900,651413898,True,1
2481,validator_1,429296973980,True,522020000,1402530,523422530,False,13
2482,validator_3,261924178690,True,507800000,2685600,510485600,False,8
2483,validator_32,49369766990,True,597100000,2182640,599282640,False,1
2484,validator_7,112818177500,True,591300000,894290,592194290,False,3
2485,validator_0,472914930020,True,694039998,22541320,716581318,True,14
2486,validator_18,64932675591,True,684000000,20011390,704011390,True,2
2487,validator_2,301610067175,True,928719998,18190020,946910018,True,9
2488,validator_0,473542850217,True,623439997,4480200,627920197,True,14
2489,validator_4,152865676467,True,678919998,10748370,689668368,True,4
2490,validator_2,302545387817,True,905880002,29440640,935320642,True,9
2491,validator_14,53299554816,True,592299999,13896960,606196959,True,1
2492,validator_3,262446302230,True,497000000,25123540,522123540,False,8
2493,validator_45,52165091470,True,606700000,7844600,614544600,False,1
2494,validator_1,429904767850,True,606100000,1693870,607793870,False,13
2495,validator_30,45115801280,True,752200000,2152300,754352300,False,1
2496,validator_14,53871948514,True,569299998,3093700,572393698,True,1
2497,validator_1,430707360290,True,794000000,8592440,802592440,False,13
2498,validator_9,51071807843,True,609440000,37292940,646732940,True,1
2499,validator_1,431254128060,True,541900000,4867770,546767770,False,13
2500,validator_2,303052485358,True,493780001,13317540,507097541,True,9
2501,validator_1,431836060760,True,559700000,22232700,581932700,False,13
2502,validator_0,474243555492,True,694100005,6605270,700705275,True,14
2503,validator_2,303759827462,True,697580004,9762100,707342104,True,9
2504,validator_49,46486272130,True,466800000,23096460,489896460,False,1
2505,validator_1,432489089080,True,650400000,2628320,653028320,False,13
2506,validator_27,49124108598,True,984740000,10721190,995461190,True,1
2507,validator_8,47861459448,True,801900000,19544340,821444340,True,1
2508,validator_2,304302890223,True,521819991,21242770,543062761,True,9
2509,validator_0,474963504377,True,663034005,56914880,719948885,True,14
2510,validator_43,47594998040,True,424900000,8883980,433783980,False,1
2511,validator_1,433174765510,True,681900000,3776430,685676430,False,13
2512,validator_4,153484004994,True,592099997,26228530,618328527,True,4
2513,validator_8,48437506750,True,567000002,9047300,576047302,True,1
2514,validator_25,49489354942,True,695264000,75119100,770383100,True,1
2515,validator_1,433645429030,True,459190000,11473520,470663520,False,13
2516,validator_40,47315875180,True,505600000,6769860,512369860,False,1
2517,validator_0,475844747819,True,877200002,4043440,881243442,True,14
2518,validator_4,154137028615,True,642740001,10283620,653023621,True,4
2519,validator_24,50684214057,True,773380000,27491700,800871700,True,1
2520,validator_2,305149878951,True,787759998,59228730,846988728,True,9
2521,validator_26,49511535363,True,416300005,9325000,425625005,True,1
2522,validator_28,54170165860,True,690365997,21284780,711650777,True,1
2523,validator_46,51477880400,True,626600000,9038000,635638000,False,1
2524,validator_6,121769061503,True,586799998,7210500,594010498,True,3
2525,validator_0,476545390736,True,690057997,10584920,700642917,True,14
2526,validator_23,55383681758,True,872423993,57196340,929620333,True,1
2527,validator_22,60735733799,True,631699999,41850240,673550239,True,1
2528,validator_36,53583165920,True,724800000,1309410,726109410,False,1
2529,validator_22,61858127802,True,1119300003,3094000,1122394003,True,1
2530,validator_5,165002179300,True,566800000,983380,567783380,False,5
2531,validator_21,54104057689,True,642520007,39357230,681877237,True,1
2532,validator_1,434179463880,True,530300000,3734850,534034850,False,13
2533,validator_38,49027484290,True,589200000,944290,590144290,False,1
2534,validator_2,305817071047,True,645039996,22152100,667192096,True,9
2535,validator_0,477306759056,True,724116000,37252320,761368320,True,14
2536,validator_0,477900974757,True,565300001,28915700,594215701,True,14
2537,validator_3,263081841010,True,616300000,19238780,635538780,False,8
2538,validator_43,48160309010,True,545900000,19410970,565310970,False,1
2539,validator_21,54727429991,True,594886002,28486300,623372302,True,1
2540,validator_4,154870203543,True,730499998,2674930,733174928,True,4
2541,validator_2,306643509304,True,780275997,46162260,826438257,True,9
2542,validator_40,47869888230,True,546500000,7513050,554013050,False,1
2543,validator_0,478945570939,True,1004457992,40138190,1044596182,True,14
2544,validator_37,50975739400,True,595300000,2538000,597838000,False,1
2545,validator_3,263720194380,True,636100000,2253370,638353370,False,8
2546,validator_1,434793449610,True,594100000,19885730,613985730,False,13
2547,validator_13,46545421435,True,686799997,24912630,711712627,True,1
2548,validator_14,54532648944,True,650720010,9980420,660700430,True,1
2549,validator_2,307426673504,True,760080000,23084200,783164200,True,9
2550,validator_3,264489072180,True,759900000,8977800,768877800,False,8
2551,validator_34,47023698370,True,644800000,7593870,652393870,False,1
2552,validator_3,264997290660,True,506000000,2218480,508218480,False,8
2553,validator_3,265617568630,True,616500000,3777970,620277970,False,8
2554,validator_7,113567073340,True,744500000,4395840,748895840,False,3
2555,validator_1,435365185310,True,568200000,3535700,571735700,False,13
2556,validator_2,307988681095,True,553966001,8041590,562007591,True,9
2557,validator_1,436046512050,True,678200000,3126740,681326740,False,13
2558,validator_0,479402562908,True,428329999,28661970,456991969,True,14
2559,validator_2,308727187626,True,729520001,8986530,738506531,True,9
2560,validator_1,436525230970,True,477800000,918920,478718920,False,13
2561,validator_2,309454262519,True,713740003,13334890,727074893,True,9
2562,validator_28,54672323392,True,487660002,14497530,502157532,True,1
2563,validator_7,114392617480,True,824100000,1444140,825544140,False,3
2564,validator_5,165703594340,True,697800000,3615040,701415040,False,5
2565,validator_3,266204086970,True,567000000,19518340,586518340,False,8
2566,validator_2,310103375619,True,610080010,39033090,649113100,True,9
2567,validator_3,266927063070,True,713700000,9276100,722976100,False,8
2568,validator_17,56893183177,True,754720000,42673000,797393000,True,1
2569,validator_14,55204838939,True,663619995,8570000,672189995,True,1
2570,validator_1,437092746310,True,565500000,2015340,567515340,False,13
2571,validator_27,50046113070,True,900940002,21064470,922004472,True,1
2572,validator_2,310879603569,True,769854000,6373950,776227950,True,9
2573,validator_25,50390564531,True,868359999,32849590,901209589,True,1
2574,validator_6,122423831696,True,627200003,27570190,654770193,True,3
2575,validator_2,311501772289,True,615000000,7168720,622168720,True,9
2576,validator_0,480229381735,True,816299997,10518830,826818827,True,15
2577,validator_31,47027789200,True,626900000,9103830,636003830,False,1
2578,validator_2,312105124368,True,601199999,2152080,603352079,True,9
2579,validator_30,45861613750,True,742800000,3012470,745812470,False,1
2580,validator_2,312776372569,True,657520001,13728200,671248201,True,9
2581,validator_10,53671791554,True,914919990,14323030,929243020,True,1
2582,validator_9,51698160877,True,583740004,42613030,626353034,True,1
2583,validator_7,115003714960,True,585500000,25597480,611097480,False,3
2584,validator_6,123429143985,True,957419999,47892290,1005312289,True,3
2585,validator_0,480865752109,True,629073994,7296380,636370374,True,15
2586,validator_41,43458628550,True,539100000,10152200,549252200,False,1
2587,validator_2,313401620777,True,615299998,9948210,625248208,True,9
2588,validator_0,481583246319,True,703299990,14194220,717494210,True,15
2589,validator_27,50787016440,True,732100000,8803370,740903370,True,1
2590,validator_0,482311097607,True,687475998,40375290,727851288,True,15
2591,validator_24,51528943271,True,827139994,17589220,844729214,True,1
2592,validator_22,62695582974,True,776558002,60897170,837455172,True,1
2593,validator_38,49597350910,True,566000000,3866620,569866620,False,1
2594,validator_15,52778170192,True,882720005,27579990,910299995,True,1
2595,validator_4,155502858534,True,624719991,7935000,632654991,True,4
2596,validator_1,437660072770,True,541200000,26126460,567326460,False,13
2597,validator_2,313982033657,True,564114000,16298880,580412880,True,9
2598,validator_0,483081284729,True,768040002,2147120,770187122,True,15
2599,validator_8,49030680988,True,573219998,19954240,593174238,True,1
2600,validator_28,55279483105,True,599979993,7179720,607159713,True,1
2601,validator_0,483892303801,True,805020002,5999070,811019072,True,15
2602,validator_2,314630522257,True,620860000,27628600,648488600,True,9
2603,validator_0,484639932313,True,731240002,16388510,747628512,True,15
2604,validator_0,485155946754,True,495274001,20740440,516014441,True,15
2605,validator_36,54119790160,True,534600000,2024240,536624240,False,1
2606,validator_1,438288485070,True,602600000,25812300,628412300,False,13
2607,validator_4,156083030341,True,548719997,31451810,580171807,True,4
2608,validator_6,124211066107,True,771100002,10822120,781922122,True,3
2609,validator_27,51568141229,True,778399989,2724800,781124789,True,1
2610,validator_2,315432080114,True,793740007,7817850,801557857,True,9
2611,validator_0,485757068795,True,584860011,16262030,601122041,True,15
2612,validator_36,54806331640,True,685000000,1541480,686541480,False,1
2613,validator_14,55888647463,True,654399994,29408530,683808524,True,1
2614,validator_1,438909642300,True,601200000,19957230,621157230,False,13
2615,validator_0,486407581095,True,641520000,8992300,650512300,True,15
2616,validator_19,48115596325,True,793665995,65281780,858947775,True,1
2617,validator_1,439381373230,True,468700000,3030930,471730930,False,13
2618,validator_7,115436008160,True,425900000,6393200,432293200,False,3
2619,validator_25,50953262363,True,553200002,9497830,562697832,True,1
2620,validator_2,316100722480,True,631100006,37542360,668642366,True,9
2621,validator_7,116075427010,True,637200000,2218850,639418850,False,3
2622,validator_2,316737629594,True,604620004,32287110,636907114,True,9
2623,validator_0,487234146731,True,794499996,32065640,826565636,True,15
2624,validator_18,65693788887,True,746619996,14493300,761113296,True,2
2625,validator_18,66224979508,True,506040001,25150620,531190621,True,2
2626,validator_18,66763105244,True,523819996,14305740,538125736,True,2
2627,validator_33,53931782930,True,483200000,3043300,486243300,False,1
2628,validator_2,317348683191,True,596759997,14293600,611053597,True,9
2629,validator_47,49704926720,True,585000000,2945740,587945740,False,1
2630,validator_19,48736577727,True,612960002,8021400,620981402,True,1
2631,validator_13,47248099535,True,686140000,16538100,702678100,True,1
2632,validator_10,54335044093,True,607439999,55812540,663252539,True,1
2633,validator_0,487988765326,True,739980005,14638590,754618595,True,15
2634,validator_3,267544095210,True,612500000,4532140,617032140,False,8
2635,validator_42,50730464150,True,677200000,6769020,683969020,False,1
2636,validator_0,488567943239,True,568320003,10857910,579177913,True,15
2637,validator_2,318054774293,True,688120002,17971100,706091102,True,9
2638,validator_1,439950459930,True,565900000,3186700,569086700,False,13
2639,validator_0,489540662650,True,943640001,29079410,972719411,True,15
2640,validator_0,490204379154,True,606600004,57116500,663716504,True,15
2641,validator_0,490933336954,True,720620000,8337800,728957800,True,15
2642,validator_1,440613093420,True,661200000,1433490,662633490,False,13
2643,validator_49,47172653150,True,679200000,7181020,686381020,False,1
2644,validator_33,54431464720,True,497300000,2381790,499681790,False,1
2645,validator_1,441252348150,True,617900000,21354730,639254730,False,13
2646,validator_1,441764127380,True,485000000,26779230,511779230,False,13
2647,validator_1,442267450400,True,489200000,14123020,503323020,False,13
2648,validator_26,50132700187,True,600899994,20264830,621164824,True,1
2649,validator_5,166176025540,True,469500000,2931200,472431200,False,5
2650,validator_1,442882437520,True,611700000,3287120,614987120,False,13
2651,validator_2,318625752636,True,568300003,2678340,570978343,True,9
2652,validator_11,50381407930,True,887639992,33461000,921100992,True,1
2653,validator_11,50908118033,True,525400003,1310100,526710103,True,1
2654,validator_25,51684164892,True,713720009,17182520,730902529,True,1
2655,validator_2,319229957577,True,602700001,1504940,604204941,True,9
2656,validator_3,268131852110,True,564300000,23456900,587756900,False,8
2657,validator_1,443486583560,True,595800000,8346040,604146040,False,13
2658,validator_2,320087019695,True,801559998,55502120,857062118,True,10
2659,validator_10,54997963791,True,637013998,25905700,662919698,True,1
2660,validator_9,52583848383,True,881200006,4487500,885687506,True,1
2661,validator_31,47489826530,True,459600000,2437330,462037330,False,1
2662,validator_1,444173722700,True,674300000,12839140,687139140,False,13
2663,validator_1,444698363440,True,520600000,4040740,524640740,False,13
2664,validator_3,268494618800,True,360340000,2426690,362766690,False,8
2665,validator_3,269118890000,True,608400000,15871200,624271200,False,8
2666,validator_37,51710150100,True,733600000,810700,734410700,False,1
2667,validator_0,491809407165,True,846560011,29510200,876070211,True,15
2668,validator_32,50164177920,True,793600000,810930,794410930,False,1
2669,validator_17,57438701439,True,543400002,2118260,545518262,True,1
2670,validator_7,116876722940,True,795000000,6295930,801295930,False,3
2671,validator_17,57990208336,True,541399997,10106900,551506897,True,1
2672,validator_1,445374582180,True,673100000,3118740,676218740,False,13
2673,validator_1,445927252160,True,515500000,37169980,552669980,False,13
2674,validator_2,320916677491,True,819200006,10457790,829657796,True,10
2675,validator_1,446585978230,True,655500000,3226070,658726070,False,13
2676,validator_0,492526421802,True,691983997,25030640,717014637,True,15
2677,validator_7,117396240140,True,518300000,1217200,519517200,False,3
2678,validator_49,47768468940,True,594180000,1635790,595815790,False,1
2679,validator_44,51797852610,True,422600000,19385650,441985650,False,1
2680,validator_18,67364522243,True,597899999,3517000,601416999,True,2
2681,validator_27,52100711529,True,511480000,21090300,532570300,True,1
2682,validator_1,447323884260,True,734500000,3406030,737906030,False,13
2683,validator_3,269547448670,True,426500000,2058670,428558670,False,8
2684,validator_12,50716664472,True,886958009,38059970,925017979,True,1
2685,validator_38,50278430610,True,680000000,1079700,681079700,False,1
2686,validator_30,46224281850,True,360900000,1768100,362668100,False,1
2687,validator_47,50432284670,True,726500000,857950,727357950,False,1
2688,validator_1,447814182230,True,487300000,2997970,490297970,False,13
2689,validator_1,448571108000,True,747500000,9425770,756925770,False,14
2690,validator_0,493375010849,True,846599997,1989050,848589047,True,15
2691,validator_1,449255610130,True,675300000,9202130,684502130,False,14
2692,validator_0,493948762970,True,561540001,12212120,573752121,True,15
2693,validator_15,53418239584,True,630379992,9689400,640069392,True,1
2694,validator_28,56031465338,True,743600003,8382230,751982233,True,1
2695,validator_15,54106465411,True,667199997,21025830,688225827,True,1
2696,validator_3,270341519020,True,788100000,5970350,794070350,False,8
2697,validator_0,494615117481,True,656599991,9754520,666354511,True,15
2698,validator_7,117970296080,True,555300000,18755940,574055940,False,3
2699,validator_2,321546713731,True,625400000,4636240,630036240,True,10
2700,validator_2,322181325912,True,624540001,10072180,634612181,True,10
2701,validator_18,67807034174,True,438900001,3611930,442511931,True,2
2702,validator_45,52711245370,True,542900000,3253900,546153900,False,1
2703,validator_16,49048363819,True,720360009,5872200,726232209,True,1
2704,validator_49,48321513740,True,548900000,4144800,553044800,False,1
2705,validator_5,166764771040,True,586300000,2445500,588745500,False,5
2706,validator_4,156776098748,True,690700007,2368400,693068407,True,4
2707,validator_43,48731702740,True,550800000,20593730,571393730,False,1
2708,validator_32,50608286380,True,442500000,1608460,444108460,False,1
2709,validator_1,449772396770,True,514460000,2326640,516786640,False,14
2710,validator_8,49744855017,True,691863999,22310030,714174029,True,1
2711,validator_3,270910860020,True,565700000,3641000,569341000,False,8
2712,validator_0,495424060286,True,738098005,70844800,808942805,True,15
2713,validator_0,496431617229,True,980740003,26816940,1007556943,True,15
2714,validator_18,68541252092,True,720939998,13277920,734217918,True,2
2715,validator_5,167300071070,True,508500000,26800030,535300030,False,5
2716,validator_0,497062175758,True,590665999,39892530,630558529,True,15
2717,validator_4,157576055250,True,778480002,21476500,799956502,True,4
2718,validator_5,167879584950,True,576100000,3413880,579513880,False,5
2719,validator_0,497646479090,True,577120002,7183330,584303332,True,15
2720,validator_0,498367946384,True,709419994,12047300,721467294,True,15
2721,validator_0,499124298484,True,752600000,3752100,756352100,True,15
2722,validator_22,63570711786,True,859579992,15548820,875128812,True,1
2723,validator_20,53673424671,True,568274007,19594900,587868907,True,1
2724,validator_17,58515115078,True,511420002,13486740,524906742,True,1
2725,validator_12,51508964522,True,773700000,18600050,792300050,True,1
2726,validator_0,499608383733,True,480599999,3485250,484085249,True,15
2727,validator_2,322881297149,True,656259997,43711240,699971237,True,10
2728,validator_0,500290637532,True,672999999,9253800,682253799,True,15
2729,validator_10,55808663760,True,808399999,2299970,810699969,True,1
2730,validator_0,501051779192,True,740800000,20341660,761141660,True,15
2731,validator_28,56863699041,True,809536003,22697700,832233703,True,1
2732,validator_5,168555063210,True,672200000,3278260,675478260,False,5
2733,validator_7,118657713410,True,649400000,38017330,687417330,False,3
2734,validator_1,450303445900,True,524300000,6749130,531049130,False,14
2735,validator_34,47522710170,True,487600000,11411800,499011800,False,1
2736,validator_1,450795846230,True,490300000,2100330,492400330,False,14
2737,validator_49,49042512440,True,718700000,2298700,720998700,False,1
2738,validator_34,48090784870,True,565400000,2674700,568074700,False,1
2739,validator_0,501969833639,True,894500007,23554440,918054447,True,15
2740,validator_0,502539815454,True,566720005,3261810,569981815,True,15
2741,validator_2,323616075305,True,726459996,8318160,734778156,True,10
2742,validator_1,451528617230,True,728800000,3971000,732771000,False,14
2743,validator_0,503012730345,True,430166011,42748880,472914891,True,15
2744,validator_34,48827090840,True,697900000,38405970,736305970,False,1
2745,validator_12,52485261121,True,941465999,34830600,976296599,True,1
2746,validator_2,324295551434,True,655385999,24090130,679476129,True,10
2747,validator_40,48561999520,True,688100000,4011290,692111290,False,1
2748,validator_5,169244048100,True,684800000,4184890,688984890,False,5
2749,validator_10,56679637707,True,867700007,3273940,870973947,True,1
2750,validator_5,169799327540,True,552800000,2479440,555279440,False,5
2751,validator_1,452108597130,True,576200000,3779900,579979900,False,14
2752,validator_0,503626009669,True,586520004,26759320,613279324,True,15
2753,validator_7,119185223610,True,503200000,24310200,527510200,False,3
2754,validator_7,119754869030,True,567700000,1945420,569645420,False,3
2755,validator_35,53586994690,True,637700000,1654530,639354530,False,1
2756,validator_0,504558307834,True,900386005,31912160,932298165,True,15
2757,validator_31,47926997910,True,433700000,3471380,437171380,False,1
2758,validator_3,271502901140,True,585800000,6241120,592041120,False,8
2759,validator_29,48663456440,True,565900000,22234900,588134900,False,1
2760,validator_14,56478906477,True,572099994,18159020,590259014,True,1
2761,validator_2,324816139071,True,516000007,4587630,520587637,True,10
2762,validator_4,158424953352,True,800840002,48058100,848898102,True,4
2763,validator_4,158841326494,True,366860002,49513140,416373142,True,4
2764,validator_22,64493293537,True,892240011,30341740,922581751,True,2
2765,validator_3,272228056740,True,723800000,1355600,725155600,False,8
2766,validator_0,505214569766,True,632799992,23461940,656261932,True,15
2767,validator_15,54727105811,True,611046000,9594400,620640400,True,1
2768,validator_0,505982377201,True,765399995,2407440,767807435,True,15
2769,validator_1,452540655060,True,428100000,3957930,432057930,False,14
2770,validator_1,453162760040,True,617900000,4204980,622104980,False,14
2771,validator_0,506739128037,True,748379996,8370840,756750836,True,15
2772,validator_24,52250135705,True,714199994,6992440,721192434,True,1
2773,validator_18,69198375928,True,636339996,20783840,657123836,True,2
2774,validator_1,453860885210,True,696200000,1925170,698125170,False,14
2775,validator_1,454514757020,True,650100000,3771810,653871810,False,14
2776,validator_5,170344048640,True,542100000,2621100,544721100,False,5
2777,validator_2,325586624987,True,749839996,20645920,770485916,True,10
2778,validator_2,326178210937,True,581413990,10171960,591585950,True,10
2779,validator_2,326928969443,True,690788006,59970500,750758506,True,10
2780,validator_7,120184752230,True,428100000,1783200,429883200,False,3
2781,validator_1,455061589490,True,544600000,2232470,546832470,False,14
2782,validator_39,45904078250,True,630400000,25049310,655449310,False,1
2783,validator_9,53523143385,True,917200002,22095000,939295002,True,1
2784,validator_35,54318311170,True,725400000,5916480,731316480,False,1
2785,validator_41,44101442550,True,640300000,2514000,642814000,False,1
2786,validator_13,47843522438,True,571680003,23742900,595422903,True,1
2787,validator_2,327636053939,True,668599996,38484500,707084496,True,10
2788,validator_4,159544868157,True,701200003,2341660,703541663,True,4
2789,validator_4,160671892036,True,1119299999,7723880,1127023879,True,5
2790,validator_0,507357069373,True,608099996,9841340,617941336,True,15
2791,validator_41,44776925100,True,666100000,9382550,675482550,False,1
2792,validator_40,49088554500,True,525000000,1554980,526554980,False,1
2793,validator_1,455619738500,True,556900000,1249010,558149010,False,14
2794,validator_49,49720794080,True,675100000,3181640,678281640,False,1
2795,validator_3,272883361170,True,645400000,9904430,655304430,False,8
2796,validator_1,456143381910,True,520200000,3443410,523643410,False,14
2797,validator_2,328441768028,True,784999999,20714090,805714089,True,10
2798,validator_43,49330877830,True,592800000,6375090,599175090,False,1
2799,validator_28,57596039769,True,720273998,12066730,732340728,True,1
2800,validator_47,51263452940,True,829600000,1568270,831168270,False,1
2801,validator_5,171143867290,True,778700000,21118650,799818650,False,5
2802,validator_3,273349069470,True,456100000,9608300,465708300,False,8
2803,validator_47,51737417040,True,470800000,3164100,473964100,False,1
2804,validator_26,50761840724,True,627399997,1740540,629140537,True,1
2805,validator_0,507887329280,True,527000007,3259900,530259907,True,15
2806,validator_21,55450918653,True,710300002,13188660,723488662,True,1
2807,validator_31,48818179180,True,888500000,2681270,891181270,False,1
2808,validator_5,171583500540,True,437600000,2033250,439633250,False,5
2809,validator_2,329016887955,True,554357997,20761930,575119927,True,10
2810,validator_0,508639429050,True,738600000,13499770,752099770,True,15
2811,validator_7,120647308940,True,460200000,2356710,462556710,False,3
2812,validator_1,456874492580,True,719200000,11910670,731110670,False,14
2813,validator_4,161362039971,True,665359995,24787940,690147935,True,5
2814,validator_5,172120226040,True,529200000,7525500,536725500,False,5
2815,validator_0,509409168894,True,746038004,23701840,769739844,True,15
2816,validator_32,51184162660,True,546900000,28976280,575876280,False,1
2817,validator_4,162088477608,True,699560007,26877630,726437637,True,5
2818,validator_0,510290989013,True,856715999,25104120,881820119,True,15
2819,validator_0,511011862685,True,696806002,24067670,720873672,True,15
2820,validator_5,172826875530,True,697800000,8849490,706649490,False,5
2821,validator_1,457360611280,True,475700000,10418700,486118700,False,14
2822,validator_26,51463892172,True,620179998,81871450,702051448,True,1
2823,validator_5,173515778960,True,667000000,21903430,688903430,False,5
2824,validator_7,121181016370,True,513000000,20707430,533707430,False,3
2825,validator_29,49483962470,True,818200000,2306030,820506030,False,1
2826,validator_0,511693274468,True,641594003,39817780,681411783,True,15
2827,validator_8,50651483198,True,873838001,32790180,906628181,True,1
2828,validator_7,121828798960,True,633900000,13882590,647782590,False,3
2829,validator_35,54947910500,True,626600000,2999330,629599330,False,1
2830,validator_7,122413999230,True,580700000,4500270,585200270,False,3
2831,validator_30,46914087930,True,685500000,4306080,689806080,False,1
2832,validator_0,512510263507,True,810439999,6549040,816989039,True,16
2833,validator_43,49798190830,True,456200000,11113000,467313000,False,1
2834,validator_46,51994258700,True,503400000,12978300,516378300,False,1
2835,validator_1,457969259650,True,606600000,2048370,608648370,False,14
2836,validator_0,513143989967,True,630100000,3626460,633726460,True,16
2837,validator_0,513761467137,True,599700000,17777170,617477170,True,16
2838,validator_42,51323421090,True,586300000,6656940,592956940,False,1
2839,validator_2,329796770549,True,770899994,8982600,779882594,True,10
2840,validator_4,162709127339,True,618300001,2349730,620649731,True,5
2841,validator_27,52810769768,True,688719999,21338240,710058239,True,1
2842,validator_32,51867114190,True,679200000,3751530,682951530,False,1
2843,validator_30,47524647830,True,607700000,2859900,610559900,False,1
2844,validator_3,273987057630,True,636500000,1488160,637988160,False,8
2845,validator_2,330392253788,True,580439999,15043240,595483239,True,10
2846,validator_0,514445501734,True,674299997,9734600,684034597,True,16
2847,validator_0,515056782128,True,604240004,7040390,611280394,True,16
2848,validator_31,49244314180,True,399100000,27035000,426135000,False,1
2849,validator_0,515815545030,True,753000002,5762900,758762902,True,16
2850,validator_0,516419348409,True,568179999,35623380,603803379,True,16
2851,validator_11,51739985535,True,811000002,20867500,831867502,True,1
2852,validator_43,50487858590,True,686600000,3067760,689667760,False,1
2853,validator_0,517224950609,True,773860000,31742200,805602200,True,16
2854,validator_3,274492215050,True,502600000,2557420,505157420,False,8
2855,validator_19,49367184155,True,621259998,9346430,630606428,True,1
2856,validator_33,54943753790,True,510200000,2089070,512289070,False,1
2857,validator_5,174148133360,True,627900000,4454400,632354400,False,5
2858,validator_0,517882736415,True,628200006,29585800,657785806,True,16
2859,validator_1,458605214510,True,632900000,3054860,635954860,False,14
2860,validator_9,54207635785,True,673980000,10512400,684492400,True,1
2861,validator_19,50056150768,True,643300003,45666610,688966613,True,1
2862,validator_5,174729649830,True,576400000,5116470,581516470,False,5
2863,validator_4,163407871557,True,673999998,24744220,698744218,True,5
2864,validator_2,331158312870,True,764300002,1759080,766059082,True,10
2865,validator_1,459103308270,True,494000000,4093760,498093760,False,14
2866,validator_22,65201145667,True,663240000,44612130,707852130,True,2
2867,validator_31,49749648740,True,496800000,8534560,505334560,False,1
2868,validator_0,518621889137,True,701360002,37792720,739152722,True,16
2869,validator_5,175429013300,True,696100000,3263470,699363470,False,5
2870,validator_24,52785471807,True,507070002,28266100,535336102,True,1
2871,validator_4,164411733700,True,971840003,32022140,1003862143,True,5
2872,validator_22,65931823363,True,690567996,40109700,730677696,True,2
2873,validator_0,519687227983,True,1060299996,5038850,1065338846,True,16
2874,validator_6,125018794050,True,761034003,46693940,807727943,True,3
2875,validator_22,67077564499,True,1107039996,38701140,1145741136,True,2
2876,validator_0,520286605977,True,596300004,3077990,599377994,True,16
2877,validator_8,51103979798,True,429690000,22806600,452496600,True,1
2878,validator_7,123230358850,True,802500000,13859620,816359620,False,3
2879,validator_31,50498199030,True,744900000,3650290,748550290,False,1
2880,validator_1,459763909540,True,659200000,1401270,660601270,False,14
2881,validator_21,56340618382,True,864377999,25321730,889699729,True,1
2882,validator_5,176029776940,True,598600000,2163640,600763640,False,5
2883,validator_0,521097636407,True,751860000,59170430,811030430,True,16
2884,validator_43,51002195780,True,512000000,2337190,514337190,False,1
2885,validator_7,123777816420,True,531800000,15657570,547457570,False,3
2886,validator_15,55275749287,True,546099996,2543480,548643476,True,1
2887,validator_40,49572080740,True,482000000,1526240,483526240,False,1
2888,validator_30,48223914210,True,696900000,2366380,699266380,False,1
2889,validator_28,58532882167,True,921959998,14882400,936842398,True,1
2890,validator_17,59383726879,True,844540001,24071800,868611801,True,1
2891,validator_7,124345553830,True,564800000,2937410,567737410,False,3
2892,validator_22,67717979432,True,619520003,20894930,640414933,True,2
2893,validator_0,521859622327,True,730584000,31401920,761985920,True,16
2894,validator_2,332003064513,True,826440003,18311640,844751643,True,10
2895,validator_1,460441592990,True,673600000,4083450,677683450,False,14
2896,validator_2,332687545189,True,646365996,38114680,684480676,True,10
2897,validator_1,461146643210,True,695700000,9350220,705050220,False,14
2898,validator_4,165266454143,True,836380003,18340440,854720443,True,5
2899,validator_3,275189653890,True,690700000,6738840,697438840,False,8
2900,validator_10,57760140102,True,1048739995,31762400,1080502395,True,1
2901,validator_0,522615605804,True,729000007,26983470,755983477,True,16
2902,validator_1,461658592510,True,487600000,24349300,511949300,False,14
2903,validator_26,52175192872,True,664702000,46598700,711300700,True,1
2904,validator_1,462411723310,True,731200000,21930800,753130800,False,14
2905,validator_2,333135372128,True,445799999,2026940,447826939,True,10
2906,validator_19,50684657008,True,599834000,28672240,628506240,True,1
2907,validator_0,523306386522,True,682939998,7840720,690780718,True,16
2908,validator_1,463164608650,True,732200000,20685340,752885340,False,14
2909,validator_8,51691354096,True,581619998,5754300,587374298,True,1
2910,validator_8,52191105306,True,491600010,8151200,499751210,True,1
2911,validator_2,333994584070,True,839560002,19651940,859211942,True,10
2912,validator_3,275693349280,True,497500000,6195390,503695390,False,8
2913,validator_7,125091807920,True,743900000,2354090,746254090,False,3
2914,validator_35,55668873210,True,712000000,8962710,720962710,False,1
2915,validator_40,50104829540,True,521400000,11348800,532748800,False,1
2916,validator_2,334555901949,True,554799999,6517880,561317879,True,10
2917,validator_6,125531647138,True,494699998,18153090,512853088,True,3
2918,validator_1,463763501840,True,593400000,5493190,598893190,False,14
2919,validator_39,46694602020,True,788300000,2223770,790523770,False,1
2920,validator_3,276214791680,True,520000000,1442400,521442400,False,8
2921,validator_34,49407250420,True,560700000,19459580,580159580,False,1
2922,validator_1,464669865380,True,900300000,6063540,906363540,False,14
2923,validator_1,465186795250,True,514300000,2629870,516929870,False,14
2924,validator_1,465698363180,True,510200000,1367930,511567930,False,14
2925,validator_3,276752167190,True,530500000,6875510,537375510,False,8
2926,validator_35,56200017030,True,528900000,2243820,531143820,False,1
2927,validator_28,59324329507,True,749160010,42287330,791447340,True,1
2928,validator_2,335070690195,True,492620006,22168240,514788246,True,10
2929,validator_15,56331419978,True,1022159991,33510700,1055670691,True,1
2930,validator_19,51333254804,True,609606006,38991790,648597796,True,1
2931,validator_0,524078502154,True,757899992,14215640,772115632,True,16
2932,validator_1,466264791170,True,565290000,1137990,566427990,False,14
2933,validator_43,51711090980,True,707300000,1595200,708895200,False,1
2934,validator_0,524832668991,True,743260007,10906830,754166837,True,16
2935,validator_3,277315959190,True,545500000,18292000,563792000,False,8
2936,validator_23,56210665661,True,807900003,19083900,826983903,True,1
2937,validator_3,278049949530,True,729900000,4090340,733990340,False,8
2938,validator_1,467039273630,True,765200000,9282460,774482460,False,14
2939,validator_7,125696407020,True,595600000,8999100,604599100,False,3
2940,validator_5,176505673800,True,468600000,7296860,475896860,False,5
2941,validator_43,52368765930,True,653900000,3774950,657674950,False,1
2942,validator_1,467636042930,True,593700000,3069300,596769300,False,14
2943,validator_1,468121880180,True,473300000,12537250,485837250,False,14
2944,validator_2,335764019352,True,668899997,24429160,693329157,True,10
2945,validator_4,166103460876,True,833900003,3106730,837006733,True,5
2946,validator_2,336158628583,True,392600001,2009230,394609231,True,10
2947,validator_3,278842656470,True,790000000,2706940,792706940,False,8
2948,validator_0,525561949831,True,674060000,55220840,729280840,True,16
2949,validator_26,53145333657,True,955479985,14660800,970140785,True,1
2950,validator_29,50149122810,True,654200000,10960340,665160340,False,1
2951,validator_4,166766200679,True,639460003,23279800,662739803,True,5
2952,validator_26,54024681794,True,877299997,2048140,879348137,True,1
2953,validator_6,126087736075,True,543119997,12968940,556088937,True,3
2954,validator_12,53218317144,True,718700003,14356020,733056023,True,1
2955,validator_7,126437188140,True,735300000,5481120,740781120,False,3
2956,validator_48,57743359860,True,625800000,10932800,636732800,False,1
2957,validator_14,57306947083,True,805320006,22720600,828040606,True,1
2958,validator_1,468821707940,True,662100000,37727760,699827760,False,14
2959,validator_3,279515826620,True,658300000,14870150,673170150,False,8
2960,validator_0,526360619450,True,761339999,37329620,798669619,True,16
2961,validator_0,527341493521,True,979600001,1274070,980874071,True,16
2962,validator_0,528076127924,True,708600003,26034400,734634403,True,16
2963,validator_1,469627643120,True,804100000,1835180,805935180,False,14
2964,validator_0,528967235912,True,842582008,48525980,891107988,True,16
2965,validator_19,52018232947,True,682100003,2878140,684978143,True,1
2966,validator_2,336586864684,True,404079991,24156110,428236101,True,10
2967,validator_3,280064734250,True,547900000,1007630,548907630,False,8
2968,validator_40,50634759780,True,502000000,27930240,529930240,False,1
2969,validator_0,529669882959,True,683719997,18927050,702647047,True,16
2970,validator_23,56970492363,True,735620002,24206700,759826702,True,1
2971,validator_2,337283810988,True,685099994,11846310,696946304,True,10
2972,validator_26,54593099825,True,556599991,11818040,568418031,True,1
2973,validator_25,52294611616,True,581337994,29108730,610446724,True,1
2974,validator_34,50140914430,True,732300000,1364010,733664010,False,1
2975,validator_5,177093820030,True,585300000,2846230,588146230,False,5
2976,validator_0,530395083363,True,712840004,12360400,725200404,True,16
2977,validator_20,54519057993,True,837240002,8393320,845633322,True,1
2978,validator_14,58175702420,True,856199997,12555340,868755337,True,1
2979,validator_4,167495351352,True,723839993,5310680,729150673,True,5
2980,validator_7,126838015070,True,392600000,8226930,400826930,False,3
2981,validator_31,51111289260,True,610700000,2390230,613090230,False,1
2982,validator_4,168387979173,True,865620001,27007820,892627821,True,5
2983,validator_48,58351041150,True,570300000,37381290,607681290,False,1
2984,validator_17,59981926581,True,574240002,23959700,598199702,True,1
2985,validator_7,127332354570,True,483700000,10639500,494339500,False,3
2986,validator_2,338175571102,True,881400004,10360110,891760114,True,10
2987,validator_30,48803753810,True,578400000,1439600,579839600,False,1
2988,validator_12,53821220756,True,590620012,12283600,602903612,True,1
2989,validator_4,168989964402,True,563979999,38005230,601985229,True,5
2990,validator_1,470288857920,True,652800000,8414800,661214800,False,14
2991,validator_3,280683126930,True,611600000,6792680,618392680,False,8
2992,validator_15,57070699448,True,720200000,19079470,739279470,True,1
2993,validator_1,470866824320,True,576100000,1866400,577966400,False,14
2994,validator_1,471572846520,True,698700000,7322200,706022200,False,14
2995,validator_10,58451682335,True,685400003,6142230,691542233,True,1
2996,validator_3,281266752550,True,576000000,7625620,583625620,False,8
2997,validator_2,338635283519,True,414939997,44772420,459712417,True,10
2998,validator_0,531164629505,True,747720002,21826140,769546142,True,16
2999,validator_4,169593151881,True,589899999,13287480,603187479,True,5
3000,validator_1,472244689090,True,662300000,9542570,671842570,False,14
3001,validator_6,126938981453,True,840539998,10705380,851245378,True,3
3002,validator_0,531877507436,True,711800001,1077930,712877931,True,16
3003,validator_0,532424575126,True,531920000,15147690,547067690,True,16
3004,validator_19,52548216082,True,521800005,8183130,529983135,True,1
3005,validator_25,53104084687,True,763599991,45873080,809473071,True,1
3006,validator_2,339200510899,True,562400000,2827380,565227380,True,10
3007,validator_0,533059162619,True,613959993,20627500,634587493,True,16
3008,validator_40,51148203880,True,509800000,3644100,513444100,False,1
3009,validator_2,340015802782,True,796100003,19191880,815291883,True,10
3010,validator_3,281999682080,True,723600000,9329530,732929530,False,8
3011,validator_10,59355104639,True,893140004,10282300,903422304,True,1
3012,validator_30,49333269730,True,523360000,6155920,529515920,False,1
3013,validator_2,340891634281,True,832859999,42971500,875831499,True,10
3014,validator_1,472938802950,True,673700000,20413860,694113860,False,14
3015,validator_0,533734813568,True,635820009,39830940,675650949,True,16
3016,validator_22,68444247759,True,706619997,19648330,726268327,True,2
3017,validator_1,473452053770,True,489600000,23650820,513250820,False,14
3018,validator_0,534374560410,True,631600002,8146840,639746842,True,16
3019,validator_23,57591468868,True,608520005,12456500,620976505,True,1
3020,validator_19,53106876453,True,490878001,67782370,558660371,True,1
3021,validator_3,282715598520,True,690900000,25016440,715916440,False,8
3022,validator_27,53611088158,True,769594000,30724390,800318390,True,1
3023,validator_1,474006851970,True,544800000,9998200,554798200,False,14
3024,validator_2,341694717021,True,777360000,25722740,803082740,True,10
3025,validator_5,177674447650,True,571300000,9327620,580627620,False,5
3026,validator_0,535195655333,True,785840003,35254920,821094923,True,16
3027,validator_41,45328102230,True,542700000,8477130,551177130,False,1
3028,validator_22,69159823856,True,679839997,35736100,715576097,True,2
3029,validator_0,535658609435,True,452200002,10754100,462954102,True,16
3030,validator_9,54950463812,True,703040007,39788020,742828027,True,1
3031,validator_7,127772124270,True,438290000,1479700,439769700,False,3
3032,validator_1,474723823870,True,709000000,7971900,716971900,False,14
3033,validator_0,536547761801,True,863444006,25708360,889152366,True,16
3034,validator_28,59941381838,True,588200001,28852330,617052331,True,1
3035,validator_1,475402024690,True,672300000,5900820,678200820,False,14
3036,validator_17,60952641795,True,961199994,9515220,970715214,True,1
3037,validator_1,476018061610,True,612400000,3636920,616036920,False,14
3038,validator_38,51084960410,True,801100000,5429800,806529800,False,1
3039,validator_1,476549592420,True,530000000,1530810,531530810,False,14
3040,validator_11,52514894014,True,751197999,23710480,774908479,True,1
3041,validator_21,57152778717,True,778174005,33986330,812160335,True,1
3042,validator_0,537300079008,True,739988007,12329200,752317207,True,16
3043,validator_3,283140309060,True,419300000,5410540,424710540,False,8
3044,validator_6,127648088557,True,694840004,14267100,709107104,True,3
3045,validator_2,342670364894,True,935440003,40207870,975647873,True,10
3046,validator_0,538082542431,True,727999993,54463430,782463423,True,16
3047,validator_1,477145260200,True,573600000,22067780,595667780,False,14
3048,validator_1,477560288040,True,412200000,2827840,415027840,False,14
3049,validator_2,343387090642,True,714899998,1825750,716725748,True,10
3050,validator_0,538976705140,True,848700009,45462700,894162709,True,16
3051,validator_5,178249872500,True,555700000,19724850,575424850,False,5
3052,validator_0,539628329534,True,635799994,15824400,651624394,True,16
3053,validator_19,53914485652,True,757619999,49989200,807609199,True,1
3054,validator_0,540250148285,True,609140001,12678750,621818751,True,16
3055,validator_0,541035217391,True,774300006,10769100,785069106,True,16
3056,validator_44,52324222660,True,513900000,12470050,526370050,False,1
3057,validator_11,53126819360,True,605600006,6325340,611925346,True,1
3058,validator_1,478058291460,True,479000000,19003420,498003420,False,14
3059,validator_8,52904256235,True,711119999,2030930,713150929,True,1
3060,validator_20,55319206704,True,792740001,7408710,800148711,True,1
3061,validator_0,541871322591,True,790520000,45585200,836105200,True,16
3062,validator_0,542516263751,True,617680000,27261160,644941160,True,16
3063,validator_4,170194907563,True,592940002,8815680,601755682,True,5
3064,validator_38,51713011780,True,606800000,21251370,628051370,False,1
3065,validator_4,170864041400,True,665839997,3293840,669133837,True,5
3066,validator_1,478669664490,True,609400000,1973030,611373030,False,14
3067,validator_2,344159687809,True,714240007,58357160,772597167,True,10
3068,validator_15,57788101456,True,652840008,64562000,717402008,True,1
3069,validator_34,50825698930,True,678600000,6184500,684784500,False,1
3070,validator_0,543197928554,True,663265993,18398810,681664803,True,16
3071,validator_8,53636381870,True,683840005,48285630,732125635,True,1
3072,validator_34,51419565820,True,592100000,1766890,593866890,False,1
3073,validator_2,344875011487,True,677593998,37729680,715323678,True,10
3074,validator_11,53874326603,True,727540003,19967240,747507243,True,1
3075,validator_33,55619721720,True,673100000,2867930,675967930,False,1
3076,validator_1,479323252050,True,652000000,1587560,653587560,False,14
3077,validator_1,479918824150,True,575600000,19972100,595572100,False,14
3078,validator_0,543873282850,True,658219996,17134300,675354296,True,16
3079,validator_7,128279362480,True,504600000,2638210,507238210,False,4
3080,validator_4,171585201895,True,710099995,11060500,721160495,True,5
3081,validator_0,544464773442,True,568140002,23350590,591490592,True,17
3082,validator_0,545468679526,True,997699994,6206090,1003906084,True,17
3083,validator_2,345460268625,True,578500008,6757130,585257138,True,10
3084,validator_3,283871886390,True,717300000,14277330,731577330,False,8
3085,validator_5,178950236200,True,699000000,1363700,700363700,False,5
3086,validator_15,58927929887,True,1127840001,11988430,1139828431,True,1
3087,validator_3,284436009370,True,561700000,2422980,564122980,False,8
3088,validator_25,53801746782,True,687119995,10542100,697662095,True,1
3089,validator_7,128848345870,True,565500000,3483390,568983390,False,4
3090,validator_3,285003640760,True,565700000,1931390,567631390,False,8
3091,validator_6,128121001701,True,444079994,28833150,472913144,True,4
3092,validator_0,546295205758,True,815840002,10686230,826526232,True,17
3093,validator_2,346059543030,True,564540005,34734400,599274405,True,10
3094,validator_2,346671060992,True,591020002,20497960,611517962,True,10
3095,validator_5,179791505030,True,821700000,19568830,841268830,False,5
3096,validator_11,54550184604,True,649440001,26418000,675858001,True,1
3097,validator_0,547203286654,True,882643996,25436900,908080896,True,17
3098,validator_4,172226479472,True,602179997,39097580,641277577,True,5
3099,validator_1,480428112740,True,502800000,6488590,509288590,False,15
3100,validator_0,547837030135,True,623680001,10063480,633743481,True,17
3101,validator_24,53439387410,True,648800003,5115600,653915603,True,1
3102,validator_42,51925429390,True,582800000,19208300,602008300,False,1
3103,validator_5,180542677230,True,727400000,23772200,751172200,False,5
3104,validator_41,45927669870,True,589700000,9867640,599567640,False,1
3105,validator_1,480949500300,True,518100000,3287560,521387560,False,15
3106,validator_0,548515389131,True,663899996,14459000,678358996,True,17
3107,validator_1,481481791310,True,530200000,2091010,532291010,False,15
3108,validator_23,58420491189,True,815520001,13502320,829022321,True,1
3109,validator_2,347516354500,True,843700008,1593500,845293508,True,10
3110,validator_5,181137602610,True,573970000,20955380,594925380,False,5
3111,validator_1,482226148010,True,744000000,356700,744356700,False,15
3112,validator_22,69710571642,True,529320006,21427780,550747786,True,2
3113,validator_2,348304004502,True,777100002,10550000,787650002,True,10
3114,validator_8,54351868336,True,712300006,3186460,715486466,True,1
3115,validator_1,482914376080,True,686500000,1728070,688228070,False,15
3116,validator_2,349010258303,True,703600001,2653800,706253801,True,10
3117,validator_41,46642672540,True,705300000,9702670,715002670,False,1
3118,validator_7,129568769330,True,718200000,2223460,720423460,False,4
3119,validator_2,349627980378,True,559620005,58102070,617722075,True,10
3120,validator_0,549290901911,True,766370000,9142780,775512780,True,17
3121,validator_27,54710138257,True,1070239999,28810100,1099050099,True,1
3122,validator_4,172701967736,True,474199994,1288270,475488264,True,5
3123,validator_11,55110869357,True,532499993,28184760,560684753,True,1
3124,validator_0,549962960611,True,651900000,20158700,672058700,True,17
3125,validator_0,550843614727,True,836099996,44554120,880654116,True,17
3126,validator_0,551462704730,True,585360003,33730000,619090003,True,17
3127,validator_33,56170646020,True,547570000,3354300,550924300,False,1
3128,validator_37,52324920300,True,611500000,3270200,614770200,False,1
3129,validator_29,50745272390,True,594300000,1849580,596149580,False,1
3130,validator_13,48443413480,True,594800002,5091040,599891042,True,1
3131,validator_23,59063850101,True,619004002,24354910,643358912,True,1
3132,validator_2,350082011207,True,427139999,26890830,454030829,True,10
3133,validator_0,552383972134,True,876960004,44307400,921267404,True,17
3134,validator_2,350519183630,True,419239993,17932430,437172423,True,10
3135,validator_47,52434207870,True,693100000,3690830,696790830,False,1
3136,validator_5,181919559010,True,778700000,3256400,781956400,False,5
3137,validator_5,182378533100,True,435400000,23574090,458974090,False,5
3138,validator_49,50393455580,True,633300000,39361500,672661500,False,1
3139,validator_25,54569305140,True,758199998,9358360,767558358,True,1
3140,validator_15,59420345603,True,473839996,18575720,492415716,True,1
3141,validator_1,483666666260,True,750200000,2090180,752290180,False,15
3142,validator_2,351248563027,True,691219997,38159400,729379397,True,10
3143,validator_5,182994656410,True,609600000,6523310,616123310,False,5
3144,validator_0,553204417070,True,748367996,72076940,820444936,True,17
3145,validator_22,70490521603,True,760440001,19509960,779949961,True,2
3146,validator_4,173413614040,True,658734004,52912300,711646304,True,5
3147,validator_7,130179067310,True,608600000,1697980,610297980,False,4
3148,validator_5,183703714860,True,688200000,20858450,709058450,False,5
3149,validator_4,174346883841,True,878900001,54369800,933269801,True,5
3150,validator_47,52811342770,True,374090000,3044900,377134900,False,1
3151,validator_2,351913225852,True,655999995,8662830,664662825,True,10
3152,validator_48,58869845450,True,516200000,2604300,518804300,False,1
3153,validator_14,58947383959,True,746790009,24891530,771681539,True,1
3154,validator_6,128723763798,True,596879997,5882100,602762097,True,4
3155,validator_0,553835743860,True,623840000,7486790,631326790,True,17
3156,validator_0,554495577067,True,656800007,3033200,659833207,True,17
3157,validator_23,59972257229,True,902267998,6139130,908407128,True,1
3158,validator_43,52787753430,True,417500000,1487500,418987500,False,1
3159,validator_0,555253301964,True,737199997,20524900,757724897,True,17
3160,validator_4,175104626819,True,754199998,3542980,757742978,True,5
3161,validator_2,352588410953,True,649660001,25525100,675185101,True,11
3162,validator_14,59448735560,True,487900001,13451600,501351601,True,1
3163,validator_0,556043019187,True,761600003,28117220,789717223,True,17
3164,validator_3,285694832560,True,688300000,2891800,691191800,False,8
3165,validator_45,53275568170,True,533200000,31122800,564322800,False,1
3166,validator_1,484483938460,True,807300000,9972200,817272200,False,15
3167,validator_0,556530262329,True,480900002,6343140,487243142,True,17
3168,validator_3,286355236980,True,649600000,10804420,660404420,False,8
3169,validator_4,175936237619,True,800600000,31010800,831610800,True,5
3170,validator_1,485216961260,True,709000000,24022800,733022800,False,15
3171,validator_5,184260407980,True,553600000,3093120,556693120,False,5
3172,validator_49,51042116640,True,629700000,18961060,648661060,False,1
3173,validator_45,53797034550,True,502300000,19166380,521466380,False,1
3174,validator_36,55490165910,True,682300000,1534270,683834270,False,1
3175,validator_3,286875755280,True,515800000,4718300,520518300,False,8
3176,validator_0,557270181920,True,730260001,9659590,739919591,True,17
3177,validator_0,557953665780,True,636820000,46663860,683483860,True,17
3178,validator_18,69620626169,True,415540001,6710240,422250241,True,2
3179,validator_1,485759479970,True,539800000,2718710,542518710,False,15
3180,validator_24,54108412182,True,657600002,11424770,669024772,True,1
3181,validator_4,176767537117,True,821939998,9359500,831299498,True,5
3182,validator_0,558769999717,True,771099997,45233940,816333937,True,17
3183,validator_0,559358375209,True,581219992,7155500,588375492,True,17
3184,validator_3,287438936260,True,561240000,1940980,563180980,False,8
3185,validator_43,53579021970,True,788000000,3268540,791268540,False,1
3186,validator_0,560132049012,True,744560003,29113800,773673803,True,17
3187,validator_0,560949889621,True,779040009,38800600,817840609,True,17
3188,validator_1,486236955390,True,471900000,5575420,477475420,False,15
3189,validator_25,55138134935,True,543799995,25029800,568829795,True,1
3190,validator_32,52475768150,True,599800000,8853960,608653960,False,1
3191,validator_0,561751319648,True,795019997,6410030,801430027,True,17
3192,validator_16,49646432629,True,586800000,11268810,598068810,True,1
3193,validator_15,60085790938,True,622519995,42925340,665445335,True,1
3194,validator_37,53169901120,True,809200000,35780820,844980820,False,1
3195,validator_7,130802669580,True,621800000,1802270,623602270,False,4
3196,validator_1,486779043990,True,533900000,8188600,542088600,False,15
3197,validator_1,487500232560,True,718200000,2988570,721188570,False,15
3198,validator_2,353380368121,True,779579998,12377170,791957168,True,11
3199,validator_1,488140528000,True,638400000,1895440,640295440,False,15
3200,validator_5,184924005980,True,659500000,4098000,663598000,False,5
3201,validator_0,562400658775,True,645499997,3839130,649339127,True,17
3202,validator_5,185666217840,True,739300000,2911860,742211860,False,5
3203,validator_2,354009064322,True,598020001,30676200,628696201,True,11
3204,validator_46,52656599200,True,653300000,9040500,662340500,False,1
3205,validator_1,488866347990,True,716100000,9719990,725819990,False,15
3206,validator_31,51787669260,True,674600000,1780000,676380000,False,1
3207,validator_0,562861705973,True,460099998,947200,461047198,True,17
3208,validator_1,489583083960,True,711500000,5235970,716735970,False,15
3209,validator_5,186341669780,True,673100000,2351940,675451940,False,5
3210,validator_9,55785467307,True,824399995,10603500,835003495,True,1
3211,validator_3,287917683270,True,477000000,1747010,478747010,False,8
3212,validator_1,490112363450,True,527600000,1679490,529279490,False,15
3213,validator_46,53184962870,True,525200000,3163670,528363670,False,1
3214,validator_1,490685496890,True,556500000,16633440,573133440,False,15
3215,validator_29,51298204220,True,527300000,25631830,552931830,False,1
3216,validator_0,563452499480,True,583239997,7553510,590793507,True,17
3217,validator_19,54732788672,True,808080000,10223020,818303020,True,1
3218,validator_2,354645200024,True,604760002,31375700,636135702,True,11
3219,validator_5,187075634680,True,733400000,564900,733964900,False,5
3220,validator_44,52871409080,True,509300000,37886420,547186420,False,1
3221,validator_45,54317945640,True,518100000,2811090,520911090,False,1
3222,validator_1,491386353320,True,697900000,2956430,700856430,False,15
3223,validator_22,71483116375,True,955119992,37474780,992594772,True,2
3224,validator_3,288494737770,True,574600000,2454500,577054500,False,9
3225,validator_1,491937734720,True,550000000,1381400,551381400,False,15
3226,validator_15,60881210501,True,791820003,3599560,795419563,True,1
3227,validator_1,492498912380,True,516610000,44567660,561177660,False,15
3228,validator_1,493065151280,True,564300000,1938900,566238900,False,15
3229,validator_1,493746672780,True,672100000,9421500,681521500,False,15
3230,validator_7,131283375260,True,476100000,4605680,480705680,False,4
3231,validator_0,564007941105,True,498639995,56801630,555441625,True,17
3232,validator_20,55977379647,True,637760003,20412940,658172943,True,1
3233,validator_4,177725261894,True,933119997,24604780,957724777,True,5
3234,validator_1,494240450790,True,485400000,8378010,493778010,False,15
3235,validator_9,56416405903,True,609379996,21558600,630938596,True,1
3236,validator_3,289097736040,True,593900000,9098270,602998270,False,9
3237,validator_18,70243433151,True,599300002,23506980,622806982,True,2
3238,validator_1,494887785270,True,630500000,16834480,647334480,False,15
3239,validator_1,495364844740,True,475200000,1859470,477059470,False,15
3240,validator_5,187862427320,True,778300000,8492640,786792640,False,5
3241,validator_3,289850289620,True,741200000,11353580,752553580,False,9
3242,validator_3,290325527620,True,471420000,3818000,475238000,False,9
3243,validator_48,59557020880,True,685400000,1775430,687175430,False,1
3244,validator_4,178531863043,True,795999999,10601150,806601149,True,5
3245,validator_16,50359987134,True,695100005,18454500,713554505,True,1
3246,validator_1,495869542800,True,502100000,2598060,504698060,False,15
3247,validator_1,496630849670,True,759700000,1606870,761306870,False,15
3248,validator_13,48863654097,True,407500007,12740610,420240617,True,1
3249,validator_6,129468665421,True,741500003,3401620,744901623,True,4
3250,validator_0,564592704934,True,582699999,2063830,584763829,True,17
3251,validator_31,52417345700,True,623600000,6076440,629676440,False,1
3252,validator_17,61686247782,True,727300007,6305980,733605987,True,1
3253,validator_31,53224007400,True,794800000,11861700,806661700,False,1
3254,validator_43,54500207570,True,917800000,3385600,921185600,False,1
3255,validator_34,51935569820,True,514600000,1404000,516004000,False,1
3256,validator_20,56478372127,True,464040000,36952480,500992480,True,1
3257,validator_0,565287705638,True,675100004,19900700,695000704,True,17
3258,validator_32,53168975610,True,672900000,20307460,693207460,False,1
3259,validator_18,71093085553,True,821040002,28612400,849652402,True,2
3260,validator_0,566078708861,True,747680003,43323220,791003223,True,17
3261,validator_41,47157105040,True,511800000,2632500,514432500,False,1
3262,validator_1,497233852400,True,600500000,2502730,603002730,False,15
3263,validator_0,566882389265,True,747060004,56620400,803680404,True,17
3264,validator_2,355520601730,True,833260006,42141700,875401706,True,11
3265,validator_41,47686818890,True,525200000,4513850,529713850,False,1
3266,validator_18,72025718676,True,893300003,39333120,932633123,True,2
3267,validator_23,60692004076,True,710499997,9246850,719746847,True,1
3268,validator_2,356503246372,True,969420002,13224640,982644642,True,11
3269,validator_3,290961287620,True,615800000,19960000,635760000,False,9
3270,validator_0,567736233509,True,824599994,29244250,853844244,True,17
3271,validator_3,291698916450,True,723300000,14328830,737628830,False,9
3272,validator_22,72339838283,True,827917998,28803910,856721908,True,2
3273,validator_7,131906518890,True,616600000,6543630,623143630,False,4
3274,validator_1,497734660050,True,497100000,3707650,500807650,False,15
3275,validator_0,568404303371,True,640400002,27669860,668069862,True,17
3276,validator_1,498556204170,True,813200000,8344120,821544120,False,15
3277,validator_35,56684584010,True,458200000,26366980,484566980,False,1
3278,validator_1,499233971230,True,671700000,6067060,677767060,False,15
3279,validator_1,499914227730,True,678600000,1656500,680256500,False,15
3280,validator_19,55479349689,True,740599997,5961020,746561017,True,1
3281,validator_0,568970947973,True,541820002,24824600,566644602,True,17
3282,validator_1,500461226840,True,545000000,1999110,546999110,False,15
3283,validator_2,357272805068,True,740619996,28938700,769558696,True,11
3284,validator_15,61301696745,True,405139994,15346250,420486244,True,1
3285,validator_2,357948688841,True,669140003,6743770,675883773,True,11
3286,validator_15,62143346758,True,834700003,6950010,841650013,True,1
3287,validator_28,60652081227,True,681799999,28899390,710699389,True,1
3288,validator_38,52090416620,True,374400000,3004840,377404840,False,1
3289,validator_3,292347532730,True,615200000,33416280,648616280,False,9
3290,validator_2,358660308438,True,705899997,5719600,711619597,True,11
3291,validator_3,292893024020,True,529100000,16391290,545491290,False,9
3292,validator_0,569506564809,True,517700006,17916830,535616836,True,17
3293,validator_35,57266580300,True,574400000,7596290,581996290,False,1
3294,validator_4,179050000872,True,487799999,30337830,518137829,True,5
3295,validator_19,56400889323,True,914600004,6939630,921539634,True,1
3296,validator_23,61410621543,True,708400007,10217460,718617467,True,1
3297,validator_14,60085671214,True,601820004,35115650,636935654,True,1
3298,validator_0,570207543210,True,675740001,25238400,700978401,True,17
3299,validator_29,51880703100,True,556600000,25898880,582498880,False,1
3300,validator_0,570902539218,True,684453988,10542020,694996008,True,17
3301,validator_6,130288849802,True,800520001,19664380,820184381,True,4
3302,validator_35,57752903390,True,462400000,23923090,486323090,False,1
3303,validator_1,501139236960,True,668000000,10010120,678010120,False,15
3304,validator_38,52708350120,True,597000000,20933500,617933500,False,1
3305,validator_0,571513322021,True,607200003,3582800,610782803,True,17
3306,validator_30,49905910170,True,558800000,13840440,572640440,False,1
3307,validator_1,501787389100,True,646200000,1952140,648152140,False,15
3308,validator_1,502510957400,True,703500000,20068300,723568300,False,15
3309,validator_30,50498428270,True,590100000,2418100,592518100,False,1
3310,validator_7,132451820900,True,525500000,19802010,545302010,False,4
3311,validator_1,503156441590,True,623000000,22484190,645484190,False,15
3312,validator_10,59917610575,True,542179996,20325940,562505936,True,1
3313,validator_48,60102344850,True,527800000,17523970,545323970,False,1
3314,validator_30,51117117180,True,618000000,688910,618688910,False,1
3315,validator_23,62263485740,True,817439997,35424200,852864197,True,1
3316,validator_6,131077331804,True,749168002,39314000,788482002,True,4
3317,validator_40,51710023650,True,556600000,5219770,561819770,False,1
3318,validator_0,572136825559,True,604273998,19229540,623503538,True,17
3319,validator_45,55080766020,True,759600000,3220380,762820380,False,1
3320,validator_0,572892247123,True,752199994,3221570,755421564,True,17
3321,validator_45,55632316190,True,538700000,12850170,551550170,False,1
3322,validator_1,503728252560,True,569800000,2010970,571810970,False,15
3323,validator_1,504361411730,True,626200000,6959170,633159170,False,15
3324,validator_3,293358840860,True,465400000,416840,465816840,False,9
3325,validator_19,56971415049,True,550839996,19685730,570525726,True,1
3326,validator_1,505051867010,True,687200000,3255280,690455280,False,15
3327,validator_2,359564230922,True,896700004,7222480,903922484,True,11
3328,validator_48,60557796690,True,452900000,2551840,455451840,False,1
3329,validator_34,52575586800,True,627200000,12816980,640016980,False,1
3330,validator_42,52530700490,True,601400000,3871100,605271100,False,1
3331,validator_33,57012390900,True,821500000,20244880,841744880,False,1
3332,validator_27,55656873260,True,891300003,55435000,946735003,True,1
3333,validator_34,53306822860,True,720000000,11236060,731236060,False,1
3334,validator_2,360189455372,True,569579990,55644460,625224450,True,11
3335,validator_0,573668084327,True,749640004,26197200,775837204,True,17
3336,validator_0,574459507057,True,789300000,2122730,791422730,True,17
3337,validator_2,360743258967,True,520939995,32863600,553803595,True,11
3338,validator_1,505625856200,True,573200000,789190,573989190,False,15
3339,validator_5,188441567130,True,573200000,5939810,579139810,False,5
3340,validator_41,48197718980,True,508500000,2400090,510900090,False,1
3341,validator_0,575151547653,True,689200006,2840590,692040596,True,17
3342,validator_8,55360261437,True,991780001,16613100,1008393101,True,1
3343,validator_2,361452057732,True,693700005,15098760,708798765,True,11
3344,validator_29,52556415670,True,674600000,1112570,675712570,False,1
3345,validator_4,179725208963,True,628720001,46488090,675208091,True,5
3346,validator_21,57955955021,True,782280004,20896300,803176304,True,1
3347,validator_26,55595514118,True,990340003,12074290,1002414293,True,1
3348,validator_3,294050840560,True,691400000,599700,691999700,False,9
3349,validator_45,56225348390,True,573200000,19832200,593032200,False,1
3350,validator_12,54584536156,True,732960000,30355400,763315400,True,1
3351,validator_6,131686216098,True,576203994,32680300,608884294,True,4
3352,validator_0,575701109321,True,516219998,33341670,549561668,True,17
3353,validator_22,72939270753,True,565526000,33906470,599432470,True,2
3354,validator_27,56308560655,True,628539995,23147400,651687395,True,1
3355,validator_5,189021166050,True,576300000,3298920,579598920,False,5
3356,validator_42,53138524190,True,606000000,1823700,607823700,False,1
3357,validator_1,506221543800,True,549600000,46087600,595687600,False,15
3358,validator_0,576315482458,True,608399997,5973140,614373137,True,18
3359,validator_38,53344820530,True,628900000,7570410,636470410,False,1
3360,validator_0,577167099752,True,831339994,20277300,851617294,True,18
3361,validator_4,180632914962,True,872959999,34746000,907705999,True,5
3362,validator_3,294683848170,True,627700000,5307610,633007610,False,9
3363,validator_35,58411054190,True,637200000,20950800,658150800,False,1
3364,validator_0,577671551887,True,489500005,14952130,504452135,True,18
3365,validator_21,58883074243,True,903200002,23919220,927119222,True,1
3366,validator_1,506733925620,True,491500000,20881820,512381820,False,15
3367,validator_6,132486312959,True,762200001,37896860,800096861,True,4
3368,validator_2,362108116233,True,651100001,4958500,656058501,True,11
3369,validator_2,362678759866,True,560638003,10005630,570643633,True,11
3370,validator_1,507273577880,True,538370000,1282260,539652260,False,15
3371,validator_40,52223442290,True,494300000,19118640,513418640,False,1
3372,validator_41,48999246380,True,796500000,5027400,801527400,False,1
3373,validator_0,578542714193,True,841739996,29422310,871162306,True,18
3374,validator_5,189585185830,True,560500000,3519780,564019780,False,5
3375,validator_0,579478897114,True,910360001,25822920,936182921,True,18
3376,validator_1,507855799710,True,574200000,8021830,582221830,False,15
3377,validator_0,580049405015,True,537780001,32727900,570507901,True,18
3378,validator_0,580841870056,True,790200001,2265040,792465041,True,18
3379,validator_44,53519942100,True,646400000,2133020,648533020,False,1
3380,validator_1,508349144540,True,478600000,14744830,493344830,False,15
3381,validator_2,363582689954,True,883199998,20730090,903930088,True,11
3382,validator_7,133243924200,True,789300000,2803300,792103300,False,4
3383,validator_45,56883640490,True,637600000,20692100,658292100,False,1
3384,validator_36,56023258010,True,528500000,4592100,533092100,False,1
3385,validator_3,295157861300,True,471300000,2713130,474013130,False,9
3386,validator_1,508905415270,True,534500000,21770730,556270730,False,15
3387,validator_0,581578895943,True,729320007,7705880,737025887,True,18
3388,validator_7,133949536660,True,685100000,20512460,705612460,False,4
3389,validator_1,509505030060,True,580300000,19314790,599614790,False,15
3390,validator_0,582090152228,True,493280005,17976280,511256285,True,18
3391,validator_31,53716345100,True,482400000,9937700,492337700,False,1
3392,validator_2,364336239680,True,729139996,24409730,753549726,True,11
3393,validator_23,62911484140,True,606700000,41298400,647998400,True,1
3394,validator_0,582572779548,True,454480000,28147320,482627320,True,18
3395,validator_22,73679656357,True,720316004,20069600,740385604,True,2
3396,validator_30,51681241910,True,533400000,30724730,564124730,False,1
3397,validator_4,181346499057,True,686879995,26704100,713584095,True,5
3398,validator_41,49596607540,True,594200000,3161160,597361160,False,1
3399,validator_45,57544572550,True,656500000,4432060,660932060,False,1
3400,validator_31,54377795610,True,653800000,7650510,661450510,False,1
3401,validator_1,510062415760,True,555200000,2185700,557385700,False,15
3402,validator_1,510539250720,True,474500000,2334960,476834960,False,15
3403,validator_20,56975038762,True,492609995,4056640,496666635,True,1
3404,validator_3,295948484810,True,786800000,3823510,790623510,False,9
3405,validator_28,61169401531,True,497020004,20300300,517320304,True,1
3406,validator_2,365071819434,True,723140004,12439750,735579754,True,11
3407,validator_1,511222349760,True,679900000,3199040,683099040,False,15
3408,validator_35,59010549470,True,597700000,1795280,599495280,False,1
3409,validator_5,190348698240,True,738400000,25112410,763512410,False,5
3410,validator_34,53904599440,True,586900000,10876580,597776580,False,1
3411,validator_8,56223444356,True,854099999,9082920,863182919,True,1
3412,validator_10,60608121299,True,665600004,24910720,690510724,True,1
3413,validator_1,511772709300,True,546400000,3959540,550359540,False,15
3414,validator_40,52945433310,True,719000000,2991020,721991020,False,1
3415,validator_7,134546983460,True,590900000,6546800,597446800,False,4
3416,validator_28,61859680560,True,666299999,23979030,690279029,True,1
3417,validator_33,57667693450,True,634800000,20502550,655302550,False,1
3418,validator_18,72665494679,True,631540003,8236000,639776003,True,2
3419,validator_10,61361717901,True,683916002,69680600,753596602,True,1
3420,validator_5,191101382020,True,750400000,2283780,752683780,False,5
3421,validator_2,365588716868,True,486440004,30457430,516897434,True,11
3422,validator_22,74286803122,True,586560005,20586760,607146765,True,2
3423,validator_2,366260524546,True,639703998,32103680,671807678,True,11
3424,validator_41,50285020890,True,667700000,20713350,688413350,False,1
3425,validator_19,57661776869,True,666186000,24175820,690361820,True,1
3426,validator_48,61132824330,True,553100000,21927640,575027640,False,1
3427,validator_3,296701498750,True,750200000,2813940,753013940,False,9
3428,validator_1,512387046000,True,593700000,20636700,614336700,False,16
3429,validator_3,297379781380,True,675900000,2382630,678282630,False,9
3430,validator_13,49736973316,True,841339999,31979220,873319219,True,1
3431,validator_9,57103453634,True,656040001,31007730,687047731,True,1
3432,validator_2,366798449688,True,492780002,45145140,537925142,True,11
3433,validator_3,297863406580,True,482400000,1225200,483625200,False,9
3434,validator_1,512906124000,True,518200000,878000,519078000,False,16
3435,validator_31,54917807040,True,531200000,8811430,540011430,False,1
3436,validator_18,73446287002,True,769600003,11192320,780792323,True,2
3437,validator_47,53320818810,True,490600000,18876040,509476040,False,1
3438,validator_2,367544079258,True,714734000,30895570,745629570,True,11
3439,validator_2,368138127061,True,574080003,19967800,594047803,True,11
3440,validator_37,53749763400,True,575400000,4462280,579862280,False,1
3441,validator_1,513395867760,True,480400000,9343760,489743760,False,16
3442,validator_0,583386534785,True,789300007,24455230,813755237,True,18
3443,validator_27,57010463734,True,693839999,8063080,701903079,True,1
3444,validator_6,133441887868,True,916995999,38578910,955574909,True,4
3445,validator_10,62197833515,True,797959994,38155620,836115614,True,1
3446,validator_1,513866578580,True,468300000,2410820,470710820,False,16
3447,validator_0,583859180850,True,467540005,5106060,472646065,True,18
3448,validator_7,135328141060,True,778100000,3057600,781157600,False,4
3449,validator_3,298609354220,True,709000000,36947640,745947640,False,9
3450,validator_2,369089864911,True,931940000,19797850,951737850,True,11
3451,validator_5,191601982820,True,495500000,5100800,500600800,False,5
3452,validator_0,584519237391,True,647320001,12736540,660056541,True,18
3453,validator_0,585515722316,True,968840005,27644920,996484925,True,18
3454,validator_36,56595863390,True,570500000,2105380,572605380,False,1
3455,validator_0,586064221042,True,519839996,28658730,548498726,True,18
3456,validator_6,134223061545,True,761499997,19673680,781173677,True,4
3457,validator_35,59534629210,True,519600000,4479740,524079740,False,1
3458,validator_0,586903081558,True,817197996,21662520,838860516,True,18
3459,validator_0,587644078292,True,717679994,23316740,740996734,True,18
3460,validator_0,588059715085,True,403099993,12536800,415636793,True,18
3461,validator_3,299067893630,True,457100000,1439410,458539410,False,9
3462,validator_4,181993546071,True,637979994,9067020,647047014,True,5
3463,validator_28,62420328208,True,551760008,8887640,560647648,True,1
3464,validator_49,51593476880,True,544700000,6660240,551360240,False,1
3465,validator_0,588800520564,True,738700009,2105470,740805479,True,18
3466,validator_1,514325206170,True,454180000,4447590,458627590,False,16
3467,validator_0,589427366558,True,602654004,24191990,626845994,True,18
3468,validator_26,56128298322,True,485960004,46824200,532784204,True,1
3469,validator_3,299627619870,True,554600000,5126240,559726240,False,9
3470,validator_35,60077907750,True,521200000,22078540,543278540,False,1
3471,validator_5,192173546220,True,569600000,1963400,571563400,False,6
3472,validator_5,192605312220,True,424100000,7666000,431766000,False,6
3473,validator_9,57717008328,True,605664004,7890690,613554694,True,1
3474,validator_0,590176575659,True,728280001,20929100,749209101,True,18
3475,validator_3,300170840800,True,540200000,3020930,543220930,False,9
3476,validator_9,58430277550,True,691100002,22169220,713269222,True,1
3477,validator_2,369532178925,True,440699994,1614020,442314014,True,11
3478,validator_35,60892997290,True,806100000,8989540,815089540,False,1
3479,validator_0,591031904744,True,831370005,23959080,855329085,True,18
3480,validator_40,53470719950,True,516000000,9286640,525286640,False,1
3481,validator_3,300718342670,True,545200000,2301870,547501870,False,9
3482,validator_31,55631104460,True,699800000,13497420,713297420,False,1
3483,validator_0,591678648303,True,626865999,19877560,646743559,True,18
3484,validator_2,370354533015,True,801468000,20886090,822354090,True,11
3485,validator_7,135815346580,True,481900000,5305520,487205520,False,4
3486,validator_22,75170150014,True,870599992,12746900,883346892,True,2
3487,validator_4,182731050700,True,717999999,19504630,737504629,True,5
3488,validator_6,134955360760,True,677207995,55091220,732299215,True,4
3489,validator_42,53541423820,True,396600000,6299630,402899630,False,1
3490,validator_1,514804542570,True,470800000,8536400,479336400,False,16
3491,validator_1,515366281070,True,542800000,18938500,561738500,False,16
3492,validator_20,57626063563,True,606620001,44404800,651024801,True,1
3493,validator_24,54695344565,True,584300003,2632380,586932383,True,1
3494,validator_0,592439346471,True,756799998,3898170,760698168,True,18
3495,validator_23,63456531886,True,525199996,19847750,545047746,True,1
3496,validator_23,64069282242,True,595939996,16810360,612750356,True,2
3497,validator_2,370887220745,True,514840000,17847730,532687730,True,11
3498,validator_0,593161365969,True,690289998,31729500,722019498,True,18
3499,validator_3,301313569770,True,592600000,2627100,595227100,False,9
3500,validator_1,516097517900,True,719600000,11636830,731236830,False,16
3501,validator_1,516697372770,True,598000000,1854870,599854870,False,16
3502,validator_8,57107466072,True,850319996,33701720,884021716,True,1
3503,validator_1,517173367410,True,473800000,2194640,475994640,False,16
3504,validator_0,593634809158,True,470199999,3243190,473443189,True,18
3505,validator_5,193214020420,True,605900000,2808200,608708200,False,6
3506,validator_29,53141499100,True,564300000,20783430,585083430,False,1
3507,validator_5,193801625580,True,585200000,2405160,587605160,False,6
3508,validator_21,59344730143,True,426130000,35525900,461655900,True,1
3509,validator_1,517848633550,True,671900000,3366140,675266140,False,16
3510,validator_16,50949320456,True,561320002,28013320,589333322,True,1
3511,validator_3,301762458370,True,426400000,22488600,448888600,False,9
3512,validator_10,62763364411,True,526599996,38930900,565530896,True,1
3513,validator_48,61612444960,True,476800000,2820630,479620630,False,1
3514,validator_39,47287546900,True,572700000,20244880,592944880,False,1
3515,validator_4,183428002303,True,686560003,10391600,696951603,True,5
3516,validator_20,58262322344,True,607566001,28692780,636258781,True,1
3517,validator_0,594302102179,True,630840001,36453020,667293021,True,18
3518,validator_42,54334727420,True,749400000,43903600,793303600,False,1
3519,validator_6,135723793556,True,732919996,35512800,768432796,True,4
3520,validator_0,595059679285,True,724120006,33457100,757577106,True,18
3521,validator_0,595873183968,True,777688003,35816680,813504683,True,18
3522,validator_2,371496203045,True,602300000,6682300,608982300,True,11
3523,validator_5,194391084770,True,585800000,3659190,589459190,False,6
3524,validator_27,57732567280,True,719299996,2803550,722103546,True,1
3525,validator_0,596851898637,True,958819999,19894670,978714669,True,18
3526,validator_12,55564537019,True,958880003,21120860,980000863,True,1
3527,validator_3,302292010870,True,517000000,12552500,529552500,False,9
3528,validator_0,597679530567,True,795360000,32271930,827631930,True,18
3529,validator_4,184387796577,True,931459994,28334280,959794274,True,5
3530,validator_5,195000690630,True,602200000,7405860,609605860,False,6
3531,validator_42,54985235050,True,641200000,9307630,650507630,False,1
3532,validator_4,185102987625,True,678303998,36887050,715191048,True,5
3533,validator_38,53859896430,True,494400000,20675900,515075900,False,1
3534,validator_23,64843843779,True,766740007,7821530,774561537,True,2
3535,validator_2,372192352550,True,676470005,19679500,696149505,True,11
3536,validator_7,136366580300,True,531600000,19633720,551233720,False,4
3537,validator_45,58110546050,True,557940000,8033500,565973500,False,1
3538,validator_47,53949795550,True,625100000,3876740,628976740,False,1
3539,validator_2,373358360764,True,1146639994,19368220,1166008214,True,11
3540,validator_1,518257996090,True,401700000,7662540,409362540,False,16
3541,validator_1,518890261200,True,611900000,20365110,632265110,False,16
3542,validator_14,60740739732,True,651899998,3168520,655068518,True,1
3543,validator_25,55679027877,True,536110002,4782940,540892942,True,1
3544,validator_3,302726689150,True,432600000,2078280,434678280,False,9
3545,validator_0,598347534201,True,636699994,31303640,668003634,True,18
3546,validator_16,51508117954,True,551373998,7423500,558797498,True,1
3547,validator_0,599143796974,True,767720003,28542770,796262773,True,18
3548,validator_26,56926725928,True,788000006,10427600,798427606,True,1
3549,validator_20,58933701145,True,663900011,7478790,671378801,True,1
3550,validator_30,52433919650,True,750290000,2387740,752677740,False,1
3551,validator_17,62291817080,True,593779998,11789300,605569298,True,1
3552,validator_1,519658433640,True,765500000,2672440,768172440,False,16
3553,validator_49,52244855420,True,632400000,18978540,651378540,False,1
3554,validator_1,520270078660,True,610100000,1545020,611645020,False,16
3555,validator_21,60222842031,True,853939998,24171890,878111888,True,1
3556,validator_15,62993200254,True,840139996,9713500,849853496,True,1
3557,validator_15,63982173480,True,942160006,46813220,988973226,True,1
3558,validator_42,55662366420,True,675100000,2031370,677131370,False,1
3559,validator_1,520749807730,True,460500000,19229070,479729070,False,16
3560,validator_7,136891649980,True,523800000,1269680,525069680,False,4
3561,validator_14,61365340682,True,610120000,14480950,624600950,True,1
3562,validator_48,62283740220,True,651800000,19495260,671295260,False,1
3563,validator_33,58203634680,True,527800000,8141230,535941230,False,1
3564,validator_0,599726459372,True,565663998,16998400,582662398,True,18
3565,validator_7,137499917270,True,607100000,1167290,608267290,False,4
3566,validator_44,54443696560,True,919700000,4054460,923754460,False,1
3567,validator_17,62985204408,True,682199998,11187330,693387328,True,1
3568,validator_0,600561416202,True,808274000,26682830,834956830,True,18
3569,validator_1,521478447160,True,718500000,10139430,728639430,False,16
3570,validator_22,75757286018,True,567240004,19896000,587136004,True,2
3571,validator_17,63633999742,True,647699994,1095340,648795334,True,1
3572,validator_11,55717918523,True,586900006,20149160,607049166,True,1
3573,validator_10,63326680667,True,553519996,9796260,563316256,True,1
3574,validator_2,374107508739,True,696760005,52387970,749147975,True,11
3575,validator_1,522072347030,True,591300000,2599870,593899870,False,16
3576,validator_3,303254364680,True,520900000,6775530,527675530,False,9
3577,validator_2,374892297268,True,776539989,8248540,784788529,True,11
3578,validator_0,601404336196,True,804620004,38299990,842919994,True,18
3579,validator_0,602159728073,True,752700007,2691870,755391877,True,18
3580,validator_37,54262942720,True,484800000,28379320,513179320,False,1
3581,validator_1,522592367600,True,512800000,7220570,520020570,False,16
3582,validator_0,602768967282,True,593020009,16219200,609239209,True,18
3583,validator_4,185753432622,True,646499997,3945000,650444997,True,5
3584,validator_39,47782732770,True,485290000,9895870,495185870,False,1
3585,validator_31,56419787160,True,767400000,21282700,788682700,False,1
3586,validator_0,603464842169,True,691999997,3874890,695874887,True,18
3587,validator_35,61724917990,True,822300000,9620700,831920700,False,1
3588,validator_38,54402464670,True,539340000,3228240,542568240,False,1
3589,validator_3,303826118880,True,553930000,17824200,571754200,False,9
3590,validator_39,48272546200,True,485100000,4713430,489813430,False,1
3591,validator_46,53691208680,True,504000000,2245810,506245810,False,1
3592,validator_2,375801881985,True,907199997,2384720,909584717,True,11
3593,validator_26,57700507110,True,746696002,27085180,773781182,True,1
3594,validator_4,186312089522,True,551634000,7022900,558656900,True,5
3595,validator_0,604401464162,True,869919993,66702000,936621993,True,18
3596,validator_3,304429888720,True,601900000,1869840,603769840,False,9
3597,validator_6,136360082060,True,624080004,12208500,636288504,True,4
3598,validator_1,523453083990,True,853200000,7516390,860716390,False,16
3599,validator_26,58425142742,True,723100002,1535630,724635632,True,1
3600,validator_24,55234218064,True,515159999,23713500,538873499,True,1
3601,validator_7,137963749030,True,462400000,1431760,463831760,False,4
3602,validator_7,138550662660,True,585000000,1913630,586913630,False,4
3603,validator_30,53005577890,True,550800000,20858240,571658240,False,1
3604,validator_3,304922322520,True,478100000,14333800,492433800,False,9
3605,validator_1,524302023060,True,841700000,7239070,848939070,False,16
3606,validator_27,58536248069,True,790499999,13180790,803680789,True,1
3607,validator_3,305370581620,True,445300000,2959100,448259100,False,9
3608,validator_1,525072431000,True,760200000,10207940,770407940,False,16
3609,validator_39,48951160920,True,676900000,1714720,678614720,False,1
3610,validator_41,50831637790,True,545000000,1616900,546616900,False,1
3611,validator_5,195689429790,True,684400000,4339160,688739160,False,6
3612,validator_12,55996075372,True,430400003,1138350,431538353,True,1
3613,validator_20,59505735147,True,566240002,5794000,572034002,True,1
3614,validator_26,59211329786,True,777400004,8787040,786187044,True,1
3615,validator_18,74169351580,True,710280008,12784570,723064578,True,2
3616,validator_4,186867450257,True,530760005,24600730,555360735,True,5
3617,validator_45,58741861950,True,628600000,2715900,631315900,False,1
3618,validator_37,54755235670,True,490600000,1692950,492292950,False,1
3619,validator_21,60821644132,True,588400001,10402100,598802101,True,1
3620,validator_5,196536510000,True,818900000,28180210,847080210,False,6
3621,validator_43,55165866950,True,643700000,21959380,665659380,False,1
3622,validator_2,376804130723,True,961319998,40928740,1002248738,True,11
3623,validator_49,53017940910,True,753400000,19685490,773085490,False,1
3624,validator_42,56161870020,True,498640000,863600,499503600,False,1
3625,validator_3,305921897120,True,548710000,2605500,551315500,False,9
3626,validator_8,57941211273,True,826600001,7145200,833745201,True,1
3627,validator_4,187548538225,True,659243998,21843970,681087968,True,5
3628,validator_1,525731697400,True,658100000,1166400,659266400,False,16
3629,validator_16,52276128848,True,754499994,13510900,768010894,True,1
3630,validator_3,306349696760,True,400500000,27299640,427799640,False,9
3631,validator_0,604993531198,True,563800006,28267030,592067036,True,18
3632,validator_0,605537598899,True,533600001,10467700,544067701,True,18
3633,validator_0,606477883468,True,915703999,24580570,940284569,True,18
3634,validator_1,526295375660,True,548900000,14778260,563678260,False,16
3635,validator_41,51349942140,True,487300000,31004350,518304350,False,1
3636,validator_7,139176500660,True,614000000,11838000,625838000,False,4
3637,validator_1,527051554160,True,754000000,2178500,756178500,False,16
3638,validator_2,377307710864,True,495200001,8380140,503580141,True,11
3639,validator_7,139691306450,True,498000000,16805790,514805790,False,4
3640,validator_2,377920514290,True,581239996,31563430,612803426,True,11
3641,validator_23,65528998591,True,630270002,54884810,685154812,True,2
3642,validator_4,188655347675,True,1100540000,6269450,1106809450,True,5
3643,validator_0,607068390224,True,577059996,13446760,590506756,True,18
3644,validator_3,306915499050,True,564700000,1102290,565802290,False,9
3645,validator_33,58704218500,True,499500000,1083820,500583820,False,1
3646,validator_11,56451730309,True,691400006,42411780,733811786,True,1
3647,validator_23,66179128090,True,634819999,15309500,650129499,True,2
3648,validator_15,64767275506,True,723859996,61242030,785102026,True,2
3649,validator_1,527578186400,True,517700000,8932240,526632240,False,16
3650,validator_32,53619861730,True,446000000,4886120,450886120,False,1
3651,validator_0,607712822419,True,636019995,8412200,644432195,True,18
3652,validator_5,197214030680,True,651800000,25720680,677520680,False,6
3653,validator_3,307616773860,True,698700000,2574810,701274810,False,9
3654,validator_23,67004974588,True,800800008,25046490,825846498,True,2
3655,validator_3,308282269670,True,633400000,32095810,665495810,False,9
3656,validator_27,59226987998,True,688799999,1939930,690739929,True,1
3657,validator_7,140296792390,True,594500000,10985940,605485940,False,4
3658,validator_25,56509629573,True,800299996,30301700,830601696,True,1
3659,validator_15,65446798208,True,661680002,17842700,679522702,True,2
3660,validator_7,140830953710,True,527500000,6661320,534161320,False,4
3661,validator_15,66019258435,True,554139997,18320230,572460227,True,2
3662,validator_1,528216272670,True,610500000,27586270,638086270,False,16
3663,validator_29,53855239880,True,712800000,940780,713740780,False,1
3664,validator_36,57266089230,True,668800000,1425840,670225840,False,1
3665,validator_26,59879243602,True,648039996,19873820,667913816,True,1
3666,validator_3,308944230810,True,658400000,3561140,661961140,False,9
3667,validator_0,608520155263,True,786800004,20532840,807332844,True,19
3668,validator_16,52910805543,True,623920005,10756690,634676695,True,1
3669,validator_41,51908659960,True,534800000,23917820,558717820,False,1
3670,validator_0,609144102981,True,590939998,33007720,623947718,True,19
3671,validator_38,55177975170,True,765300000,10210500,775510500,False,1
3672,validator_10,64136583767,True,777760000,32143100,809903100,True,2
3673,validator_8,58519491102,True,557199999,21079830,578279829,True,1
3674,validator_3,309565851650,True,619100000,2520840,621620840,False,9
3675,validator_0,609767073407,True,611839996,11130430,622970426,True,19
3676,validator_28,63236049339,True,782514001,33207130,815721131,True,1
3677,validator_0,610611471781,True,838000004,6398370,844398374,True,19
3678,validator_3,310059855650,True,485170000,8834000,494004000,False,9
3679,validator_8,59222314702,True,663400000,39423600,702823600,True,1
3680,validator_4,189316573280,True,637099995,24125610,661225605,True,5
3681,validator_0,611181968910,True,548079999,22417130,570497129,True,19
3682,validator_2,378527662113,True,584536003,22611820,607147823,True,11
3683,validator_39,49709304750,True,747800000,10343830,758143830,False,1
3684,validator_24,55785207609,True,540900005,10089540,550989545,True,1
3685,validator_0,611930603024,True,708120004,40514110,748634114,True,19
3686,validator_19,58437224374,True,716130005,59317500,775447505,True,1
3687,validator_32,54196183410,True,573500000,2821680,576321680,False,1
3688,validator_28,64063577865,True,813999996,13528530,827528526,True,2
3689,validator_7,141325795090,True,475700000,19141380,494841380,False,4
3690,validator_2,379249329333,True,718600000,3067220,721667220,True,11
3691,validator_1,528833052860,True,612900000,3880190,616780190,False,16
3692,validator_23,67514785531,True,502100003,7710940,509810943,True,2
3693,validator_8,60231917891,True,978999999,30603190,1009603189,True,1
3694,validator_1,529404952050,True,555600000,16299190,571899190,False,16
3695,validator_0,612476147545,True,542160001,3384520,545544521,True,19
3696,validator_1,529831475870,True,425200000,1323820,426523820,False,16
3697,validator_23,68382366860,True,856299999,11281330,867581329,True,2
3698,validator_20,60462318350,True,936500003,20083200,956583203,True,1
3699,validator_7,141899312080,True,571300000,2216990,573516990,False,4
3700,validator_14,62059739669,True,662659997,31738990,694398987,True,1
3701,validator_1,530311706500,True,460600000,19630630,480230630,False,16
3702,validator_15,66969013857,True,947300002,2455420,949755422,True,2
3703,validator_0,613049707683,True,564700008,8860130,573560138,True,19
3704,validator_11,57329559844,True,845079995,32749540,877829535,True,1
3705,validator_0,613628553422,True,577899999,945740,578845739,True,19
3706,validator_1,530775752900,True,461200000,2846400,464046400,False,16
3707,validator_0,614322069206,True,683700004,9815780,693515784,True,19
3708,validator_1,531561656400,True,740900000,45003500,785903500,False,16
3709,validator_24,56416806830,True,578950001,52649220,631599221,True,1
3710,validator_39,50307216050,True,593500000,4411300,597911300,False,1
3711,validator_26,60804746474,True,902000002,23502870,925502872,True,1
3712,validator_2,379818145530,True,568299997,516200,568816197,True,11
3713,validator_28,64752381670,True,651858005,36945800,688803805,True,2
3714,validator_34,54554077360,True,645800000,3677920,649477920,False,1
3715,validator_1,532201759460,True,638900000,1203060,640103060,False,16
3716,validator_28,65327769691,True,547158001,28230020,575388021,True,2
3717,validator_2,380627448484,True,785200004,24102950,809302954,True,11
3718,validator_4,190192325487,True,855500007,20252200,875752207,True,5
3719,validator_16,53857461171,True,921453998,25201630,946655628,True,1
3720,validator_0,615127807650,True,801500004,4238440,805738444,True,19
3721,validator_7,142427507060,True,522900000,5294980,528194980,False,4
3722,validator_0,615829181945,True,684119995,17254300,701374295,True,19
3723,validator_1,532949745740,True,738900000,9086280,747986280,False,16
3724,validator_5,197671012280,True,455600000,1381600,456981600,False,6
3725,validator_4,191006255133,True,794800006,19129640,813929646,True,5
3726,validator_1,533795595060,True,827100000,18749320,845849320,False,16
3727,validator_10,64616819147,True,469700000,10535380,480235380,True,2
3728,validator_48,62955174260,True,670800000,634040,671434040,False,1
3729,validator_1,534494226620,True,696700000,1931560,698631560,False,16
3730,validator_5,198328716930,True,636900000,20804650,657704650,False,6
3731,validator_4,191845106734,True,801580001,37271600,838851601,True,5
3732,validator_19,59025833004,True,569680000,18928630,588608630,True,1
3733,validator_22,76633282122,True,798660004,77336100,875996104,True,2
3734,validator_1,535059976550,True,545800000,19949930,565749930,False,16
3735,validator_7,143030496890,True,592700000,10289830,602989830,False,4
3736,validator_15,67813345694,True,806939997,37391840,844331837,True,2
3737,validator_32,54663166980,True,464600000,2383570,466983570,False,1
3738,validator_2,381252724810,True,623500006,1776320,625276326,True,11
3739,validator_38,55789024310,True,609800000,1249140,611049140,False,1
3740,validator_4,192498994797,True,640140003,13748060,653888063,True,6
3741,validator_3,310628054450,True,558400000,9798800,568198800,False,9
3742,validator_48,63672088340,True,711900000,5014080,716914080,False,1
3743,validator_1,535551532910,True,488800000,2756360,491556360,False,16
3744,validator_0,616501372040,True,647554005,24636090,672190095,True,19
3745,validator_32,55280254100,True,606600000,10487120,617087120,False,1
3746,validator_3,311089606150,True,459500000,2051700,461551700,False,9
3747,validator_1,536055355090,True,501600000,2222180,503822180,False,16
3748,validator_15,68565884310,True,707145996,45392620,752538616,True,2
3749,validator_0,617367066519,True,840315999,25378480,865694479,True,19
3750,validator_7,143606187990,True,572900000,2791100,575691100,False,4
3751,validator_1,536742118640,True,684900000,1863550,686763550,False,16
3752,validator_23,69206584597,True,781679997,42537740,824217737,True,2
3753,validator_24,56989635457,True,545135997,27692630,572828627,True,1
3754,validator_24,57470449120,True,434279993,46533670,480813663,True,1
3755,validator_12,56675722011,True,668819999,10826640,679646639,True,1
3756,validator_1,537728466680,True,984100000,2248040,986348040,False,16
3757,validator_4,193120721894,True,590019997,31707100,621727097,True,6
3758,validator_24,58231447347,True,725779997,35218230,760998227,True,1
3759,validator_2,381823663488,True,557206008,13732670,570938678,True,11
3760,validator_7,144261058730,True,638400000,16470740,654870740,False,4
3761,validator_22,77276353017,True,625539995,17530900,643070895,True,2
3762,validator_49,53690674240,True,669300000,3433330,672733330,False,1
3763,validator_3,311722301860,True,628900000,3795710,632695710,False,9
3764,validator_2,382612070774,True,768870006,19537280,788407286,True,11
3765,validator_10,65310466874,True,666269997,27377730,693647727,True,2
3766,validator_24,58768896245,True,527399998,10048900,537448898,True,1
3767,validator_1,538337163120,True,601900000,6796440,608696440,False,16
3768,validator_1,538956396430,True,615200000,4033310,619233310,False,16
3769,validator_22,77779384707,True,478500000,24531690,503031690,True,2
3770,validator_1,539421119460,True,456200000,8523030,464723030,False,16
3771,validator_6,136984924885,True,623300005,1542820,624842825,True,4
3772,validator_7,144828472350,True,565700000,1713620,567413620,False,4
3773,validator_27,59989192386,True,759099998,3104390,762204388,True,1
3774,validator_0,618086740257,True,704339998,15333740,719673738,True,19
3775,validator_3,312449142090,True,725400000,1440230,726840230,False,9
3776,validator_43,55711990720,True,545100000,1023770,546123770,False,1
3777,validator_5,199091221970,True,760200000,2305040,762505040,False,6
3778,validator_32,55664053130,True,381200000,2599030,383799030,False,1
3779,validator_6,137573514021,True,578619996,9969140,588589136,True,4
3780,validator_7,145552208970,True,703100000,20636620,723736620,False,4
3781,validator_48,64296754370,True,617400000,7266030,624666030,False,2
3782,validator_15,69331830012,True,751020002,14925700,765945702,True,2
3783,validator_0,618643784286,True,555599999,1444030,557044029,True,19
3784,validator_16,54619210012,True,722452001,39296840,761748841,True,1
3785,validator_42,56858108940,True,675100000,21138920,696238920,False,1
3786,validator_2,383450582838,True,813420004,25092060,838512064,True,11
3787,validator_0,619541140710,True,872820004,24536420,897356424,True,19
3788,validator_22,78468658109,True,672540002,16733400,689273402,True,2
3789,validator_19,59830623888,True,785059994,19730890,804790884,True,1
3790,validator_1,539910090360,True,464100000,24870900,488970900,False,16
3791,validator_24,59637456426,True,841339991,27220190,868560181,True,1
3792,validator_19,60574377613,True,688439995,55313730,743753725,True,1
3793,validator_0,620078427145,True,517099995,20186440,537286435,True,19
3794,validator_0,620634871600,True,548139995,8304460,556444455,True,19
3795,validator_45,59293927860,True,549100000,2965910,552065910,False,1
3796,validator_2,383982269833,True,517877995,13809000,531686995,True,11
3797,validator_36,57767855390,True,495300000,6466160,501766160,False,1
3798,validator_2,384416384736,True,427240003,6874900,434114903,True,12
3799,validator_1,540459583460,True,546300000,3193100,549493100,False,16
3800,validator_14,63049242094,True,988200005,1302420,989502425,True,1
3801,validator_4,193770220175,True,627540001,21958280,649498281,True,6
3802,validator_3,313155542790,True,700400000,6000700,706400700,False,9
3803,validator_5,199666339970,True,555100000,20018000,575118000,False,6
3804,validator_34,55174685620,True,615100000,5508260,620608260,False,1
3805,validator_7,145898971000,True,343500000,3262030,346762030,False,4
3806,validator_45,60046448040,True,729400000,23120180,752520180,False,1
3807,validator_10,66210514417,True,894620003,5427540,900047543,True,2
3808,validator_15,70039202914,True,700740002,6632900,707372902,True,2
3809,validator_28,66056673892,True,704260001,24644200,728904201,True,2
3810,validator_49,54338450000,True,645800000,1975760,647775760,False,1
3811,validator_0,621306356977,True,662899997,8585380,671485377,True,19
3812,validator_3,313776547630,True,618800000,2204840,621004840,False,9
3813,validator_8,60784823476,True,527099995,25805590,552905585,True,1
3814,validator_3,314329330490,True,551800000,982860,552782860,False,9
3815,validator_1,541236402690,True,775300000,1519230,776819230,False,16
3816,validator_1,541878338430,True,621500000,20435740,641935740,False,16
3817,validator_1,542355368930,True,446600000,30430500,477030500,False,16
3818,validator_13,50501807585,True,754479999,10354270,764834269,True,1
3819,validator_22,79268375963,True,756120004,43597850,799717854,True,2
3820,validator_0,621944007573,True,594409996,43240600,637650596,True,19
3821,validator_0,622715176114,True,753620001,17548540,771168541,True,19
3822,validator_18,74762616480,True,569840000,23424900,593264900,True,2
3823,validator_22,79996311664,True,724900001,3035700,727935701,True,2
3824,validator_3,314831168730,True,499900000,1938240,501838240,False,9
3825,validator_2,385349561431,True,923199995,9976700,933176695,True,12
3826,validator_47,54374443570,True,420700000,3948020,424648020,False,1
3827,validator_49,54873924930,True,512200000,23274930,535474930,False,1
3828,validator_5,200261501080,True,574900000,20261110,595161110,False,6
3829,validator_9,59208370655,True,770060005,8033100,778093105,True,1
3830,validator_1,543114764450,True,758800000,595520,759395520,False,16
3831,validator_15,70741947923,True,699839999,2905010,702745009,True,2
3832,validator_38,56279988240,True,488700000,2263930,490963930,False,1
3833,validator_5,200891634940,True,612100000,18033860,630133860,False,6
3834,validator_5,201616573940,True,718400000,6539000,724939000,False,6
3835,validator_7,146681753180,True,746000000,36782180,782782180,False,4
3836,validator_5,202275807430,True,654100000,5133490,659233490,False,6
3837,validator_2,386420594871,True,1039578000,31455440,1071033440,True,12
3838,validator_2,387180387504,True,724440003,35352630,759792633,True,12
3839,validator_10,66809368918,True,574460001,24394500,598854501,True,2
3840,validator_1,543766559190,True,649900000,1894740,651794740,False,16
3841,validator_0,623487304127,True,763300003,8828010,772128013,True,19
3842,validator_1,544475799520,True,700200000,9040330,709240330,False,17
3843,validator_14,63740529723,True,681399999,9887630,691287629,True,1
3844,validator_1,545075559940,True,598000000,1760420,599760420,False,17
3845,validator_35,62381040330,True,618200000,37922340,656122340,False,1
3846,validator_1,545667828120,True,583300000,8968180,592268180,False,17
3847,validator_41,52501381120,True,589400000,3321160,592721160,False,1
3848,validator_11,58275540876,True,903299992,42681040,945981032,True,1
3849,validator_1,546249725940,True,571400000,10497820,581897820,False,17
3850,validator_0,624141480425,True,598519998,55656300,654176298,True,19
3851,validator_18,75335325297,True,561739997,10968820,572708817,True,2
3852,validator_31,57058841790,True,618200000,20854630,639054630,False,1
3853,validator_1,546903717820,True,651900000,2091880,653991880,False,17
3854,validator_3,315380645120,True,528670000,20806390,549476390,False,9
3855,validator_1,547651593990,True,745300000,2576170,747876170,False,17
3856,validator_0,624794174118,True,642439993,10253700,652693693,True,19
3857,validator_35,62922991270,True,517800000,24150940,541950940,False,1
3858,validator_0,625396037148,True,549386000,52477030,601863030,True,19
3859,validator_7,147476788520,True,786900000,8135340,795035340,False,4
3860,validator_30,53925001970,True,899400000,20024080,919424080,False,1
3861,validator_20,61245949899,True,760700009,22931540,783631549,True,1
3862,validator_23,69881629440,True,662940003,12104840,675044843,True,2
3863,validator_1,548261289490,True,601600000,8095500,609695500,False,17
3864,validator_2,387979196909,True,792220005,6589400,798809405,True,12
3865,validator_2,388686604442,True,702899993,4507540,707407533,True,12
3866,validator_5,202720846660,True,430300000,14739230,445039230,False,6
3867,validator_4,194657607573,True,879579998,7807400,887387398,True,6
3868,validator_5,203418610920,True,695500000,2264260,697764260,False,6
3869,validator_21,61365929533,True,514788001,29497400,544285401,True,1
3870,validator_48,64875949860,True,558500000,20695490,579195490,False,2
3871,validator_29,54402449100,True,515800000,31409220,547209220,False,1
3872,validator_7,148138297590,True,640800000,20709070,661509070,False,4
3873,validator_40,54131713250,True,653500000,7493300,660993300,False,1
3874,validator_0,626178698211,True,761420003,21241060,782661063,True,19
3875,validator_47,55045844470,True,653500000,17900900,671400900,False,1
3876,validator_15,71439228354,True,691220001,6060430,697280431,True,2
3877,validator_4,195458880359,True,722139996,79132790,801272786,True,6
3878,validator_34,55737900840,True,560900000,2315220,563215220,False,1
3879,validator_20,61819908640,True,546680001,27278740,573958741,True,1
3880,validator_1,548947124410,True,667000000,18834920,685834920,False,17
3881,validator_1,549367059450,True,417900000,2035040,419935040,False,17
3882,validator_28,66767427280,True,703440008,7313380,710753388,True,2
3883,validator_0,627084756011,True,891800000,14257800,906057800,True,19
3884,validator_1,550022796520,True,646200000,9537070,655737070,False,17
3885,validator_20,62591707816,True,755079996,16719180,771799176,True,1
3886,validator_4,196296935953,True,816899994,21155600,838055594,True,6
3887,validator_23,70924600369,True,1036119999,6850930,1042970929,True,2
3888,validator_10,67455565525,True,623720007,22476600,646196607,True,2
3889,validator_4,197104599658,True,768426005,39237700,807663705,True,6
3890,validator_31,57476453310,True,413700000,3911520,417611520,False,1
3891,validator_0,627669491809,True,549383998,35351800,584735798,True,19
3892,validator_28,67625432041,True,855100001,2904760,858004761,True,2
3893,validator_1,550565086850,True,540000000,2290330,542290330,False,17
3894,validator_23,71944290439,True,998600000,21090070,1019690070,True,2
3895,validator_2,389588349824,True,896899992,4845390,901745382,True,12
3896,validator_8,61669494407,True,862600001,22070930,884670931,True,1
3897,validator_0,628319043727,True,622739998,26811920,649551918,True,19
3898,validator_1,551233230140,True,664800000,3343290,668143290,False,17
3899,validator_1,551804519660,True,561900000,9389520,571289520,False,17
3900,validator_0,629163003849,True,792119992,51840130,843960122,True,19
3901,validator_25,57240051968,True,693295995,37126400,730422395,True,1
3902,validator_1,552513971010,True,705900000,3551350,709451350,False,17
3903,validator_2,390274155256,True,657480002,28325430,685805432,True,12
3904,validator_22,80592959496,True,589900002,6747830,596647832,True,2
3905,validator_2,391039286315,True,760899999,4231060,765131059,True,12
3906,validator_6,138272583063,True,686900002,12169040,699069042,True,4
3907,validator_2,391836763550,True,757239995,40237240,797477235,True,12
3908,validator_2,392415613351,True,558600001,20249800,578849801,True,12
3909,validator_1,553169724730,True,652700000,3053720,655753720,False,17
3910,validator_1,553772001660,True,581600000,20676930,602276930,False,17
3911,validator_1,554441217960,True,648400000,20816300,669216300,False,17
3912,validator_23,72683495413,True,723786004,15418970,739204974,True,2
3913,validator_1,555006412510,True,562900000,2294550,565194550,False,17
3914,validator_1,555630270210,True,602700000,21157700,623857700,False,17
3915,validator_5,203960824820,True,536500000,5713900,542213900,False,6
3916,validator_4,197772065690,True,662440002,5026030,667466032,True,6
3917,validator_0,629715999251,True,549700002,3295400,552995402,True,19
3918,validator_1,556198747210,True,566500000,1977000,568477000,False,17
3919,validator_46,54202084620,True,508400000,2475940,510875940,False,1
3920,validator_6,139041413019,True,764859996,3969960,768829956,True,4
3921,validator_28,68266106242,True,616326001,24348200,640674201,True,2
3922,validator_3,315988510300,True,605800000,2065180,607865180,False,9
3923,validator_0,630465134191,True,736140000,12994940,749134940,True,19
3924,validator_1,556807547940,True,603500000,5300730,608800730,False,17
3925,validator_18,76141398676,True,768353999,37719380,806073379,True,2
3926,validator_23,73572612205,True,880699992,8416800,889116792,True,2
3927,validator_4,198493869384,True,697100004,24703690,721803694,True,6
3928,validator_1,557329957310,True,519300000,3109370,522409370,False,17
3929,validator_2,393244276357,True,821058006,7605000,828663006,True,12
3930,validator_11,58874159918,True,596400002,2219040,598619042,True,1
3931,validator_9,59940358697,True,727400002,4588040,731988042,True,1
3932,validator_2,394044327665,True,788240008,11811300,800051308,True,12
3933,validator_2,394796843756,True,706080011,46436080,752516091,True,12
3934,validator_0,631084374029,True,598077998,21161840,619239838,True,19
3935,validator_10,68022076073,True,553199998,13310550,566510548,True,2
3936,validator_0,631644664722,True,545303993,14986700,560290693,True,19
3937,validator_1,557922949410,True,566400000,26592100,592992100,False,17
3938,validator_6,139592114359,True,549600000,1101340,550701340,True,4
3939,validator_1,558481846190,True,553800000,5096780,558896780,False,17
3940,validator_0,632519411142,True,858920000,15826420,874746420,True,19
3941,validator_3,316571724330,True,575900000,7314030,583214030,False,9
3942,validator_3,317272830630,True,694300000,6806300,701106300,False,9
3943,validator_2,395414413261,True,601610005,15959500,617569505,True,12
3944,validator_6,140371915029,True,770600000,9200670,779800670,True,4
3945,validator_1,559271584460,True,787800000,1938270,789738270,False,17
3946,validator_2,396369172951,True,915500000,39259690,954759690,True,12
3947,validator_40,54833450120,True,699200000,2536870,701736870,False,1
3948,validator_25,57874172292,True,627399994,6720330,634120324,True,1
3949,validator_3,317727777970,True,431500000,23447340,454947340,False,9
3950,validator_21,62021203026,True,627239993,28033500,655273493,True,1
3951,validator_0,633346595860,True,823959998,3224720,827184718,True,19
3952,validator_20,63432948115,True,837799999,3440300,841240299,True,1
3953,validator_2,396974539590,True,590120009,15246630,605366639,True,12
3954,validator_4,199074008964,True,576420000,3719580,580139580,True,6
3955,validator_5,204695655950,True,728500000,6331130,734831130,False,6
3956,validator_1,559864775600,True,590600000,2591140,593191140,False,17
3957,validator_16,55305764235,True,657740003,28814220,686554223,True,1
3958,validator_2,397577920457,True,593819997,9560870,603380867,True,12
3959,validator_10,68902813542,True,836573999,44163470,880737469,True,2
3960,validator_24,60561684000,True,920039994,4187580,924227574,True,1
3961,validator_3,318330646100,True,599500000,3368130,602868130,False,9
3962,validator_48,65501130140,True,606600000,18580280,625180280,False,2
3963,validator_1,560505674580,True,614200000,26698980,640898980,False,17
3964,validator_18,76671392819,True,520160003,9834140,529994143,True,2
3965,validator_15,72116015600,True,671039996,5747250,676787246,True,2
3966,validator_17,64304932439,True,661040007,9892690,670932697,True,2
3967,validator_5,205362708220,True,665100000,1952270,667052270,False,6
3968,validator_40,55405537830,True,567900000,4187710,572087710,False,1
3969,validator_45,60591078470,True,542600000,2030430,544630430,False,1
3970,validator_22,81193068794,True,568699998,31409300,600109298,True,2
3971,validator_2,398252999662,True,649339995,25739210,675079205,True,12
3972,validator_24,61100217576,True,513539996,24993580,538533576,True,1
3973,validator_32,56330284530,True,665500000,731400,666231400,False,1
3974,validator_14,64445635017,True,679299994,25805300,705105294,True,2
3975,validator_27,60877573475,True,875620009,12761080,888381089,True,1
3976,validator_49,55469379330,True,573500000,21954400,595454400,False,1
3977,validator_5,206077971410,True,713300000,1963190,715263190,False,6
3978,validator_36,58532032010,True,744600000,19576620,764176620,False,1
3979,validator_6,141076832947,True,680739998,24177920,704917918,True,4
3980,validator_7,148685086280,True,545300000,1488690,546788690,False,4
3981,validator_0,634064346387,True,690719997,27030530,717750527,True,19
3982,validator_4,199748427758,True,632539994,41878800,674418794,True,6
3983,validator_13,51076458124,True,552499989,22150550,574650539,True,1
3984,validator_1,561037268020,True,529900000,1693440,531593440,False,17
3985,validator_1,561616633090,True,576500000,2865070,579365070,False,17
3986,validator_2,398957786163,True,680240001,24546500,704786501,True,12
3987,validator_1,562061293240,True,442800000,1860150,444660150,False,17
3988,validator_30,54736815390,True,807800000,4013420,811813420,False,1
3989,validator_26,61292520283,True,485999999,1773810,487773809,True,1
3990,validator_26,62126877527,True,832500004,1857240,834357244,True,1
3991,validator_1,562689527520,True,621200000,7034280,628234280,False,17
3992,validator_31,58160232650,True,682300000,1479340,683779340,False,1
3993,validator_0,634662622764,True,588720007,9556370,598276377,True,19
3994,validator_1,563286961920,True,590400000,7034400,597434400,False,17
3995,validator_0,635295900990,True,589140006,44138220,633278226,True,19
3996,validator_5,206875612690,True,776200000,21441280,797641280,False,6
3997,validator_2,399555400057,True,578100004,19513890,597613894,True,12
3998,validator_0,635777080229,True,473899999,7279240,481179239,True,19
3999,validator_6,141821462602,True,713599995,31029660,744629655,True,4
4000,validator_1,563828006020,True,538700000,2344100,541044100,False,17
4001,validator_12,57202158956,True,523060005,3376940,526436945,True,1
4002,validator_0,636587936148,True,791039999,19815920,810855919,True,19
4003,validator_3,319000285430,True,666900000,2739330,669639330,False,9
4004,validator_44,55002602260,True,539000000,19905700,558905700,False,1
4005,validator_1,564553802010,True,722600000,3195990,725795990,False,17
4006,validator_2,400271963849,True,710240002,6323790,716563792,True,12
4007,validator_1,565185981830,True,624900000,7279820,632179820,False,17
4008,validator_19,61198936714,True,614900001,9659100,624559101,True,1
4009,validator_2,400900411631,True,582419992,46027790,628447782,True,12
4010,validator_18,77541232721,True,825180002,44659900,869839902,True,2
4011,validator_5,207484335810,True,606000000,2723120,608723120,False,6
4012,validator_13,51814095433,True,720470009,17167300,737637309,True,1
4013,validator_6,142592255250,True,734060008,36732640,770792648,True,4
4014,validator_5,207930837480,True,442000000,4501670,446501670,False,6
4015,validator_48,66005866080,True,501700000,3035940,504735940,False,2
4016,validator_4,200378242009,True,616460001,13354250,629814251,True,6
4017,validator_1,565740711430,True,553000000,1729600,554729600,False,17
4018,validator_31,58617450550,True,418170000,39047900,457217900,False,1
4019,validator_33,59270116300,True,555500000,10397800,565897800,False,1
4020,validator_0,637239278669,True,650100001,1242520,651342521,True,19
4021,validator_7,149240189150,True,542400000,12702870,555102870,False,4
4022,validator_23,74478622627,True,885100002,20910420,906010422,True,2
4023,validator_4,201011745409,True,595020000,38483400,633503400,True,6
4024,validator_5,208671022090,True,730000000,10184610,740184610,False,6
4025,validator_42,57581596140,True,720600000,2887200,723487200,False,1
4026,validator_2,401593662672,True,671540001,21711040,693251041,True,12
4027,validator_5,209056140830,True,383700000,1418740,385118740,False,6
4028,validator_4,201744773545,True,715739996,17288140,733028136,True,6
4029,validator_3,319556976730,True,549300000,7391300,556691300,False,9
4030,validator_0,637827390611,True,560940002,27171940,588111942,True,19
4031,validator_5,209616432460,True,558100000,2191630,560291630,False,6
4032,validator_3,320180257440,True,614200000,9080710,623280710,False,10
4033,validator_21,62705142540,True,661579994,22359520,683939514,True,1
4034,validator_14,65238101525,True,785700008,6766500,792466508,True,2
4035,validator_23,75178338227,True,677066000,22649600,699715600,True,2
4036,validator_39,50988999070,True,678000000,3783020,681783020,False,1
4037,validator_30,55455386080,True,697100000,21470690,718570690,False,1
4038,validator_1,566305882060,True,562900000,2270630,565170630,False,17
4039,validator_2,402146414613,True,490500001,62251940,552751941,True,12
4040,validator_30,56075272670,True,618500000,1386590,619886590,False,1
4041,validator_2,402807016202,True,658500009,2101580,660601589,True,12
4042,validator_7,149818199950,True,575700000,2310800,578010800,False,4
4043,validator_28,68870892382,True,584740000,20046140,604786140,True,2
4044,validator_3,320712471070,True,504600000,27613630,532213630,False,10
4045,validator_0,638556066463,True,708160002,20515850,728675852,True,19
4046,validator_0,639195780775,True,636100002,3614310,639714312,True,19
4047,validator_5,210141791840,True,506400000,18959380,525359380,False,6
4048,validator_0,639571522635,True,368060000,7681860,375741860,True,19
4049,validator_17,65115078235,True,807600006,2545790,810145796,True,2
4050,validator_2,403411259614,True,570140002,34103410,604243412,True,12
4051,validator_12,57754252159,True,530740003,21353200,552093203,True,1
4052,validator_8,62415200621,True,743699994,2006220,745706214,True,1
4053,validator_1,566935183720,True,625500000,3801660,629301660,False,17
4054,validator_37,55396712130,True,631000000,10476460,641476460,False,1
4055,validator_4,202256192762,True,498759997,12659220,511419217,True,6
4056,validator_3,321286957310,True,566200000,8286240,574486240,False,10
4057,validator_0,640080794978,True,494240003,15032340,509272343,True,20
4058,validator_4,203016088102,True,735214000,24681340,759895340,True,6
4059,validator_39,51570151370,True,578800000,2352300,581152300,False,1
4060,validator_0,640676262424,True,567360006,28107440,595467446,True,20
4061,validator_2,403830401205,True,414440001,4701590,419141591,True,12
4062,validator_1,567379181350,True,443400000,597630,443997630,False,17
4063,validator_7,150590232840,True,766800000,5232890,772032890,False,4
4064,validator_45,61114783250,True,520000000,3704780,523704780,False,1
4065,validator_0,641337760364,True,628498000,32999940,661497940,True,20
4066,validator_33,59882137960,True,609500000,2521660,612021660,False,1
4067,validator_1,567911328770,True,528300000,3847420,532147420,False,17
4068,validator_2,404708039502,True,869819997,7818300,877638297,True,12
4069,validator_48,66573632630,True,547300000,20466550,567766550,False,2
4070,validator_46,55060965060,True,856300000,2580440,858880440,False,1
4071,validator_2,405307586689,True,577920007,21627180,599547187,True,12
4072,validator_10,69723694643,True,806600001,14281100,820881101,True,2
4073,validator_17,65660965628,True,536740003,9147390,545887393,True,2
4074,validator_0,642063239001,True,675759997,49718640,725478637,True,20
4075,validator_21,63662832255,True,956400005,1289710,957689715,True,1
4076,validator_2,405868116121,True,557820002,2709430,560529432,True,12
4077,validator_37,55840665000,True,440400000,3552870,443952870,False,1
4078,validator_0,642701055071,True,617199990,20616080,637816070,True,20
4079,validator_19,61718361031,True,511340007,8084310,519424317,True,1
4080,validator_2,406550863000,True,676619999,6126880,682746879,True,12
4081,validator_1,568613571940,True,699000000,3243170,702243170,False,17
4082,validator_1,569403591010,True,783300000,6719070,790019070,False,17
4083,validator_1,570072281510,True,666900000,1790500,668690500,False,17
4084,validator_0,643201772312,True,467080001,33637240,500717241,True,20
4085,validator_1,570691158940,True,618100000,777430,618877430,False,17
4086,validator_0,643999857827,True,765139995,32945520,798085515,True,20
4087,validator_5,210724420010,True,574000000,8628170,582628170,False,6
4088,validator_33,60540247300,True,636000000,22109340,658109340,False,1
4089,validator_2,407206994596,True,631379996,24751600,656131596,True,12
4090,validator_34,56401998130,True,646700000,17397290,664097290,False,1
4091,validator_3,321849605780,True,559900000,2748470,562648470,False,10
4092,validator_2,407979395127,True,758060001,14340530,772400531,True,12
4093,validator_14,65744097567,True,460280002,45716040,505996042,True,2
4094,validator_7,151255008740,True,643000000,21775900,664775900,False,4
4095,validator_1,571180179940,True,487300000,1721000,489021000,False,17
4096,validator_31,59304676690,True,663200000,24026140,687226140,False,1
4097,validator_27,61667360588,True,770919993,18867120,789787113,True,1
4098,validator_4,203726876739,True,695619997,15168640,710788637,True,6
4099,validator_3,322418108830,True,558600000,9903050,568503050,False,10
4100,validator_44,55630404640,True,621100000,6702380,627802380,False,1
4101,validator_6,143362993879,True,729165999,41572630,770738629,True,4
4102,validator_45,61742853710,True,605800000,22270460,628070460,False,1
4103,validator_1,571607858740,True,425300000,2378800,427678800,False,17
4104,validator_17,66199041128,True,518120000,19955500,538075500,True,2
4105,validator_5,211442034310,True,715800000,1814300,717614300,False,6
4106,validator_6,144292505273,True,911394004,18117390,929511394,True,4
4107,validator_4,204487402163,True,712939994,47585430,760525424,True,6
4108,validator_34,57168188530,True,764900000,1290400,766190400,False,1
4109,validator_1,572290100980,True,654600000,27642240,682242240,False,17
4110,validator_46,55683984120,True,620200000,2819060,623019060,False,1
4111,validator_12,58450489985,True,671519996,24717830,696237826,True,1
4112,validator_29,54979604940,True,571500000,5655840,577155840,False,1
4113,validator_7,151836537270,True,544500000,37028530,581528530,False,4
4114,validator_37,56436529920,True,593100000,2764920,595864920,False,1
4115,validator_1,572794096810,True,500700000,3295830,503995830,False,17
4116,validator_23,75701851519,True,512119992,11393300,523513292,True,2
4117,validator_0,644743997826,True,743699999,440000,744139999,True,20
4118,validator_6,145180057274,True,881240001,6312000,887552001,True,4
4119,validator_0,645452859168,True,688000002,20861340,708861342,True,20
4120,validator_18,78241974820,True,691179999,9562100,700742099,True,2
4121,validator_7,152492075210,True,653000000,2537940,655537940,False,4
4122,validator_15,72819294223,True,671919993,31358630,703278623,True,2
4123,validator_0,646216550001,True,728560003,35130830,763690833,True,20
4124,validator_2,408834077517,True,842440000,12242390,854682390,True,12
4125,validator_5,212104791710,True,660000000,2757400,662757400,False,6
4126,validator_1,573340614510,True,519000000,27517700,546517700,False,17
4127,validator_26,62984520829,True,821420002,36223300,857643302,True,1
4128,validator_1,574188258560,True,845400000,2244050,847644050,False,17
4129,validator_4,205124206752,True,629440009,7364580,636804589,True,6
4130,validator_3,322955909150,True,535700000,2100320,537800320,False,10
4131,validator_33,61047045920,True,493700000,13098620,506798620,False,1
4132,validator_21,64347594182,True,674499997,10261930,684761927,True,2
4133,validator_10,70599505705,True,872500002,3311060,875811062,True,2
4134,validator_7,153099821040,True,586800000,20945830,607745830,False,4
4135,validator_34,57785738710,True,614700000,2850180,617550180,False,1
4136,validator_21,65081150084,True,726800002,6755900,733555902,True,2
4137,validator_3,323679414950,True,703000000,20505800,723505800,False,10
4138,validator_2,409607254140,True,765200003,7976620,773176623,True,12
4139,validator_6,145867734668,True,666487994,21189400,687677394,True,4
4140,validator_3,324386358690,True,698000000,8943740,706943740,False,10
4141,validator_3,325010782190,True,616740000,7683500,624423500,False,10
4142,validator_11,59704432915,True,799519997,30753000,830272997,True,1
4143,validator_3,325971995620,True,959800000,1413430,961213430,False,10
4144,validator_0,646782712234,True,563540003,2622230,566162233,True,20
4145,validator_4,205959911803,True,794780001,40925050,835705051,True,6
4146,validator_1,574821645160,True,627000000,6386600,633386600,False,17
4147,validator_3,326450896420,True,476800000,2100800,478900800,False,10
4148,validator_45,62277106140,True,532400000,1852430,534252430,False,1
4149,validator_1,575355939740,True,531400000,2894580,534294580,False,17
4150,validator_38,56914733340,True,613700000,21045100,634745100,False,1
4151,validator_17,66829125531,True,611456003,18628400,630084403,True,2
4152,validator_1,575950704230,True,591900000,2864490,594764490,False,17
4153,validator_4,206524383793,True,554320000,10151990,564471990,True,6
4154,validator_1,576571927550,True,619100000,2123320,621223320,False,18
4155,validator_43,56175360770,True,459000000,4370050,463370050,False,1
4156,validator_24,61632327382,True,520845996,11263810,532109806,True,1
4157,validator_9,60531719627,True,583400000,7960930,591360930,True,1
4158,validator_3,327060542660,True,603100000,6546240,609646240,False,10
4159,validator_0,647495578334,True,709400000,3466100,712866100,True,20
4160,validator_0,648168302660,True,670099996,2624330,672724326,True,20
4161,validator_33,61618577850,True,568300000,3231930,571531930,False,1
4162,validator_37,56955602520,True,510700000,8372600,519072600,False,1
4163,validator_5,212773743110,True,666400000,2551400,668951400,False,6
4164,validator_1,577000036620,True,427090000,1019070,428109070,False,18
4165,validator_46,56279088310,True,576000000,19104190,595104190,False,1
4166,validator_0,649042387699,True,852359999,21725040,874085039,True,20
4167,validator_17,67620979649,True,790199998,1654120,791854118,True,2
4168,validator_7,153646086460,True,542500000,3765420,546265420,False,4
4169,validator_14,66530010867,True,780800000,5113300,785913300,True,2
4170,validator_1,577581157620,True,577600000,3521000,581121000,False,18
4171,validator_3,327681827360,True,595800000,25484700,621284700,False,10
4172,validator_8,63120000045,True,663979994,40819430,704799424,True,1
4173,validator_33,62264232120,True,643200000,2454270,645654270,False,1
4174,validator_15,73703347670,True,813780007,70273440,884053447,True,2
4175,validator_2,410482465824,True,856806004,18405680,875211684,True,12
4176,validator_1,578288954940,True,704900000,2897320,707797320,False,18
4177,validator_5,213394497070,True,618810000,1943960,620753960,False,6
4178,validator_4,207044931008,True,512600005,7947210,520547215,True,6
4179,validator_14,67330665718,True,777100001,23554850,800654851,True,2
4180,validator_0,649719263913,True,621240004,55636210,676876214,True,20
4181,validator_1,578814319810,True,517400000,7964870,525364870,False,18
4182,validator_38,57388413890,True,472100000,1580550,473680550,False,1
4183,validator_3,328113191660,True,428000000,3364300,431364300,False,10
4184,validator_1,579600569640,True,784300000,1949830,786249830,False,18
4185,validator_23,76389673825,True,603750006,84072300,687822306,True,2
4186,validator_5,213850456130,True,454100000,1859060,455959060,False,6
4187,validator_5,214511466850,True,656900000,4110720,661010720,False,6
4188,validator_20,64059244816,True,550920001,75376700,626296701,True,2
4189,validator_45,62703257620,True,411200000,14951480,426151480,False,1
4190,validator_0,650461684847,True,672620004,69800930,742420934,True,20
4191,validator_14,68086866796,True,734959998,21241080,756201078,True,2
4192,validator_4,207633257699,True,553660001,34666690,588326691,True,6
4193,validator_1,580117328240,True,507000000,9758600,516758600,False,18
4194,validator_35,63470026270,True,544300000,2735000,547035000,False,1
4195,validator_40,56011883430,True,603500000,2845600,606345600,False,1
4196,validator_1,580964595940,True,809500000,37767700,847267700,False,18
4197,validator_14,68621887298,True,532800002,2220500,535020502,True,2
4198,validator_18,78923755917,True,654425997,27355100,681781097,True,2
4199,validator_1,581469560040,True,501900000,3064100,504964100,False,18
4200,validator_1,582235985960,True,757900000,8525920,766425920,False,18
4201,validator_0,651040525471,True,539759994,39080630,578840624,True,20
4202,validator_6,146619519765,True,700239997,51545100,751785097,True,4
4203,validator_1,582929768790,True,691000000,2782830,693782830,False,18
4204,validator_2,411192404850,True,684219996,25719030,709939026,True,12
4205,validator_4,208558452596,True,891559997,33634900,925194897,True,6
4206,validator_15,74293365070,True,551320000,38697400,590017400,True,2
4207,validator_2,411787883431,True,591140001,4338580,595478581,True,12
4208,validator_0,651689800572,True,621180001,28095100,649275101,True,20
4209,validator_5,215324281750,True,808800000,4014900,812814900,False,6
4210,validator_12,58906492275,True,429640000,26362290,456002290,True,1
4211,validator_0,652361979666,True,669299994,2879100,672179094,True,20
4212,validator_45,63341556470,True,635900000,2398850,638298850,False,1
4213,validator_0,652941568870,True,552220004,27369200,579589204,True,20
4214,validator_7,154317210360,True,665600000,5523900,671123900,False,4
4215,validator_0,653606837085,True,649319995,15948220,665268215,True,20
4216,validator_1,583636529590,True,703100000,3660800,706760800,False,18
4217,validator_6,147402646380,True,755299995,27826620,783126615,True,4
4218,validator_15,74949913872,True,618860002,37688800,656548802,True,2
4219,validator_27,62441959455,True,759959997,14638870,774598867,True,1
4220,validator_17,68530949042,True,899099993,10869400,909969393,True,2
4221,validator_1,584300717340,True,655300000,8887750,664187750,False,18
4222,validator_2,412493803273,True,687540002,18379840,705919842,True,12
4223,validator_3,328718929130,True,602100000,3637470,605737470,False,10
4224,validator_0,654333191083,True,681697998,44656000,726353998,True,20
4225,validator_0,655114249957,True,772900004,8158870,781058874,True,20
4226,validator_30,56596750230,True,511170000,10307560,521477560,False,1
4227,validator_0,655685790024,True,567000007,4540060,571540067,True,20
4228,validator_3,329441452710,True,720800000,1723580,722523580,False,10
4229,validator_11,60444270817,True,737000002,2837900,739837902,True,1
4230,validator_0,656370707710,True,665300006,19617680,684917686,True,20
4231,validator_4,209507217556,True,937920000,10844960,948764960,True,6
4232,validator_7,154941238150,True,614200000,9827790,624027790,False,4
4233,validator_0,657165408544,True,768840004,25860830,794700834,True,20
4234,validator_24,62232608664,True,577630002,22651280,600281282,True,1
4235,validator_3,329972097700,True,519800000,10844990,530644990,False,10
4236,validator_48,67238007930,True,663300000,1075300,664375300,False,2
4237,validator_0,657789228542,True,599979998,23840000,623819998,True,20
4238,validator_0,658379250162,True,570039990,19981630,590021620,True,20
4239,validator_48,67786516520,True,546400000,2108590,548508590,False,2
4240,validator_2,413183728348,True,658606005,31319070,689925075,True,12
4241,validator_4,210225058056,True,710320000,7520500,717840500,True,6
4242,validator_0,658830806358,True,443257996,8298200,451556196,True,20
4243,validator_9,61323243925,True,788499998,3024300,791524298,True,1
4244,validator_3,330567863100,True,594000000,1765400,595765400,False,10
4245,validator_1,584850166290,True,546200000,3248950,549448950,False,18
4246,validator_24,63051446584,True,776820000,42017920,818837920,True,1
4247,validator_33,62925461210,True,659900000,1329090,661229090,False,1
4248,validator_2,414004998992,True,818700004,2570640,821270644,True,12
4249,validator_30,57178591570,True,580110000,1731340,581841340,False,1
4250,validator_3,331126582000,True,555900000,2818900,558718900,False,10
4251,validator_6,148211155150,True,797540000,10968770,808508770,True,4
4252,validator_0,659502350185,True,647469997,24073830,671543827,True,20
4253,validator_14,69206164087,True,564119999,20156790,584276789,True,2
4254,validator_25,58367199494,True,470128002,22899200,493027202,True,1
4255,validator_0,660085279190,True,570740005,12189000,582929005,True,20
4256,validator_36,59157404510,True,623200000,2172500,625372500,False,1
4257,validator_9,62151086433,True,809299998,18542510,827842508,True,1
4258,validator_1,585574880120,True,705300000,19413830,724713830,False,18
4259,validator_5,215939501020,True,611400000,3819270,615219270,False,6
4260,validator_2,414881021601,True,825739999,50282610,876022609,True,12
4261,validator_3,331917261670,True,761800000,28879670,790679670,False,10
4262,validator_44,56184389180,True,549200000,4784540,553984540,False,1
4263,validator_19,62332993704,True,608640003,5992670,614632673,True,1
4264,validator_11,61308833118,True,835360001,29202300,864562301,True,1
4265,validator_35,64284981940,True,811900000,3055670,814955670,False,2
4266,validator_39,52132132090,True,559800000,2180720,561980720,False,1
4267,validator_47,55595484810,True,533200000,16440340,549640340,False,1
4268,validator_4,210943129404,True,691059998,27011350,718071348,True,6
4269,validator_0,660821306223,True,727399993,8627040,736027033,True,20
4270,validator_0,661630613259,True,783139996,26167040,809307036,True,20
4271,validator_25,59069051694,True,638250000,63602200,701852200,True,1
4272,validator_1,586293547960,True,716600000,2067840,718667840,False,18
4273,validator_3,332572668840,True,632300000,23107170,655407170,False,10
4274,validator_40,56563188670,True,532000000,19305240,551305240,False,1
4275,validator_1,586911718000,True,585500000,32670040,618170040,False,18
4276,validator_10,71371035071,True,709885996,61643370,771529366,True,2
4277,validator_17,69410674074,True,831280002,48445030,879725032,True,2
4278,validator_14,69952629644,True,703199997,43265560,746465557,True,2
4279,validator_7,155534241820,True,572700000,20303670,593003670,False,4
4280,validator_21,65792406787,True,683132003,28124700,711256703,True,2
4281,validator_15,75767130966,True,784059994,33157100,817217094,True,2
4282,validator_0,662088105458,True,448767999,8724200,457492199,True,20
4283,validator_4,211697517926,True,729700002,24688520,754388522,True,6
4284,validator_7,156100524440,True,563700000,2582620,566282620,False,4
4285,validator_10,71913438595,True,504460004,37943520,542403524,True,2
4286,validator_35,64815787880,True,522000000,8805940,530805940,False,2
4287,validator_15,76445974863,True,665479997,13363900,678843897,True,2
4288,validator_0,662724040977,True,621999999,13935520,635935519,True,20
4289,validator_7,156587862450,True,477800000,9538010,487338010,False,4
4290,validator_5,216563850490,True,622500000,1849470,624349470,False,6
4291,validator_42,58281068760,True,678100000,21372620,699472620,False,1
4292,validator_13,52602733535,True,750958002,37680100,788638102,True,1
4293,validator_0,663509627907,True,781300000,4286930,785586930,True,20
4294,validator_2,415396560301,True,512120000,3418700,515538700,True,12
4295,validator_18,79465741611,True,512079994,29905700,541985694,True,2
4296,validator_15,77267186337,True,804600004,16611470,821211474,True,2
4297,validator_22,81906884816,True,688824002,24992020,713816022,True,2
4298,validator_5,217096002200,True,521200000,10951710,532151710,False,6
4299,validator_0,664316393437,True,735996000,70769530,806765530,True,20
4300,validator_46,56904894490,True,621900000,3906180,625806180,False,1
4301,validator_44,56575471340,True,388600000,2482160,391082160,False,1
4302,validator_32,56922885060,True,589100000,3500530,592600530,False,1
4303,validator_10,72526558907,True,610140002,2980310,613120312,True,2
4304,validator_1,587708009940,True,786800000,9491940,796291940,False,18
4305,validator_3,333160478060,True,586000000,1809220,587809220,False,10
4306,validator_13,53617190866,True,959120001,55337330,1014457331,True,1
4307,validator_4,212230232232,True,476339996,56374310,532714306,True,6
4308,validator_1,588254496980,True,540600000,5887040,546487040,False,18
4309,validator_0,665100217534,True,779999997,3824100,783824097,True,20
4310,validator_10,73286752142,True,738679995,21513240,760193235,True,2
4311,validator_49,56009156250,True,537200000,2576920,539776920,False,1
4312,validator_28,69577787557,True,669479995,37415180,706895175,True,2
4313,validator_3,333795979400,True,632000000,3501340,635501340,False,10
4314,validator_11,62002062096,True,659099998,34128980,693228978,True,1
4315,validator_0,665691980564,True,565914000,25849030,591763030,True,20
4316,validator_2,415908461059,True,507599998,4300760,511900758,True,12
4317,validator_25,59858218694,True,779300000,9867000,789167000,True,1
4318,validator_31,59895150420,True,588300000,2173730,590473730,False,1
4319,validator_10,74026445146,True,733840004,5853000,739693004,True,2
4320,validator_7,157074520550,True,485400000,1258100,486658100,False,4
4321,validator_3,334330406800,True,533500000,927400,534427400,False,10
4322,validator_6,148882237352,True,619368002,51714200,671082202,True,4
4323,validator_15,77948605872,True,661240005,20179530,681419535,True,2
4324,validator_9,62792800033,True,638920000,2793600,641713600,True,1
4325,validator_1,588800139280,True,544100000,1542300,545642300,False,18
4326,validator_31,60544029450,True,645500000,3379030,648879030,False,1
4327,validator_0,666596418964,True,876540000,27898400,904438400,True,20
4328,validator_23,77317427126,True,894540011,33213290,927753301,True,2
4329,validator_5,217904843610,True,807600000,1241410,808841410,False,6
4330,validator_3,335015066100,True,682500000,2159300,684659300,False,10
4331,validator_0,667118959162,True,518699998,3840200,522540198,True,20
4332,validator_6,149458970484,True,563700002,13033130,576733132,True,4
4333,validator_30,57814329060,True,626300000,9437490,635737490,False,1
4334,validator_2,416707901842,True,773600003,25840780,799440783,True,13
4335,validator_3,335572680480,True,549500000,8114380,557614380,False,10
4336,validator_1,589582486550,True,779700000,2647270,782347270,False,18
4337,validator_1,590241988870,True,656400000,3102320,659502320,False,18
4338,validator_24,63480467692,True,367010008,62011100,429021108,True,1
4339,validator_9,63354303136,True,539258003,22245100,561503103,True,1
4340,validator_1,590949034210,True,701700000,5345340,707045340,False,18
4341,validator_21,66484283811,True,665580004,26297020,691877024,True,2
4342,validator_1,591578224330,True,623800000,5390120,629190120,False,18
4343,validator_2,417467391044,True,749520002,9969200,759489202,True,13
4344,validator_49,56649689850,True,637400000,3133600,640533600,False,1
4345,validator_0,667943021162,True,813720000,10342000,824062000,True,20
4346,validator_5,218674622410,True,766700000,3078800,769778800,False,6
4347,validator_10,74680734871,True,646439995,7849730,654289725,True,2
4348,validator_14,70505892712,True,521437998,31825070,553263068,True,2
4349,validator_28,70292860743,True,689799996,25273190,715073186,True,2
4350,validator_21,67136089517,True,646120006,5685700,651805706,True,2
4351,validator_22,82460281789,True,524680003,28716970,553396973,True,2
4352,validator_0,668517534562,True,543520000,30993400,574513400,True,20
4353,validator_40,57084533710,True,519100000,2245040,521345040,False,1
4354,validator_5,219352001150,True,669500000,7878740,677378740,False,6
4355,validator_2,418254906471,True,784599997,2915430,787515427,True,13
4356,validator_13,54163521479,True,530239993,16090620,546330613,True,1
4357,validator_24,64041050308,True,522879996,37702620,560582616,True,2
4358,validator_48,68269975540,True,464200000,19259020,483459020,False,2
4359,validator_4,212968904826,True,730959994,7712600,738672594,True,6
4360,validator_4,213508135798,True,524900002,14330970,539230972,True,6
4361,validator_28,70838261445,True,543000002,2400700,545400702,True,2
4362,validator_20,64822716352,True,740285996,23185540,763471536,True,2
4363,validator_7,157621580040,True,543770000,3289490,547059490,False,4
4364,validator_0,669127134507,True,590000005,19599940,609599945,True,20
4365,validator_5,219927043590,True,551500000,23542440,575042440,False,6
4366,validator_24,64795529094,True,723140006,31338780,754478786,True,2
4367,validator_5,220526559150,True,596200000,3315560,599515560,False,6
4368,validator_5,221151093460,True,622500000,2034310,624534310,False,6
4369,validator_0,669745112534,True,590900007,27078020,617978027,True,20
4370,validator_31,61094751380,True,548800000,1921930,550721930,False,1
4371,validator_0,670455656180,True,695520006,15023640,710543646,True,20
4372,validator_21,67718627616,True,568719999,13818100,582538099,True,2
4373,validator_3,336148031810,True,572500000,2851330,575351330,False,10
4374,validator_6,150170485327,True,657200003,54314840,711514843,True,4
4375,validator_0,671260750995,True,785800005,19294810,805094815,True,20
4376,validator_47,56214101010,True,604500000,14116200,618616200,False,1
4377,validator_10,75443696867,True,740999996,21962000,762961996,True,2
4378,validator_16,55964286689,True,631980004,26542450,658522454,True,1
4379,validator_36,59913629110,True,735400000,20824600,756224600,False,1
4380,validator_4,214059248212,True,545440004,5672410,551112414,True,6
4381,validator_22,83322440371,True,853900002,8258580,862158582,True,2
4382,validator_0,672119670778,True,835640003,23279780,858919783,True,21
4383,validator_0,672891113170,True,762853992,8588400,771442392,True,21
4384,validator_22,84072366950,True,717320009,32606570,749926579,True,2
4385,validator_0,673493371596,True,585000006,17258420,602258426,True,21
4386,validator_25,60501017925,True,629190001,13609230,642799231,True,1
4387,validator_8,63864552805,True,739900000,4652760,744552760,True,1
4388,validator_24,65750925199,True,929953995,25442110,955396105,True,2
4389,validator_42,58877093860,True,589700000,6325100,596025100,False,1
4390,validator_0,674097507191,True,602599995,1535600,604135595,True,21
4391,validator_47,56910933950,True,669300000,27532940,696832940,False,1
4392,validator_1,592160967710,True,555000000,27743380,582743380,False,18
4393,validator_20,65658330451,True,805179999,30434100,835614099,True,2
4394,validator_2,418967509256,True,701500005,11102780,712602785,True,13
4395,validator_8,64675416208,True,780240003,30623400,810863403,True,2
4396,validator_2,419555728596,True,542389990,45829350,588219340,True,13
4397,validator_3,336835585890,True,685000000,2554080,687554080,False,10
4398,validator_5,221633544300,True,479200000,3250840,482450840,False,6
4399,validator_1,592651565640,True,464300000,26297930,490597930,False,18
4400,validator_7,158361300500,True,719900000,19820460,739720460,False,4
4401,validator_22,84812271591,True,703980001,35924640,739904641,True,2
4402,validator_22,85662357197,True,807320006,42765600,850085606,True,2
4403,validator_20,66416647451,True,730040000,28277000,758317000,True,2
4404,validator_3,337395614950,True,558800000,1229060,560029060,False,10
4405,validator_15,78530996075,True,573900003,8490200,582390203,True,2
4406,validator_18,80182844525,True,692499994,24602920,717102914,True,2
4407,validator_3,337989694810,True,566000000,28079860,594079860,False,10
4408,validator_8,65379008505,True,683099997,20492300,703592297,True,2
4409,validator_36,60561000370,True,640400000,6971260,647371260,False,1
4410,validator_1,593220482000,True,565300000,3616360,568916360,False,18
4411,validator_18,80749995098,True,559719993,7430580,567150573,True,2
4412,validator_1,593747089700,True,523000000,3607700,526607700,False,18
4413,validator_0,675355188388,True,1220599997,37081200,1257681197,True,21
4414,validator_7,158939933440,True,533000000,45632940,578632940,False,4
4415,validator_0,676070649048,True,688940000,26520660,715460660,True,21
4416,validator_13,54913636776,True,722959997,27155300,750115297,True,1
4417,validator_39,52797989420,True,663600000,2257330,665857330,False,1
4418,validator_2,420410614726,True,831900000,22986130,854886130,True,13
4419,validator_10,75996001709,True,542500002,9804840,552304842,True,2
4420,validator_28,71485399487,True,606300002,40838040,647138042,True,2
4421,validator_3,338499999610,True,509000000,1304800,510304800,False,10
4422,validator_2,421327048720,True,904739994,11694000,916433994,True,13
4423,validator_24,66495149898,True,699785999,44438700,744224699,True,2
4424,validator_4,214741845713,True,621296001,61301500,682597501,True,6
4425,validator_7,159501885640,True,555400000,6552200,561952200,False,4
4426,validator_1,594438004500,True,684600000,6314800,690914800,False,18
4427,validator_1,595146311730,True,681500000,26807230,708307230,False,18
4428,validator_4,215430275528,True,672999995,15429820,688429815,True,6
4429,validator_3,339071535770,True,560900000,10636160,571536160,False,10
4430,validator_16,56651373682,True,669300003,17786990,687086993,True,1
4431,validator_46,57533516830,True,608900000,19722340,628622340,False,1
4432,validator_0,676649995069,True,558940001,20406020,579346021,True,21
4433,validator_8,65909499788,True,495080003,35411280,530491283,True,2
4434,validator_4,216323482046,True,886499998,6706520,893206518,True,6
4435,validator_0,677299440671,True,625884002,23561600,649445602,True,21
4436,validator_1,595695327910,True,543750000,5266180,549016180,False,18
4437,validator_0,677969371158,True,667219997,2710490,669930487,True,21
4438,validator_0,678654368497,True,640899999,44097340,684997339,True,21
4439,validator_29,55664303120,True,680500000,4198180,684698180,False,1
4440,validator_34,58286746100,True,498800000,2207390,501007390,False,1
4441,validator_0,679627361515,True,953099998,19893020,972993018,True,21
4442,validator_2,421794696620,True,444020000,23627900,467647900,True,13
4443,validator_23,77893437602,True,573999996,2010480,576010476,True,2
4444,validator_10,76525405708,True,476465999,52938000,529403999,True,2
4445,validator_1,596173985780,True,476200000,2457870,478657870,False,18
4446,validator_24,67047371577,True,536739999,15481680,552221679,True,2
4447,validator_0,680212554421,True,571239996,13952910,585192906,True,21
4448,validator_34,58752857030,True,463400000,2710930,466110930,False,1
4449,validator_1,596708196240,True,533100000,1110460,534210460,False,18
4450,validator_7,160098791980,True,594600000,2306340,596906340,False,5
4451,validator_0,680863291730,True,637906009,12831300,650737309,True,21
4452,validator_35,65602834540,True,761700000,25346660,787046660,False,2
4453,validator_7,160971206880,True,861300000,11114900,872414900,False,5
4454,validator_22,86492614198,True,829400001,857000,830257001,True,2
4455,validator_7,161560746250,True,587700000,1839370,589539370,False,5
4456,validator_1,597368677360,True,640500000,19981120,660481120,False,18
4457,validator_5,222272253700,True,635000000,3709400,638709400,False,6
4458,validator_13,55752288004,True,809399998,29251230,838651228,True,1
4459,validator_5,222815591400,True,541300000,2037700,543337700,False,6
4460,validator_0,681380757433,True,498000003,19465700,517465703,True,21
4461,validator_18,81477159600,True,715859992,11304510,727164502,True,2
4462,validator_0,682283231333,True,880160000,22313900,902473900,True,21
4463,validator_1,598016150830,True,643600000,3873470,647473470,False,18
4464,validator_7,162068670320,True,490000000,17924070,507924070,False,5
4465,validator_2,422513364191,True,666540001,52127570,718667571,True,13
4466,validator_48,68761001310,True,472100000,18925770,491025770,False,2
4467,validator_1,598626394950,True,595800000,14444120,610244120,False,18
4468,validator_2,423147616371,True,631000000,3252180,634252180,True,13
4469,validator_17,70172784323,True,738039999,24070250,762110249,True,2
4470,validator_2,424142088869,True,989199998,5272500,994472498,True,13
4471,validator_34,59261380360,True,506000000,2523330,508523330,False,1
4472,validator_45,63976653850,True,631180000,3917380,635097380,False,1
4473,validator_5,223536877400,True,716300000,4986000,721286000,False,6
4474,validator_16,57191483917,True,505580005,34530230,540110235,True,1
4475,validator_35,66147411860,True,537970000,6607320,544577320,False,2
4476,validator_1,599313547180,True,658000000,29152230,687152230,False,18
4477,validator_0,683052356297,True,762400004,6724960,769124964,True,21
4478,validator_2,424776091193,True,614699994,19302330,634002324,True,13
4479,validator_0,683689749196,True,626889999,10502900,637392899,True,21
4480,validator_0,684503503592,True,785919996,27834400,813754396,True,21
4481,validator_41,53332149820,True,820800000,9968700,830768700,False,1
4482,validator_27,63089432158,True,641380003,6092700,647472703,True,1
4483,validator_33,63628298510,True,672500000,30337300,702837300,False,1
4484,validator_3,339814727420,True,727100000,16091650,743191650,False,10
4485,validator_18,82092891277,True,613899997,1831680,615731677,True,2
4486,validator_0,685082132130,True,566039998,12588540,578628538,True,21
4487,validator_1,599952161250,True,635500000,3114070,638614070,False,18
4488,validator_20,66985486860,True,566319999,2519410,568839409,True,2
4489,validator_7,162558962920,True,462500000,27792600,490292600,False,5
4490,validator_0,686066202993,True,973960003,10110860,984070863,True,21
4491,validator_4,217116506418,True,754360002,38664370,793024372,True,6
4492,validator_8,66796368690,True,875520002,11348900,886868902,True,2
4493,validator_5,224064714800,True,521200000,6637400,527837400,False,7
4494,validator_23,78671334344,True,745500002,32396740,777896742,True,2
4495,validator_0,686664339711,True,581579998,16556720,598136718,True,21
4496,validator_5,224581369000,True,513500000,3154200,516654200,False,7
4497,validator_0,687351076608,True,639973997,46762900,686736897,True,21
4498,validator_16,58017884238,True,805246001,21154320,826400321,True,1
4499,validator_41,53877158660,True,537800000,7208840,545008840,False,1
4500,validator_15,79450397046,True,910100001,9300970,919400971,True,2
4501,validator_7,163033186710,True,436300000,37923790,474223790,False,5
4502,validator_25,61385609895,True,870159990,14431980,884591970,True,1
4503,validator_7,163519436470,True,484200000,2049760,486249760,False,5
4504,validator_3,340310036720,True,492900000,2409300,495309300,False,10
4505,validator_1,600616656840,True,657400000,7095590,664495590,False,18
4506,validator_4,217576000717,True,450540009,8954290,459494299,True,6
4507,validator_7,164163185510,True,633300000,10449040,643749040,False,5
4508,validator_7,164922338400,True,757200000,1952890,759152890,False,5
4509,validator_15,80094058477,True,634140001,9521430,643661431,True,2
4510,validator_2,425519457097,True,740900004,2465900,743365904,True,13
4511,validator_5,225149977650,True,566300000,2308650,568608650,False,7
4512,validator_14,71159746885,True,601585993,52268180,653854173,True,2
4513,validator_10,77145664905,True,599539997,20719200,620259197,True,2
4514,validator_5,225752434650,True,593600000,8857000,602457000,False,7
4515,validator_4,218297858258,True,676146001,45711540,721857541,True,6
4516,validator_0,688053283427,True,657099999,45106820,702206819,True,21
4517,validator_3,340976938640,True,663000000,3901920,666901920,False,10
4518,validator_1,601347373620,True,727200000,3516780,730716780,False,18
4519,validator_14,71897830587,True,730700002,7383700,738083702,True,2
4520,validator_18,82539583672,True,426919995,19772400,446692395,True,2
4521,validator_6,150915443630,True,729500003,15458300,744958303,True,4
4522,validator_0,689079815164,True,1005999997,20531740,1026531737,True,21
4523,validator_6,151614034631,True,684480001,14111000,698591001,True,4
4524,validator_7,165490764060,True,566900000,1525660,568425660,False,5
4525,validator_2,426337339064,True,810900007,6981960,817881967,True,13
4526,validator_30,58455729370,True,638100000,3300310,641400310,False,1
4527,validator_35,66929510790,True,779500000,2598930,782098930,False,2
4528,validator_7,166226993260,True,726200000,10029200,736229200,False,5
4529,validator_19,63086284627,True,726359993,26930930,753290923,True,1
4530,validator_20,67475724065,True,484220005,6017200,490237205,True,2
4531,validator_2,426958131388,True,594216004,26576320,620792324,True,13
4532,validator_1,601822973120,True,469200000,6399500,475599500,False,18
4533,validator_45,64693323080,True,715300000,1369230,716669230,False,2
4534,validator_2,427866069856,True,899219998,8718470,907938468,True,13
4535,validator_18,83269987496,True,725300004,5103820,730403824,True,2
4536,validator_15,80893687559,True,766740002,32889080,799629082,True,2
4537,validator_21,68262431878,True,541500002,2304260,543804262,True,2
4538,validator_17,70791334750,True,605379997,13170430,618550427,True,2
4539,validator_18,84041110635,True,745463999,25659140,771123139,True,2
4540,validator_23,79257068444,True,568770000,16964100,585734100,True,2
4541,validator_21,68940644618,True,668480000,9732740,678212740,True,2
4542,validator_1,602418019460,True,586300000,8746340,595046340,False,18
4543,validator_1,603016113600,True,595500000,2594140,598094140,False,18
4544,validator_0,689498631307,True,403940003,14876140,418816143,True,21
4545,validator_1,603557302710,True,539900000,1289110,541189110,False,18
4546,validator_26,63640304547,True,636119998,19663720,655783718,True,1
4547,validator_0,690139448712,True,628640005,12177400,640817405,True,21
4548,validator_2,428555872062,True,674240006,15562200,689802206,True,13
4549,validator_14,72510376984,True,607939997,4606400,612546397,True,2
4550,validator_3,341573247620,True,594400000,1908980,596308980,False,10
4551,validator_48,69434902340,True,653200000,20701030,673901030,False,2
4552,validator_1,604189281250,True,625000000,6978540,631978540,False,18
4553,validator_0,690682465173,True,496880001,46136460,543016461,True,21
4554,validator_2,429519266151,True,918479989,44914100,963394089,True,13
4555,validator_0,691532327624,True,848300001,1562450,849862451,True,21
4556,validator_5,226446308870,True,684600000,9274220,693874220,False,7
4557,validator_3,342412738030,True,818200000,21290410,839490410,False,10
4558,validator_0,692263160780,True,705188006,25645150,730833156,True,21
4559,validator_17,71383265335,True,566100005,25830580,591930585,True,2
4560,validator_4,218915844765,True,584280007,33706500,617986507,True,6
4561,validator_42,59554141120,True,674500000,2547260,677047260,False,1
4562,validator_23,79885138752,True,563979988,64090320,628070308,True,2
4563,validator_3,343135353230,True,702800000,19815200,722615200,False,10
4564,validator_46,58012199030,True,468800000,9882200,478682200,False,1
4565,validator_2,430196825154,True,643540003,34019000,677559003,True,13
4566,validator_1,604969080150,True,771300000,8498900,779798900,False,18
4567,validator_40,57835923140,True,749900000,1489430,751389430,False,1
4568,validator_32,57445441950,True,520000000,2556890,522556890,False,1
4569,validator_31,61649488160,True,551100000,3636780,554736780,False,1
4570,validator_35,67487561690,True,544000000,14050900,558050900,False,2
4571,validator_2,430702493295,True,483240001,22428140,505668141,True,13
4572,validator_2,431476338225,True,770600000,3244930,773844930,True,13
4573,validator_31,62225794100,True,573500000,2805940,576305940,False,1
4574,validator_24,67725744599,True,677100002,1273020,678373022,True,2
4575,validator_15,81475953252,True,555839993,26425700,582265693,True,2
4576,validator_37,57612012120,True,642100000,14309600,656409600,False,1
4577,validator_8,67710245167,True,905039997,8836480,913876477,True,2
4578,validator_18,84895498573,True,832779998,21607940,854387938,True,2
4579,validator_31,62811084730,True,583400000,1890630,585290630,False,1
4580,validator_1,605409142620,True,433300000,6762470,440062470,False,18
4581,validator_2,432063338461,True,562920006,24080230,587000236,True,13
4582,validator_3,343625395420,True,488400000,1642190,490042190,False,10
4583,validator_31,63484520370,True,669300000,4135640,673435640,False,1
4584,validator_1,605894504170,True,465400000,19961550,485361550,False,18
4585,validator_5,226975984570,True,522800000,6875700,529675700,False,7
4586,validator_1,606595532590,True,699500000,1528420,701028420,False,18
4587,validator_5,227585660840,True,604200000,5476270,609676270,False,7
4588,validator_7,166676319590,True,441700000,7626330,449326330,False,5
4589,validator_1,607325661980,True,727200000,2929390,730129390,False,18
4590,validator_11,62845531614,True,826217998,17251520,843469518,True,1
4591,validator_47,57456941390,True,537500000,8507440,546007440,False,1
4592,validator_6,152389449652,True,749820001,25595020,775415021,True,4
4593,validator_2,432967542184,True,876380003,27823720,904203723,True,13
4594,validator_20,68287204961,True,804599996,6880900,811480896,True,2
4595,validator_35,68199502400,True,708100000,3840710,711940710,False,2
4596,validator_44,57326915150,True,735700000,15743810,751443810,False,1
4597,validator_0,692886038672,True,591040002,31837890,622877892,True,21
4598,validator_48,69957338330,True,518500000,3935990,522435990,False,2
4599,validator_4,219438516858,True,512060003,10612090,522672093,True,6
4600,validator_1,607893286550,True,562440000,5184570,567624570,False,18
4601,validator_0,693238505256,True,345719994,6746590,352466584,True,21
4602,validator_3,344195625450,True,568500000,1730030,570230030,False,10
4603,validator_2,433538990909,True,547864005,23584720,571448725,True,13
4604,validator_42,60027136520,True,469100000,3895400,472995400,False,1
4605,validator_3,344705635850,True,506800000,3210400,510010400,False,10
4606,validator_2,434246699783,True,687800004,19908870,707708874,True,13
4607,validator_1,608461483270,True,547700000,20496720,568196720,False,19
4608,validator_6,153147415954,True,702480002,55486300,757966302,True,4
4609,validator_4,219959799747,True,484739999,36542890,521282889,True,6
4610,validator_43,56899609900,True,721000000,3249130,724249130,False,1
4611,validator_5,228036481170,True,448300000,2520330,450820330,False,7
4612,validator_2,435001766384,True,748300001,6766600,755066601,True,13
4613,validator_1,609076159070,True,612200000,2475800,614675800,False,19
4614,validator_1,609691910210,True,609600000,6151140,615751140,False,19
4615,validator_28,72125000927,True,615140000,24461440,639601440,True,2
4616,validator_4,220564930366,True,599959999,5170620,605130619,True,6
4617,validator_1,610148578910,True,453200000,3468700,456668700,False,19
4618,validator_0,694073550668,True,826239992,8805420,835045412,True,21
4619,validator_0,694665707810,True,563560002,28597140,592157142,True,21
4620,validator_32,57949840380,True,497800000,6598430,504398430,False,1
4621,validator_1,610768747430,True,618840000,1328520,620168520,False,19
4622,validator_10,77720419871,True,560140006,14614960,574754966,True,2
4623,validator_1,611380947930,True,610800000,1400500,612200500,False,19
4624,validator_2,435799343482,True,782999998,14577100,797577098,True,13
4625,validator_0,695384150291,True,708320001,10122480,718442481,True,21
4626,validator_2,436426631622,True,585520000,41768140,627288140,True,13
4627,validator_5,228473927870,True,429500000,7946700,437446700,False,7
4628,validator_6,153716678656,True,548280002,20982700,569262702,True,4
4629,validator_15,81965605704,True,468854002,20798450,489652452,True,2
4630,validator_5,228996376570,True,519700000,2748700,522448700,False,7
4631,validator_28,72678620253,True,536599996,17019330,553619326,True,2
4632,validator_0,696135159495,True,737919994,13089210,751009204,True,21
4633,validator_20,68875449365,True,561960004,26284400,588244404,True,2
4634,validator_1,611804245420,True,421800000,1497490,423297490,False,19
4635,validator_22,87176203001,True,641266003,42322800,683588803,True,2
4636,validator_43,57398216580,True,498200000,406680,498606680,False,1
4637,validator_21,69746504134,True,795639996,10219520,805859516,True,2
4638,validator_2,437259441302,True,811680000,21129680,832809680,True,13
4639,validator_17,72184507487,True,789760002,11482150,801242152,True,2
4640,validator_26,64487496155,True,822679998,24511610,847191608,True,2
4641,validator_19,63927573708,True,826579991,14709090,841289081,True,1
4642,validator_2,437766425142,True,492560000,14423840,506983840,True,13
4643,validator_18,85626488537,True,703860004,27129960,730989964,True,2
4644,validator_6,154376432262,True,632800006,26953600,659753606,True,4
4645,validator_1,612371264950,True,563500000,3519530,567019530,False,19
4646,validator_5,229545829620,True,547400000,2053050,549453050,False,7
4647,validator_4,221387558343,True,806399997,16227980,822627977,True,6
4648,validator_3,345183221490,True,457500000,20085640,477585640,False,10
4649,validator_6,154842376481,True,439419999,26524220,465944219,True,4
4650,validator_23,80513475454,True,571986002,56350700,628336702,True,2
4651,validator_19,64726119616,True,761339998,37205910,798545908,True,2
4652,validator_1,613028809150,True,656800000,744200,657544200,False,19
4653,validator_3,345702784180,True,516700000,2862690,519562690,False,10
4654,validator_35,68782921260,True,553000000,30418860,583418860,False,2
4655,validator_24,68504904702,True,762180003,16980100,779160103,True,2
4656,validator_1,613830947290,True,791800000,10338140,802138140,False,19
4657,validator_5,230107520050,True,558900000,2790430,561690430,False,7
4658,validator_1,614497912120,True,665100000,1864830,666964830,False,19
4659,validator_2,438547355937,True,779299995,1630800,780930795,True,13
4660,validator_2,439571440741,True,1017799994,6284810,1024084804,True,13
4661,validator_37,58280071690,True,665700000,2359570,668059570,False,1
4662,validator_0,696673137794,True,496599999,41378300,537978299,True,21
4663,validator_0,697375945040,True,690999996,11807250,702807246,True,21
4664,validator_2,440053442954,True,475763993,6238220,482002213,True,13
4665,validator_0,698188332336,True,799679996,12707300,812387296,True,21
4666,validator_24,69199026120,True,673559998,20561420,694121418,True,2
4667,validator_0,699023271937,True,814100001,20839600,834939601,True,21
4668,validator_5,230795197380,True,663700000,23977330,687677330,False,7
4669,validator_1,615147371820,True,647600000,1859700,649459700,False,19
4670,validator_7,167250520530,True,564600000,9600940,574200940,False,5
4671,validator_6,155734024281,True,865310000,26337800,891647800,True,4
4672,validator_5,231286097390,True,470360000,20540010,490900010,False,7
4673,validator_38,57907390480,True,509100000,9876590,518976590,False,1
4674,validator_0,699707769530,True,645700003,38797590,684497593,True,21
4675,validator_43,58098993880,True,698400000,2377300,700777300,False,1
4676,validator_35,69392228050,True,600300000,9006790,609306790,False,2
4677,validator_2,440562439170,True,488399996,20596220,508996216,True,13
4678,validator_13,56342111338,True,584340004,5483330,589823334,True,1
4679,validator_1,615778945620,True,612100000,19473800,631573800,False,19
4680,validator_2,441242305401,True,610520001,69346230,679866231,True,13
4681,validator_0,700326694559,True,599799999,19125030,618925029,True,21
4682,validator_5,231987595870,True,693200000,8298480,701498480,False,7
4683,validator_17,72742849291,True,554060004,4281800,558341804,True,2
4684,validator_0,700976517798,True,644919999,4903240,649823239,True,21
4685,validator_21,70626585170,True,859760006,20321030,880081036,True,2
4686,validator_3,346360869670,True,636700000,21385490,658085490,False,10
4687,validator_30,58878581420,True,402400000,20452050,422852050,False,1
4688,validator_2,442282610003,True,1017496002,22808600,1040304602,True,13
4689,validator_5,232558266110,True,569300000,1370240,570670240,False,7
4690,validator_7,168001803000,True,741500000,9782470,751282470,False,5
4691,validator_15,82726233589,True,750639995,9987890,760627885,True,2
4692,validator_38,58536664380,True,624500000,4773900,629273900,False,1
4693,validator_22,87833132797,True,655399996,1529800,656929796,True,2
4694,validator_25,62098911333,True,688579998,24721440,713301438,True,1
4695,validator_16,58817832123,True,770520005,29427880,799947885,True,1
4696,validator_2,442866648245,True,576240002,7798240,584038242,True,13
4697,validator_18,86300372619,True,671300002,2584080,673884082,True,2
4698,validator_24,69603029005,True,384219995,19782890,404002885,True,2
4699,validator_39,53368813860,True,568900000,1924440,570824440,False,1
4700,validator_38,59202701880,True,662980000,3057500,666037500,False,1
4701,validator_32,58548763140,True,595900000,3022760,598922760,False,1
4702,validator_21,71330986997,True,691339997,13061830,704401827,True,2
4703,validator_0,701689414326,True,710039998,2856530,712896528,True,21
4704,validator_0,702669904028,True,977700002,2789700,980489702,True,21
4705,validator_1,616449646030,True,668300000,2400410,670700410,False,19
4706,validator_8,68306983513,True,594519996,2218350,596738346,True,2
4707,validator_5,233245317990,True,682200000,4851880,687051880,False,7
4708,validator_2,443830408569,True,948459994,15300330,963760324,True,13
4709,validator_1,617376289460,True,906700000,19943430,926643430,False,19
4710,validator_16,59490438891,True,641436008,31170760,672606768,True,1
4711,validator_1,617983595930,True,601100000,6206470,607306470,False,19
4712,validator_5,234021620330,True,773500000,2802340,776302340,False,7
4713,validator_2,444537789798,True,698140009,9241220,707381229,True,13
4714,validator_5,234696475300,True,665200000,9654970,674854970,False,7
4715,validator_6,156459637817,True,699380006,26233530,725613536,True,4
4716,validator_33,64525212460,True,842700000,54213950,896913950,False,2
4717,validator_30,59453321450,True,572700000,2040030,574740030,False,1
4718,validator_0,703173416397,True,501599999,1912370,503512369,True,21
4719,validator_2,445275925139,True,684040001,54095340,738135341,True,13
4720,validator_0,704014734173,True,833859996,7457780,841317776,True,22
4721,validator_38,59744516280,True,531400000,10414400,541814400,False,1
4722,validator_7,168604857590,True,599400000,3654590,603054590,False,5
4723,validator_20,69483044969,True,606000004,1595600,607595604,True,2
4724,validator_1,618416705000,True,431100000,2009070,433109070,False,19
4725,validator_2,445814742439,True,517466000,21351300,538817300,True,13
4726,validator_1,619067338980,True,644800000,5833980,650633980,False,19
4727,validator_1,619598370800,True,528800000,2231820,531031820,False,19
4728,validator_15,83418133496,True,676040007,15859900,691899907,True,2
4729,validator_0,704652719171,True,611139998,26845000,637984998,True,22
4730,validator_48,70607939520,True,638600000,12001190,650601190,False,2
4731,validator_49,57124680640,True,468600000,6390790,474990790,False,1
4732,validator_2,446714679123,True,873640004,26296680,899936684,True,13
4733,validator_24,70303149996,True,694300001,5820990,700120991,True,2
4734,validator_1,620319630100,True,707100000,14159300,721259300,False,19
4735,validator_42,60521971120,True,490100000,4734600,494834600,False,1
4736,validator_28,73582053363,True,864039990,39393120,903433110,True,2
4737,validator_0,705269580436,True,600819995,16041270,616861265,True,22
4738,validator_0,706113947446,True,823800010,20567000,844367010,True,22
4739,validator_19,65258008073,True,520999997,10888460,531888457,True,2
4740,validator_1,620931427880,True,605600000,6197780,611797780,False,19
4741,validator_0,706818055582,True,693199996,10908140,704108136,True,22
4742,validator_0,707611603669,True,774773997,18774090,793548087,True,22
4743,validator_7,169360478920,True,730900000,24721330,755621330,False,5
4744,validator_1,621704860280,True,770400000,3032400,773432400,False,19
4745,validator_26,65176977849,True,654399994,35081700,689481694,True,2
4746,validator_0,708223282968,True,597799999,13879300,611679299,True,22
4747,validator_1,622400045480,True,673400000,21785200,695185200,False,19
4748,validator_0,708958830598,True,721920000,13627630,735547630,True,22
4749,validator_2,447704415926,True,960980003,28756800,989736803,True,13
4750,validator_2,448586134827,True,862440011,19278890,881718901,True,14
4751,validator_4,221998073144,True,588880001,21634800,610514801,True,6
4752,validator_0,709667963338,True,699320000,9812740,709132740,True,22
4753,validator_31,64225714440,True,738300000,2894070,741194070,False,2
4754,validator_6,157213112250,True,703473993,50000440,753474433,True,4
4755,validator_29,56363706900,True,694200000,5203780,699403780,False,1
4756,validator_0,710399698437,True,716639999,15095100,731735099,True,22
4757,validator_2,449384174376,True,776839999,21199550,798039549,True,14
4758,validator_1,622907437080,True,488000000,19391600,507391600,False,19
4759,validator_2,450230934287,True,806779991,39979920,846759911,True,14
4760,validator_4,222756475746,True,731620002,26782600,758402602,True,6
4761,validator_1,623546982730,True,638100000,1445650,639545650,False,19
4762,validator_42,61065686640,True,538140000,5575520,543715520,False,1
4763,validator_18,86994287627,True,676180008,17735000,693915008,True,2
4764,validator_2,451080900199,True,832859992,17105920,849965912,True,14
4765,validator_0,711283879539,True,861280002,22901100,884181102,True,22
4766,validator_4,223428162242,True,633939996,37746500,671686496,True,6
4767,validator_2,451832843493,True,745739994,6203300,751943294,True,14
4768,validator_30,60002607920,True,530900000,18386470,549286470,False,1
4769,validator_44,57860574010,True,530900000,2758860,533658860,False,1
4770,validator_5,235328906500,True,626300000,6131200,632431200,False,7
4771,validator_10,78356930369,True,616919998,19590500,636510498,True,2
4772,validator_0,712250287454,True,945939995,20467920,966407915,True,22
4773,validator_32,59073912340,True,510900000,14249200,525149200,False,1
4774,validator_15,84033693382,True,574207996,41351890,615559886,True,2
4775,validator_0,712937689678,True,672620004,14782220,687402224,True,22
4776,validator_33,65104293880,True,576500000,2581420,579081420,False,2
4777,validator_49,57613065040,True,468400000,19984400,488384400,False,1
4778,validator_37,58918147950,True,630400000,7676260,638076260,False,1
4779,validator_3,347063241950,True,675200000,27172280,702372280,False,10
4780,validator_0,713527960573,True,566239995,24030900,590270895,True,22
4781,validator_6,157985932911,True,744200001,28620660,772820661,True,4
4782,validator_34,59804205950,True,539000000,3825590,542825590,False,1
4783,validator_0,714095095094,True,534038001,33096520,567134521,True,22
4784,validator_0,714737291499,True,630908005,11288400,642196405,True,22
4785,validator_32,59562320870,True,477000000,11408530,488408530,False,1
4786,validator_10,79109948941,True,707960002,45058570,753018572,True,2
4787,validator_0,715410343386,True,663699997,9351890,673051887,True,22
4788,validator_0,716074318924,True,642960008,21015530,663975538,True,22
4789,validator_3,347579974430,True,513600000,3132480,516732480,False,10
4790,validator_3,348171672500,True,588100000,3598070,591698070,False,10
4791,validator_0,716751513954,True,645200000,31995030,677195030,True,22
4792,validator_1,624202062840,True,644700000,10380110,655080110,False,19
4793,validator_3,348736061530,True,544700000,19689030,564389030,False,10
4794,validator_1,624713130370,True,508000000,3067530,511067530,False,19
4795,validator_2,452619901396,True,776640003,10417900,787057903,True,14
4796,validator_12,59602802268,True,689300003,7009990,696309993,True,1
4797,validator_5,235923787340,True,586700000,8180840,594880840,False,7
4798,validator_14,73334311129,True,821400005,2534140,823934145,True,2
4799,validator_0,717279655452,True,524939998,3201500,528141498,True,22
4800,validator_0,718023074752,True,711860000,31559300,743419300,True,22
4801,validator_0,718839344948,True,795460006,20810190,816270196,True,22
4802,validator_7,170027665600,True,638700000,28486680,667186680,False,5
4803,validator_26,66138449481,True,933866002,27605630,961471632,True,2
4804,validator_3,349167494850,True,397500000,33933320,431433320,False,10
4805,validator_21,72244358861,True,882179994,31191870,913371864,True,2
4806,validator_4,224018869668,True,588200006,2507420,590707426,True,7
4807,validator_37,59419587740,True,496800000,4639790,501439790,False,1
4808,validator_26,66656221869,True,487459988,30312400,517772388,True,2
4809,validator_1,625502576330,True,787600000,1845960,789445960,False,19
4810,validator_3,349826734450,True,639800000,19439600,659239600,False,10
4811,validator_44,58475168320,True,612100000,2494310,614594310,False,1
4812,validator_1,626068439920,True,564200000,1663590,565863590,False,19
4813,validator_6,158616289738,True,594939997,35416830,630356827,True,4
4814,validator_3,350453623040,True,624200000,2688590,626888590,False,10
4815,validator_7,170547613280,True,517700000,2247680,519947680,False,5
4816,validator_2,453423125570,True,801699994,1524180,803224174,True,14
4817,validator_2,454221695069,True,773999999,24569500,798569499,True,14
4818,validator_3,351027338040,True,536000000,37715000,573715000,False,10
4819,validator_10,79858664168,True,691845997,56869230,748715227,True,2
4820,validator_5,236359410840,True,431600000,4023500,435623500,False,7
4821,validator_35,70298074090,True,889200000,16646040,905846040,False,2
4822,validator_3,351671961720,True,633700000,10923680,644623680,False,10
4823,validator_1,626760521120,True,685300000,6781200,692081200,False,19
4824,validator_6,159253458779,True,609060001,28109040,637169041,True,4
4825,validator_4,224664518571,True,628000003,17648900,645648903,True,7
4826,validator_4,225504235172,True,807400001,32316600,839716601,True,7
4827,validator_15,84715240521,True,661799999,19747140,681547139,True,2
4828,validator_17,73604090612,True,859899991,1341330,861241321,True,2
4829,validator_9,64012592805,True,646620009,11669660,658289669,True,2
4830,validator_0,719385870746,True,538540008,7985790,546525798,True,22
4831,validator_5,236808159490,True,440000000,8748650,448748650,False,7
4832,validator_26,67127000793,True,461339994,9438930,470778924,True,2
4833,validator_1,627400186280,True,633300000,6365160,639665160,False,19
4834,validator_1,628005722280,True,598600000,6936000,605536000,False,19
4835,validator_0,720190671873,True,781539997,23261130,804801127,True,22
4836,validator_5,237495728670,True,656900000,30669180,687569180,False,7
4837,validator_28,74438225065,True,830580002,25591700,856171702,True,2
4838,validator_9,64826311410,True,802700005,11018600,813718605,True,2
4839,validator_0,720920029309,True,714119996,15237440,729357436,True,22
4840,validator_5,237927551500,True,430100000,1722830,431822830,False,7
4841,validator_48,71284627160,True,656400000,20287640,676687640,False,2
4842,validator_0,721654354764,True,706739995,27585460,734325455,True,22
4843,validator_1,628503929960,True,496700000,1507680,498207680,False,19
4844,validator_23,81199190816,True,683200002,2515360,685715362,True,2
4845,validator_1,629223412660,True,718300000,1182700,719482700,False,19
4846,validator_8,68984163906,True,635859993,41320400,677180393,True,2
4847,validator_46,58735000030,True,719500000,3301000,722801000,False,1
4848,validator_23,81762293721,True,550040005,13062900,563102905,True,2
4849,validator_3,352116610330,True,442100000,2548610,444648610,False,11
4850,validator_11,63537481909,True,689400005,2550290,691950295,True,1
4851,validator_21,73255401037,True,969839996,41202180,1011042176,True,2
4852,validator_48,71931956640,True,646900000,429480,647329480,False,2
4853,validator_1,629932285940,True,702400000,6473280,708873280,False,19
4854,validator_24,70895232001,True,568266005,23816000,592082005,True,2
4855,validator_25,62769060534,True,659766001,10383200,670149201,True,1
4856,validator_0,722282800113,True,596813999,31631350,628445349,True,22
4857,validator_16,60118578332,True,624100001,4039440,628139441,True,1
4858,validator_42,61729288860,True,644200000,19402220,663602220,False,1
4859,validator_1,630494977120,True,557800000,4891180,562691180,False,19
4860,validator_17,74202671991,True,551319999,47261380,598581379,True,2
4861,validator_31,64774221440,True,545800000,2707000,548507000,False,2
4862,validator_0,723145272809,True,806020006,56452690,862472696,True,22
4863,validator_1,631136456720,True,604800000,36679600,641479600,False,19
4864,validator_4,226112469572,True,584020000,24214400,608234400,True,7
4865,validator_1,631926741350,True,789000000,1284630,790284630,False,19
4866,validator_5,238551241030,True,621600000,2089530,623689530,False,7
4867,validator_4,226781351459,True,642303997,26577890,668881887,True,7
4868,validator_9,65410362451,True,557240001,26811040,584051041,True,2
4869,validator_0,723936479409,True,739320000,51886600,791206600,True,22
4870,validator_3,352776137990,True,657100000,2427660,659527660,False,11
4871,validator_4,227453294760,True,662760001,9183300,671943301,True,7
4872,validator_4,227934707444,True,461740004,19672680,481412684,True,7
4873,validator_0,724730609786,True,766039997,28090380,794130377,True,22
4874,validator_44,59110796880,True,631100000,4528560,635628560,False,1
4875,validator_10,80640856434,True,753059996,29132270,782192266,True,2
4876,validator_0,725498875775,True,765919999,2345990,768265989,True,22
4877,validator_25,63593924689,True,810139995,14724160,824864155,True,1
4878,validator_24,71716301396,True,815299995,5769400,821069395,True,2
4879,validator_1,632500572430,True,570640000,3191080,573831080,False,19
4880,validator_0,726343229607,True,788660002,55693830,844353832,True,22
4881,validator_0,727076105104,True,715539997,17335500,732875497,True,22
4882,validator_19,65782580418,True,521140005,3432340,524572345,True,2
4883,validator_8,69649202648,True,634760002,30278740,665038742,True,2
4884,validator_3,353226936850,True,442900000,7898860,450798860,False,11
4885,validator_0,727986709203,True,875239999,35364100,910604099,True,22
4886,validator_1,633014947710,True,511900000,2475280,514375280,False,19
4887,validator_0,728606480394,True,597986001,21785190,619771191,True,22
4888,validator_4,228467517252,True,531040008,1769800,532809808,True,7
4889,validator_21,73943583176,True,682040009,6142130,688182139,True,2
4890,validator_4,229084541746,True,614299994,2724500,617024494,True,7
4891,validator_1,633651601610,True,630500000,6153900,636653900,False,19
4892,validator_14,74212095273,True,867300004,10484140,877784144,True,2
4893,validator_3,353842812550,True,608800000,7075700,615875700,False,11
4894,validator_6,159902420782,True,627596003,21366000,648962003,True,4
4895,validator_0,729495045590,True,832480006,56085190,888565196,True,22
4896,validator_27,63614177109,True,497340001,27404950,524744951,True,1
4897,validator_7,171235459680,True,674200000,13646400,687846400,False,5
4898,validator_0,730020456883,True,506739993,18671300,525411293,True,22
4899,validator_24,72427818666,True,676340000,35177270,711517270,True,2
4900,validator_0,730857295581,True,819599998,17238700,836838698,True,22
4901,validator_3,354528536450,True,683100000,2623900,685723900,False,11
4902,validator_5,239100175910,True,524100000,24834880,548934880,False,7
4903,validator_19,66590996437,True,795599999,12816020,808416019,True,2
4904,validator_15,85517082025,True,797700004,4141500,801841504,True,2
4905,validator_42,62251541660,True,502300000,19952800,522252800,False,1
4906,validator_8,70295342850,True,624120002,22020200,646140202,True,2
4907,validator_3,355207110380,True,669240000,9333930,678573930,False,11
4908,validator_6,160443996168,True,522573996,19001390,541575386,True,5
4909,validator_0,731453998626,True,541139995,55563050,596703045,True,22
4910,validator_47,58015444890,True,554500000,4003500,558503500,False,1
4911,validator_26,68320024529,True,1181740006,11283730,1193023736,True,2
4912,validator_2,455137809391,True,892800002,23314320,916114322,True,14
4913,validator_21,74538822159,True,578240003,16998980,595238983,True,2
4914,validator_15,86251091461,True,707483996,26525440,734009436,True,2
4915,validator_23,82494280360,True,718863999,13122640,731986639,True,2
4916,validator_1,634181032800,True,519600000,9831190,529431190,False,19
4917,validator_45,65305295790,True,603500000,8472710,611972710,False,2
4918,validator_6,161323634066,True,873599998,6037900,879637898,True,5
4919,validator_3,355729514870,True,519800000,2604490,522404490,False,11
4920,validator_8,71064963252,True,731260002,38360400,769620402,True,2
4921,validator_4,229727523215,True,626165999,16815470,642981469,True,7
4922,validator_3,356416445670,True,684100000,2830800,686930800,False,11
4923,validator_0,731994744066,True,530654000,10091440,540745440,True,22
4924,validator_33,65699991140,True,576500000,19197260,595697260,False,2
4925,validator_23,83209684563,True,695760003,19644200,715404203,True,2
4926,validator_5,239488521240,True,382800000,5545330,388345330,False,7
4927,validator_16,60961755613,True,814360001,28817280,843177281,True,1
4928,validator_9,65911909425,True,497399994,4146980,501546974,True,2
4929,validator_13,57245404220,True,882860002,20432880,903292882,True,1
4930,validator_1,634882310380,True,664100000,37177580,701277580,False,19
4931,validator_4,230405431704,True,658500009,19408480,677908489,True,7
4932,validator_20,70116345420,True,622195991,11104460,633300451,True,2
4933,validator_0,732644735506,True,623714000,26277440,649991440,True,22
4934,validator_2,455810725627,True,671300006,1616230,672916236,True,14
4935,validator_2,456568812722,True,728120005,29967090,758087095,True,14
4936,validator_0,733471003313,True,797114007,29153800,826267807,True,22
4937,validator_1,635575062020,True,691200000,1551640,692751640,False,19
4938,validator_0,734282419502,True,807399999,4016190,811416189,True,22
4939,validator_0,735005913725,True,679760003,43734220,723494223,True,22
4940,validator_19,67535684164,True,935320007,9367720,944687727,True,2
4941,validator_3,356905975240,True,469900000,19629570,489529570,False,11
4942,validator_3,357479918800,True,564900000,9043560,573943560,False,11
4943,validator_1,636098500740,True,521600000,1838720,523438720,False,19
4944,validator_16,61735578718,True,733905995,39917110,773823105,True,1
4945,validator_0,735759742608,True,731846003,21982880,753828883,True,22
4946,validator_44,59841330160,True,728100000,2433280,730533280,False,1
4947,validator_34,60540234430,True,731300000,4728480,736028480,False,1
4948,validator_9,66797783561,True,882000006,3874130,885874136,True,2
4949,validator_35,70888371550,True,588100000,2197460,590297460,False,2
4950,validator_28,75211962096,True,765740001,7997030,773737031,True,2
4951,validator_0,736792778850,True,997940002,35096240,1033036242,True,23
4952,validator_3,358086457020,True,603900000,2638220,606538220,False,11
4953,validator_31,65332794670,True,557300000,1273230,558573230,False,2
4954,validator_2,457192368624,True,619600002,3955900,623555902,True,14
4955,validator_23,83847964960,True,594299997,43980400,638280397,True,2
4956,validator_6,161978037686,True,646900000,7503620,654403620,True,5
4957,validator_0,737479347451,True,619020011,67548590,686568601,True,23
4958,validator_39,54058017490,True,682600000,6603630,689203630,False,1
4959,validator_32,60354449030,True,789500000,2628160,792128160,False,1
4960,validator_19,68239053683,True,687879999,15489520,703369519,True,2
4961,validator_30,60671297390,True,660100000,8589470,668689470,False,1
4962,validator_1,636862780840,True,761200000,3080100,764280100,False,19
4963,validator_11,64271693473,True,732800004,1411560,734211564,True,2
4964,validator_4,231069879306,True,637060002,27387600,664447602,True,7
4965,validator_4,231883163227,True,800154001,13129920,813283921,True,7
4966,validator_30,61219982850,True,532500000,16185460,548685460,False,1
4967,validator_19,68735294934,True,474368001,21873250,496241251,True,2
4968,validator_23,84511713092,True,654020002,9728130,663748132,True,2
4969,validator_35,71388540550,True,492900000,7269000,500169000,False,2
4970,validator_2,457929997622,True,707439998,30189000,737628998,True,14
4971,validator_6,162800046655,True,777779999,44228970,822008969,True,5
4972,validator_3,358749099460,True,643200000,19442440,662642440,False,11
4973,validator_3,359194607520,True,444200000,1308060,445508060,False,11
4974,validator_0,738207445234,True,704659993,23437790,728097783,True,23
4975,validator_2,458654592404,True,692500002,32094780,724594782,True,14
4976,validator_2,459481707497,True,803460003,23655090,827115093,True,14
4977,validator_26,69107579364,True,762339995,25214840,787554835,True,2
4978,validator_45,65963110820,True,656100000,1715030,657815030,False,2
4979,validator_19,69417558234,True,656740000,25523300,682263300,True,2
4980,validator_0,738927016427,True,690810003,28761190,719571193,True,23
4981,validator_27,64238944127,True,611599998,13167020,624767018,True,2
4982,validator_1,637473724040,True,591600000,19343200,610943200,False,19
4983,validator_3,359918063120,True,721100000,2355600,723455600,False,11
4984,validator_4,232677464525,True,784099998,10201300,794301298,True,7
4985,validator_1,638134386440,True,639400000,21262400,660662400,False,19
4986,validator_2,460275012461,True,762619994,30684970,793304964,True,14
4987,validator_14,74674392533,True,429100000,33197260,462297260,True,2
4988,validator_3,360483327640,True,545900000,19364520,565264520,False,11
4989,validator_3,361085580240,True,591800000,10452600,602252600,False,11
4990,validator_4,233379417724,True,681299999,20653200,701953199,True,7
4991,validator_33,66288277070,True,587400000,885930,588285930,False,2
4992,validator_24,73124250770,True,645780004,50652100,696432104,True,2
4993,validator_31,66319045590,True,984200000,2050920,986250920,False,2
4994,validator_48,72455087000,True,517220000,5910360,523130360,False,2
4995,validator_3,361602300780,True,497000000,19720540,516720540,False,11
4996,validator_5,240048892350,True,539300000,21071110,560371110,False,7
4997,validator_1,638651681360,True,513600000,3694920,517294920,False,19
4998,validator_1,639481445350,True,809600000,20163990,829763990,False,19
4999,validator_34,61193505810,True,647100000,6171380,653271380,False,1
5000,validator_9,67434839028,True,592419997,44635470,637055467,True,2
5001,validator_33,66844698660,True,535900000,20521590,556421590,False,2
5002,validator_7,171877369530,True,638900000,3009850,641909850,False,5
5003,validator_2,461089993263,True,808820002,6160800,814980802,True,14
5004,validator_6,163669134057,True,842300002,26787400,869087402,True,5
5005,validator_2,461733087779,True,619464006,23630510,643094516,True,14
5006,validator_0,739873617298,True,931670001,14930870,946600871,True,23
5007,validator_2,462228557776,True,475579997,19890000,495469997,True,14
5008,validator_31,66862141830,True,502300000,40796240,543096240,False,2
5009,validator_35,72216980040,True,825900000,2539490,828439490,False,2
5010,validator_30,61793581550,True,571000000,2598700,573598700,False,1
5011,validator_4,234030677762,True,643599998,7660040,651260038,True,7
5012,validator_4,234799989493,True,724738001,44573730,769311731,True,7
5013,validator_2,462749510953,True,462779997,58173180,520953177,True,14
5014,validator_12,60156538731,True,543845993,9890470,553736463,True,1
5015,validator_1,640156764410,True,668600000,6719060,675319060,False,20
5016,validator_4,235685647594,True,856514001,29144100,885658101,True,7
5017,validator_1,640704157450,True,545500000,1893040,547393040,False,20
5018,validator_0,740650314917,True,743039999,33657620,776697619,True,23
5019,validator_6,164373286865,True,687300008,16852800,704152808,True,5
5020,validator_23,85253377293,True,714520001,27144200,741664201,True,2
5021,validator_0,741248210247,True,579340000,18555330,597895330,True,23
5022,validator_36,61361882170,True,798200000,2681800,800881800,False,1
5023,validator_0,741840654748,True,581760001,10684500,592444501,True,23
5024,validator_0,742533711858,True,664240010,28817100,693057110,True,23
5025,validator_32,60922415420,True,566700000,1266390,567966390,False,1
5026,validator_2,463477505430,True,721139997,6854480,727994477,True,14
5027,validator_14,75347030336,True,619862003,52775800,672637803,True,2
5028,validator_2,464380353456,True,851680006,51168020,902848026,True,14
5029,validator_1,641314664990,True,606900000,3607540,610507540,False,20
5030,validator_31,67352619070,True,480800000,9677240,490477240,False,2
5031,validator_10,81217380174,True,557800000,18723740,576523740,True,2
5032,validator_3,362419928140,True,802200000,15427360,817627360,False,11
5033,validator_0,743525300071,True,944620003,46968210,991588213,True,23
5034,validator_33,67416224740,True,543600000,27926080,571526080,False,2
5035,validator_45,66460084420,True,485700000,11273600,496973600,False,2
5036,validator_1,642255808400,True,922300000,18843410,941143410,False,20
5037,validator_2,464934063554,True,533399998,20310100,553710098,True,14
5038,validator_33,67834181310,True,415700000,2256570,417956570,False,2
5039,validator_3,363183175650,True,761700000,1547510,763247510,False,11
5040,validator_20,70825554654,True,685619994,23589240,709209234,True,2
5041,validator_48,73200698760,True,744400000,1211760,745611760,False,2
5042,validator_43,58751578910,True,650700000,1885030,652585030,False,1
5043,validator_0,744061023773,True,492020002,43703700,535723702,True,23
5044,validator_17,74750284491,True,539800000,7812500,547612500,True,2
5045,validator_2,465550638763,True,607919999,8655210,616575209,True,14
5046,validator_41,54521037880,True,621900000,21979220,643879220,False,1
5047,validator_0,744772891421,True,686320008,25547640,711867648,True,23
5048,validator_0,745278598332,True,482200001,23506910,505706911,True,23
5049,validator_32,61529954100,True,599100000,8438680,607538680,False,1
5050,validator_19,70097485230,True,655439996,24487000,679926996,True,2
5051,validator_6,165008655834,True,633499999,1868970,635368969,True,5
5052,validator_33,68351623110,True,507400000,10041800,517441800,False,2
5053,validator_3,363631992410,True,436800000,12016760,448816760,False,11
5054,validator_1,642901684300,True,637900000,7975900,645875900,False,20
5055,validator_2,466275570888,True,705119995,19812130,724932125,True,14
5056,validator_2,466928045113,True,649400005,3074220,652474225,True,14
5057,validator_22,88521350093,True,677899996,10317300,688217296,True,2
5058,validator_14,75972023295,True,615299999,9692960,624992959,True,2
5059,validator_0,745914277537,True,622500005,13179200,635679205,True,23
5060,validator_1,643583087350,True,672400000,9003050,681403050,False,20
5061,validator_6,165516905730,True,470059996,38189900,508249896,True,5
5062,validator_18,87810117453,True,806199996,9629830,815829826,True,2
5063,validator_32,62075054610,True,543500000,1600510,545100510,False,1
5064,validator_29,57059991370,True,690000000,6284470,696284470,False,1
5065,validator_1,644071438150,True,486600000,1750800,488350800,False,20
5066,validator_3,364171972650,True,539000000,980240,539980240,False,11
5067,validator_46,59523080230,True,784900000,3180200,788080200,False,1
5068,validator_31,68015568140,True,660400000,2549070,662949070,False,2
5069,validator_14,76845204889,True,854973994,18207600,873181594,True,2
5070,validator_27,64966676035,True,700858008,26873900,727731908,True,2
5071,validator_40,58333505600,True,495000000,2582460,497582460,False,1
5072,validator_5,240513758240,True,444800000,20065890,464865890,False,7
5073,validator_33,68936239410,True,574500000,10116300,584616300,False,2
5074,validator_30,62316716080,True,521100000,2034530,523134530,False,1
5075,validator_35,72834155570,True,608000000,9175530,617175530,False,2
5076,validator_2,467539926284,True,587346001,24535170,611881171,True,14
5077,validator_8,71800839948,True,708419996,27456700,735876696,True,2
5078,validator_2,468216473683,True,635883999,40663400,676547399,True,14
5079,validator_39,54673795790,True,605600000,10178300,615778300,False,1
5080,validator_43,59298215330,True,543700000,2936420,546636420,False,1
5081,validator_20,71435304526,True,588708002,21041870,609749872,True,2
5082,validator_29,57653461480,True,591000000,2470110,593470110,False,1
5083,validator_1,645051747350,True,978100000,2209200,980309200,False,20
5084,validator_19,70867562930,True,739500000,30577700,770077700,True,2
5085,validator_3,364663255750,True,489400000,1883100,491283100,False,11
5086,validator_33,69493637310,True,533200000,24197900,557397900,False,2
5087,validator_43,59830350490,True,519500000,12635160,532135160,False,1
5088,validator_23,85985124346,True,724440003,7307050,731747053,True,2
5089,validator_14,77394236692,True,502694003,46337800,549031803,True,2
5090,validator_33,70107656810,True,611400000,2619500,614019500,False,2
5091,validator_0,746703321738,True,749280001,39764200,789044201,True,23
5092,validator_2,468898534181,True,680799998,1260500,682060498,True,14
5093,validator_11,64905171930,True,594999997,38478460,633478457,True,2
5094,validator_9,68081809726,True,615855998,31114700,646970698,True,2
5095,validator_0,747607632958,True,888740000,15571220,904311220,True,23
5096,validator_5,241157808260,True,617300000,26750020,644050020,False,7
5097,validator_6,166010283630,True,484640000,8737900,493377900,True,5
5098,validator_0,748146382250,True,534239992,4509300,538749292,True,23
5099,validator_0,748757909769,True,596093999,15433520,611527519,True,23
5100,validator_1,645614484630,True,554700000,8037280,562737280,False,20
5101,validator_4,236343621132,True,656300008,1673530,657973538,True,7
5102,validator_25,64348112906,True,750599997,3588220,754188217,True,2
5103,validator_27,65559777551,True,592499996,601520,593101516,True,2
5104,validator_32,62690372040,True,612600000,2717430,615317430,False,1
5105,validator_48,73853197130,True,649600000,2898370,652498370,False,2
5106,validator_0,749412944299,True,645340000,9694530,655034530,True,23
5107,validator_5,241557549860,True,397100000,2641600,399741600,False,7
5108,validator_20,72181528953,True,738419997,7804430,746224427,True,2
5109,validator_1,646322432170,True,688700000,19247540,707947540,False,20
5110,validator_2,469410138292,True,492300001,19304110,511604111,True,14
5111,validator_31,68552270770,True,533900000,2802630,536702630,False,2
5112,validator_24,73656983855,True,521719995,11013090,532733085,True,2
5113,validator_18,88483575853,True,620280000,53178400,673458400,True,2
5114,validator_28,75948817274,True,725185998,11669180,736855178,True,2
5115,validator_43,60404421760,True,564800000,9271270,574071270,False,1
5116,validator_2,470037771847,True,612899995,14733560,627633555,True,14
5117,validator_36,62119408620,True,752700000,4826450,757526450,False,1
5118,validator_34,61813244540,True,612000000,7738730,619738730,False,1
5119,validator_0,750143255203,True,717920004,12390900,730310904,True,23
5120,validator_48,74409272540,True,552500000,3575410,556075410,False,2
5121,validator_8,72476735479,True,666200001,9695530,675895531,True,2
5122,validator_4,236759691578,True,392999996,23070450,416070446,True,7
5123,validator_10,81963841196,True,744700002,1761020,746461022,True,2
5124,validator_1,646868425280,True,542800000,3193110,545993110,False,20
5125,validator_4,237504764304,True,742099996,2972730,745072726,True,7
5126,validator_20,72831291073,True,628800000,20962120,649762120,True,2
5127,validator_3,365211079010,True,546500000,1323260,547823260,False,11
5128,validator_3,365731078060,True,515800000,4199050,519999050,False,11
5129,validator_5,242238179280,True,670900000,9729420,680629420,False,7
5130,validator_1,647637785880,True,749600000,19760600,769360600,False,20
5131,validator_14,78191821474,True,794900002,2684780,797584782,True,2
5132,validator_35,73482156270,True,640800000,7200700,648000700,False,2
5133,validator_2,470895034292,True,847400005,9862440,857262445,True,14
5134,validator_5,242855166340,True,614900000,2087060,616987060,False,7
5135,validator_46,60072719830,True,548300000,1339600,549639600,False,1
5136,validator_1,648345890780,True,705800000,2304900,708104900,False,20
5137,validator_0,750853801751,True,702619998,7926550,710546548,True,23
5138,validator_2,471389554764,True,483199992,11320480,494520472,True,14
5139,validator_6,166775080801,True,744100001,20697170,764797171,True,5
5140,validator_5,243335419440,True,475300000,4953100,480253100,False,7
5141,validator_2,471839937046,True,413074012,37308270,450382282,True,14
5142,validator_3,366399003240,True,666900000,1025180,667925180,False,11
5143,validator_22,89102999445,True,561800002,19849350,581649352,True,2
5144,validator_1,648914341740,True,530200000,38250960,568450960,False,20
5145,validator_3,366987135140,True,579000000,9131900,588131900,False,11
5146,validator_1,649473387270,True,557000000,2045530,559045530,False,20
5147,validator_7,172592482720,True,694800000,20313190,715113190,False,5
5148,validator_2,472470651249,True,619600003,11114200,630714203,True,14
5149,validator_42,63007322420,True,718000000,37780760,755780760,False,1
5150,validator_1,650174883410,True,698200000,3296140,701496140,False,20
5151,validator_19,71459026608,True,579979998,11483680,591463678,True,2
5152,validator_31,69068802970,True,490600000,25932200,516532200,False,2
5153,validator_26,69831969461,True,713399997,10990100,724390097,True,2
5154,validator_34,62436214470,True,615000000,7969930,622969930,False,1
5155,validator_0,751389577851,True,532940000,2836100,535776100,True,23
5156,validator_1,650658626700,True,481100000,2643290,483743290,False,20
5157,validator_26,70616103992,True,769599991,14534540,784134531,True,2
5158,validator_6,167320800428,True,495199997,50519630,545719627,True,5
5159,validator_3,367609540940,True,599100000,23305800,622405800,False,11
5160,validator_2,473092520596,True,581684007,40185340,621869347,True,14
5161,validator_35,74058088070,True,566000000,9931800,575931800,False,2
5162,validator_0,751891643298,True,498639997,3425450,502065447,True,23
5163,validator_7,173200205630,True,596500000,11222910,607722910,False,5
5164,validator_26,71133864187,True,491559995,26200200,517760195,True,2
5165,validator_3,368114009640,True,502500000,1968700,504468700,False,11
5166,validator_2,473701715578,True,607500002,1694980,609194982,True,14
5167,validator_8,73357350402,True,867020003,13594920,880614923,True,2
5168,validator_8,74287563361,True,860427999,69784960,930212959,True,2
5169,validator_20,73440233776,True,589680003,19262700,608942703,True,2
5170,validator_22,90102706477,True,972440002,27267030,999707032,True,2
5171,validator_4,238230877201,True,701819997,24292900,726112897,True,7
5172,validator_7,173752296950,True,550700000,1391320,552091320,False,5
5173,validator_3,368608949940,True,494100000,840300,494940300,False,11
5174,validator_5,244137032700,True,774500000,27113260,801613260,False,7
5175,validator_2,474414091322,True,695840004,16535740,712375744,True,14
5176,validator_6,168078119639,True,737900001,19419210,757319211,True,5
5177,validator_22,90858380071,True,741979994,13693600,755673594,True,2
5178,validator_22,91539461128,True,676299997,4781060,681081057,True,2
5179,validator_33,70690712450,True,562100000,20955640,583055640,False,2
5180,validator_9,68998792794,True,894793998,22189070,916983068,True,2
5181,validator_33,71302708610,True,608600000,3396160,611996160,False,2
5182,validator_6,168760844937,True,661479998,21245300,682725298,True,5
5183,validator_2,475114090018,True,679239996,20758700,699998696,True,14
5184,validator_15,87013320661,True,751700000,10529200,762229200,True,2
5185,validator_20,74010213195,True,567699999,2279420,569979419,True,2
5186,validator_34,63234753610,True,778900000,19639140,798539140,False,1
5187,validator_16,62361204794,True,609299996,16326080,625626076,True,1
5188,validator_20,75027436200,True,1007200005,10023000,1017223005,True,2
5189,validator_15,87687395366,True,671900005,2174700,674074705,True,2
5190,validator_21,75105694286,True,556339997,10532130,566872127,True,2
5191,validator_7,174262102720,True,507800000,2005770,509805770,False,5
5192,validator_35,74895112670,True,833400000,3624600,837024600,False,2
5193,validator_14,78906834113,True,691819999,23192640,715012639,True,2
5194,validator_4,238958925224,True,726000003,2048020,728048023,True,7
5195,validator_4,239614395960,True,633197996,22272740,655470736,True,7
5196,validator_6,169432738173,True,664300006,7593230,671893236,True,5
5197,validator_39,55260622370,True,585000000,1826580,586826580,False,1
5198,validator_1,651309633140,True,646900000,4106440,651006440,False,20
5199,validator_4,240280836885,True,658140005,8300920,666440925,True,7
5200,validator_4,241182954582,True,892299997,9817700,902117697,True,7
5201,validator_1,651796508460,True,480000000,6875320,486875320,False,20
5202,validator_1,652517547960,True,719100000,1939500,721039500,False,20
5203,validator_0,752521794829,True,596880001,33271530,630151531,True,23
5204,validator_15,88193519361,True,491959995,14164000,506123995,True,2
5205,validator_25,65125454950,True,719740004,57602040,777342044,True,2
5206,validator_7,174860061260,True,577300000,20658540,597958540,False,5
5207,validator_1,653196871920,True,677700000,1623960,679323960,False,20
5208,validator_0,753084006099,True,534620000,27591270,562211270,True,23
5209,validator_0,753591680403,True,487300004,20374300,507674304,True,23
5210,validator_1,653673655460,True,473800000,2983540,476783540,False,20
5211,validator_41,55168566110,True,640400000,7128230,647528230,False,1
5212,validator_5,244810078260,True,669500000,3545560,673045560,False,7
5213,validator_0,754329757035,True,710646002,27430630,738076632,True,23
5214,validator_14,79761208817,True,845800004,8574700,854374704,True,2
5215,validator_1,654340892460,True,638400000,28837000,667237000,False,20
5216,validator_45,67032425750,True,555800000,16541330,572341330,False,2
5217,validator_1,655077015960,True,735400000,723500,736123500,False,20
5218,validator_0,754919891830,True,587799995,2334800,590134795,True,23
5219,validator_1,655524406160,True,445000000,2390200,447390200,False,20
5220,validator_3,369252189850,True,640300000,2939910,643239910,False,11
5221,validator_21,75743271376,True,635000000,2577090,637577090,True,2
5222,validator_1,656255949390,True,710700000,20843230,731543230,False,20
5223,validator_2,475920279046,True,797239998,8949030,806189028,True,14
5224,validator_0,755563464789,True,606219999,37352960,643572959,True,23
5225,validator_2,476554628523,True,624599997,9749480,634349477,True,14
5226,validator_0,756207811689,True,597580000,46766900,644346900,True,23
5227,validator_11,65723374463,True,809660003,8542530,818202533,True,2
5228,validator_1,656941578310,True,676100000,9528920,685628920,False,20
5229,validator_5,245250828560,True,429900000,10850300,440750300,False,7
5230,validator_25,65805066455,True,649219995,30391510,679611505,True,2
5231,validator_3,369936279790,True,672500000,11589940,684089940,False,11
5232,validator_1,657772284440,True,801800000,28906130,830706130,False,20
5233,validator_30,62957813280,True,638700000,2397200,641097200,False,1
5234,validator_4,241890421682,True,651580000,55887100,707467100,True,7
5235,validator_0,756848622788,True,588219999,52591100,640811099,True,23
5236,validator_19,72176697946,True,705839998,11831340,717671338,True,2
5237,validator_1,658272099030,True,490930000,8884590,499814590,False,20
5238,validator_1,659045647330,True,766200000,7348300,773548300,False,20
5239,validator_7,175609810660,True,744100000,5649400,749749400,False,5
5240,validator_4,242672914324,True,780100002,2392640,782492642,True,7
5241,validator_22,92253362347,True,710399999,3501220,713901219,True,2
5242,validator_1,659503763430,True,438300000,19816100,458116100,False,20
5243,validator_12,60998120246,True,819039995,22541520,841581515,True,1
5244,validator_9,69660753927,True,648200003,13761130,661961133,True,2
5245,validator_28,76802315272,True,829919998,23578000,853497998,True,2
5246,validator_49,58238437190,True,606700000,18672150,625372150,False,1
5247,validator_2,477487125927,True,924840004,7657400,932497404,True,14
5248,validator_47,58700269510,True,680600000,4224620,684824620,False,1
5249,validator_22,93161724232,True,904240005,4121880,908361885,True,2
5250,validator_1,660055854430,True,547000000,5091000,552091000,False,20
5251,validator_39,55790144230,True,526100000,3421860,529521860,False,1
5252,validator_6,170385315090,True,926719997,25856920,952576917,True,5
5253,validator_0,757455626792,True,593340004,13664000,607004004,True,23
5254,validator_4,243311234771,True,567000007,71320440,638320447,True,7
5255,validator_0,758040871774,True,567500002,17744980,585244982,True,23
5256,validator_10,82557993797,True,570300001,23852600,594152601,True,2
5257,validator_5,245886721240,True,625100000,10792680,635892680,False,7
5258,validator_2,478108554826,True,615499999,5928900,621428899,True,14
5259,validator_0,758851135221,True,807800007,2463440,810263447,True,23
5260,validator_5,246574430280,True,686200000,1509040,687709040,False,7
5261,validator_1,660634389150,True,575900000,2634720,578534720,False,20
5262,validator_4,243990698568,True,676059997,3403800,679463797,True,7
5263,validator_33,72221459740,True,916700000,2051130,918751130,False,2
5264,validator_2,478829309165,True,674529999,46224340,720754339,True,14
5265,validator_11,66388317096,True,658600003,6342630,664942633,True,2
5266,validator_0,759534381078,True,669340007,13905850,683245857,True,23
5267,validator_7,176166121320,True,546500000,9810660,556310660,False,5
5268,validator_23,86786714877,True,794480001,7110530,801590531,True,2
5269,validator_21,76463267196,True,704340000,15655820,719995820,True,2
5270,validator_31,69599895480,True,529800000,1292510,531092510,False,2
5271,validator_1,661235636370,True,582300000,18947220,601247220,False,20
5272,validator_6,171090184679,True,696699999,8169590,704869589,True,5
5273,validator_0,760088211372,True,540059994,13770300,553830294,True,23
5274,validator_3,370398279180,True,441400000,20599390,461999390,False,11
5275,validator_24,74534557195,True,856240000,21333340,877573340,True,2
5276,validator_35,75734635950,True,835800000,3723280,839523280,False,2
5277,validator_4,244734943864,True,715899996,28345300,744245296,True,7
5278,validator_3,371030500400,True,630100000,2121220,632221220,False,11
5279,validator_3,371674100600,True,637300000,6300200,643600200,False,11
5280,validator_1,661906925930,True,660300000,10989560,671289560,False,20
5281,validator_4,245527592897,True,790799993,1849040,792649033,True,7
5282,validator_11,67168357322,True,762619996,17420230,780040226,True,2
5283,validator_3,372312885230,True,636600000,2184630,638784630,False,11
5284,validator_2,479457482250,True,624800005,3373080,628173085,True,14
5285,validator_4,246335094987,True,770374000,37128090,807502090,True,7
5286,validator_26,71708826366,True,567620009,7342170,574962179,True,2
5287,validator_3,372970153650,True,655400000,1868420,657268420,False,11
5288,validator_42,63388991400,True,380470000,1198980,381668980,False,1
5289,validator_41,55782134200,True,596700000,16868090,613568090,False,1
5290,validator_0,760672807474,True,565240002,19356100,584596102,True,23
5291,validator_1,662613889600,True,700200000,6763670,706963670,False,20
5292,validator_0,761264553982,True,567040008,24706500,591746508,True,23
5293,validator_34,63909147010,True,670300000,4093400,674393400,False,1
5294,validator_1,663250673300,True,631900000,4883700,636783700,False,20
5295,validator_1,663798953340,True,546800000,1480040,548280040,False,20
5296,validator_2,480358972697,True,884799997,16690450,901490447,True,15
5297,validator_1,664358665620,True,557200000,2512280,559712280,False,20
5298,validator_12,61726324931,True,704677995,23526690,728204685,True,1
5299,validator_5,247456697400,True,871900000,10367120,882267120,False,7
5300,validator_8,74968860788,True,643419997,37877430,681297427,True,2
5301,validator_7,176801168760,True,634300000,747440,635047440,False,5
5302,validator_0,761847509903,True,578800001,4155920,582955921,True,23
5303,validator_0,762379566003,True,530900000,1156100,532056100,True,23
5304,validator_26,72382602767,True,651994001,21782400,673776401,True,2
5305,validator_33,72775497900,True,550600000,3438160,554038160,False,2
5306,validator_1,665135072680,True,775100000,1307060,776407060,False,20
5307,validator_28,77445389272,True,623488000,19586000,643074000,True,2
5308,validator_25,66394862755,True,543540000,46256300,589796300,True,2
5309,validator_1,665837335200,True,700600000,1662520,702262520,False,20
5310,validator_2,481163152896,True,775739999,28440200,804180199,True,15
5311,validator_42,63989047100,True,597700000,2355700,600055700,False,1
5312,validator_37,60361696840,True,923700000,18409100,942109100,False,1
5313,validator_14,80442729774,True,653769997,27750960,681520957,True,2
5314,validator_6,171937948514,True,821000005,26763830,847763835,True,5
5315,validator_3,373584444750,True,591900000,22391100,614291100,False,11
5316,validator_40,59084049530,True,741700000,8843930,750543930,False,1
5317,validator_44,60370580180,True,527600000,1650020,529250020,False,1
5318,validator_10,83144850399,True,577100002,9756600,586856602,True,2
5319,validator_38,60348049920,True,596500000,7033640,603533640,False,1
5320,validator_0,763097176224,True,681314001,36296220,717610221,True,23
5321,validator_1,666354313250,True,516070000,908050,516978050,False,20
5322,validator_3,374211407510,True,603400000,23562760,626962760,False,11
5323,validator_8,75701763926,True,714060008,18843130,732903138,True,2
5324,validator_2,482019717969,True,764880003,91685070,856565073,True,15
5325,validator_2,482649228272,True,600680003,28830300,629510303,True,15
5326,validator_1,666986947810,True,613100000,19534560,632634560,False,20
5327,validator_12,62326282630,True,589959999,9997700,599957699,True,1
5328,validator_1,667569612510,True,574600000,8064700,582664700,False,20
5329,validator_24,75486110639,True,927040004,24513440,951553444,True,2
5330,validator_2,483396473075,True,715968003,31276800,747244803,True,15
5331,validator_45,67647965780,True,613600000,1940030,615540030,False,2
5332,validator_3,374773920130,True,560600000,1912620,562512620,False,11
5333,validator_1,668219034110,True,647700000,1721600,649421600,False,20
5334,validator_3,375476796040,True,700800000,2075910,702875910,False,11
5335,validator_0,763757790391,True,642819997,17794170,660614167,True,23
5336,validator_31,70221051170,True,616100000,5055690,621155690,False,2
5337,validator_48,74973728170,True,557700000,6755630,564455630,False,2
5338,validator_3,376079142400,True,600800000,1546360,602346360,False,11
5339,validator_27,66165168853,True,586020002,19371300,605391302,True,2
5340,validator_0,764312012436,True,537420005,16802040,554222045,True,23
5341,validator_13,57743060922,True,496700002,956700,497656702,True,1
5342,validator_48,75552318140,True,572200000,6389970,578589970,False,2
5343,validator_27,67017929750,True,812383997,40376900,852760897,True,2
5344,validator_1,668832844650,True,608000000,5810540,613810540,False,20
5345,validator_27,67638073349,True,596585999,23557600,620143599,True,2
5346,validator_23,87529973057,True,721000000,22258180,743258180,True,2
5347,validator_12,63120761242,True,785100002,9378610,794478612,True,1
5348,validator_1,669285466280,True,451800000,821630,452621630,False,20
5349,validator_0,764979868025,True,630439999,37415590,667855589,True,23
5350,validator_3,376707637620,True,608500000,19995220,628495220,False,11
5351,validator_2,484129239524,True,702540009,30226440,732766449,True,15
5352,validator_2,484808123219,True,658033995,20849700,678883695,True,15
5353,validator_5,248026431850,True,566900000,2834450,569734450,False,7
5354,validator_8,76512381447,True,805700001,4917520,810617521,True,2
5355,validator_0,765735715397,True,728940002,26907370,755847372,True,23
5356,validator_32,63241126740,True,546700000,4054700,550754700,False,1
5357,validator_41,56370343700,True,587100000,1109500,588209500,False,1
5358,validator_1,670033959610,True,726900000,21593330,748493330,False,20
5359,validator_17,75371979291,True,610100000,11594800,621694800,True,2
5360,validator_21,77311941427,True,826836001,21838230,848674231,True,2
5361,validator_2,485583630971,True,753560002,21947750,775507752,True,15
5362,validator_0,766360643000,True,590620003,34307600,624927603,True,23
5363,validator_5,248685108280,True,638400000,20276430,658676430,False,7
5364,validator_5,249366411620,True,657200000,24103340,681303340,False,7
5365,validator_0,767236083487,True,872799997,2640490,875440487,True,23
5366,validator_3,377193919880,True,477020000,9262260,486282260,False,11
5367,validator_0,767911483714,True,664239997,11160230,675400227,True,23
5368,validator_0,768722204347,True,753180003,57540630,810720633,True,24
5369,validator_40,59758147660,True,648000000,26098130,674098130,False,1
5370,validator_1,670435189510,True,399500000,1729900,401229900,False,20
5371,validator_31,70544493790,True,315600000,7842620,323442620,False,2
5372,validator_31,71142964990,True,595300000,3171200,598471200,False,2
5373,validator_3,377801376410,True,606500000,956530,607456530,False,11
5374,validator_48,76098590380,True,542300000,3972240,546272240,False,2
5375,validator_31,71904559190,True,752500000,9094200,761594200,False,2
5376,validator_45,68440579470,True,781400000,11213690,792613690,False,2
5377,validator_0,769552151711,True,810279994,19667370,829947364,True,24
5378,validator_10,83702652197,True,556999998,801800,557801798,True,2
5379,validator_26,72905702291,True,513920004,9179520,523099524,True,2
5380,validator_3,378253177320,True,449900000,1900910,451800910,False,11
5381,validator_0,770234974897,True,652899996,29923190,682823186,True,24
5382,validator_21,78139017570,True,800600003,26476140,827076143,True,2
5383,validator_24,76133773357,True,627999998,19662720,647662718,True,2
5384,validator_23,88402046593,True,861758006,10315530,872073536,True,2
5385,validator_42,64871568100,True,880000000,2521000,882521000,False,2
5386,validator_1,671151910110,True,715600000,1120600,716720600,False,20
5387,validator_2,486499140415,True,902739994,12769450,915509444,True,15
5388,validator_3,378961997550,True,705300000,3520230,708820230,False,11
5389,validator_0,770971012307,True,730100000,5937410,736037410,True,24
5390,validator_7,177319997720,True,508200000,10628960,518828960,False,5
5391,validator_0,772119160302,True,1106399995,41748000,1148147995,True,24
5392,validator_47,59424793910,True,723900000,624400,724524400,False,1
5393,validator_21,78967382211,True,808720001,19644640,828364641,True,2
5394,validator_3,379549321640,True,584200000,3124090,587324090,False,11
5395,validator_1,671742180510,True,578990000,11280400,590270400,False,20
5396,validator_22,93877592739,True,679420007,36448500,715868507,True,2
5397,validator_1,672453237740,True,709000000,2057230,711057230,False,21
5398,validator_4,247028579994,True,651560007,41925000,693485007,True,7
5399,validator_41,56853843200,True,480300000,3199500,483499500,False,1
5400,validator_16,63037475787,True,643160003,33110990,676270993,True,1
5401,validator_25,67124057376,True,719100001,10094620,729194621,True,2
5402,validator_29,58282561870,True,620800000,8300390,629100390,False,1
5403,validator_14,81163049519,True,697390005,22929740,720319745,True,2
5404,validator_2,487107547082,True,594239997,14166670,608406667,True,15
5405,validator_3,380068103040,True,510300000,8481400,518781400,False,11
5406,validator_3,380770095120,True,696300000,5692080,701992080,False,11
5407,validator_2,487849272485,True,726920003,14805400,741725403,True,15
5408,validator_2,488376746913,True,525499998,1974430,527474428,True,15
5409,validator_45,68965780340,True,508700000,16500870,525200870,False,2
5410,validator_0,772892507904,True,753320002,20027600,773347602,True,24
5411,validator_17,75807930461,True,407079990,28871180,435951170,True,2
5412,validator_7,178129501220,True,801600000,7903500,809503500,False,5
5413,validator_26,73824813751,True,915800000,3311460,919111460,True,2
5414,validator_28,78117992476,True,659360004,13243200,672603204,True,2
5415,validator_2,489124536116,True,698200003,49589200,747789203,True,15
5416,validator_18,89321043244,True,814260001,23207390,837467391,True,2
5417,validator_5,250071897440,True,702900000,2585820,705485820,False,7
5418,validator_0,773481895427,True,568999993,20387530,589387523,True,24
5419,validator_23,89002846799,True,590840006,9960200,600800206,True,2
5420,validator_1,673159172820,True,704000000,1935080,705935080,False,21
5421,validator_13,58375120718,True,630099996,1959800,632059796,True,1
5422,validator_3,381283670420,True,495100000,18475300,513575300,False,11
5423,validator_1,673752393550,True,572100000,21120730,593220730,False,21
5424,validator_1,674286539170,True,529800000,4345620,534145620,False,21
5425,validator_45,69721693640,True,753300000,2613300,755913300,False,2
5426,validator_25,67882749620,True,721480004,37212240,758692244,True,2
5427,validator_39,56473220920,True,663500000,19576690,683076690,False,1
5428,validator_1,675064278140,True,775400000,2338970,777738970,False,21
5429,validator_6,172717746648,True,769799994,9998140,779798134,True,5
5430,validator_6,173270285064,True,503220006,49318410,552538416,True,5
5431,validator_5,250527147610,True,452300000,2950170,455250170,False,7
5432,validator_27,68417596302,True,775910003,3612950,779522953,True,2
5433,validator_1,675636503480,True,550750000,21475340,572225340,False,21
5434,validator_3,381833239460,True,545700000,3869040,549569040,False,11
5435,validator_45,70375645320,True,650800000,3151680,653951680,False,2
5436,validator_2,489951348809,True,799979993,26832700,826812693,True,15
5437,validator_42,65538505660,True,646900000,20037560,666937560,False,2
5438,validator_1,676272267480,True,616700000,19064000,635764000,False,21
5439,validator_0,773860990010,True,372610003,6484580,379094583,True,24
5440,validator_1,676908104880,True,633700000,2137400,635837400,False,21
5441,validator_0,774371002207,True,506599997,3412200,510012197,True,24
5442,validator_1,677538473180,True,614300000,16068300,630368300,False,21
5443,validator_24,76726470964,True,558100007,34597600,592697607,True,2
5444,validator_19,73067709843,True,835357997,55653900,891011897,True,2
5445,validator_1,678015832200,True,469000000,8359020,477359020,False,21
5446,validator_34,64467024650,True,549400000,8477640,557877640,False,2
5447,validator_0,775263870703,True,871919996,20948500,892868496,True,24
5448,validator_20,75612455293,True,567019993,17999100,585019093,True,2
5449,validator_21,79543348639,True,538799998,37166430,575966428,True,2
5450,validator_25,68209835527,True,319740007,7345900,327085907,True,2
5451,validator_4,247645135574,True,607420000,9135580,616555580,True,7
5452,validator_4,247991100013,True,336679999,9284440,345964439,True,7
5453,validator_5,251086394420,True,525000000,34246810,559246810,False,7
5454,validator_19,73741415823,True,671100000,2605980,673705980,True,2
5455,validator_15,88724934807,True,445316006,86099440,531415446,True,2
5456,validator_0,776192190015,True,920639992,7679320,928319312,True,24
5457,validator_0,776929243887,True,717220002,19833870,737053872,True,24
5458,validator_20,76053116466,True,420100003,20561170,440661173,True,2
5459,validator_1,678583275640,True,529800000,37643440,567443440,False,21
5460,validator_1,679249299440,True,658100000,7923800,666023800,False,21
5461,validator_0,777703465823,True,745199996,29021940,774221936,True,24
5462,validator_38,61187119690,True,802000000,37069770,839069770,False,1
5463,validator_21,80149068185,True,587720006,17999540,605719546,True,2
5464,validator_21,81309189989,True,1107810004,52311800,1160121804,True,2
5465,validator_1,679701007350,True,451000000,707910,451707910,False,21
5466,validator_35,76224260480,True,487200000,2424530,489624530,False,2
5467,validator_0,778537890573,True,783060000,51364750,834424750,True,24
5468,validator_0,779203129612,True,638239999,26999040,665239039,True,24
5469,validator_3,382534459150,True,675700000,25519690,701219690,False,11
5470,validator_0,779799437746,True,580399994,15908140,596308134,True,24
5471,validator_39,57080321950,True,605300000,1801030,607101030,False,1
5472,validator_46,60622591710,True,546500000,3371880,549871880,False,1
5473,validator_0,780368469747,True,565800001,3232000,569032001,True,24
5474,validator_10,84449274297,True,733780000,12842100,746622100,True,2
5475,validator_1,680332022520,True,629500000,1515170,631015170,False,21
5476,validator_48,76701416330,True,598500000,4325950,602825950,False,2
5477,validator_2,490700109702,True,714827993,33932900,748760893,True,15
5478,validator_0,781102108440,True,728400003,5238690,733638693,True,24
5479,validator_1,680882092020,True,539500000,10569500,550069500,False,21
5480,validator_2,491423705020,True,695679998,27915320,723595318,True,15
5481,validator_26,74312821536,True,468800005,19207780,488007785,True,2
5482,validator_0,781870550680,True,745180000,23262240,768442240,True,24
5483,validator_0,782328069994,True,448239994,9279320,457519314,True,24
5484,validator_0,783302336222,True,943300008,30966220,974266228,True,24
5485,validator_1,681509916680,True,625870000,1954660,627824660,False,21
5486,validator_19,74423102227,True,667640004,14046400,681686404,True,2
5487,validator_45,71128809260,True,750900000,2263940,753163940,False,2
5488,validator_1,682010684890,True,495800000,4968210,500768210,False,21
5489,validator_28,78854870294,True,722685998,14191820,736877818,True,2
5490,validator_33,73564493300,True,768600000,20395400,788995400,False,2
5491,validator_2,491994425625,True,563700005,7020600,570720605,True,15
5492,validator_0,784019066449,True,667507997,49222230,716730227,True,24
5493,validator_21,82013015430,True,698820001,5005440,703825441,True,2
5494,validator_1,682574770490,True,555700000,8385600,564085600,False,21
5495,validator_27,69209263801,True,772899999,18767500,791667499,True,2
5496,validator_3,383164662190,True,621900000,8303040,630203040,False,11
5497,validator_30,63502370600,True,540700000,3857320,544557320,False,1
5498,validator_4,248586548513,True,593200000,2248500,595448500,True,7
5499,validator_2,492640285130,True,642500005,3359500,645859505,True,15
5500,validator_0,784896031223,True,852799994,24164780,876964774,True,24
5501,validator_10,85345894604,True,885699997,10920310,896620307,True,2
5502,validator_43,61121875500,True,708600000,8853740,717453740,False,1
5503,validator_0,785574286831,True,619439998,58815610,678255608,True,24
5504,validator_48,77062285070,True,357000000,3868740,360868740,False,2
5505,validator_0,786293998121,True,713599990,6111300,719711290,True,24
5506,validator_35,76725393110,True,474700000,26432630,501132630,False,2
5507,validator_44,60829380390,True,449900000,8900210,458800210,False,1
5508,validator_31,72428913150,True,513100000,11253960,524353960,False,2
5509,validator_1,683129133790,True,553600000,763300,554363300,False,21
5510,validator_2,493259424027,True,615339997,3798900,619138897,True,15
5511,validator_47,60062647340,True,635900000,1953430,637853430,False,1
5512,validator_12,64146226558,True,983179996,42285320,1025465316,True,2
5513,validator_2,494034821447,True,760900000,14497420,775397420,True,15
5514,validator_0,787017242850,True,703999999,19244730,723244729,True,24
5515,validator_0,787665247454,True,618160004,29844600,648004604,True,24
5516,validator_39,57668134710,True,562700000,25112760,587812760,False,1
5517,validator_1,683724403950,True,558200000,37070160,595270160,False,21
5518,validator_25,69307848930,True,1092200003,5813400,1098013403,True,2
5519,validator_26,74874394729,True,546460003,15113190,561573193,True,2
5520,validator_3,383857917310,True,683000000,10255120,693255120,False,11
5521,validator_3,384435019910,True,573100000,4002600,577102600,False,12
5522,validator_4,249493718801,True,857999988,49170300,907170288,True,7
5523,validator_3,385170940740,True,723900000,12020830,735920830,False,12
5524,validator_2,494648495744,True,593899997,19774300,613674297,True,15
5525,validator_24,77387141659,True,634187995,26482700,660670695,True,2
5526,validator_19,75249716229,True,765680002,60934000,826614002,True,2
5527,validator_15,89688062776,True,882179989,80947980,963127969,True,2
5528,validator_0,788730622744,True,1036099990,29275300,1065375290,True,24
5529,validator_0,789455637427,True,716860003,8154680,725014683,True,24
5530,validator_3,385835614600,True,663500000,1173860,664673860,False,12
5531,validator_11,67775965589,True,600140007,7468260,607608267,True,2
5532,validator_4,250227510707,True,707400006,26391900,733791906,True,7
5533,validator_28,79731695258,True,839600004,37224960,876824964,True,2
5534,validator_2,495300553089,True,603005995,49051350,652057345,True,15
5535,validator_6,173771058847,True,474840003,25933780,500773783,True,5
5536,validator_1,684299681650,True,570400000,4877700,575277700,False,21
5537,validator_3,386221268530,True,379170000,6483930,385653930,False,12
5538,validator_18,89962215433,True,628099999,13072190,641172189,True,2
5539,validator_7,178693628020,True,562500000,1626800,564126800,False,5
5540,validator_0,790220773626,True,705219999,59916200,765136199,True,24
5541,validator_1,684897562320,True,587900000,9980670,597880670,False,21
5542,validator_3,386839103710,True,614400000,3435180,617835180,False,12
5543,validator_3,387407121430,True,557600000,10417720,568017720,False,12
5544,validator_42,66276377960,True,727900000,9972300,737872300,False,2
5545,validator_0,790863289025,True,635899999,6615400,642515399,True,24
5546,validator_15,90314277474,True,599495998,26718700,626214698,True,2
5547,validator_14,81843613719,True,665496000,15068200,680564200,True,2
5548,validator_38,61816038350,True,626000000,2918660,628918660,False,1
5549,validator_4,251097349339,True,778700002,91138630,869838632,True,7
5550,validator_41,57705642820,True,828400000,23399620,851799620,False,1
5551,validator_49,58942533220,True,697700000,6396030,704096030,False,1
5552,validator_5,251734933140,True,630700000,17838720,648538720,False,7
5553,validator_10,86181651052,True,826857998,8898450,835756448,True,2
5554,validator_11,68376336820,True,574008001,26363230,600371231,True,2
5555,validator_1,685328235870,True,423800000,6873550,430673550,False,21
5556,validator_42,66932844780,True,654500000,1966820,656466820,False,2
5557,validator_1,685993529810,True,664300000,993940,665293940,False,21
5558,validator_27,70106002980,True,887899999,8839180,896739179,True,2
5559,validator_45,71855464060,True,705800000,20854800,726654800,False,2
5560,validator_6,174632818751,True,836099994,25659910,861759904,True,5
5561,validator_35,77338817270,True,574000000,39424160,613424160,False,2
5562,validator_1,686648408110,True,652400000,2478300,654878300,False,21
5563,validator_44,61676718190,True,841500000,5837800,847337800,False,1
5564,validator_47,60692462850,True,628700000,1115510,629815510,False,1
5565,validator_0,791590016524,True,709413999,17313500,726727499,True,24
5566,validator_0,792520359223,True,911819999,18522700,930342699,True,24
5567,validator_0,793250438642,True,693865999,36213420,730079419,True,24
5568,validator_32,63862300150,True,618900000,2273410,621173410,False,1
5569,validator_0,793811688087,True,533120005,28129440,561249445,True,24
5570,validator_0,794476695884,True,625927997,39079800,665007797,True,24
5571,validator_36,62577617660,True,457300000,909040,458209040,False,1
5572,validator_12,64879967371,True,688868003,44872810,733740813,True,2
5573,validator_15,91064509570,True,728019996,22212100,750232096,True,2
5574,validator_2,495990582527,True,662539998,27489440,690029438,True,15
5575,validator_21,82605661052,True,589040002,3605620,592645622,True,2
5576,validator_2,496476255358,True,469240001,16432830,485672831,True,15
5577,validator_8,77231041680,True,641680003,76980230,718660233,True,2
5578,validator_7,179297733120,True,585000000,19105100,604105100,False,5
5579,validator_2,497160976693,True,647020005,37701330,684721335,True,15
5580,validator_4,251714938701,True,577420002,40169360,617589362,True,7
5581,validator_11,68960524618,True,574219998,9967800,584187798,True,2
5582,validator_42,67582140300,True,638200000,11095520,649295520,False,2
5583,validator_2,497766394788,True,596219995,9198100,605418095,True,15
5584,validator_21,83350809355,True,742300003,2848300,745148303,True,2
5585,validator_8,77995617361,True,754240001,10335680,764575681,True,2
5586,validator_2,498281192314,True,505999996,8797530,514797526,True,15
5587,validator_1,687351684510,True,700800000,2476400,703276400,False,21
5588,validator_1,688057321410,True,695700000,9936900,705636900,False,21
5589,validator_1,688543654470,True,469300000,17033060,486333060,False,21
5590,validator_17,76519090956,True,702839995,8320500,711160495,True,2
5591,validator_6,175488141747,True,845439996,9883000,855322996,True,5
5592,validator_1,689132908690,True,585200000,4054220,589254220,False,21
5593,validator_1,689785069410,True,650200000,1960720,652160720,False,21
5594,validator_20,76610228865,True,545569999,11542400,557112399,True,2
5595,validator_4,252345732762,True,628800001,1994060,630794061,True,7
5596,validator_2,499011238948,True,711919994,18126640,730046634,True,15
5597,validator_1,690654144310,True,867200000,1874900,869074900,False,21
5598,validator_0,795295603423,True,781699989,37207550,818907539,True,24
5599,validator_21,84000147661,True,633104006,16234300,649338306,True,2
5600,validator_0,796167951947,True,854460004,17888520,872348524,True,24
5601,validator_24,77935862262,True,528400003,20320600,548720603,True,2
5602,validator_37,61008286880,True,642700000,3890040,646590040,False,1
5603,validator_5,252203826210,True,457500000,11393070,468893070,False,7
5604,validator_35,77879955790,True,539600000,1538520,541138520,False,2
5605,validator_26,75731494149,True,821260000,35839420,857099420,True,2
5606,validator_1,691302750230,True,639900000,8705920,648605920,False,21
5607,validator_1,691931311440,True,612000000,16561210,628561210,False,21
5608,validator_45,72619272700,True,748400000,15408640,763808640,False,2
5609,validator_2,499770553654,True,706920006,52394700,759314706,True,15
5610,validator_10,86892760347,True,682259995,28849300,711109295,True,2
5611,validator_8,78706824256,True,679459995,31746900,711206895,True,2
5612,validator_0,796787343245,True,567325998,52065300,619391298,True,24
5613,validator_25,70058123638,True,742799998,7474710,750274708,True,2
5614,validator_20,77520000664,True,852919999,56851800,909771799,True,2
5615,validator_25,70862185421,True,792239993,11821790,804061783,True,2
5616,validator_28,80407433788,True,630256000,45482530,675738530,True,2
5617,validator_18,91050290657,True,1076869994,11205230,1088075224,True,2
5618,validator_4,252803879869,True,436500007,21647100,458147107,True,7
5619,validator_2,500547154854,True,769600000,7001200,776601200,True,15
5620,validator_0,797583469027,True,788100002,8025780,796125782,True,24
5621,validator_1,692576449320,True,618000000,27137880,645137880,False,21
5622,validator_5,252847026690,True,639900000,3300480,643200480,False,7
5623,validator_1,693164690490,True,582400000,5841170,588241170,False,21
5624,validator_2,501244385654,True,671220000,26010800,697230800,True,15
5625,validator_3,387965039330,True,524700000,33217900,557917900,False,12
5626,validator_33,74048141580,True,463900000,19748280,483648280,False,2
5627,validator_3,388517281210,True,550700000,1541880,552241880,False,12
5628,validator_1,693777800290,True,611300000,1809800,613109800,False,21
5629,validator_42,68105777930,True,516600000,7037630,523637630,False,2
5630,validator_1,694411567990,True,620100000,13667700,633767700,False,21
5631,validator_7,179873874000,True,573300000,2840880,576140880,False,5
5632,validator_23,89636466104,True,613540005,20079300,633619305,True,2
5633,validator_23,90170182448,True,531390004,2326340,533716344,True,2
5634,validator_28,81173710161,True,728649993,37626380,766276373,True,2
5635,validator_2,501823096796,True,571900002,6811140,578711142,True,15
5636,validator_1,694894477410,True,477800000,5109420,482909420,False,21
5637,validator_0,798280515873,True,692800006,4246840,697046846,True,24
5638,validator_1,695605486090,True,709600000,1408680,711008680,False,21
5639,validator_20,78087249782,True,540953998,26295120,567249118,True,2
5640,validator_1,696222665120,True,614900000,2279030,617179030,False,21
5641,validator_26,76547442083,True,807100004,8847930,815947934,True,2
5642,validator_0,799140165309,True,808499996,51149440,859649436,True,24
5643,validator_0,799788321617,True,633019998,15136310,648156308,True,24
5644,validator_12,65716442249,True,830139998,6334880,836474878,True,2
5645,validator_0,800697469431,True,833159994,75987820,909147814,True,25
5646,validator_48,77438875770,True,375200000,1390700,376590700,False,2
5647,validator_26,77234643194,True,666280011,20921100,687201111,True,2
5648,validator_4,253784025968,True,960119999,20026100,980146099,True,7
5649,validator_3,389223382940,True,704910000,1191730,706101730,False,12
5650,validator_5,253598997980,True,750500000,1471290,751971290,False,7
5651,validator_1,696709629320,True,478100000,8864200,486964200,False,21
5652,validator_1,697131641050,True,412740000,9271730,422011730,False,21
5653,validator_0,801473880924,True,765000003,11411490,776411493,True,25
5654,validator_1,697834308970,True,700800000,1867920,702667920,False,21
5655,validator_3,389777277680,True,551700000,2194740,553894740,False,12
5656,validator_0,802213068416,True,729399992,9787500,739187492,True,25
5657,validator_26,77710646062,True,472539998,3462870,476002868,True,2
5658,validator_1,698261872870,True,426600000,963900,427563900,False,21
5659,validator_46,61116278540,True,480500000,13186830,493686830,False,1
5660,validator_5,254074858520,True,473900000,1960540,475860540,False,7
5661,validator_1,698813609970,True,549700000,2037100,551737100,False,21
5662,validator_0,802819354714,True,567581998,38704300,606286298,True,25
5663,validator_19,75973323268,True,680659999,42947040,723607039,True,2
5664,validator_12,66595835475,True,861500006,17893220,879393226,True,2
5665,validator_45,73284798600,True,662700000,2825900,665525900,False,2
5666,validator_4,254401087263,True,588935995,28125300,617061295,True,7
5667,validator_20,78668603676,True,558400004,22953890,581353894,True,2
5668,validator_19,76719580207,True,690163999,56092940,746256939,True,2
5669,validator_6,176278309420,True,785300003,4867670,790167673,True,5
5670,validator_5,254683306200,True,606300000,2147680,608447680,False,7
5671,validator_24,78664227664,True,683494002,44871400,728365402,True,2
5672,validator_0,803509237620,True,661560006,28322900,689882906,True,25
5673,validator_19,77375005504,True,635399997,20025300,655425297,True,2
5674,validator_1,699416565450,True,592400000,10555480,602955480,False,21
5675,validator_1,699889307520,True,471000000,1742070,472742070,False,21
5676,validator_0,803975183111,True,439040001,26905490,465945491,True,25
5677,validator_18,91638764479,True,582780002,5693820,588473822,True,2
5678,validator_3,390291773800,True,511800000,2696120,514496120,False,12
5679,validator_0,804707557631,True,730400000,1974520,732374520,True,25
5680,validator_4,254988317726,True,555886003,31344460,587230463,True,7
5681,validator_33,74664096650,True,613900000,2055070,615955070,False,2
5682,validator_1,700331464740,True,441000000,1157220,442157220,False,21
5683,validator_2,502740139622,True,889993996,27048830,917042826,True,15
5684,validator_5,255559972330,True,874700000,1966130,876666130,False,7
5685,validator_2,503773016931,True,1019939999,12937310,1032877309,True,15
5686,validator_46,61759872110,True,620900000,22693570,643593570,False,1
5687,validator_2,504474093833,True,664790002,36286900,701076902,True,15
5688,validator_1,700813305540,True,473380000,8460800,481840800,False,21
5689,validator_17,77500048153,True,949059997,31897200,980957197,True,2
5690,validator_1,701343709200,True,528800000,1603660,530403660,False,21
5691,validator_1,701978664370,True,626100000,8855170,634955170,False,21
5692,validator_25,71685881423,True,813620002,10076000,823696002,True,2
5693,validator_5,256088026230,True,505900000,22153900,528053900,False,8
5694,validator_0,805260774451,True,532260000,20956820,553216820,True,25
5695,validator_0,805795339981,True,496460010,38105520,534565530,True,25
5696,validator_41,58460816220,True,752000000,3173400,755173400,False,1
5697,validator_0,806622815476,True,793453995,34021500,827475495,True,25
5698,validator_2,505021967333,True,527080000,20793500,547873500,True,15
5699,validator_2,505862554546,True,804439993,36147220,840587213,True,15
5700,validator_3,390929292360,True,629600000,7918560,637518560,False,12
5701,validator_4,255531170524,True,529659998,13192800,542852798,True,7
5702,validator_3,391441787900,True,509100000,3395540,512495540,False,12
5703,validator_3,392028803930,True,584200000,2816030,587016030,False,12
5704,validator_2,506612179351,True,719952005,29672800,749624805,True,15
5705,validator_34,65096873650,True,625800000,4049000,629849000,False,2
5706,validator_0,807329829761,True,675560005,31454280,707014285,True,25
5707,validator_0,808167135358,True,817939997,19365600,837305597,True,25
5708,validator_0,808919003624,True,720886006,30982260,751868266,True,25
5709,validator_38,62406400490,True,585500000,4862140,590362140,False,1
5710,validator_2,507116162381,True,493874000,10109030,503983030,True,15
5711,validator_34,65846742650,True,724900000,24969000,749869000,False,2
5712,validator_31,72996753820,True,566100000,1740670,567840670,False,2
5713,validator_6,177095844568,True,791639998,25895150,817535148,True,5
5714,validator_6,177957051293,True,815099995,46106730,861206725,True,5
5715,validator_5,256687290930,True,597100000,2164700,599264700,False,8
5716,validator_0,809571074323,True,640859999,11210700,652070699,True,25
5717,validator_23,90674778946,True,465239998,39356500,504596498,True,2
5718,validator_28,81988212553,True,802845992,11656400,814502392,True,2
5719,validator_11,69813482453,True,828200005,24757830,852957835,True,2
5720,validator_21,84479599193,True,472800002,6651530,479451532,True,2
5721,validator_10,87741462047,True,839320000,9381700,848701700,True,2
5722,validator_7,180363516700,True,470800000,18842700,489642700,False,5
5723,validator_4,256329320151,True,765960007,32189620,798149627,True,8
5724,validator_14,82681771501,True,812500002,25657780,838157782,True,2
5725,validator_9,70760322146,True,1072039999,27528220,1099568219,True,2
5726,validator_0,810497438822,True,864139999,62224500,926364499,True,25
5727,validator_1,702544968760,True,555200000,11104390,566304390,False,21
5728,validator_7,181094949620,True,708800000,22632920,731432920,False,5
5729,validator_31,73417291690,True,383700000,36837870,420537870,False,2
5730,validator_2,507977137340,True,859199999,1774960,860974959,True,15
5731,validator_34,66384524910,True,498900000,38882260,537782260,False,2
5732,validator_0,811104189523,True,605599991,1150710,606750701,True,25
5733,validator_0,811628494197,True,522500004,1804670,524304674,True,25
5734,validator_2,508663641980,True,679800000,6704640,686504640,True,15
5735,validator_1,703343543210,True,792300000,6274450,798574450,False,21
5736,validator_14,83610971575,True,920399994,8800080,929200074,True,2
5737,validator_4,256901241852,True,569700001,2221700,571921701,True,8
5738,validator_3,392588144030,True,553100000,6240100,559340100,False,12
5739,validator_0,812097691618,True,457768001,11429420,469197421,True,25
5740,validator_47,61322481310,True,622000000,8018460,630018460,False,1
5741,validator_2,509259629908,True,558513998,37473930,595987928,True,15
5742,validator_30,64000740580,True,496600000,1769980,498369980,False,2
5743,validator_0,812793103622,True,650880004,44532000,695412004,True,25
5744,validator_1,703884766610,True,527700000,13523400,541223400,False,21
5745,validator_11,70415066652,True,590539999,11044200,601584199,True,2
5746,validator_2,510043793046,True,781299998,2863140,784163138,True,15
5747,validator_0,813575246217,True,727999995,54142600,782142595,True,25
5748,validator_1,704619046820,True,729800000,4480210,734280210,False,22
5749,validator_6,178743055591,True,769829998,16174300,786004298,True,5
5750,validator_21,85131659397,True,623676004,28384200,652060204,True,2
5751,validator_3,393079727840,True,489400000,2183810,491583810,False,12
5752,validator_9,71380129290,True,593256004,26551140,619807144,True,2
5753,validator_3,393609839860,True,510700000,19412020,530112020,False,12
5754,validator_0,814259160414,True,642839997,41074200,683914197,True,25
5755,validator_22,94493413919,True,614000000,1821180,615821180,True,2
5756,validator_4,257448861564,True,533499992,14119720,547619712,True,8
5757,validator_0,815154399320,True,881940006,13298900,895238906,True,25
5758,validator_2,510986549149,True,932500003,10256100,942756103,True,15
5759,validator_45,73860628950,True,556400000,19430350,575830350,False,2
5760,validator_2,511745358554,True,748960005,9849400,758809405,True,15
5761,validator_0,815952377250,True,769420000,28557930,797977930,True,25
5762,validator_3,394209908850,True,593100000,6968990,600068990,False,12
5763,validator_1,705277670490,True,656000000,2623670,658623670,False,22
5764,validator_17,78283637422,True,759199999,24389270,783589269,True,2
5765,validator_27,70689973224,True,555500004,28470240,583970244,True,2
5766,validator_34,66813792010,True,418600000,10667100,429267100,False,2
5767,validator_9,71761291095,True,379700005,1461800,381161805,True,2
5768,validator_5,257318203460,True,607900000,23012530,630912530,False,8
5769,validator_2,512397521251,True,648799997,3362700,652162697,True,16
5770,validator_7,181764007420,True,649400000,19657800,669057800,False,5
5771,validator_4,258171267485,True,702820001,19585920,722405921,True,8
5772,validator_1,706105023750,True,824700000,2653260,827353260,False,22
5773,validator_2,513245814650,True,828063999,20229400,848293399,True,16
5774,validator_2,514282425844,True,999473994,37137200,1036611194,True,16
5775,validator_1,706630014370,True,521600000,3390620,524990620,False,22
5776,validator_28,82594876491,True,573559998,33103940,606663938,True,2
5777,validator_18,92371533213,True,729999994,2768740,732768734,True,2
5778,validator_1,707322213200,True,681700000,10498830,692198830,False,22
5779,validator_2,514960581450,True,630460006,47695600,678155606,True,16
5780,validator_1,707761521800,True,431800000,7508600,439308600,False,22
5781,validator_20,79415361789,True,735799993,10958120,746758113,True,2
5782,validator_45,74497225200,True,597900000,38696250,636596250,False,2
5783,validator_7,182311210850,True,543900000,3303430,547203430,False,5
5784,validator_1,708452691820,True,687500000,3670020,691170020,False,22
5785,validator_24,79469176707,True,785820003,19129040,804949043,True,2
5786,validator_5,258020675190,True,700900000,1571730,702471730,False,8
5787,validator_12,67472642423,True,872300008,4506940,876806948,True,2
5788,validator_6,179549623773,True,773094002,33474180,806568182,True,5
5789,validator_19,78295418466,True,881580002,38832960,920412962,True,2
5790,validator_3,394839851350,True,627400000,2542500,629942500,False,12
5791,validator_2,515698989155,True,717680005,20727700,738407705,True,16
5792,validator_1,709506645970,True,1051500000,2454150,1053954150,False,22
5793,validator_0,816412117396,True,457899996,1840150,459740146,True,25
5794,validator_0,817293328091,True,793837995,87372700,881210695,True,25
5795,validator_3,395254075550,True,411500000,2724200,414224200,False,12
5796,validator_27,71384041744,True,692200000,1868520,694068520,True,2
5797,validator_3,395746727150,True,476500000,16151600,492651600,False,12
5798,validator_0,817797518750,True,444319999,59870660,504190659,True,25
5799,validator_4,258864730213,True,682099998,11362730,693462728,True,8
5800,validator_23,91361522747,True,684600001,2143800,686743801,True,2
5801,validator_13,59165001241,True,757468003,32412520,789880523,True,1
5802,validator_39,58407220680,True,734500000,4585970,739085970,False,1
5803,validator_1,710210373290,True,700900000,2827320,703727320,False,22
5804,validator_0,818484067079,True,678819999,7728330,686548329,True,25
5805,validator_12,68260278798,True,780069995,7566380,787636375,True,2
5806,validator_45,75087672900,True,579600000,10847700,590447700,False,2
5807,validator_42,68933793190,True,794900000,33115260,828015260,False,2
5808,validator_0,819300987275,True,785759996,31160200,816920196,True,25
5809,validator_0,819841900162,True,497297997,43614890,540912887,True,25
5810,validator_33,75205011350,True,531200000,9714700,540914700,False,2
5811,validator_3,396178793990,True,429500000,2566840,432066840,False,12
5812,validator_20,80616424517,True,1179980008,21082720,1201062728,True,2
5813,validator_39,59016414580,True,589600000,19593900,609193900,False,1
5814,validator_49,59506528720,True,557500000,6495500,563995500,False,1
5815,validator_1,710806867880,True,585700000,10794590,596494590,False,22
5816,validator_14,84368634031,True,733879996,23782460,757662456,True,2
5817,validator_2,516606128921,True,890600006,16539760,907139766,True,16
5818,validator_27,72201554949,True,797200005,20313200,817513205,True,2
5819,validator_19,78894167100,True,565080004,33668630,598748634,True,2
5820,validator_2,517485561137,True,842899996,36532220,879432216,True,16
5821,validator_2,518008730347,True,517264010,5905200,523169210,True,16
5822,validator_27,72933410784,True,702579995,29275840,731855835,True,2
5823,validator_5,258491705800,True,442200000,28830610,471030610,False,8
5824,validator_10,88314620168,True,536480001,36678120,573158121,True,2
5825,validator_35,78642279890,True,759600000,2724100,762324100,False,2
5826,validator_1,711438327520,True,624200000,7259640,631459640,False,22
5827,validator_9,72499450997,True,717500002,20659900,738159902,True,2
5828,validator_10,88925065972,True,608900004,1545800,610445804,True,2
5829,validator_33,75791669390,True,584500000,2158040,586658040,False,2
5830,validator_0,820678525990,True,806635998,29989830,836625828,True,25
5831,validator_2,518731288749,True,672700002,49858400,722558402,True,16
5832,validator_0,821710467536,True,1023500006,8441540,1031941546,True,25
5833,validator_21,85797722729,True,640320002,25743330,666063332,True,2
5834,validator_2,519389695631,True,634400002,24006880,658406882,True,16
5835,validator_3,396783235050,True,601400000,3041060,604441060,False,12
5836,validator_0,822306363181,True,570860005,25035640,595895645,True,25
5837,validator_48,77985133810,True,526800000,19458040,546258040,False,2
5838,validator_26,78256758355,True,455661993,90450300,546112293,True,2
5839,validator_0,822743213490,True,430169999,6680310,436850309,True,25
5840,validator_1,712021200910,True,579600000,3273390,582873390,False,22
5841,validator_0,823622776904,True,860279994,19283420,879563414,True,25
5842,validator_19,79670281126,True,759877996,16236030,776114026,True,2
5843,validator_40,60364140280,True,584400000,21592620,605992620,False,1
5844,validator_2,520050793352,True,630260001,30837720,661097721,True,16
5845,validator_1,712717049760,True,693000000,2848850,695848850,False,22
5846,validator_1,713129765600,True,411300000,1415840,412715840,False,22
5847,validator_0,824346099806,True,707600002,15722900,723322902,True,25
5848,validator_3,397311042150,True,507100000,20707100,527807100,False,12
5849,validator_10,89515778977,True,570696005,20017000,590713005,True,2
5850,validator_6,180049239780,True,489420007,10196000,499616007,True,5
5851,validator_7,182951013460,True,613300000,26502610,639802610,False,5
5852,validator_14,85142164408,True,729865997,43664380,773530377,True,2
5853,validator_0,825239752001,True,868953995,24698200,893652195,True,25
5854,validator_21,86332878795,True,507179996,27976070,535156066,True,2
5855,validator_44,62385122190,True,705000000,3404000,708404000,False,1
5856,validator_6,180660470183,True,587874003,23356400,611230403,True,5
5857,validator_8,79602645392,True,864086006,31735130,895821136,True,2
5858,validator_1,713705515870,True,554200000,21550270,575750270,False,22
5859,validator_0,825793550695,True,527984004,25814690,553798694,True,25
5860,validator_5,258974658950,True,462900000,20053150,482953150,False,8
5861,validator_5,259539683760,True,556000000,9024810,565024810,False,8
5862,validator_4,259357044808,True,478569995,13744600,492314595,True,8
5863,validator_33,76379898790,True,585500000,2729400,588229400,False,2
5864,validator_5,260107265300,True,562800000,4781540,567581540,False,8
5865,validator_19,80434184451,True,720239995,43663330,763903325,True,2
5866,validator_2,520735558448,True,666279996,18485100,684765096,True,16
5867,validator_1,714430570660,True,714600000,10454790,725054790,False,22
5868,validator_1,715099600960,True,655900000,13130300,669030300,False,22
5869,validator_11,70977155294,True,541640002,20448640,562088642,True,2
5870,validator_7,183573493060,True,614470000,8009600,622479600,False,5
5871,validator_0,826786933712,True,990139997,3243020,993383017,True,25
5872,validator_3,398115634730,True,800900000,3692580,804592580,False,12
5873,validator_34,67369180340,True,529700000,25688330,555388330,False,2
5874,validator_2,521883888037,True,1135319999,13009590,1148329589,True,16
5875,validator_12,68842103142,True,578699994,3124350,581824344,True,2
5876,validator_5,260449434070,True,341200000,968770,342168770,False,8
5877,validator_24,79925456900,True,454900003,1380190,456280193,True,2
5878,validator_1,715754326740,True,635200000,19525780,654725780,False,22
5879,validator_20,81260306198,True,642120001,1761680,643881681,True,2
5880,validator_36,63098485600,True,509900000,10967940,520867940,False,1
5881,validator_45,75779001920,True,685400000,5929020,691329020,False,2
5882,validator_14,85840711499,True,686467991,12079100,698547091,True,2
5883,validator_2,522455372427,True,558660000,12824390,571484390,True,16
5884,validator_1,716460118440,True,695300000,10491700,705791700,False,22
5885,validator_17,78770958388,True,484899996,2420970,487320966,True,2
5886,validator_22,95162288669,True,665500010,3374740,668874750,True,2
5887,validator_30,64668477760,True,654000000,13737180,667737180,False,2
5888,validator_35,79276782330,True,632100000,2402440,634502440,False,2
5889,validator_3,398783127730,True,661000000,6493000,667493000,False,12
5890,validator_1,716970353470,True,504400000,5835030,510235030,False,22
5891,validator_2,523111092931,True,617120004,38600500,655720504,True,16
5892,validator_4,259920828728,True,547080000,16703920,563783920,True,8
5893,validator_1,717409118150,True,425100000,13664680,438764680,False,22
5894,validator_26,79071258265,True,803820010,10679900,814499910,True,2
5895,validator_1,717940678970,True,529200000,2360820,531560820,False,22
5896,validator_6,181454510406,True,754910003,39130220,794040223,True,5
5897,validator_3,399464026330,True,678300000,2598600,680898600,False,12
5898,validator_1,718434041100,True,490200000,3162130,493362130,False,22
5899,validator_14,86686277304,True,839100005,6465800,845565805,True,2
5900,validator_24,80845795537,True,906660007,13678630,920338637,True,2
5901,validator_6,182447170262,True,982100006,10559850,992659856,True,5
5902,validator_1,718961657040,True,525400000,2215940,527615940,False,22
5903,validator_2,523873526557,True,734939996,27493630,762433626,True,16
5904,validator_10,90116573479,True,577000002,23794500,600794502,True,2
5905,validator_0,827402835614,True,605800002,10101900,615901902,True,25
5906,validator_6,183014016259,True,553557997,13288000,566845997,True,5
5907,validator_22,95853686981,True,681019992,10378320,691398312,True,2
5908,validator_26,79655584643,True,577799998,6526380,584326378,True,2
5909,validator_1,719413216040,True,447000000,4559000,451559000,False,22
5910,validator_2,524525658334,True,619215997,32915780,652131777,True,16
5911,validator_18,92965757965,True,583539992,10684760,594224752,True,2
5912,validator_1,719982433850,True,564200000,5017810,569217810,False,22
5913,validator_3,400415503860,True,949200000,2277530,951477530,False,12
5914,validator_0,828102325616,True,694220002,5270000,699490002,True,25
5915,validator_15,91555330502,True,481500002,9320930,490820932,True,2
5916,validator_5,261078125650,True,622900000,5791580,628691580,False,8
5917,validator_9,73459519975,True,951399998,8668980,960068978,True,2
5918,validator_1,720533840630,True,549800000,1606780,551406780,False,22
5919,validator_2,525449820211,True,893773997,30387880,924161877,True,16
5920,validator_1,721193730070,True,639800000,20089440,659889440,False,22
5921,validator_0,828822504553,True,715299997,4878940,720178937,True,25
5922,validator_7,184196502490,True,616800000,6209430,623009430,False,5
5923,validator_2,526013075931,True,537040000,26215720,563255720,True,16
5924,validator_0,829528760944,True,691700001,14556390,706256391,True,25
5925,validator_2,526593416767,True,574799996,5540840,580340836,True,16
5926,validator_19,81196270086,True,717140005,44945630,762085635,True,2
5927,validator_20,82118655730,True,808640002,49709530,858349532,True,2
5928,validator_6,183625236407,True,602939998,8280150,611220148,True,5
5929,validator_5,261762266850,True,682800000,1341200,684141200,False,8
5930,validator_5,262365341850,True,592800000,10275000,603075000,False,8
5931,validator_2,527369353864,True,765219997,10717100,775937097,True,16
5932,validator_0,829987506845,True,447750001,10995900,458745901,True,25
5933,validator_48,78391428770,True,402870000,3424960,406294960,False,2
5934,validator_3,401058403610,True,639300000,3599750,642899750,False,12
5935,validator_42,69407311660,True,464900000,8618470,473518470,False,2
5936,validator_7,185046045560,True,847900000,1643070,849543070,False,5
5937,validator_14,87473903334,True,778800000,8826030,787626030,True,2
5938,validator_1,721917596400,True,721300000,2566330,723866330,False,22
5939,validator_7,185600768800,True,551700000,3023240,554723240,False,5
5940,validator_6,184227644953,True,574640006,27768540,602408546,True,5
5941,validator_44,62951146720,True,564200000,1824530,566024530,False,1
5942,validator_1,722447673000,True,507500000,22576600,530076600,False,22
5943,validator_1,722938219130,True,489300000,1246130,490546130,False,22
5944,validator_23,92120644135,True,756399998,2721390,759121388,True,2
5945,validator_47,61913799110,True,585100000,6217800,591317800,False,1
5946,validator_33,76989422490,True,607400000,2123700,609523700,False,2
5947,validator_3,401674756350,True,608900000,7452740,616352740,False,12
5948,validator_25,72502726559,True,812799996,4045140,816845136,True,2
5949,validator_25,73392297282,True,859120003,30450720,889570723,True,2
5950,validator_45,76470604960,True,682500000,9103040,691603040,False,2
5951,validator_5,263050617130,True,678000000,7275280,685275280,False,8
5952,validator_2,527865550503,True,460920009,35276630,496196639,True,16
5953,validator_7,186121534140,True,518100000,2665340,520765340,False,5
5954,validator_5,263610848170,True,550800000,9431040,560231040,False,8
5955,validator_32,64566730720,True,701500000,2930570,704430570,False,2
5956,validator_7,186781712740,True,654300000,5878600,660178600,False,5
5957,validator_0,830619914344,True,605345999,27061500,632407499,True,25
5958,validator_4,260480688922,True,556320004,3540190,559860194,True,8
5959,validator_3,402334882880,True,658000000,2126530,660126530,False,12
5960,validator_4,261253291849,True,718879997,53722930,772602927,True,8
5961,validator_28,83226842461,True,614340000,17625970,631965970,True,2
5962,validator_1,723669405650,True,730300000,886520,731186520,False,22
5963,validator_23,92925352103,True,782739998,21967970,804707968,True,2
5964,validator_0,831322981761,True,683740007,19327410,703067417,True,25
5965,validator_31,74109442320,True,689300000,2850630,692150630,False,2
5966,validator_10,90843453903,True,688760004,38120420,726880424,True,2
5967,validator_2,528456236417,True,559400004,31285910,590685914,True,16
5968,validator_15,92320238886,True,743640004,21268380,764908384,True,2
5969,validator_22,96449173570,True,574273999,21212590,595486589,True,3
5970,validator_26,80426282129,True,715499996,55197490,770697486,True,2
5971,validator_3,403166845820,True,812300000,19662940,831962940,False,12
5972,validator_30,65206727290,True,514800000,23449530,538249530,False,2
5973,validator_33,77314826610,True,317980000,7424120,325404120,False,2
5974,validator_20,83151963132,True,1021900002,11407400,1033307402,True,2
5975,validator_12,69568355671,True,701379999,24872530,726252529,True,2
5976,validator_10,91817150002,True,969099999,4596100,973696099,True,2
5977,validator_1,724236470850,True,563300000,3765200,567065200,False,22
5978,validator_4,262032468346,True,769099997,10076500,779176497,True,8
5979,validator_0,832096343590,True,763100009,10261820,773361829,True,26
5980,validator_4,262902566174,True,861399998,8697830,870097828,True,8
5981,validator_1,724692314630,True,453200000,2643780,455843780,False,22
5982,validator_0,833079709783,True,960359993,23006200,983366193,True,26
5983,validator_16,63931289787,True,869660000,24154000,893814000,True,1
5984,validator_42,70031381660,True,622000000,2070000,624070000,False,2
5985,validator_22,97157348100,True,704700000,3474530,708174530,True,3
5986,validator_3,403742725120,True,573000000,2879300,575879300,False,12
5987,validator_47,62711337270,True,795500000,2038160,797538160,False,1
5988,validator_2,529103982232,True,645599995,2145820,647745815,True,16
5989,validator_44,63709701650,True,756500000,2054930,758554930,False,1
5990,validator_2,530190475371,True,1085099999,1393140,1086493139,True,16
5991,validator_34,67887650390,True,517200000,1270050,518470050,False,2
5992,validator_3,404563744290,True,797200000,23819170,821019170,False,12
5993,validator_0,833708378243,True,609740000,18928460,628668460,True,26
5994,validator_10,92396036305,True,555246003,23640300,578886303,True,2
5995,validator_0,834345637739,True,631599996,5659500,637259496,True,26
5996,validator_0,834827503941,True,453280002,28586200,481866202,True,26
5997,validator_4,263679001067,True,756539993,19894900,776434893,True,8
5998,validator_19,81820281487,True,603520001,20491400,624011401,True,2
5999,validator_15,93097513056,True,753400000,23874170,777274170,True,2
6000,validator_42,70681091500,True,648800000,909840,649709840,False,2
6001,validator_4,264282220258,True,573660001,29559190,603219191,True,8
6002,validator_7,187499753040,True,697900000,20140300,718040300,False,5
6003,validator_40,60967426260,True,600100000,3185980,603285980,False,1
6004,validator_7,188252179120,True,743400000,9026080,752426080,False,5
6005,validator_2,530896776371,True,705500010,800990,706301000,True,16
6006,validator_1,725358278070,True,658100000,7863440,665963440,False,22
6007,validator_21,87171655208,True,815460003,23316410,838776413,True,2
6008,validator_3,405264489850,True,697500000,3245560,700745560,False,12
6009,validator_0,835748062015,True,871180004,49378070,920558074,True,26
6010,validator_0,836388962220,True,631340005,9560200,640900205,True,26
6011,validator_7,188756880540,True,483800000,20901420,504701420,False,5
6012,validator_1,725954154730,True,577600000,18276660,595876660,False,22
6013,validator_16,64702943495,True,761100008,10553700,771653708,True,2
6014,validator_15,93913245889,True,794374003,21358830,815732833,True,2
6015,validator_4,265067837168,True,732945990,52670920,785616910,True,8
6016,validator_0,837058546518,True,662399998,7184300,669584298,True,26
6017,validator_5,264321041500,True,701800000,8393330,710193330,False,8
6018,validator_32,65148561960,True,557300000,24531240,581831240,False,2
6019,validator_3,405860497890,True,576300000,19708040,596008040,False,12
6020,validator_30,65834247020,True,616100000,11419730,627519730,False,2
6021,validator_6,184856193920,True,623219997,5328970,628548967,True,5
6022,validator_13,59929792078,True,749896007,14894830,764790837,True,1
6023,validator_0,838074729812,True,996547994,19635300,1016183294,True,26
6024,validator_1,726548431460,True,573700000,20576730,594276730,False,22
6025,validator_19,82421656772,True,564660005,36715280,601375285,True,2
6026,validator_2,531417183001,True,513120000,7286630,520406630,True,16
6027,validator_2,531941479532,True,499640001,24656530,524296531,True,16
6028,validator_5,265045885900,True,706100000,18744400,724844400,False,8
6029,validator_2,532615628338,True,631023996,43124810,674148806,True,16
6030,validator_22,97829029899,True,647319999,24361800,671681799,True,3
6031,validator_35,79840599720,True,557400000,6417390,563817390,False,2
6032,validator_0,838702390238,True,625900006,1760420,627660426,True,26
6033,validator_5,265604773290,True,555200000,3687390,558887390,False,8
6034,validator_1,727142366110,True,589800000,4134650,593934650,False,22
6035,validator_27,73697207701,True,760300007,3496910,763796917,True,2
6036,validator_6,185705061230,True,829799990,19067320,848867310,True,5
6037,validator_0,839408800360,True,673919992,32490130,706410122,True,26
6038,validator_0,840112356989,True,699099999,4456630,703556629,True,26
6039,validator_2,533288588688,True,659340000,13620350,672960350,True,16
6040,validator_42,71314595280,True,631300000,2203780,633503780,False,2
6041,validator_18,93624303932,True,636240007,22305960,658545967,True,2
6042,validator_3,406546672150,True,684300000,1874260,686174260,False,12
6043,validator_33,78040433970,True,724300000,1307360,725607360,False,2
6044,validator_1,727892245420,True,711200000,38679310,749879310,False,22
6045,validator_25,74127484681,True,714799999,20387400,735187399,True,2
6046,validator_41,59111577180,True,648000000,2760960,650760960,False,1
6047,validator_2,534026772187,True,710883999,27299500,738183499,True,16
6048,validator_0,840969446993,True,854200004,2890000,857090004,True,26
6049,validator_38,63220476290,True,812400000,1675800,814075800,False,1
6050,validator_6,186404465161,True,692519991,6883940,699403931,True,5
6051,validator_1,728590232490,True,665100000,32887070,697987070,False,22
6052,validator_1,729167407230,True,567000000,10174740,577174740,False,22
6053,validator_0,841706354692,True,729419999,7487700,736907699,True,26
6054,validator_1,729731956250,True,563000000,1549020,564549020,False,22
6055,validator_0,842247972713,True,539100001,2518020,541618021,True,26
6056,validator_6,187235221168,True,792160007,38596000,830756007,True,5
6057,validator_12,70182062192,True,595246001,18460520,613706521,True,2
6058,validator_19,83172946876,True,741520004,9770100,751290104,True,2
6059,validator_1,730393208290,True,641800000,19452040,661252040,False,22
6060,validator_27,74414169778,True,689379997,27582080,716962077,True,2
6061,validator_0,842906554730,True,620399997,38182020,658582017,True,26
6062,validator_46,62497729110,True,730400000,7457000,737857000,False,1
6063,validator_3,407029607150,True,471900000,11035000,482935000,False,12
6064,validator_24,81795340035,True,930199998,19344500,949544498,True,2
6065,validator_35,80478562690,True,631100000,6862970,637962970,False,2
6066,validator_3,407598821090,True,566500000,2713940,569213940,False,12
6067,validator_20,83891808629,True,720063997,19781500,739845497,True,2
6068,validator_0,843512119029,True,575019999,30544300,605564299,True,26
6069,validator_6,188130567107,True,879946009,15399930,895345939,True,5
6070,validator_12,70838644392,True,628034000,28548200,656582200,True,2
6071,validator_45,77051956160,True,579400000,1951200,581351200,False,2
6072,validator_6,188786079144,True,635359997,20152040,655512037,True,5
6073,validator_0,844064348387,True,542220008,10009350,552229358,True,26
6074,validator_0,844740617047,True,592106000,84162660,676268660,True,26
6075,validator_1,731004450610,True,592300000,18942320,611242320,False,22
6076,validator_21,87915490042,True,724100004,19734830,743834834,True,2
6077,validator_0,845278379969,True,519480002,18282920,537762922,True,26
6078,validator_2,534773395259,True,705780002,40843070,746623072,True,16
6079,validator_35,81254855370,True,771400000,4892680,776292680,False,2
6080,validator_0,845838582554,True,513300005,46902580,560202585,True,26
6081,validator_6,189625993325,True,824340001,15574180,839914181,True,5
6082,validator_3,408259778720,True,658400000,2557630,660957630,False,12
6083,validator_8,80174931003,True,551240011,21045600,572285611,True,2
6084,validator_3,408799110810,True,529400000,9932090,539332090,False,12
6085,validator_31,74816143980,True,703800000,2901660,706701660,False,2
6086,validator_1,731581748940,True,573600000,3698330,577298330,False,22
6087,validator_1,732071205280,True,488500000,956340,489456340,False,22
6088,validator_2,535603258161,True,808060002,21802900,829862902,True,16
6089,validator_37,61414362770,True,403500000,2575890,406075890,False,1
6090,validator_32,65679842820,True,527900000,3380860,531280860,False,2
6091,validator_4,265558966404,True,469079996,22049240,491129236,True,8
6092,validator_0,846645378154,True,799610000,7185600,806795600,True,26
6093,validator_3,409321108620,True,515900000,6097810,521997810,False,12
6094,validator_5,266198405220,True,588400000,5231930,593631930,False,8
6095,validator_20,84529470227,True,606299998,31361600,637661598,True,2
6096,validator_4,266167396376,True,585000002,23429970,608429972,True,8
6097,validator_2,536334249402,True,717900011,13091230,730991241,True,16
6098,validator_5,266982282980,True,744600000,39277760,783877760,False,8
6099,validator_3,409863550950,True,535200000,7242330,542442330,False,12
6100,validator_3,410520383480,True,653700000,3132530,656832530,False,12
6101,validator_17,79327117305,True,518687997,37470920,556158917,True,2
6102,validator_44,64472768340,True,754100000,8966690,763066690,False,2
6103,validator_4,266775527904,True,545027998,63103530,608131528,True,8
6104,validator_5,267642861720,True,657200000,3378740,660578740,False,8
6105,validator_0,847271305746,True,604940002,20987590,625927592,True,26
6106,validator_1,732737068820,True,657800000,8063540,665863540,False,22
6107,validator_4,267484524991,True,695399997,13597090,708997087,True,8
6108,validator_5,268093474420,True,449100000,1512700,450612700,False,8
6109,validator_0,847901698444,True,600259998,30132700,630392698,True,26
6110,validator_8,80862376382,True,680799999,6645380,687445379,True,2
6111,validator_32,66287867180,True,600600000,7424360,608024360,False,2
6112,validator_24,82793971429,True,986600004,12031390,998631394,True,2
6113,validator_1,733283310680,True,525300000,20941860,546241860,False,22
6114,validator_27,75204974891,True,761540003,29265110,790805113,True,2
6115,validator_2,536982619144,True,624420012,23949730,648369742,True,16
6116,validator_0,848886443888,True,938139994,46605450,984745444,True,26
6117,validator_0,849699533320,True,810199992,2889440,813089432,True,26
6118,validator_4,268344364994,True,792258003,67582000,859840003,True,8
6119,validator_22,98517414853,True,651939994,36444960,688384954,True,3
6120,validator_3,411008134080,True,477500000,10250600,487750600,False,12
6121,validator_20,85287651225,True,734239998,23941000,758180998,True,2
6122,validator_36,63644797950,True,543600000,2712350,546312350,False,1
6123,validator_1,733914244600,True,608400000,22533920,630933920,False,22
6124,validator_0,850286250921,True,558260001,28457600,586717601,True,26
6125,validator_0,850882288617,True,581965996,14071700,596037696,True,26
6126,validator_6,190401598727,True,732680002,42925400,775605402,True,5
6127,validator_0,851583696713,True,698999996,2408100,701408096,True,26
6128,validator_22,99330772614,True,793400001,19957760,813357761,True,3
6129,validator_43,61832257200,True,689200000,21181700,710381700,False,1
6130,validator_37,62068333910,True,647900000,6071140,653971140,False,1
6131,validator_1,734493004390,True,558000000,20759790,578759790,False,22
6132,validator_11,71827419722,True,835115988,15148440,850264428,True,2
6133,validator_5,268678488130,True,563600000,21413710,585013710,False,8
6134,validator_0,852239595320,True,635800007,20098600,655898607,True,26
6135,validator_17,80057836964,True,683115999,47603660,730719659,True,2
6136,validator_21,88761704845,True,841900003,4314800,846214803,True,2
6137,validator_37,62554665240,True,476100000,10231330,486331330,False,1
6138,validator_22,100194605842,True,860639998,3193230,863833228,True,3
6139,validator_7,189359223940,True,585500000,16843400,602343400,False,5
6140,validator_2,537600787360,True,583137996,35030220,618168216,True,16
6141,validator_1,735208025470,True,712000000,3021080,715021080,False,22
6142,validator_39,59645752580,True,620600000,8738000,629338000,False,1
6143,validator_7,190182534340,True,820500000,2810400,823310400,False,5
6144,validator_0,852918363922,True,634060002,44708600,678768602,True,26
6145,validator_22,100958513933,True,718940001,44968090,763908091,True,3
6146,validator_2,538231492162,True,589860002,40844800,630704802,True,16
6147,validator_0,853911232822,True,981420000,11448900,992868900,True,26
6148,validator_0,854732641021,True,817399999,4008200,821408199,True,26
6149,validator_3,411730856670,True,721600000,1122590,722722590,False,12
6150,validator_33,78675060870,True,624600000,10026900,634626900,False,2
6151,validator_1,735722793300,True,512000000,2767830,514767830,False,22
6152,validator_3,412453063120,True,720300000,1906450,722206450,False,12
6153,validator_9,74286025677,True,779850002,46655700,826505702,True,2
6154,validator_17,80988769578,True,887399994,43532620,930932614,True,2
6155,validator_28,83824706677,True,596099996,1764220,597864216,True,2
6156,validator_2,538879223464,True,640500002,7231300,647731302,True,16
6157,validator_0,855475196106,True,739099995,3455090,742555085,True,26
6158,validator_25,74831999327,True,679819996,24694650,704514646,True,2
6159,validator_0,856290793228,True,786754002,28843120,815597122,True,26
6160,validator_0,856949064520,True,656599992,1671300,658271292,True,26
6161,validator_44,65052036750,True,576700000,2568410,579268410,False,2
6162,validator_6,190891334141,True,470499994,19235420,489735414,True,5
6163,validator_2,539649800492,True,767699998,2877030,770577028,True,16
6164,validator_2,540173871094,True,500720002,23350600,524070602,True,16
6165,validator_42,72050557060,True,728100000,7861780,735961780,False,2
6166,validator_2,540844128312,True,662039998,8217220,670257218,True,16
6167,validator_2,541473152820,True,591873998,37150510,629024508,True,16
6168,validator_33,79226644070,True,531400000,20183200,551583200,False,2
6169,validator_48,78869097760,True,469700000,7968990,477668990,False,2
6170,validator_46,62990069090,True,490400000,1939980,492339980,False,1
6171,validator_42,72822913450,True,750200000,22156390,772356390,False,2
6172,validator_0,857389509957,True,401980007,38465430,440445437,True,26
6173,validator_2,542132882922,True,624286002,35444100,659730102,True,16
6174,validator_27,76036363245,True,771760004,59628350,831388354,True,2
6175,validator_31,75325045120,True,506300000,2601140,508901140,False,2
6176,validator_3,412952618020,True,497900000,1654900,499554900,False,12
6177,validator_5,269182360430,True,502100000,1772300,503872300,False,8
6178,validator_15,94511955596,True,561540007,37169700,598709707,True,2
6179,validator_6,191570463982,True,659740011,19389830,679129841,True,5
6180,validator_2,542810857715,True,667060003,10914790,677974793,True,16
6181,validator_5,269731047920,True,546000000,2687490,548687490,False,8
6182,validator_45,77813888950,True,734300000,27632790,761932790,False,2
6183,validator_16,65586315409,True,880400004,2971910,883371914,True,2
6184,validator_48,79584374270,True,696000000,19276510,715276510,False,2
6185,validator_27,76882010144,True,819139999,26506900,845646899,True,2
6186,validator_43,62525460600,True,691000000,2203400,693203400,False,1
6187,validator_5,270266773780,True,534600000,1125860,535725860,False,8
6188,validator_47,63445304070,True,731200000,2766800,733966800,False,1
6189,validator_4,269113353453,True,747639999,21348460,768988459,True,8
6190,validator_5,270805029180,True,519200000,19055400,538255400,False,8
6191,validator_21,89588956691,True,816600006,10651840,827251846,True,2
6192,validator_7,190853606300,True,668800000,2271960,671071960,False,5
6193,validator_0,858039265487,True,644300000,5455530,649755530,True,26
6194,validator_0,858502180199,True,460300002,2614710,462914712,True,26
6195,validator_24,83407010620,True,575600001,37439190,613039191,True,2
6196,validator_7,191495556460,True,636400000,5550160,641950160,False,5
6197,validator_17,81796432878,True,806000000,1663300,807663300,True,2
6198,validator_0,859560312384,True,1048400005,9732180,1058132185,True,26
6199,validator_5,271399440220,True,592500000,1911040,594411040,False,8
6200,validator_11,72528715448,True,648832006,52463720,701295726,True,2
6201,validator_1,736137066140,True,394900000,19372840,414272840,False,23
6202,validator_1,737047034540,True,888000000,21968400,909968400,False,23
6203,validator_45,78581567250,True,762200000,5478300,767678300,False,2
6204,validator_0,860311929116,True,720980002,30636730,751616732,True,26
6205,validator_10,93071947401,True,634080006,41831090,675911096,True,2
6206,validator_1,737637755850,True,588000000,2721310,590721310,False,23
6207,validator_0,861117296618,True,797700002,7667500,805367502,True,26
6208,validator_0,861811046075,True,628899997,64849460,693749457,True,26
6209,validator_5,272261540390,True,852800000,9300170,862100170,False,8
6210,validator_2,543553360746,True,734820001,7683030,742503031,True,16
6211,validator_46,63591396790,True,599570000,1757700,601327700,False,1
6212,validator_0,862340408255,True,526299990,3062190,529362180,True,26
6213,validator_3,413607488720,True,612900000,41970700,654870700,False,12
6214,validator_6,192435226891,True,862399999,2362910,864762909,True,6
6215,validator_24,84207161212,True,745719992,54430600,800150592,True,2
6216,validator_1,738143602750,True,504100000,1746900,505846900,False,23
6217,validator_21,90392905594,True,795680003,8268900,803948903,True,2
6218,validator_22,101660972029,True,692259996,10198100,702458096,True,3
6219,validator_0,863033423550,True,686699995,6315300,693015295,True,26
6220,validator_44,65552799450,True,497300000,3462700,500762700,False,2
6221,validator_1,738966141280,True,801300000,21238530,822538530,False,23
6222,validator_1,739580705420,True,613200000,1364140,614564140,False,23
6223,validator_0,863776153349,True,695119999,47609800,742729799,True,26
6224,validator_40,61604316700,True,626200000,10690440,636890440,False,1
6225,validator_6,193223480025,True,784439994,3813140,788253134,True,6
6226,validator_2,544332776347,True,757104001,22311600,779415601,True,17
6227,validator_1,740170511650,True,585400000,4406230,589806230,False,23
6228,validator_14,88143350835,True,665500001,3947500,669447501,True,2
6229,validator_33,79724419740,True,459100000,38675670,497775670,False,2
6230,validator_2,544821582336,True,471199999,17605990,488805989,True,17
6231,validator_38,63751403620,True,527100000,3827330,530927330,False,1
6232,validator_2,545511363671,True,668660005,21121330,689781335,True,17
6233,validator_6,193977992315,True,716280000,38232290,754512290,True,6
6234,validator_3,414182743950,True,564200000,11055230,575255230,False,12
6235,validator_41,59674142660,True,552000000,10565480,562565480,False,1
6236,validator_1,740789650970,True,600000000,19139320,619139320,False,23
6237,validator_5,272898010630,True,635900000,570240,636470240,False,8
6238,validator_22,102171251229,True,479818000,30461200,510279200,True,3
6239,validator_2,545859090792,True,316160001,31567120,347727121,True,17
6240,validator_27,77571245674,True,681500000,7735530,689235530,True,2
6241,validator_18,94373467135,True,747500003,1663200,749163203,True,2
6242,validator_0,864415362289,True,620094000,19114940,639208940,True,27
6243,validator_1,741484428990,True,691400000,3378020,694778020,False,23
6244,validator_11,73198986170,True,655460002,14810720,670270722,True,2
6245,validator_20,85859651311,True,556920006,15080080,572000086,True,2
6246,validator_1,742175453130,True,688600000,2424140,691024140,False,23
6247,validator_20,86442915345,True,574320004,8944030,583264034,True,2
6248,validator_2,546480941495,True,616420003,5430700,621850703,True,17
6249,validator_4,269810586320,True,679259997,17972870,697232867,True,8
6250,validator_5,273454834210,True,545100000,11723580,556823580,False,8
6251,validator_3,414752127140,True,566900000,2483190,569383190,False,12
6252,validator_33,80241108860,True,515200000,1489120,516689120,False,2
6253,validator_25,75508096029,True,642800002,33296700,676096702,True,2
6254,validator_0,865151080641,True,709714002,26004350,735718352,True,27
6255,validator_2,547169320536,True,682300001,6079040,688379041,True,17
6256,validator_5,274114787150,True,656300000,3652940,659952940,False,8
6257,validator_39,60170906400,True,523100000,2053820,525153820,False,1
6258,validator_6,194751570249,True,747540004,26037930,773577934,True,6
6259,validator_21,90983623693,True,568299999,22418100,590718099,True,2
6260,validator_3,415297192500,True,526600000,18465360,545065360,False,12
6261,validator_27,78382606257,True,741777993,69582590,811360583,True,2
6262,validator_2,547789813933,True,592920007,27573390,620493397,True,17
6263,validator_0,865781728344,True,608760003,21887700,630647703,True,27
6264,validator_2,548451231412,True,657499999,3917480,661417479,True,17
6265,validator_16,66388134694,True,779100005,22719280,801819285,True,2
6266,validator_1,742954031970,True,773600000,4978840,778578840,False,23
6267,validator_15,95372807857,True,842200001,18652260,860852261,True,2
6268,validator_22,102940682181,True,757639992,11790960,769430952,True,3
6269,validator_2,549009382378,True,551299996,6850970,558150966,True,17
6270,validator_0,866804796373,True,1021199999,1868030,1023068029,True,27
6271,validator_12,71577348035,True,709980003,28723640,738703643,True,2
6272,validator_14,88890519262,True,732199997,14968430,747168427,True,2
6273,validator_43,62985750280,True,459400000,889680,460289680,False,1
6274,validator_16,67013852664,True,614900000,10817970,625717970,True,2
6275,validator_4,270464171221,True,629436001,24148900,653584901,True,8
6276,validator_6,195415550744,True,658500005,5480490,663980495,True,6
6277,validator_23,93627995686,True,682440003,20203580,702643583,True,2
6278,validator_5,274796312150,True,680600000,925000,681525000,False,8
6279,validator_0,867887744206,True,1063560003,19387830,1082947833,True,27
6280,validator_0,868614275329,True,723200003,3331120,726531123,True,27
6281,validator_0,869461809773,True,836200004,11334440,847534444,True,27
6282,validator_48,80226282030,True,639300000,2607760,641907760,False,2
6283,validator_0,870133943856,True,651600003,20534080,672134083,True,27
6284,validator_2,549644033585,True,593660007,40991200,634651207,True,17
6285,validator_26,80958848098,True,531199999,1365970,532565969,True,2
6286,validator_35,81952277330,True,695300000,2121960,697421960,False,2
6287,validator_3,415877678800,True,577900000,2586300,580486300,False,12
6288,validator_44,66277020100,True,713300000,10920650,724220650,False,2
6289,validator_11,74109528069,True,898295999,12245900,910541899,True,2
6290,validator_0,870979164939,True,821200003,24021080,845221083,True,27
6291,validator_21,91597851483,True,604040000,10187790,614227790,True,2
6292,validator_21,92270419693,True,630928000,41640210,672568210,True,2
6293,validator_1,743497134170,True,539000000,4102200,543102200,False,23
6294,validator_30,66403335630,True,559500000,9588610,569088610,False,2
6295,validator_2,550257291987,True,591640002,21618400,613258402,True,17
6296,validator_37,62971759640,True,416400000,694400,417094400,False,1
6297,validator_0,871479876980,True,493700001,7012040,500712041,True,27
6298,validator_5,275434485450,True,636100000,2073300,638173300,False,8
6299,validator_13,60878542945,True,938199997,10550870,948750867,True,1
6300,validator_3,416383535300,True,502800000,3056500,505856500,False,13
6301,validator_7,192204805380,True,703700000,5548920,709248920,False,6
6302,validator_22,103566279260,True,622699999,2897080,625597079,True,3
6303,validator_11,74957877325,True,823800006,24549250,848349256,True,2
6304,validator_33,81044093390,True,777500000,25484530,802984530,False,2
6305,validator_0,872155099219,True,644319999,30902240,675222239,True,27
6306,validator_0,872823402124,True,661420005,6882900,668302905,True,27
6307,validator_17,82306396407,True,500299999,9663530,509963529,True,2
6308,validator_26,81942905140,True,974200002,9857040,984057042,True,2
6309,validator_0,873554839024,True,708160000,23276900,731436900,True,27
6310,validator_3,417179029440,True,784500000,10994140,795494140,False,13
6311,validator_25,76275823951,True,742620002,25107920,767727922,True,2
6312,validator_5,276189157830,True,745800000,8872380,754672380,False,8
6313,validator_40,62210548000,True,604500000,1731300,606231300,False,1
6314,validator_0,874148305725,True,575760001,17706700,593466701,True,27
6315,validator_8,81586216381,True,699879999,23960000,723839999,True,2
6316,validator_3,417768322740,True,586100000,3193300,589293300,False,13
6317,validator_33,81666508930,True,616400000,6015540,622415540,False,2
6318,validator_0,875045442140,True,876440005,20696410,897136415,True,27
6319,validator_1,743936002480,True,429000000,9868310,438868310,False,23
6320,validator_9,74937618865,True,604999998,46593190,651593188,True,2
6321,validator_2,550809832160,True,542000003,10540170,552540173,True,17
6322,validator_7,193010016380,True,780600000,24611000,805211000,False,6
6323,validator_34,68510461880,True,616000000,6811490,622811490,False,2
6324,validator_0,875602612123,True,554560003,2609980,557169983,True,27
6325,validator_0,876441437927,True,814979994,23845810,838825804,True,27
6326,validator_0,877156680863,True,712599996,2642940,715242936,True,27
6327,validator_9,75580254265,True,625640000,16995400,642635400,True,2
6328,validator_7,193643428360,True,605600000,27811980,633411980,False,6
6329,validator_21,93104378648,True,810339995,23618960,833958955,True,2
6330,validator_6,195965768082,True,537399998,12817340,550217338,True,6
6331,validator_0,878046890793,True,871440000,18769930,890209930,True,27
6332,validator_2,551343561485,True,515480005,18249320,533729325,True,17
6333,validator_6,196709989817,True,715739995,28481740,744221735,True,6
6334,validator_15,95977002453,True,593899996,10294600,604194596,True,2
6335,validator_17,82748609278,True,431400001,10812870,442212871,True,2
6336,validator_6,197449919016,True,712939999,26989200,739929199,True,6
6337,validator_26,82791699309,True,815259999,33534170,848794169,True,2
6338,validator_3,418325507200,True,552500000,4684460,557184460,False,13
6339,validator_7,194368394810,True,722300000,2666450,724966450,False,6
6340,validator_28,84497978073,True,624369996,48901400,673271396,True,2
6341,validator_7,195043556800,True,673900000,1261990,675161990,False,6
6342,validator_48,80959130180,True,724300000,8548150,732848150,False,2
6343,validator_4,271085341520,True,585567999,35602300,621170299,True,8
6344,validator_0,878979875092,True,917399999,15584300,932984299,True,27
6345,validator_7,195656201700,True,605000000,7644900,612644900,False,6
6346,validator_7,196310968760,True,648600000,6167060,654767060,False,6
6347,validator_0,879863125969,True,839399997,43850880,883250877,True,27
6348,validator_2,551922206452,True,566499997,12144970,578644967,True,17
6349,validator_0,880626580326,True,731459997,31994360,763454357,True,27
6350,validator_5,276919578940,True,727500000,2921110,730421110,False,8
6351,validator_5,277511284600,True,577500000,14205660,591705660,False,8
6352,validator_2,552461526047,True,537999995,1319600,539319595,True,17
6353,validator_2,553050401264,True,573689997,15185220,588875217,True,17
6354,validator_26,83439087548,True,644699999,2688240,647388239,True,2
6355,validator_26,84241292387,True,798999999,3204840,802204839,True,2
6356,validator_19,83802212178,True,606080002,23185300,629265302,True,2
6357,validator_13,61694860272,True,783579997,32737330,816317327,True,1
6358,validator_6,198183262417,True,704740001,28603400,733343401,True,6
6359,validator_1,744526018300,True,583600000,6415820,590015820,False,23
6360,validator_2,553944910067,True,886200003,8308800,894508803,True,17
6361,validator_1,745087324400,True,557400000,3906100,561306100,False,23
6362,validator_26,85180737589,True,929100002,10345200,939445202,True,2
6363,validator_1,745810007800,True,719600000,3083400,722683400,False,23
6364,validator_0,881388864025,True,716279999,46003700,762283699,True,27
6365,validator_5,277959301040,True,445700000,2316440,448016440,False,8
6366,validator_19,84378796806,True,549067998,27516630,576584628,True,2
6367,validator_3,419089286100,True,753700000,10078900,763778900,False,13
6368,validator_5,278577564260,True,602700000,15563220,618263220,False,8
6369,validator_8,82347810677,True,723439996,38154300,761594296,True,2
6370,validator_47,64120592700,True,673700000,1588630,675288630,False,2
6371,validator_34,69124103090,True,606300000,7341210,613641210,False,2
6372,validator_6,198910774247,True,725400000,2111830,727511830,True,6
6373,validator_6,199446909345,True,505317998,30817100,536135098,True,6
6374,validator_1,746388793330,True,577700000,1085530,578785530,False,23
6375,validator_26,85736460812,True,520660003,35063220,555723223,True,2
6376,validator_1,746856958150,True,466400000,1764820,468164820,False,23
6377,validator_32,66834903480,True,546000000,1036300,547036300,False,2
6378,validator_5,279141438960,True,561100000,2774700,563874700,False,8
6379,validator_19,84857912145,True,454319999,24795340,479115339,True,2
6380,validator_46,64154656450,True,561400000,1859660,563259660,False,2
6381,validator_8,83125427539,True,758819992,18796870,777616862,True,2
6382,validator_0,881978818321,True,575199996,14754300,589954296,True,27
6383,validator_48,81650434880,True,670300000,21004700,691304700,False,2
6384,validator_49,60015633480,True,507600000,1504760,509104760,False,1
6385,validator_5,279620518660,True,477000000,2079700,479079700,False,8
6386,validator_23,94268939955,True,637099999,3844270,640944269,True,2
6387,validator_0,882687609648,True,696919997,11871330,708791327,True,27
6388,validator_6,200125049599,True,653059994,25080260,678140254,True,6
6389,validator_6,200837504898,True,664953999,47501300,712455299,True,6
6390,validator_22,104145003327,True,534459997,44264070,578724067,True,3
6391,validator_14,89585959967,True,655840005,39600700,695440705,True,2
6392,validator_4,272061749888,True,923919998,52488370,976408368,True,8
6393,validator_0,883235821281,True,524880003,23331630,548211633,True,27
6394,validator_2,554665838313,True,697900006,23028240,720928246,True,17
6395,validator_31,75932092520,True,599100000,7947400,607047400,False,2
6396,validator_1,747472873790,True,614100000,1815640,615915640,False,23
6397,validator_44,66727176340,True,447210000,2946240,450156240,False,2
6398,validator_22,104893833027,True,735340000,13489700,748829700,True,3
6399,validator_15,96633173153,True,606762000,49408700,656170700,True,3
6400,validator_2,555308888351,True,631339998,11710040,643050038,True,17
6401,validator_3,419480644480,True,387140000,4218380,391358380,False,13
6402,validator_4,272637772883,True,566019995,10003000,576022995,True,8
6403,validator_45,79171122050,True,586600000,2954800,589554800,False,2
6404,validator_1,748066306500,True,587000000,6432710,593432710,False,23
6405,validator_1,748640917030,True,570900000,3710530,574610530,False,23
6406,validator_32,67314349100,True,476100000,3345620,479445620,False,2
6407,validator_42,73329874490,True,499850000,7111040,506961040,False,2
6408,validator_15,97402293661,True,750600008,18520500,769120508,True,3
6409,validator_34,69717397680,True,570100000,23194590,593294590,False,2
6410,validator_33,82258280570,True,584800000,6971640,591771640,False,2
6411,validator_0,884048371800,True,802559999,9990520,812550519,True,27
6412,validator_0,884573222901,True,506560001,18291100,524851101,True,27
6413,validator_22,105635408005,True,730199998,11374980,741574978,True,3
6414,validator_47,64726095100,True,602900000,2602400,605502400,False,2
6415,validator_10,93761006417,True,657959996,31099020,689059016,True,2
6416,validator_2,555954896400,True,620559999,25448050,646008049,True,17
6417,validator_3,420241479350,True,759200000,1634870,760834870,False,13
6418,validator_0,885581644269,True,986500008,21921360,1008421368,True,27
6419,validator_17,83376581584,True,626399996,1572310,627972306,True,2
6420,validator_11,75627154653,True,660399998,8877330,669277328,True,2
6421,validator_23,95060461051,True,772163996,19357100,791521096,True,2
6422,validator_3,420729854260,True,486300000,2074910,488374910,False,13
6423,validator_34,70357559910,True,638400000,1762230,640162230,False,2
6424,validator_33,82985309300,True,701000000,26028730,727028730,False,2
6425,validator_2,556603948693,True,628499993,20552300,649052293,True,17
6426,validator_27,79057244963,True,664800006,9838700,674638706,True,2
6427,validator_0,886322434404,True,738599995,2190140,740790135,True,27
6428,validator_4,273308747857,True,643219994,27754980,670974974,True,8
6429,validator_9,76116260666,True,532920001,3086400,536006401,True,2
6430,validator_18,95068781410,True,675500005,19814270,695314275,True,2
6431,validator_24,84910024533,True,700500001,2363320,702863321,True,2
6432,validator_0,887206331724,True,845940000,37957320,883897320,True,27
6433,validator_3,421339185730,True,608200000,1131470,609331470,False,13
6434,validator_28,85271453186,True,730640003,42835110,773475113,True,2
6435,validator_4,273930627257,True,610300000,11579400,621879400,True,8
6436,validator_25,76918956775,True,635440004,7692820,643132824,True,2
6437,validator_44,67329280340,True,583100000,19004000,602104000,False,2
6438,validator_20,87153826587,True,704900002,6011240,710911242,True,2
6439,validator_15,98074772059,True,666639998,5838400,672478398,True,3
6440,validator_15,98732662266,True,634739997,23150210,657890207,True,3
6441,validator_0,887939488865,True,704658001,28499140,733157141,True,27
6442,validator_40,62916979600,True,698500000,7931600,706431600,False,1
6443,validator_0,888815338008,True,873300003,2549140,875849143,True,27
6444,validator_16,67685346903,True,625829999,45664240,671494239,True,2
6445,validator_3,422019280510,True,677400000,2694780,680094780,False,13
6446,validator_7,196836199360,True,517900000,7330600,525230600,False,6
6447,validator_14,90493888865,True,868799998,39128900,907928898,True,2
6448,validator_0,889376372782,True,549699994,11334780,561034774,True,27
6449,validator_0,890311792717,True,932460005,2959930,935419935,True,27
6450,validator_1,749137867210,True,489800000,7150180,496950180,False,23
6451,validator_47,65464577800,True,734800000,3682700,738482700,False,2
6452,validator_0,891201241004,True,878139997,11308290,889448287,True,27
6453,validator_3,422508753110,True,481100000,8372600,489472600,False,13
6454,validator_37,63770677770,True,796000000,2918130,798918130,False,1
6455,validator_30,66978077830,True,571300000,3442200,574742200,False,2
6456,validator_1,749774192010,True,631900000,4424800,636324800,False,23
6457,validator_0,892190447845,True,969860001,19346840,989206841,True,27
6458,validator_2,557373887133,True,750020000,19918440,769938440,True,17
6459,validator_2,558053730220,True,658820007,21023080,679843087,True,17
6460,validator_39,60798696900,True,612270000,15520500,627790500,False,1
6461,validator_2,558941981516,True,854599996,33651300,888251296,True,17
6462,validator_38,64204859320,True,445600000,7855700,453455700,False,2
6463,validator_20,87869822504,True,714299997,1695920,715995917,True,2
6464,validator_11,76334120683,True,654580000,52386030,706966030,True,2
6465,validator_9,76717599429,True,565540003,35798760,601338763,True,2
6466,validator_19,85334694251,True,456040006,20742100,476782106,True,2
6467,validator_17,84228886593,True,850799999,1505010,852305009,True,2
6468,validator_3,423061781250,True,546600000,6428140,553028140,False,13
6469,validator_29,59018743300,True,733900000,2281430,736181430,False,1
6470,validator_48,82144035680,True,492400000,1200800,493600800,False,2
6471,validator_45,79792981620,True,619500000,2359570,621859570,False,2
6472,validator_3,423718851470,True,651700000,5370220,657070220,False,13
6473,validator_3,424207640560,True,468800000,19989090,488789090,False,13
6474,validator_1,750311105810,True,515800000,21113800,536913800,False,23
6475,validator_33,83557402550,True,551800000,20293250,572093250,False,2
6476,validator_19,85945167348,True,592099997,18373100,610473097,True,2
6477,validator_28,85966553479,True,693600003,1500290,695100293,True,2
6478,validator_0,892864694051,True,670040006,4206200,674246206,True,27
6479,validator_49,60794448800,True,772200000,6615320,778815320,False,1
6480,validator_2,559600637014,True,612439998,46215500,658655498,True,17
6481,validator_2,560250931336,True,638940002,11354320,650294322,True,17
6482,validator_1,750974668710,True,661000000,2562900,663562900,False,23
6483,validator_3,424601763380,True,386800000,7322820,394122820,False,13
6484,validator_48,82711425470,True,565100000,2289790,567389790,False,2
6485,validator_20,88430078909,True,542860005,17396400,560256405,True,2
6486,validator_1,751632962150,True,630800000,27493440,658293440,False,23
6487,validator_0,893513285262,True,630040001,18551210,648591211,True,27
6488,validator_34,70966057320,True,604800000,3697410,608497410,False,2
6489,validator_0,894277377062,True,735658000,28433800,764091800,True,27
6490,validator_8,83688439977,True,541799998,21212440,563012438,True,2
6491,validator_0,894942258389,True,642240007,22641320,664881327,True,27
6492,validator_2,560798613840,True,500820004,46862500,547682504,True,17
6493,validator_0,895732780110,True,766256001,24265720,790521721,True,27
6494,validator_1,752307079430,True,665900000,8217280,674117280,False,23
6495,validator_3,425155185280,True,534500000,18921900,553421900,False,13
6496,validator_3,425769363380,True,607100000,7078100,614178100,False,13
6497,validator_10,94359298054,True,594900007,3391630,598291637,True,2
6498,validator_40,63533048210,True,591600000,24468610,616068610,False,1
6499,validator_2,561400169936,True,598399996,3156100,601556096,True,17
6500,validator_4,274659015976,True,718619999,9768720,728388719,True,8
6501,validator_13,62573469770,True,857719998,20889500,878609498,True,1
6502,validator_4,275110092361,True,440339995,10736390,451076385,True,8
6503,validator_15,99645369596,True,872726000,39981330,912707330,True,3
6504,validator_1,752784356090,True,465700000,11576660,477276660,False,23
6505,validator_7,197497863480,True,660000000,1664120,661664120,False,6
6506,validator_2,562206309142,True,782340006,23799200,806139206,True,17
6507,validator_2,563047316438,True,838699996,2307300,841007296,True,17
6508,validator_33,84329962850,True,770300000,2260300,772560300,False,2
6509,validator_10,94949981984,True,578258000,12425930,590683930,True,2
6510,validator_42,73959395220,True,627500000,2020730,629520730,False,2
6511,validator_0,896507775704,True,752260004,22735590,774995594,True,28
6512,validator_6,201524027848,True,669559990,16962960,686522950,True,6
6513,validator_7,198054490010,True,555900000,726530,556626530,False,6
6514,validator_6,202017790848,True,492700000,1063000,493763000,True,6
6515,validator_2,563964452641,True,882380003,34756200,917136203,True,17
6516,validator_0,897051198325,True,541100001,2322620,543422621,True,28
6517,validator_39,61590103730,True,788300000,3106830,791406830,False,1
6518,validator_0,897781429421,True,726999996,3231100,730231096,True,28
6519,validator_21,93856296642,True,738767994,13150000,751917994,True,2
6520,validator_35,82469148160,True,513200000,3670830,516870830,False,2
6521,validator_7,198661181250,True,580000000,26691240,606691240,False,6
6522,validator_1,753428734100,True,641300000,3078010,644378010,False,23
6523,validator_26,86519220462,True,769840010,12919640,782759650,True,2
6524,validator_4,276056156810,True,944799999,1264450,946064449,True,8
6525,validator_7,199213406290,True,513300000,38925040,552225040,False,6
6526,validator_6,202681128448,True,626520000,36817600,663337600,True,6
6527,validator_5,280351378460,True,729600000,1259800,730859800,False,8
6528,validator_48,83231023250,True,512500000,7097780,519597780,False,2
6529,validator_37,64324933110,True,544240000,10015340,554255340,False,2
6530,validator_17,85000594496,True,742760003,28947900,771707903,True,2
6531,validator_20,89001657904,True,550080005,21498990,571578995,True,2
6532,validator_3,426220399000,True,447500000,3535620,451035620,False,13
6533,validator_3,426974787880,True,753300000,1088880,754388880,False,13
6534,validator_5,280798579990,True,442500000,4701530,447201530,False,8
6535,validator_1,753905934120,True,474300000,2900020,477200020,False,23
6536,validator_2,564475091686,True,482940005,27699040,510639045,True,17
6537,validator_4,276718882905,True,609933995,52792100,662726095,True,8
6538,validator_9,77369048122,True,632020003,19428690,651448693,True,2
6539,validator_1,754618388840,True,710500000,1954720,712454720,False,23
6540,validator_16,68184037475,True,469839992,28850580,498690572,True,2
6541,validator_1,755097076960,True,475700000,2988120,478688120,False,23
6542,validator_11,76900851596,True,559299993,7430920,566730913,True,2
6543,validator_16,68885916492,True,653960007,47919010,701879017,True,2
6544,validator_44,67888569650,True,556000000,3289310,559289310,False,2
6545,validator_13,63274589967,True,685679997,15440200,701120197,True,1
6546,validator_16,69432311399,True,525100007,21294900,546394907,True,2
6547,validator_2,565217730377,True,740000001,2638690,742638691,True,17
6548,validator_1,755583130220,True,478200000,7853260,486053260,False,23
6549,validator_1,756352478590,True,760500000,8848370,769348370,False,23
6550,validator_1,756798500920,True,433100000,12922330,446022330,False,23
6551,validator_1,757560606970,True,759800000,2306050,762106050,False,23
6552,validator_29,59551256170,True,529300000,3212870,532512870,False,1
6553,validator_17,85609389675,True,555039999,53755180,608795179,True,2
6554,validator_42,74499025500,True,534970000,4660280,539630280,False,2
6555,validator_42,74994693100,True,478600000,17067600,495667600,False,2
6556,validator_4,277261814346,True,518960001,23971440,542931441,True,8
6557,validator_40,64054698760,True,520000000,1650550,521650550,False,2
6558,validator_34,71468993120,True,491700000,11235800,502935800,False,2
6559,validator_4,277744793143,True,479579997,3398800,482978797,True,8
6560,validator_7,199907973710,True,685700000,8867420,694567420,False,6
6561,validator_27,79825855065,True,746800002,21810100,768610102,True,2
6562,validator_10,95546420221,True,576239997,20198240,596438237,True,2
6563,validator_14,91153718462,True,657799997,2029600,659829597,True,2
6564,validator_16,70140860276,True,671749997,36798880,708548877,True,2
6565,validator_3,427592538160,True,612800000,4950280,617750280,False,13
6566,validator_2,565804107519,True,559100002,27277140,586377142,True,17
6567,validator_20,89708766324,True,691700000,15408420,707108420,True,2
6568,validator_2,566463463253,True,645320004,14035730,659355734,True,17
6569,validator_0,898542094159,True,757799998,2864740,760664738,True,28
6570,validator_18,95733157121,True,658399991,5975720,664375711,True,2
6571,validator_19,86763658869,True,801400001,17091520,818491521,True,2
6572,validator_16,70796878955,True,638447999,17570680,656018679,True,2
6573,validator_0,899296236406,True,740220007,13922240,754142247,True,28
6574,validator_25,78003106641,True,1079899996,4249870,1084149866,True,2
6575,validator_4,278667971969,True,902400006,20778820,923178826,True,8
6576,validator_5,281440099020,True,638300000,3219030,641519030,False,8
6577,validator_3,428208440260,True,596700000,19202100,615902100,False,13
6578,validator_19,87385240647,True,571880008,49701770,621581778,True,2
6579,validator_19,87970457351,True,575420004,9796700,585216704,True,2
6580,validator_2,567088235724,True,587940001,36832470,624772471,True,17
6581,validator_0,899856926261,True,542639995,18049860,560689855,True,28
6582,validator_0,900414483726,True,501500005,56057460,557557465,True,28
6583,validator_0,901312040453,True,877499997,20056730,897556727,True,28
6584,validator_40,64595769150,True,540000000,1070390,541070390,False,2
6585,validator_2,567641496207,True,519880003,33380480,553260483,True,17
6586,validator_17,86426772773,True,766519998,50863100,817383098,True,2
6587,validator_5,281995740260,True,552500000,3141240,555641240,False,8
6588,validator_0,902381236668,True,1026759995,42436220,1069196215,True,28
6589,validator_0,902902901777,True,518879999,2785110,521665109,True,28
6590,validator_1,758254226400,True,692100000,1519430,693619430,False,23
6591,validator_2,568222159105,True,553905998,26756900,580662898,True,17
6592,validator_14,91746521301,True,590699999,2102840,592802839,True,2
6593,validator_1,758950021100,True,684000000,11794700,695794700,False,23
6594,validator_5,282549081360,True,534100000,19241100,553341100,False,8
6595,validator_7,200509033650,True,599000000,2059940,601059940,False,6
6596,validator_7,201023722060,True,508300000,6388410,514688410,False,6
6597,validator_1,759398556440,True,445730000,2805340,448535340,False,23
6598,validator_1,760134221440,True,722500000,13165000,735665000,False,23
6599,validator_2,568840981506,True,594374001,24448400,618822401,True,17
6600,validator_21,94727819539,True,843157997,28364900,871522897,True,2
6601,validator_24,85706294530,True,794299997,1970000,796269997,True,2
6602,validator_1,760732398940,True,582600000,15577500,598177500,False,23
6603,validator_2,569587999736,True,719220010,27798220,747018230,True,17
6604,validator_0,903603530616,True,689459999,11168840,700628839,True,28
6605,validator_48,83810354070,True,574200000,5130820,579330820,False,2
6606,validator_2,570146477999,True,523366003,35112260,558478263,True,17
6607,validator_1,761337472940,True,591100000,13974000,605074000,False,23
6608,validator_7,201641570960,True,615200000,2648900,617848900,False,6
6609,validator_8,84246685097,True,556200000,2045120,558245120,True,2
6610,validator_28,86578256430,True,608000001,3702950,611702951,True,2
6611,validator_4,279257237007,True,547159998,42105040,589265038,True,8
6612,validator_20,90430487621,True,698663997,23057300,721721297,True,2
6613,validator_5,283059199770,True,501600000,8518410,510118410,False,8
6614,validator_34,72210139080,True,733200000,7945960,741145960,False,2
6615,validator_2,570917386471,True,736600002,34308470,770908472,True,17
6616,validator_22,106424867604,True,753639999,35819600,789459599,True,3
6617,validator_2,571524997383,True,601468002,6142910,607610912,True,17
6618,validator_10,96315171521,True,719672000,49079300,768751300,True,3
6619,validator_20,91183676913,True,742729992,10459300,753189292,True,2
6620,validator_22,107036223983,True,600599999,10756380,611356379,True,3
6621,validator_1,761934756880,True,577900000,19383940,597283940,False,23
6622,validator_30,67464884330,True,484800000,2006500,486806500,False,2
6623,validator_5,283612024740,True,548600000,4224970,552824970,False,8
6624,validator_7,202281166050,True,619800000,19795090,639595090,False,6
6625,validator_6,203438693878,True,731340000,26225430,757565430,True,6
6626,validator_1,762531487600,True,594500000,2230720,596730720,False,23
6627,validator_1,763040085140,True,505300000,3297540,508597540,False,23
6628,validator_0,904204032020,True,598400004,2101400,600501404,True,28
6629,validator_47,66002731150,True,533200000,4953350,538153350,False,2
6630,validator_3,428865079750,True,653700000,2939490,656639490,False,13
6631,validator_48,84376236890,True,552400000,13482820,565882820,False,2
6632,validator_1,763761732870,True,719700000,1947730,721647730,False,23
6633,validator_34,72845588920,True,633600000,1849840,635449840,False,2
6634,validator_1,764455916210,True,691600000,2583340,694183340,False,23
6635,validator_2,572128795983,True,553368000,50430600,603798600,True,17
6636,validator_1,765029111150,True,562800000,10394940,573194940,False,23
6637,validator_5,284085162640,True,457000000,16137900,473137900,False,8
6638,validator_0,904820374217,True,587200007,29142190,616342197,True,28
6639,validator_6,204124746736,True,685300008,752850,686052858,True,6
6640,validator_0,905611952334,True,773139997,18438120,791578117,True,28
6641,validator_1,765767905270,True,734600000,4194120,738794120,False,23
6642,validator_11,77717430433,True,770023997,46554840,816578837,True,2
6643,validator_13,63971088895,True,681300008,15198920,696498928,True,1
6644,validator_15,100179448300,True,512396004,21682700,534078704,True,3
6645,validator_0,906246505828,True,622599994,11953500,634553494,True,28
6646,validator_19,88673248072,True,683060001,19730720,702790721,True,2
6647,validator_22,107782442969,True,744399996,1818990,746218986,True,3
6648,validator_0,906930323438,True,664100000,19717610,683817610,True,28
6649,validator_0,907832917539,True,892100001,10494100,902594101,True,28
6650,validator_5,284665390340,True,577000000,3227700,580227700,False,8
6651,validator_48,84957520610,True,576000000,5283720,581283720,False,2
6652,validator_3,429322946940,True,438200000,19667190,457867190,False,13
6653,validator_25,78715878334,True,693540003,19231690,712771693,True,2
6654,validator_0,908624338141,True,781760002,9660600,791420602,True,28
6655,validator_12,72145175137,True,539400002,28427100,567827102,True,2
6656,validator_2,572874592787,True,714838004,30958800,745796804,True,17
6657,validator_4,279915120175,True,653900008,3983160,657883168,True,8
6658,validator_30,67991557640,True,521200000,5473310,526673310,False,2
6659,validator_1,766308495690,True,537100000,3490420,540590420,False,23
6660,validator_2,573451413591,True,573560004,3260800,576820804,True,17
6661,validator_22,108530673848,True,727357999,20872880,748230879,True,3
6662,validator_0,909185145447,True,545964006,14843300,560807306,True,28
6663,validator_22,109245588659,True,690339991,24574820,714914811,True,3
6664,validator_47,66634928580,True,610600000,21597430,632197430,False,2
6665,validator_4,280567827970,True,650599995,2107800,652707795,True,8
6666,validator_34,73738983620,True,890700000,2694700,893394700,False,2
6667,validator_0,909935250129,True,734560002,15544680,750104682,True,28
6668,validator_8,84909562158,True,659700001,3177060,662877061,True,2
6669,validator_12,72565900181,True,396146004,24579040,420725044,True,2
6670,validator_4,281762320255,True,1192000005,2492280,1194492285,True,8
6671,validator_14,92304266140,True,533179999,24564840,557744839,True,2
6672,validator_5,285351578310,True,681800000,4387970,686187970,False,8
6673,validator_8,85460505961,True,533300003,17643800,550943803,True,2
6674,validator_0,910733371016,True,786193997,11926890,798120887,True,28
6675,validator_0,911492675852,True,725000006,34304830,759304836,True,28
6676,validator_8,85975031162,True,501280001,13245200,514525201,True,2
6677,validator_34,74386625640,True,645300000,2342020,647642020,False,2
6678,validator_0,912350581240,True,821739998,36165390,857905388,True,28
6679,validator_42,75537223140,True,521600000,20930040,542530040,False,2
6680,validator_5,285791291830,True,435900000,3813520,439713520,False,8
6681,validator_2,574030012192,True,544520001,34078600,578598601,True,17
6682,validator_2,574757596789,True,697395997,30188600,727584597,True,17
6683,validator_42,76189549350,True,634500000,17826210,652326210,False,2
6684,validator_28,87191795216,True,601920006,11618780,613538786,True,2
6685,validator_21,95599026675,True,842839996,28367140,871207136,True,2
6686,validator_7,203000345450,True,700100000,19079400,719179400,False,6
6687,validator_15,100741140484,True,553763994,7928190,561692184,True,3
6688,validator_0,913017864474,True,660940004,6343230,667283234,True,28
6689,validator_22,109948124783,True,689063994,13472130,702536124,True,3
6690,validator_9,77957811406,True,582970004,5793280,588763284,True,2
6691,validator_2,575462401614,True,674019995,30784830,704804825,True,17
6692,validator_9,78711546505,True,742999999,10735100,753735099,True,2
6693,validator_28,87654326351,True,457579995,4951140,462531135,True,2
6694,validator_2,576067647813,True,593679999,11566200,605246199,True,18
6695,validator_1,766884424960,True,574500000,1429270,575929270,False,23
6696,validator_7,203584863950,True,576000000,8518500,584518500,False,6
6697,validator_46,64706477540,True,546800000,5021090,551821090,False,2
6698,validator_1,767644659960,True,751400000,8835000,760235000,False,23
6699,validator_17,87317523768,True,876800005,13950990,890750995,True,2
6700,validator_10,97113239821,True,788034000,10034300,798068300,True,3
6701,validator_24,86561587772,True,823256012,32037230,855293242,True,2
6702,validator_35,83213919400,True,741400000,3371240,744771240,False,2
6703,validator_0,913837042059,True,794400005,24777580,819177585,True,28
6704,validator_5,286445385100,True,653100000,993270,654093270,False,8
6705,validator_17,88001091778,True,637486000,46082010,683568010,True,2
6706,validator_10,97792789424,True,649040003,30509600,679549603,True,3
6707,validator_3,429926119580,True,595200000,7972640,603172640,False,13
6708,validator_1,768090203750,True,434200000,11343790,445543790,False,24
6709,validator_2,576724799975,True,599800002,57352160,657152162,True,18
6710,validator_7,204078696860,True,454300000,39532910,493832910,False,6
6711,validator_1,768695304650,True,602800000,2300900,605100900,False,24
6712,validator_28,88372789488,True,648439997,70023140,718463137,True,2
6713,validator_42,76767367720,True,574200000,3618370,577818370,False,2
6714,validator_45,80337971460,True,523600000,21389840,544989840,False,2
6715,validator_6,204968409774,True,832969998,10693040,843663038,True,6
6716,validator_42,77361681450,True,592200000,2113730,594313730,False,2
6717,validator_15,101434405026,True,687660002,5604540,693264542,True,3
6718,validator_0,914511260274,True,671219995,2998220,674218215,True,28
6719,validator_1,769295409830,True,596000000,4105180,600105180,False,24
6720,validator_47,67240558970,True,596900000,8730390,605630390,False,2
6721,validator_3,430566563980,True,638800000,1644400,640444400,False,13
6722,validator_45,80988022660,True,646600000,3451200,650051200,False,2
6723,validator_2,577326531274,True,570599999,31131300,601731299,True,18
6724,validator_17,88558638405,True,527279997,30266630,557546627,True,2
6725,validator_29,60265832130,True,711400000,3175960,714575960,False,1
6726,validator_0,915115919673,True,590039999,14619400,604659399,True,28
6727,validator_0,915762497714,True,624138011,22440030,646578041,True,28
6728,validator_3,431122285080,True,545800000,9921100,555721100,False,13
6729,validator_0,916300357131,True,528039997,9819420,537859417,True,28
6730,validator_2,577777108770,True,370219996,80357500,450577496,True,18
6731,validator_48,85740841710,True,780600000,2721100,783321100,False,2
6732,validator_0,916820684009,True,500699998,19626880,520326878,True,28
6733,validator_5,287037817320,True,565400000,27032220,592432220,False,8
6734,validator_0,917514197038,True,662499999,31013030,693513029,True,28
6735,validator_14,92915273408,True,608499998,2507270,611007268,True,2
6736,validator_23,95813198126,True,720059995,32677080,752737075,True,2
6737,validator_19,89177645812,True,442940000,61457740,504397740,True,2
6738,validator_26,87258508545,True,726400003,12888080,739288083,True,2
6739,validator_5,287648695310,True,608800000,2077990,610877990,False,8
6740,validator_27,80535413168,True,689700003,19858100,709558103,True,2
6741,validator_27,81228123291,True,678380003,14330120,692710123,True,2
6742,validator_39,62329613450,True,738100000,1409720,739509720,False,1
6743,validator_3,431586563810,True,456900000,7378730,464278730,False,13
6744,validator_1,769864943110,True,567600000,1933280,569533280,False,24
6745,validator_0,918015140875,True,472819997,28123840,500943837,True,28
6746,validator_35,83976896730,True,745600000,17377330,762977330,False,2
6747,validator_32,67996585270,True,662700000,19536170,682236170,False,2
6748,validator_1,770459135640,True,558200000,35992530,594192530,False,24
6749,validator_26,87967867374,True,694339999,15018830,709358829,True,2
6750,validator_0,918559132175,True,529220000,14771300,543991300,True,28
6751,validator_39,62806500490,True,440100000,36787040,476887040,False,1
6752,validator_23,96549182962,True,727700006,8284830,735984836,True,3
6753,validator_21,96159076468,True,559200003,849790,560049793,True,3
6754,validator_1,771314035280,True,853400000,1499640,854899640,False,24
6755,validator_32,68575506500,True,577800000,1121230,578921230,False,2
6756,validator_1,771989467700,True,673440000,1992420,675432420,False,24
6757,validator_1,772613278170,True,610400000,13410470,623810470,False,24
6758,validator_4,282593109937,True,787054002,43735680,830789682,True,8
6759,validator_44,68434154550,True,543600000,1984900,545584900,False,2
6760,validator_37,64781281650,True,453440000,2908540,456348540,False,2
6761,validator_0,919384927389,True,819399994,6395220,825795214,True,28
6762,validator_23,97297159218,True,709700006,38276250,747976256,True,3
6763,validator_38,64777458420,True,570500000,2099100,572599100,False,2
6764,validator_23,97830647611,True,529260003,4228390,533488393,True,3
6765,validator_1,773163105830,True,547800000,2027660,549827660,False,24
6766,validator_0,920039019493,True,635460004,18632100,654092104,True,28
6767,validator_0,920657144516,True,594020003,24105020,618125023,True,28
6768,validator_14,93665171242,True,736203994,13693840,749897834,True,2
6769,validator_3,432228211210,True,611600000,30047400,641647400,False,13
6770,validator_24,87204707371,True,639239999,3879600,643119599,True,2
6771,validator_41,60227221140,True,532640000,20438480,553078480,False,1
6772,validator_49,61516658010,True,718000000,4209210,722209210,False,1
6773,validator_7,204697835860,True,616500000,2639000,619139000,False,6
6774,validator_25,79338792405,True,599414001,23500070,622914071,True,2
6775,validator_2,578368974869,True,590899999,966100,591866099,True,18
6776,validator_1,773894873840,True,725200000,6568010,731768010,False,24
6777,validator_23,98458918158,True,602079997,26190550,628270547,True,3
6778,validator_3,432860449990,True,624500000,7738780,632238780,False,13
6779,validator_33,84862281350,True,530300000,2018500,532318500,False,2
6780,validator_41,60577042170,True,348600000,1221030,349821030,False,1
6781,validator_46,65180030210,True,455700000,17852670,473552670,False,2
6782,validator_4,283210322436,True,578737999,38474500,617212499,True,8
6783,validator_0,921614902268,True,941400002,16357750,957757752,True,28
6784,validator_0,922290218501,True,664200003,11116230,675316233,True,28
6785,validator_11,78518925331,True,796299998,5194900,801494898,True,2
6786,validator_20,91700502914,True,511500001,5326000,516826001,True,2
6787,validator_0,922861945665,True,562299994,9427170,571727164,True,28
6788,validator_4,283787615170,True,559700004,17592730,577292734,True,8
6789,validator_5,288186321800,True,536400000,1226490,537626490,False,9
6790,validator_0,923607221764,True,735499999,9776100,745276099,True,28
6791,validator_5,288693292660,True,503700000,3270860,506970860,False,9
6792,validator_3,433306739450,True,434780000,11509460,446289460,False,13
6793,validator_16,71650402254,True,823079999,30443300,853523299,True,2
6794,validator_2,578967571293,True,581264004,17332420,598596424,True,18
6795,validator_40,65134838180,True,532100000,6969030,539069030,False,2
6796,validator_1,774474982560,True,571500000,8608720,580108720,False,24
6797,validator_5,289246648760,True,550800000,2556100,553356100,False,9
6798,validator_2,579559383796,True,505540003,86272500,591812503,True,18
6799,validator_0,924595307046,True,968040002,20045280,988085282,True,28
6800,validator_36,64237822470,True,589800000,3224520,593024520,False,2
6801,validator_1,775081778800,True,602200000,4596240,606796240,False,24
6802,validator_2,580242180797,True,675458001,7339000,682797001,True,18
6803,validator_29,60810969890,True,525700000,19437760,545137760,False,1
6804,validator_1,775592347940,True,489700000,20869140,510569140,False,24
6805,validator_33,85453137690,True,580900000,9956340,590856340,False,2
6806,validator_35,84561374770,True,577500000,6978040,584478040,False,2
6807,validator_16,72553555517,True,844426013,58727250,903153263,True,2
6808,validator_10,98626540722,True,832019998,1731300,833751298,True,3
6809,validator_30,68746650540,True,746000000,9092900,755092900,False,2
6810,validator_26,88615689362,True,645699998,2121990,647821988,True,2
6811,validator_42,77763664040,True,394700000,7282590,401982590,False,2
6812,validator_1,776232845540,True,631000000,9497600,640497600,False,24
6813,validator_0,925178134747,True,555080001,27747700,582827701,True,28
6814,validator_5,289959236950,True,705200000,7388190,712588190,False,9
6815,validator_25,80130783608,True,779300003,12691200,791991203,True,2
6816,validator_36,64726929800,True,443800000,45307330,489107330,False,2
6817,validator_16,73259790852,True,665120005,41115330,706235335,True,2
6818,validator_22,110520634113,True,562760000,9749330,572509330,True,3
6819,validator_0,925875303365,True,659539998,37628620,697168618,True,28
6820,validator_5,290733390920,True,769600000,4553970,774153970,False,9
6821,validator_1,776997161140,True,755800000,8515600,764315600,False,24
6822,validator_15,101989981392,True,553199996,2376370,555576366,True,3
6823,validator_4,284665673007,True,871399997,6657840,878057837,True,8
6824,validator_3,433852240480,True,542300000,3201030,545501030,False,13
6825,validator_44,68933596850,True,498000000,1442300,499442300,False,2
6826,validator_3,434525414880,True,670700000,2474400,673174400,False,13
6827,validator_31,76477899620,True,526500000,19307100,545807100,False,2
6828,validator_3,435120298080,True,574400000,20483200,594883200,False,13
6829,validator_2,580954918466,True,691219999,21517670,712737669,True,18
6830,validator_1,777594358010,True,590000000,7196870,597196870,False,24
6831,validator_23,99069396048,True,585180000,25297890,610477890,True,3
6832,validator_47,67870681910,True,626400000,3722940,630122940,False,2
6833,validator_1,778241313340,True,626100000,20855330,646955330,False,24
6834,validator_34,75037352800,True,616500000,34227160,650727160,False,2
6835,validator_28,88935760421,True,536605993,26364940,562970933,True,2
6836,validator_4,285438641840,True,753599993,19368840,772968833,True,8
6837,validator_7,205232782910,True,532700000,2247050,534947050,False,6
6838,validator_31,77117769900,True,636100000,3770280,639870280,False,2
6839,validator_6,205757622798,True,783520004,5693020,789213024,True,6
6840,validator_2,581660361468,True,668640002,36803000,705443002,True,18
6841,validator_0,926544768573,True,667400008,2065200,669465208,True,28
6842,validator_6,206377257126,True,615299998,4334330,619634328,True,6
6843,validator_38,65539570620,True,740700000,21412200,762112200,False,2
6844,validator_1,778716481440,True,470200000,4968100,475168100,False,24
6845,validator_1,779441000970,True,716400000,8119530,724519530,False,24
6846,validator_5,291310665020,True,551970000,25304100,577274100,False,9
6847,validator_28,89668231619,True,709899998,22571200,732471198,True,2
6848,validator_2,582510999908,True,817544000,33094440,850638440,True,18
6849,validator_1,779894965610,True,450930000,3034640,453964640,False,24
6850,validator_34,75598138630,True,536300000,24485830,560785830,False,2
6851,validator_1,780348249130,True,449900000,3383520,453283520,False,24
6852,validator_17,89296452105,True,723340000,14473700,737813700,True,2
6853,validator_0,927244048160,True,688499997,10779590,699279587,True,28
6854,validator_15,102814012176,True,817560004,6470780,824030784,True,3
6855,validator_0,928423051794,True,1176799994,2203640,1179003634,True,29
6856,validator_4,286150007856,True,692840006,18526010,711366016,True,8
6857,validator_39,63294740930,True,482300000,5940440,488240440,False,1
6858,validator_40,65768648210,True,629800000,4010030,633810030,False,2
6859,validator_0,929114664294,True,645310000,46302500,691612500,True,29
6860,validator_16,74068486251,True,780399999,28295400,808695399,True,2
6861,validator_5,291996552220,True,663400000,22487200,685887200,False,9
6862,validator_1,780986775640,True,634100000,4426510,638526510,False,24
6863,validator_22,111150688886,True,620200003,9854770,630054773,True,3
6864,validator_22,111885293045,True,705677999,28926160,734604159,True,3
6865,validator_38,66071389210,True,522600000,9218590,531818590,False,2
6866,validator_38,66804755110,True,730900000,2465900,733365900,False,2
6867,validator_5,292445527620,True,446700000,2275400,448975400,False,9
6868,validator_15,103741105316,True,917100000,9993140,927093140,True,3
6869,validator_0,929804074126,True,679440002,9969830,689409832,True,29
6870,validator_30,69426692280,True,671800000,8241740,680041740,False,2
6871,validator_0,930529327071,True,710300005,14952940,725252945,True,29
6872,validator_14,94366035478,True,692140006,8724230,700864236,True,2
6873,validator_21,96927611049,True,741600001,26934580,768534581,True,3
6874,validator_7,205857021730,True,619000000,5238820,624238820,False,6
6875,validator_0,931271504401,True,711314000,30863330,742177330,True,29
6876,validator_27,81876765316,True,631079995,17562030,648642025,True,2
6877,validator_9,79330572030,True,611866005,7159520,619025525,True,2
6878,validator_2,583227183340,True,674480002,41703430,716183432,True,18
6879,validator_4,286774269937,True,616400001,7862080,624262081,True,8
6880,validator_2,583921203196,True,691459996,2559860,694019856,True,18
6881,validator_18,96516667199,True,769703998,13806080,783510078,True,3
6882,validator_3,435902742940,True,768200000,14244860,782444860,False,13
6883,validator_12,73606682974,True,996800003,43982790,1040782793,True,2
6884,validator_3,436601733450,True,693800000,5190510,698990510,False,13
6885,validator_2,584665462985,True,742319999,1939790,744259789,True,18
6886,validator_1,781536564900,True,541300000,8489260,549789260,False,24
6887,validator_20,92439437439,True,710520005,28414520,738934525,True,2
6888,validator_0,931930047452,True,650120001,8423050,658543051,True,29
6889,validator_8,86853174366,True,873899994,4243210,878143204,True,2
6890,validator_0,932515179688,True,571679996,13452240,585132236,True,29
6891,validator_0,933232127870,True,674600002,42348180,716948182,True,29
6892,validator_5,293046526890,True,599100000,1899270,600999270,False,9
6893,validator_1,782129672030,True,591100000,2007130,593107130,False,24
6894,validator_22,112674462774,True,788199999,969730,789169729,True,3
6895,validator_6,207033074971,True,652140005,3677840,655817845,True,6
6896,validator_45,81440973620,True,451200000,1750960,452950960,False,2
6897,validator_10,99184588449,True,551939997,6107730,558047727,True,3
6898,validator_22,113556388575,True,879800001,2125800,881925801,True,3
6899,validator_34,76146830670,True,546800000,1892040,548692040,False,2
6900,validator_42,78549198570,True,774500000,11034530,785534530,False,2
6901,validator_18,97164632205,True,637200006,10765000,647965006,True,3
6902,validator_2,585085834564,True,402279999,18091580,420371579,True,18
6903,validator_25,80672410783,True,539339995,2287180,541627175,True,2
6904,validator_0,934295597210,True,1039780000,23689340,1063469340,True,29
6905,validator_8,87520106810,True,654120004,12812440,666932444,True,2
6906,validator_1,782554781630,True,419600000,5509600,425109600,False,24
6907,validator_0,935044703531,True,707820001,41286320,749106321,True,29
6908,validator_44,69755765090,True,819200000,2968240,822168240,False,2
6909,validator_12,74211067596,True,598720002,5664620,604384622,True,2
6910,validator_0,935660863576,True,586339995,29820050,616160045,True,29
6911,validator_7,206602811610,True,743600000,2189880,745789880,False,6
6912,validator_47,68507960210,True,610100000,27178300,637278300,False,2
6913,validator_18,97720350737,True,518026002,37692530,555718532,True,3
6914,validator_4,287355088236,True,568299999,12518300,580818299,True,8
6915,validator_1,783129417380,True,565700000,8935750,574635750,False,24
6916,validator_28,90615926016,True,909539997,38154400,947694397,True,2
6917,validator_2,585797010520,True,700699996,10475960,711175956,True,18
6918,validator_1,783528373620,True,392000000,6956240,398956240,False,24
6919,validator_3,437230214240,True,622300000,6180790,628480790,False,13
6920,validator_49,62178290060,True,659000000,2632050,661632050,False,1
6921,validator_38,67363864020,True,556300000,2808910,559108910,False,2
6922,validator_0,936402935058,True,738800002,3271480,742071482,True,29
6923,validator_38,68066605760,True,675000000,27741740,702741740,False,2
6924,validator_7,207302199270,True,693600000,5787660,699387660,False,6
6925,validator_1,784137302850,True,606470000,2459230,608929230,False,24
6926,validator_36,65208710180,True,476000000,5780380,481780380,False,2
6927,validator_10,100309750230,True,1101400001,23761780,1125161781,True,3
6928,validator_2,586357209525,True,524836005,35363000,560199005,True,18
6929,validator_0,936961996247,True,549199999,9861190,559061189,True,29
6930,validator_48,86318456910,True,574500000,3115200,577615200,False,2
6931,validator_10,101158158017,True,818460007,29947780,848407787,True,3
6932,validator_3,437936183640,True,704200000,1769400,705969400,False,13
6933,validator_1,784627251090,True,487000000,2948240,489948240,False,24
6934,validator_9,80053130471,True,703640001,18918440,722558441,True,2
6935,validator_6,207712657884,True,659020003,20562910,679582913,True,6
6936,validator_27,82278976817,True,388280001,13931500,402211501,True,2
6937,validator_41,61393271150,True,809200000,7028980,816228980,False,1
6938,validator_1,785318844720,True,689300000,2293630,691593630,False,24
6939,validator_44,70375572790,True,607100000,12707700,619807700,False,2
6940,validator_0,937724761184,True,729085997,33678940,762764937,True,29
6941,validator_12,74939832091,True,709120005,19644490,728764495,True,2
6942,validator_2,587007919917,True,644346002,6364390,650710392,True,18
6943,validator_29,61477521010,True,656700000,9851120,666551120,False,1
6944,validator_6,208393613568,True,653160004,27795680,680955684,True,6
6945,validator_24,88046399756,True,787919995,53772390,841692385,True,2
6946,validator_5,293497845710,True,448600000,2718820,451318820,False,9
6947,validator_0,938413968756,True,651699992,37507580,689207572,True,29
6948,validator_0,939011930694,True,561997998,35963940,597961938,True,29
6949,validator_38,68813913440,True,744300000,3007680,747307680,False,2
6950,validator_0,939803938400,True,783100006,8907700,792007706,True,29
6951,validator_6,209142463285,True,732239997,16609720,748849717,True,6
6952,validator_13,64751955834,True,761999999,18866940,780866939,True,2
6953,validator_10,101896179621,True,715220004,22801600,738021604,True,3
6954,validator_0,940588030600,True,751040000,33052200,784092200,True,29
6955,validator_3,438603797760,True,665200000,2414120,667614120,False,13
6956,validator_1,785917707450,True,597200000,1662730,598862730,False,24
6957,validator_38,69349446570,True,525800000,9733130,535533130,False,2
6958,validator_0,941073912699,True,466919999,18962100,485882099,True,29
6959,validator_19,89634556917,True,425400005,31511100,456911105,True,2
6960,validator_1,786408899480,True,489300000,1892030,491192030,False,24
6961,validator_6,209619918785,True,475300000,2155500,477455500,True,6
6962,validator_2,587958366164,True,931519997,18926250,950446247,True,18
6963,validator_6,210358756254,True,705819999,33017470,738837469,True,6
6964,validator_31,77563085200,True,418700000,26615300,445315300,False,2
6965,validator_2,588817130762,True,839339988,19424610,858764598,True,18
6966,validator_40,66471780110,True,700800000,2331900,703131900,False,2
6967,validator_0,941778051738,True,657163999,46975040,704139039,True,29
6968,validator_1,787022417810,True,610500000,3018330,613518330,False,24
6969,validator_5,294128269930,True,611400000,19024220,630424220,False,9
6970,validator_1,787573720340,True,530700000,20602530,551302530,False,24
6971,validator_5,294986349030,True,854900000,3179100,858079100,False,9
6972,validator_22,114308296770,True,720639995,31268200,751908195,True,3
6973,validator_0,942311717784,True,488540006,45126040,533666046,True,29
6974,validator_0,943118239845,True,777226001,29296060,806522061,True,29
6975,validator_2,589368350282,True,548900000,2319520,551219520,True,18
6976,validator_1,788200783580,True,620900000,6163240,627063240,False,24
6977,validator_43,63559534560,True,567800000,5984280,573784280,False,1
6978,validator_35,85281834000,True,700500000,19959230,720459230,False,2
6979,validator_7,207862040710,True,558200000,1641440,559841440,False,6
6980,validator_2,589901918080,True,530699998,2867800,533567798,True,18
6981,validator_42,79214993770,True,663700000,2095200,665795200,False,2
6982,validator_44,71200636520,True,805900000,19163730,825063730,False,2
6983,validator_4,287898746408,True,536380002,7278170,543658172,True,8
6984,validator_30,70011124460,True,564600000,19832180,584432180,False,2
6985,validator_3,439151712990,True,544300000,3615230,547915230,False,13
6986,validator_24,88764929746,True,713900000,4629990,718529990,True,2
6987,validator_34,76736002560,True,587500000,1671890,589171890,False,2
6988,validator_14,95007699419,True,614700001,26963940,641663941,True,2
6989,validator_3,439752251190,True,594200000,6338200,600538200,False,13
6990,validator_3,440391622330,True,636600000,2771140,639371140,False,13
6991,validator_13,65871133912,True,1113999998,5178080,1119178078,True,2
6992,validator_7,208597683750,True,733500000,2143040,735643040,False,6
6993,validator_15,104517505475,True,754619999,21780160,776400159,True,3
6994,validator_21,97695678725,True,758120006,9947670,768067676,True,3
6995,validator_1,788863069820,True,651800000,10486240,662286240,False,24
6996,validator_4,288764264201,True,835879993,29637800,865517793,True,9
6997,validator_12,75532164481,True,580400000,11932390,592332390,True,2
6998,validator_32,69366247030,True,780400000,10340530,790740530,False,2
6999,validator_2,590632321710,True,665180000,65223630,730403630,True,18
7000,validator_23,99731146158,True,601884000,59866110,661750110,True,3
7001,validator_1,789458719550,True,593000000,2649730,595649730,False,24
7002,validator_0,943868050419,True,714839994,34970580,749810574,True,29
7003,validator_27,83010976713,True,711499996,20499900,731999896,True,2
7004,validator_0,944675965137,True,787439998,20474720,807914718,True,29
7005,validator_28,91294240611,True,663899995,14414600,678314595,True,2
7006,validator_2,591407681546,True,747899996,27459840,775359836,True,18
7007,validator_25,81263881683,True,572500000,18970900,591470900,True,2
7008,validator_17,90077389194,True,768499999,12437090,780937089,True,2
7009,validator_44,71779955090,True,567600000,11718570,579318570,False,2
7010,validator_32,69826743420,True,458700000,1796390,460496390,False,2
7011,validator_46,65849193310,True,648500000,20663100,669163100,False,2
7012,validator_5,295456509170,True,467900000,2260140,470160140,False,9
7013,validator_4,289604604432,True,815040001,25300230,840340231,True,9
7014,validator_1,790178659310,True,700000000,19939760,719939760,False,24
7015,validator_4,290262595829,True,656799997,1191400,657991397,True,9
7016,validator_46,66528488650,True,668600000,10695340,679295340,False,2
7017,validator_48,86868928640,True,548400000,2071730,550471730,False,2
7018,validator_26,89407252073,True,763600001,27962710,791562711,True,2
7019,validator_5,296002573470,True,536100000,9964300,546064300,False,9
7020,validator_2,591962384630,True,503760004,50943080,554703084,True,18
7021,validator_29,62188693140,True,708300000,2872130,711172130,False,1
7022,validator_1,790863233270,True,682000000,2573960,684573960,False,24
7023,validator_5,296538291500,True,532300000,3418030,535718030,False,9
7024,validator_23,100207417436,True,450669998,25601280,476271278,True,3
7025,validator_37,65418960470,True,631200000,6478820,637678820,False,2
7026,validator_1,791411198260,True,545000000,2964990,547964990,False,24
7027,validator_35,85820950220,True,534400000,4716220,539116220,False,2
7028,validator_0,945459466359,True,716555992,66945230,783501222,True,29
7029,validator_1,792072893760,True,660300000,1395500,661695500,False,24
7030,validator_7,209277901600,True,673900000,6317850,680217850,False,6
7031,validator_5,297516988940,True,977500000,1197440,978697440,False,9
7032,validator_1,792650827100,True,575300000,2633340,577933340,False,24
7033,validator_10,102789399749,True,830467998,62752130,893220128,True,3
7034,validator_5,298130544720,True,604500000,9055780,613555780,False,9
7035,validator_28,92292206717,True,991200006,6766100,997966106,True,2
7036,validator_21,98320855939,True,590660004,34517210,625177214,True,3
7037,validator_30,70721189780,True,694300000,15765320,710065320,False,2
7038,validator_0,946274389753,True,783513994,31409400,814923394,True,29
7039,validator_34,77204148560,True,465000000,3146000,468146000,False,2
7040,validator_31,78055174110,True,490300000,1788910,492088910,False,2
7041,validator_8,88068706212,True,538764002,9835400,548599402,True,2
7042,validator_1,793229242840,True,571800000,6615740,578415740,False,24
7043,validator_2,592565476429,True,592759999,10331800,603091799,True,18
7044,validator_4,291015846569,True,731920010,21330730,753250740,True,9
7045,validator_40,67104240510,True,629100000,3360400,632460400,False,2
7046,validator_33,85988391890,True,525800000,9454200,535254200,False,2
7047,validator_46,67294935420,True,762200000,4246770,766446770,False,2
7048,validator_5,298807831820,True,675900000,1387100,677287100,False,9
7049,validator_20,93325380847,True,863660008,22283400,885943408,True,2
7050,validator_39,64022395310,True,722800000,4854380,727654380,False,2
7051,validator_42,79786809870,True,552800000,19016100,571816100,False,2
7052,validator_0,946720068871,True,436939998,8739120,445679118,True,29
7053,validator_2,593467720435,True,856579996,45664010,902244006,True,18
7054,validator_7,209827580280,True,545000000,4678680,549678680,False,6
7055,validator_28,92944899220,True,644600003,8092500,652692503,True,2
7056,validator_1,793652589010,True,415500000,7846170,423346170,False,24
7057,validator_2,594215122666,True,742400001,5002230,747402231,True,18
7058,validator_27,83654290915,True,624360002,18954200,643314202,True,2
7059,validator_25,82061550961,True,777180008,20489270,797669278,True,2
7060,validator_1,794171625710,True,517800000,1236700,519036700,False,24
7061,validator_3,440894427130,True,501100000,1704800,502804800,False,13
7062,validator_23,100951107869,True,733900003,9790430,743690433,True,3
7063,validator_47,69228945350,True,690500000,30485140,720985140,False,2
7064,validator_1,795063711840,True,875200000,16886130,892086130,False,24
7065,validator_1,795742774160,True,672700000,6362320,679062320,False,24
7066,validator_3,441574320760,True,676900000,2993630,679893630,False,13
7067,validator_0,947476865364,True,724119993,32676500,756796493,True,29
7068,validator_6,210985928654,True,620520000,6652400,627172400,True,6
7069,validator_2,594971095123,True,728279997,27692460,755972457,True,18
7070,validator_21,99245054557,True,896099998,28098620,924198618,True,3
7071,validator_7,210513021860,True,673700000,11741580,685441580,False,6
7072,validator_5,299453575270,True,632800000,12943450,645743450,False,9
7073,validator_12,76463698637,True,863879996,67654160,931534156,True,2
7074,validator_7,211301555690,True,786500000,2033830,788533830,False,6
7075,validator_27,84307600997,True,628040012,25270070,653310082,True,2
7076,validator_15,105220976268,True,674573993,28896800,703470793,True,3
7077,validator_1,796303370310,True,558000000,2596150,560596150,False,24
7078,validator_10,103556948769,True,734720000,32829020,767549020,True,3
7079,validator_0,948243900334,True,744040000,22994970,767034970,True,29
7080,validator_2,595581406127,True,555420004,54891000,610311004,True,18
7081,validator_13,66664797134,True,772820002,20843220,793663222,True,2
7082,validator_4,291539952450,True,515004001,9101880,524105881,True,9
7083,validator_30,71524469270,True,795100000,8179490,803279490,False,2
7084,validator_5,300084478890,True,628400000,2503620,630903620,False,9
7085,validator_16,74691875949,True,619499998,3889700,623389698,True,2
7086,validator_2,596112430047,True,517020000,14003920,531023920,True,18
7087,validator_7,212098241390,True,792400000,4285700,796685700,False,6
7088,validator_10,104148832767,True,582219998,9664000,591883998,True,3
7089,validator_0,949051290867,True,789159993,18230540,807390533,True,29
7090,validator_13,67406149076,True,727240002,14111940,741351942,True,2
7091,validator_4,292391725872,True,817976002,33797420,851773422,True,9
7092,validator_22,114949747683,True,605540003,35910910,641450913,True,3
7093,validator_32,70415816850,True,586800000,2273430,589073430,False,2
7094,validator_21,100056479552,True,802999995,8425000,811424995,True,3
7095,validator_38,70171740730,True,820800000,1494160,822294160,False,2
7096,validator_2,596633334973,True,494339996,26564930,520904926,True,18
7097,validator_4,293392931536,True,989620004,11585660,1001205664,True,9
7098,validator_1,796892315200,True,586500000,2444890,588944890,False,24
7099,validator_38,70743974530,True,554000000,18233800,572233800,False,2
7100,validator_0,949739782830,True,677654003,10837960,688491963,True,29
7101,validator_17,90834489485,True,716416001,40684290,757100291,True,2
7102,validator_3,442372401500,True,789700000,8380740,798080740,False,13
7103,validator_16,75495592946,True,784879997,18837000,803716997,True,2
7104,validator_47,70041740480,True,809600000,3195130,812795130,False,2
7105,validator_7,212639032470,True,530300000,10491080,540791080,False,6
7106,validator_13,68249380300,True,834139994,9091230,843231224,True,2
7107,validator_31,78759216460,True,680770000,23272350,704042350,False,2
7108,validator_3,443134753120,True,757800000,4551620,762351620,False,13
7109,validator_42,80368571070,True,572800000,8961200,581761200,False,2
7110,validator_31,79318033530,True,556500000,2317070,558817070,False,2
7111,validator_1,797322961180,True,420900000,9745980,430645980,False,24
7112,validator_45,82263274100,True,819600000,2700480,822300480,False,2
7113,validator_0,950457213257,True,715510007,1920420,717430427,True,29
7114,validator_4,294132370872,True,711500006,27939330,739439336,True,9
7115,validator_0,951218955693,True,735260006,26482430,761742436,True,29
7116,validator_21,100867532752,True,809600000,1453200,811053200,True,3
7117,validator_0,951978385790,True,744079997,15350100,759430097,True,29
7118,validator_0,952535280750,True,527536000,29358960,556894960,True,29
7119,validator_35,86336173620,True,501700000,13523400,515223400,False,2
7120,validator_5,300572443690,True,478400000,9564800,487964800,False,9
7121,validator_17,91781853014,True,920639999,26723530,947363529,True,2
7122,validator_0,953284521552,True,727200002,22040800,749240802,True,29
7123,validator_2,597517372847,True,857940004,26097870,884037874,True,18
7124,validator_8,88867966602,True,780896000,18364390,799260390,True,2
7125,validator_1,797954498320,True,628000000,3537140,631537140,False,24
7126,validator_7,213385990170,True,744600000,2357700,746957700,False,6
7127,validator_0,954183525640,True,893220008,5784080,899004088,True,29
7128,validator_2,598222599163,True,678359996,26866320,705226316,True,18
7129,validator_10,104858458554,True,703200007,6425780,709625787,True,3
7130,validator_14,95743490401,True,662200002,73590980,735790982,True,2
7131,validator_14,96475086023,True,696460002,35135620,731595622,True,3
7132,validator_6,211572097242,True,583120008,3048580,586168588,True,6
7133,validator_0,954741161849,True,548240009,9396200,557636209,True,29
7134,validator_3,443602683400,True,466900000,1030280,467930280,False,13
7135,validator_37,66007031670,True,584400000,3671200,588071200,False,2
7136,validator_0,955314634858,True,563354009,10119000,573473009,True,29
7137,validator_20,94164502496,True,823219999,15901650,839121649,True,2
7138,validator_49,62809035200,True,624500000,6245140,630745140,False,1
7139,validator_23,101592428030,True,629480001,11840160,641320161,True,3
7140,validator_6,212219974875,True,637546003,10331630,647877633,True,6
7141,validator_36,65778662100,True,560300000,9651920,569951920,False,2
7142,validator_0,956075009427,True,755599999,4774570,760374569,True,29
7143,validator_4,294533483364,True,394239992,6872500,401112492,True,9
7144,validator_22,115864668102,True,910699999,4220420,914920419,True,3
7145,validator_0,956709290052,True,620165995,14114630,634280625,True,29
7146,validator_35,86855437820,True,515000000,4264200,519264200,False,2
7147,validator_38,71314174170,True,568900000,1299640,570199640,False,2
7148,validator_1,798670919490,True,715000000,1421170,716421170,False,24
7149,validator_3,444274554000,True,670700000,1170600,671870600,False,13
7150,validator_8,89304892998,True,422079996,14846400,436926396,True,2
7151,validator_13,69126663055,True,846099985,31182770,877282755,True,2
7152,validator_4,295093407739,True,544199995,15724380,559924375,True,9
7153,validator_0,957483895343,True,772500001,2105290,774605291,True,29
7154,validator_0,958397057318,True,898360005,14801970,913161975,True,29
7155,validator_0,958924952579,True,507884001,20011260,527895261,True,29
7156,validator_41,61867971850,True,468500000,6200700,474700700,False,1
7157,validator_34,77944228570,True,738400000,1680010,740080010,False,2
7158,validator_5,301138110890,True,564000000,1667200,565667200,False,9
7159,validator_5,301746076170,True,588200000,19765280,607965280,False,9
7160,validator_47,70490450000,True,446900000,1809520,448709520,False,2
7161,validator_17,92429369309,True,636150005,11366290,647516295,True,2
7162,validator_0,959644514198,True,699945989,19615630,719561619,True,29
7163,validator_26,90172061655,True,716366002,48443580,764809582,True,2
7164,validator_17,93102271961,True,658140002,14762650,672902652,True,2
7165,validator_2,598799847709,True,565400006,11848540,577248546,True,18
7166,validator_36,66590780900,True,790000000,22118800,812118800,False,2
7167,validator_2,599633891102,True,815720003,18323390,834043393,True,18
7168,validator_11,79177113934,True,628636003,29552600,658188603,True,2
7169,validator_2,600189867988,True,543000006,12976880,555976886,True,18
7170,validator_15,105990389075,True,758499997,10912810,769412807,True,3
7171,validator_0,960204886002,True,534400004,25971800,560371804,True,30
7172,validator_3,445127214080,True,850700000,1960080,852660080,False,13
7173,validator_1,799114056090,True,435600000,7536600,443136600,False,24
7174,validator_0,961000311742,True,749160000,46265740,795425740,True,30
7175,validator_17,93893266757,True,762005996,28988800,790994796,True,2
7176,validator_45,82820017040,True,554300000,2442940,556742940,False,2
7177,validator_2,601164965870,True,940506002,34591880,975097882,True,18
7178,validator_1,799672284740,True,555300000,2928650,558228650,False,24
7179,validator_23,102271634625,True,647959995,31246600,679206595,True,3
7180,validator_2,601916068511,True,748300001,2802640,751102641,True,18
7181,validator_17,94689251601,True,776140004,19844840,795984844,True,2
7182,validator_10,105532564593,True,657339989,16766050,674106039,True,3
7183,validator_1,800244952320,True,551670000,20997580,572667580,False,25
7184,validator_21,101413286556,True,479720004,66033800,545753804,True,3
7185,validator_6,213051983390,True,818759995,13248520,832008515,True,6
7186,validator_0,961479723215,True,470119993,9291480,479411473,True,30
7187,validator_29,62920662840,True,721500000,10469700,731969700,False,1
7188,validator_40,67849824550,True,744200000,1384040,745584040,False,2
7189,validator_1,800792867510,True,546700000,1215190,547915190,False,25
7190,validator_7,214044709890,True,654400000,4319720,658719720,False,6
7191,validator_10,106228823972,True,683439999,12819380,696259379,True,3
7192,validator_5,302346493670,True,598700000,1717500,600417500,False,9
7193,validator_26,90816218972,True,635219997,8937320,644157317,True,2
7194,validator_1,801525484250,True,722500000,10116740,732616740,False,25
7195,validator_4,295773701872,True,661000003,19294130,680294133,True,9
7196,validator_0,962406002313,True,905399998,20879100,926279098,True,30
7197,validator_6,213781464797,True,697737997,31743410,729481407,True,6
7198,validator_0,963227239304,True,817399991,3837000,821236991,True,30
7199,validator_9,81036442116,True,950500005,32811640,983311645,True,2
7200,validator_30,72108156470,True,579600000,4087200,583687200,False,2
7201,validator_43,64050787060,True,482000000,9252500,491252500,False,2
7202,validator_6,214293675400,True,497340003,14870600,512210603,True,6
7203,validator_15,106779618116,True,749220001,40009040,789229041,True,3
7204,validator_47,71161121100,True,666400000,4271100,670671100,False,2
7205,validator_15,107241844044,True,450620008,11605920,462225928,True,3
7206,validator_1,801919834640,True,391200000,3150390,394350390,False,25
7207,validator_23,102910556677,True,612739992,26182060,638922052,True,3
7208,validator_1,802466489680,True,543100000,3555040,546655040,False,25
7209,validator_13,69845114057,True,700160002,18291000,718451002,True,2
7210,validator_5,302831929660,True,483000000,2435990,485435990,False,9
7211,validator_40,68463746210,True,611500000,2421660,613921660,False,2
7212,validator_6,214947435183,True,632740003,21019780,653759783,True,6
7213,validator_1,802980592980,True,505000000,9103300,514103300,False,25
7214,validator_6,215726664381,True,753339998,25889200,779229198,True,6
7215,validator_4,296690018291,True,893279999,23036420,916316419,True,9
7216,validator_34,78600112420,True,636500000,19383850,655883850,False,2
7217,validator_2,602512121843,True,576000002,20053330,596053332,True,18
7218,validator_37,66514016270,True,487200000,19784600,506984600,False,2
7219,validator_33,86750646410,True,756900000,5354520,762254520,False,2
7220,validator_7,214755812570,True,709600000,1502680,711102680,False,6
7221,validator_15,108087388227,True,833599993,11944190,845544183,True,3
7222,validator_3,445742763390,True,606700000,8849310,615549310,False,13
7223,validator_12,76999356381,True,493340004,42317740,535657744,True,2
7224,validator_1,803506213180,True,524200000,1420200,525620200,False,25
7225,validator_1,803993002760,True,460600000,26189580,486789580,False,25
7226,validator_15,108812906825,True,719339998,6178600,725518598,True,3
7227,validator_2,603239124472,True,694959999,32042630,727002629,True,18
7228,validator_20,94625206393,True,458799997,1903900,460703897,True,2
7229,validator_14,97346343943,True,849820000,21437920,871257920,True,3
7230,validator_40,69047515330,True,579800000,3969120,583769120,False,2
7231,validator_1,804719495400,True,705500000,20992640,726492640,False,25
7232,validator_20,95385632439,True,752299996,8126050,760426046,True,2
7233,validator_1,805415326460,True,693500000,2331060,695831060,False,25
7234,validator_2,603962942573,True,718720001,5098100,723818101,True,18
7235,validator_0,964032775637,True,786300003,19236330,805536333,True,30
7236,validator_1,806133204990,True,711600000,6278530,717878530,False,25
7237,validator_10,107012617888,True,745299996,38493920,783793916,True,3
7238,validator_6,216435475394,True,689479993,19331020,708811013,True,6
7239,validator_10,107867991186,True,807339998,48033300,855373298,True,3
7240,validator_0,964669757576,True,635299999,1681940,636981939,True,30
7241,validator_4,297389730375,True,681740004,17972080,699712084,True,9
7242,validator_0,965413251181,True,725000005,18493600,743493605,True,30
7243,validator_23,103775001700,True,861300003,3145020,864445023,True,3
7244,validator_0,966125905813,True,665740002,46914630,712654632,True,30
7245,validator_14,98248539461,True,894739998,7455520,902195518,True,3
7246,validator_42,80977870770,True,602700000,6599700,609299700,False,2
7247,validator_43,64801383880,True,748700000,1896820,750596820,False,2
7248,validator_0,966869786053,True,717220000,26660240,743880240,True,30
7249,validator_12,77423701787,True,394240006,30105400,424345406,True,2
7250,validator_37,67194558010,True,678300000,2241740,680541740,False,2
7251,validator_23,104379337901,True,561020001,43316200,604336201,True,3
7252,validator_13,70469409466,True,621300009,2995400,624295409,True,2
7253,validator_0,967472244594,True,596100001,6358540,602458541,True,30
7254,validator_4,298016278670,True,612105995,14442300,626548295,True,9
7255,validator_0,967998777434,True,511054000,15478840,526532840,True,30
7256,validator_18,98270538373,True,541200006,8987630,550187636,True,3
7257,validator_11,79892543778,True,694820004,20609840,715429844,True,2
7258,validator_3,446432595000,True,669600000,20231610,689831610,False,13
7259,validator_0,968661993460,True,624300006,38916020,663216026,True,30
7260,validator_36,67075968430,True,474900000,10287530,485187530,False,2
7261,validator_0,969466275687,True,803500007,782220,804282227,True,30
7262,validator_2,604671661408,True,698279995,10438840,708718835,True,18
7263,validator_4,298825723100,True,773920000,35524430,809444430,True,9
7264,validator_0,970233435009,True,746846002,20313320,767159322,True,30
7265,validator_4,299428205947,True,598499997,3982850,602482847,True,9
7266,validator_3,446885759900,True,451000000,2164900,453164900,False,13
7267,validator_0,971006225293,True,769999994,2790290,772790284,True,30
7268,validator_4,300212377535,True,727073998,57097590,784171588,True,9
7269,validator_14,98787409337,True,525399996,13469880,538869876,True,3
7270,validator_0,971702554490,True,691160007,5169190,696329197,True,30
7271,validator_42,81742565770,True,758400000,6295000,764695000,False,2
7272,validator_1,806520209960,True,384310000,2694970,387004970,False,25
7273,validator_0,972372475625,True,625316005,44605130,669921135,True,30
7274,validator_7,215243411960,True,480670000,6929390,487599390,False,6
7275,validator_35,87430399940,True,568100000,6862120,574962120,False,2
7276,validator_3,447352754440,True,440700000,26294540,466994540,False,13
7277,validator_0,973139875461,True,758400006,8999830,767399836,True,30
7278,validator_34,79287282990,True,684200000,2970570,687170570,False,2
7279,validator_23,104914419633,True,528640002,6441730,535081732,True,3
7280,validator_18,99040679567,True,756440004,13701190,770141194,True,3
7281,validator_1,807191800620,True,666500000,5090660,671590660,False,25
7282,validator_2,605302132240,True,602440002,28030830,630470832,True,18
7283,validator_3,447975354640,True,618100000,4500200,622600200,False,13
7284,validator_18,99648567280,True,595860003,12027710,607887713,True,3
7285,validator_7,215888211330,True,638100000,6699370,644799370,False,6
7286,validator_0,973933483111,True,786000010,7607640,793607650,True,30
7287,validator_5,303446784000,True,595000000,19854340,614854340,False,9
7288,validator_38,71930624350,True,579600000,36850180,616450180,False,2
7289,validator_0,974583709882,True,636860001,13366770,650226771,True,30
7290,validator_4,300866322258,True,633320003,20624720,653944723,True,9
7291,validator_12,78010088580,True,549579993,36806800,586386793,True,2
7292,validator_2,606199331785,True,849199995,47999550,897199545,True,18
7293,validator_22,116561281930,True,683065998,13547830,696613828,True,3
7294,validator_43,65426145180,True,618600000,6161300,624761300,False,2
7295,validator_1,807595499020,True,402500000,1198400,403698400,False,25
7296,validator_1,808233911720,True,628900000,9512700,638412700,False,25
7297,validator_0,975302382563,True,689840001,28832680,718672681,True,30
7298,validator_4,301513790792,True,638340004,9128530,647468534,True,9
7299,validator_0,976076863836,True,722619993,51861280,774481273,True,30
7300,validator_3,448694089040,True,710600000,8134400,718734400,False,14
7301,validator_3,449305598490,True,608800000,2709450,611509450,False,14
7302,validator_2,606897806089,True,652540004,45934300,698474304,True,18
7303,validator_2,607614618527,True,672299998,44512440,716812438,True,18
7304,validator_7,216469001970,True,579100000,1690640,580790640,False,6
7305,validator_32,71126746320,True,705600000,5329470,710929470,False,2
7306,validator_43,65973732210,True,547000000,587030,547587030,False,2
7307,validator_2,608228077428,True,591160001,22298900,613458901,True,19
7308,validator_0,976847210717,True,756219991,14126890,770346881,True,30
7309,validator_18,100111882922,True,439080002,24235640,463315642,True,3
7310,validator_3,449874684320,True,549100000,19985830,569085830,False,14
7311,validator_3,450529189360,True,651400000,3105040,654505040,False,14
7312,validator_1,808726929590,True,491400000,1617870,493017870,False,25
7313,validator_5,303880508280,True,424040000,9684280,433724280,False,9
7314,validator_0,977626342189,True,750020002,29111470,779131472,True,30
7315,validator_42,82297499530,True,525000000,29933760,554933760,False,2
7316,validator_2,609049543465,True,818600007,2866030,821466037,True,19
7317,validator_16,76135888089,True,628510003,11785140,640295143,True,2
7318,validator_6,217185004295,True,721394001,28134900,749528901,True,6
7319,validator_1,809328155580,True,564200000,37025990,601225990,False,25
7320,validator_14,99404550061,True,603299994,13840730,617140724,True,3
7321,validator_1,809931832780,True,602200000,1477200,603677200,False,25
7322,validator_0,978442166770,True,787120001,28704580,815824581,True,30
7323,validator_0,979149630836,True,703799996,3664070,707464066,True,30
7324,validator_2,609636764897,True,576454002,10767430,587221432,True,19
7325,validator_1,810556480410,True,623200000,1447630,624647630,False,25
7326,validator_3,451008163860,True,467600000,11374500,478974500,False,14
7327,validator_21,102066352653,True,625419997,27646100,653066097,True,3
7328,validator_7,217167485560,True,688900000,9583590,698483590,False,6
7329,validator_0,979705745236,True,523678000,32436400,556114400,True,30
7330,validator_21,102886093685,True,809260002,10481030,819741032,True,3
7331,validator_38,72654525550,True,697700000,26201200,723901200,False,2
7332,validator_1,811237316180,True,678100000,2735770,680835770,False,25
7333,validator_31,79993843370,True,654500000,21309840,675809840,False,2
7334,validator_20,96217636107,True,807717998,24285670,832003668,True,3
7335,validator_1,811983073300,True,736800000,8957120,745757120,False,25
7336,validator_0,980533016136,True,815266000,12004900,827270900,True,30
7337,validator_36,67634355530,True,556300000,2087100,558387100,False,2
7338,validator_1,812705694800,True,720300000,2321500,722621500,False,25
7339,validator_4,302197189495,True,666600003,16798700,683398703,True,9
7340,validator_7,217747822120,True,572100000,8236560,580336560,False,6
7341,validator_0,981173597941,True,609960005,30621800,640581805,True,30
7342,validator_1,813326723130,True,607100000,13928330,621028330,False,25
7343,validator_8,90006572115,True,688299997,13379120,701679117,True,2
7344,validator_33,87410024210,True,645200000,14177800,659377800,False,2
7345,validator_2,610423537098,True,729460001,57312200,786772201,True,19
7346,validator_25,82773474356,True,684379995,27543400,711923395,True,2
7347,validator_44,72506746990,True,724800000,1991900,726791900,False,2
7348,validator_48,87275198380,True,397500000,8769740,406269740,False,2
7349,validator_12,78594341100,True,558568000,25684520,584252520,True,2
7350,validator_25,83650494885,True,861145999,15874530,877020529,True,2
7351,validator_33,87921993700,True,510400000,1569490,511969490,False,2
7352,validator_6,218055205094,True,863419999,6780800,870200799,True,6
7353,validator_20,96777600430,True,527000003,32964320,559964323,True,3
7354,validator_1,813949602260,True,619800000,3079130,622879130,False,25
7355,validator_31,80572043770,True,557200000,21000400,578200400,False,2
7356,validator_28,93762333365,True,798299995,19134150,817434145,True,2
7357,validator_2,611323010179,True,865920001,33553080,899473081,True,19
7358,validator_47,71687937960,True,518500000,8316860,526816860,False,2
7359,validator_47,72073721790,True,383700000,2083830,385783830,False,2
7360,validator_4,302799468292,True,590439997,11838800,602278797,True,9
7361,validator_18,100703752374,True,567500002,24369450,591869452,True,3
7362,validator_26,91367320871,True,517519999,33581900,551101899,True,2
7363,validator_27,85024413543,True,710635996,6176550,716812546,True,2
7364,validator_31,81126565460,True,545600000,8921690,554521690,False,2
7365,validator_25,84239877084,True,586099999,3282200,589382199,True,2
7366,validator_1,814420946690,True,469000000,2344430,471344430,False,25
7367,validator_1,814978098850,True,537000000,20152160,557152160,False,25
7368,validator_0,981959952471,True,751000000,35354530,786354530,True,30
7369,validator_39,64498558610,True,472200000,3963300,476163300,False,2
7370,validator_41,62521512820,True,651700000,1840970,653540970,False,1
7371,validator_13,71137181664,True,644459998,23312200,667772198,True,2
7372,validator_0,982674368788,True,712599997,1816320,714416317,True,30
7373,validator_19,90415904212,True,767099995,14247300,781347295,True,2
7374,validator_32,71669987280,True,540900000,2340960,543240960,False,2
7375,validator_0,983463442243,True,781320005,7753450,789073455,True,30
7376,validator_1,815730157400,True,724900000,27158550,752058550,False,25
7377,validator_2,611840351091,True,502700002,14640910,517340912,True,19
7378,validator_24,89306842584,True,540600008,1312830,541912838,True,2
7379,validator_0,984039108944,True,550580001,25086700,575666701,True,30
7380,validator_25,84909676012,True,666399988,3398940,669798928,True,2
7381,validator_36,68396988490,True,759900000,2732960,762632960,False,2
7382,validator_0,984743669583,True,675570009,28990630,704560639,True,30
7383,validator_0,985545202288,True,791040005,10492700,801532705,True,30
7384,validator_0,986095269687,True,528339999,21727400,550067399,True,30
7385,validator_7,218345789310,True,591000000,6967190,597967190,False,6
7386,validator_29,63412295650,True,489700000,1932810,491632810,False,1
7387,validator_28,94443237094,True,636919999,43983730,680903729,True,2
7388,validator_8,90782870602,True,723540007,52758480,776298487,True,2
7389,validator_22,117173096960,True,587320000,24495030,611815030,True,3
7390,validator_1,816281953480,True,549300000,2496080,551796080,False,25
7391,validator_1,816656694780,True,364700000,10041300,374741300,False,25
7392,validator_5,304354428750,True,466900000,7020470,473920470,False,9
7393,validator_0,986704688099,True,556160012,53258400,609418412,True,30
7394,validator_19,91215514313,True,778452001,21158100,799610101,True,2
7395,validator_0,987664419825,True,939279996,20451730,959731726,True,30
7396,validator_1,817024516830,True,364240000,3582050,367822050,False,25
7397,validator_26,92047025567,True,673357996,6346700,679704696,True,2
7398,validator_1,817616339260,True,590200000,1622430,591822430,False,25
7399,validator_1,818283033660,True,643900000,22794400,666694400,False,25
7400,validator_1,818828934390,True,543500000,2400730,545900730,False,25
7401,validator_5,305067597450,True,710600000,2568700,713168700,False,9
7402,validator_4,303334537892,True,516140000,18929600,535069600,True,9
7403,validator_0,988353650232,True,634360007,54870400,689230407,True,30
7404,validator_0,989127975961,True,757063999,17261730,774325729,True,30
7405,validator_40,69690889830,True,641000000,2374500,643374500,False,2
7406,validator_33,88478753180,True,552900000,3859480,556759480,False,2
7407,validator_4,304082325610,True,732019998,15767720,747787718,True,9
7408,validator_1,819420099090,True,590200000,964700,591164700,False,25
7409,validator_10,108483863678,True,584005992,31866500,615872492,True,3
7410,validator_0,989690604588,True,512859997,49768630,562628627,True,30
7411,validator_8,91522765121,True,728159999,11734520,739894519,True,2
7412,validator_27,85484154235,True,421710002,38030690,459740692,True,2
7413,validator_25,85478692009,True,550379997,18636000,569015997,True,2
7414,validator_2,612333198469,True,485699998,7147380,492847378,True,19
7415,validator_20,97480169566,True,672499996,30069140,702569136,True,3
7416,validator_1,820126923490,True,687900000,18924400,706824400,False,25
7417,validator_4,304710258252,True,624840002,3092640,627932642,True,9
7418,validator_28,95421474511,True,910297997,67939420,978237417,True,2
7419,validator_0,990599580590,True,892700002,16276000,908976002,True,30
7420,validator_34,80148525660,True,858300000,2942670,861242670,False,2
7421,validator_48,87961122180,True,685000000,923800,685923800,False,2
7422,validator_49,63427517780,True,601600000,16882580,618482580,False,1
7423,validator_34,80628806640,True,478900000,1380980,480280980,False,2
7424,validator_34,81176913540,True,542700000,5406900,548106900,False,2
7425,validator_2,612897354260,True,562300001,1855790,564155791,True,19
7426,validator_10,109305051201,True,795839993,25347530,821187523,True,3
7427,validator_0,991358603196,True,714656006,44366600,759022606,True,30
7428,validator_7,218889269590,True,542100000,1380280,543480280,False,6
7429,validator_27,86342904440,True,813040005,45710200,858750205,True,2
7430,validator_2,613850005292,True,945667992,6983040,952651032,True,19
7431,validator_2,614655158817,True,785419995,19733530,805153525,True,19
7432,validator_23,105499456827,True,575154004,9883190,585037194,True,3
7433,validator_0,992368445593,True,953647997,56194400,1009842397,True,31
7434,validator_0,993186779788,True,778066005,40268190,818334195,True,31
7435,validator_27,87261071496,True,889179996,28987060,918167056,True,2
7436,validator_0,993707580235,True,513123997,7676450,520800447,True,31
7437,validator_31,81577572280,True,448840000,2166820,451006820,False,2
7438,validator_36,69050897070,True,649600000,4308580,653908580,False,2
7439,validator_3,451483868590,True,465300000,10404730,475704730,False,14
7440,validator_1,820814171730,True,685400000,1848240,687248240,False,25
7441,validator_8,92143887253,True,617300002,3822130,621122132,True,2
7442,validator_20,98143980187,True,642920001,20890620,663810621,True,3
7443,validator_0,994625039867,True,896300002,21159630,917459632,True,31
7444,validator_19,91886472440,True,650199997,20758130,670958127,True,2
7445,validator_5,305642198080,True,572400000,2200630,574600630,False,9
7446,validator_0,995579496727,True,935658000,18798860,954456860,True,31
7447,validator_32,72241887720,True,567000000,4900440,571900440,False,2
7448,validator_13,71616131520,True,477299996,1649860,478949856,True,2
7449,validator_37,67854245350,True,640000000,19687340,659687340,False,2
7450,validator_30,72619049220,True,507200000,3692750,510892750,False,2
7451,validator_2,615223408702,True,521180005,47069880,568249885,True,19
7452,validator_44,73173116230,True,656300000,10069240,666369240,False,2
7453,validator_0,996182534826,True,578655999,24382100,603038099,True,31
7454,validator_4,305599391096,True,874260004,14872840,889132844,True,9
7455,validator_5,306179900750,True,533700000,4002670,537702670,False,9
7456,validator_1,821462282750,True,646800000,1311020,648111020,False,25
7457,validator_3,452168092430,True,682670000,1553840,684223840,False,14
7458,validator_46,67857204820,True,559600000,2669400,562269400,False,2
7459,validator_43,66507181350,True,508500000,24949140,533449140,False,2
7460,validator_6,218817118021,True,719126007,42786920,761912927,True,6
7461,validator_2,616212200770,True,953805998,34986070,988792068,True,19
7462,validator_33,89081775410,True,601600000,1422230,603022230,False,2
7463,validator_1,822129098750,True,660200000,6616000,666816000,False,25
7464,validator_1,822893751250,True,757300000,7352500,764652500,False,25
7465,validator_22,117715276651,True,526359991,15819700,542179691,True,3
7466,validator_19,92518414942,True,618360002,13582500,631942502,True,2
7467,validator_10,109812217032,True,485310001,21855830,507165831,True,3
7468,validator_15,109305790220,True,491799995,1083400,492883395,True,3
7469,validator_0,996826429369,True,633220003,10674540,643894543,True,31
7470,validator_2,616977577967,True,764099997,1277200,765377197,True,19
7471,validator_16,76630920785,True,473519996,21512700,495032696,True,2
7472,validator_0,997376135471,True,548100002,1606100,549706102,True,31
7473,validator_4,306113253666,True,489320000,24542570,513862570,True,9
7474,validator_13,72391560618,True,764059998,11369100,775429098,True,2
7475,validator_0,997927010090,True,547639999,3234620,550874619,True,31
7476,validator_48,88765327220,True,783700000,20505040,804205040,False,2
7477,validator_37,68276841060,True,418500000,4095710,422595710,False,2
7478,validator_20,98851448597,True,686754000,20714410,707468410,True,3
7479,validator_46,68489373510,True,625600000,6568690,632168690,False,2
7480,validator_0,998314304085,True,368220005,19073990,387293995,True,31
7481,validator_5,306695874840,True,501500000,14474090,515974090,False,9
7482,validator_21,103412936984,True,523999999,2843300,526843299,True,3
7483,validator_3,452914555030,True,745000000,1462600,746462600,False,14
7484,validator_36,69697061970,True,626100000,20064900,646164900,False,2
7485,validator_13,72906379311,True,512040003,2778690,514818693,True,2
7486,validator_32,72830928850,True,585700000,3341130,589041130,False,2
7487,validator_2,617696340090,True,706859993,11902130,718762123,True,19
7488,validator_0,998801119220,True,472539995,14275140,486815135,True,31
7489,validator_2,618305880086,True,594499996,15040000,609539996,True,19
7490,validator_45,83378505800,True,539300000,19188760,558488760,False,2
7491,validator_0,999356641152,True,551700002,3821930,555521932,True,31
7492,validator_0,999938648453,True,579800001,2207300,582007301,True,31
7493,validator_27,87767691388,True,468659992,37959900,506619892,True,2
7494,validator_1,823573652990,True,660400000,19501740,679901740,False,25
7495,validator_1,824106110290,True,529800000,2657300,532457300,False,25
7496,validator_42,82720517770,True,416300000,6718240,423018240,False,2
7497,validator_5,307379131040,True,680600000,2656200,683256200,False,9
7498,validator_2,618976850156,True,669200000,1770070,670970070,True,19
7499,validator_1,824724022490,True,615600000,2312200,617912200,False,25
7500,validator_0,1000694638082,True,727665999,28323630,755989629,True,31
7501,validator_24,90018015330,True,704199996,6972750,711172746,True,2
7502,validator_33,89551875100,True,459500000,10599690,470099690,False,2
7503,validator_1,825363560590,True,638500000,1038100,639538100,False,25
7504,validator_1,826183118850,True,811600000,7958260,819558260,False,25
7505,validator_2,619771996914,True,768439998,26706760,795146758,True,19
7506,validator_0,1001477827811,True,760559999,22629730,783189729,True,31
7507,validator_7,219585670890,True,694200000,2201300,696401300,False,6
7508,validator_2,620545630879,True,762639995,10993970,773633965,True,19
7509,validator_45,83877673250,True,497300000,1867450,499167450,False,2
7510,validator_40,70258677770,True,559800000,7987940,567787940,False,2
7511,validator_3,453614089120,True,696900000,2634090,699534090,False,14
7512,validator_37,68889626300,True,605500000,7285240,612785240,False,2
7513,validator_21,104068823930,True,655599996,286950,655886946,True,3
7514,validator_22,118424641574,True,668646003,40718920,709364923,True,3
7515,validator_25,86227646006,True,735619997,13334000,748953997,True,2
7516,validator_22,119288425664,True,826904000,36880090,863784090,True,3
7517,validator_3,454287554480,True,662600000,10865360,673465360,False,14
7518,validator_0,1002124268276,True,616200005,30240460,646440465,True,31
7519,validator_1,826608464290,True,405800000,19545440,425345440,False,25
7520,validator_9,81857839541,True,819300005,2097420,821397425,True,2
7521,validator_44,73892954930,True,699000000,20838700,719838700,False,2
7522,validator_8,92798502751,True,642939998,11675500,654615498,True,2
7523,validator_10,110343315954,True,509500002,21598920,531098922,True,3
7524,validator_4,306822474256,True,684640000,24580590,709220590,True,9
7525,validator_28,96066156133,True,630420002,14261620,644681622,True,3
7526,validator_0,1002977795613,True,817620007,35907330,853527337,True,31
7527,validator_1,827159904840,True,542900000,8540550,551440550,False,25
7528,validator_22,119998625359,True,707399995,2799700,710199695,True,3
7529,validator_1,827651239450,True,487700000,3634610,491334610,False,25
7530,validator_31,82178468700,True,585500000,15396420,600896420,False,2
7531,validator_17,95713565230,True,1003399999,20913630,1024313629,True,2
7532,validator_15,109985786351,True,654300001,25696130,679996131,True,3
7533,validator_26,92585371616,True,517759999,20586050,538346049,True,2
7534,validator_2,621117484437,True,564219998,7633560,571853558,True,19
7535,validator_0,1003636154320,True,623018007,35340700,658358707,True,31
7536,validator_31,82662642840,True,473500000,10674140,484174140,False,2
7537,validator_1,828306140920,True,653300000,1601470,654901470,False,25
7538,validator_32,73469652540,True,636400000,2323690,638723690,False,2
7539,validator_6,219357976022,True,538400001,2458000,540858001,True,6
7540,validator_0,1004275445950,True,598280000,41011630,639291630,True,31
7541,validator_40,70906541880,True,627700000,20164110,647864110,False,2
7542,validator_6,219889064944,True,513540002,17548920,531088922,True,6
7543,validator_13,73552789245,True,632740004,13669930,646409934,True,2
7544,validator_6,220774844689,True,882899995,2879750,885779745,True,6
7545,validator_19,93391990758,True,848919986,24655830,873575816,True,2
7546,validator_0,1004914103888,True,624213998,14443940,638657938,True,31
7547,validator_3,454914945510,True,621400000,5991030,627391030,False,14
7548,validator_0,1005521255654,True,599600006,7551760,607151766,True,31
7549,validator_4,307710078329,True,866899993,20704080,887604073,True,9
7550,validator_0,1006510694257,True,975540013,13898590,989438603,True,31
7551,validator_3,455473576240,True,553300000,5330730,558630730,False,14
7552,validator_13,74236703051,True,678140006,5773800,683913806,True,2
7553,validator_7,219995582020,True,389910000,20001130,409911130,False,6
7554,validator_4,308395120749,True,674420000,10622420,685042420,True,9
7555,validator_0,1007165860455,True,648699998,6466200,655166198,True,31
7556,validator_20,99442015739,True,499790002,90777140,590567142,True,3
7557,validator_1,828908952340,True,595400000,7411420,602811420,False,25
7558,validator_29,63987927970,True,568200000,7432320,575632320,False,1
7559,validator_0,1007670585497,True,494520002,10205040,504725042,True,31
7560,validator_45,84709737250,True,828800000,3264000,832064000,False,2
7561,validator_48,89258757940,True,490200000,3230720,493430720,False,2
7562,validator_4,309106231149,True,695980000,15130400,711110400,True,9
7563,validator_1,829459312460,True,527000000,23360120,550360120,False,25
7564,validator_7,220740542540,True,743400000,1560520,744960520,False,6
7565,validator_0,1008300640816,True,627199999,2855320,630055319,True,31
7566,validator_26,93171661371,True,573390005,12899750,586289755,True,2
7567,validator_2,621698029065,True,577599998,2944630,580544628,True,19
7568,validator_4,309839025186,True,722399997,10394040,732794037,True,9
7569,validator_1,830007273060,True,539200000,8760600,547960600,False,25
7570,validator_3,456198500260,True,716300000,8624020,724924020,False,14
7571,validator_2,622398763156,True,659020001,41714090,700734091,True,19
7572,validator_0,1009083155046,True,776620000,5894230,782514230,True,31
7573,validator_34,81798176450,True,613900000,7362910,621262910,False,2
7574,validator_7,221396120540,True,652500000,3078000,655578000,False,6
7575,validator_12,79499103501,True,889200001,15562400,904762401,True,2
7576,validator_2,623006383262,True,598360006,9260100,607620106,True,19
7577,validator_3,456782041000,True,582100000,1440740,583540740,False,14
7578,validator_1,830556286600,True,544500000,4513540,549013540,False,25
7579,validator_1,831166440240,True,602700000,7453640,610153640,False,25
7580,validator_7,221783449800,True,367230000,20099260,387329260,False,6
7581,validator_0,1009691007049,True,605400003,2452000,607852003,True,31
7582,validator_1,831832845440,True,644200000,22205200,666405200,False,25
7583,validator_48,89842432740,True,581500000,2174800,583674800,False,2
7584,validator_9,82660151259,True,746059998,56251720,802311718,True,2
7585,validator_22,120490747047,True,490099998,2021690,492121688,True,3
7586,validator_49,64077502280,True,647500000,2484500,649984500,False,2
7587,validator_28,96881180813,True,749220000,65804680,815024680,True,3
7588,validator_0,1010421679954,True,658840005,71832900,730672905,True,31
7589,validator_10,111258428674,True,861818000,53294720,915112720,True,3
7590,validator_2,623742092927,True,722370005,13339660,735709665,True,19
7591,validator_3,457409290310,True,626100000,1149310,627249310,False,14
7592,validator_2,624644931564,True,875319997,27518640,902838637,True,19
7593,validator_38,73277921950,True,599200000,24196400,623396400,False,2
7594,validator_40,71484798870,True,560300000,17956990,578256990,False,2
7595,validator_23,106193166722,True,684019995,9689900,693709895,True,3
7596,validator_30,73137419320,True,509500000,8870100,518370100,False,2
7597,validator_1,832371934130,True,536300000,2788690,539088690,False,26
7598,validator_25,86668722437,True,432804001,8272430,441076431,True,2
7599,validator_32,74136691870,True,658100000,8939330,667039330,False,2
7600,validator_0,1011186392143,True,749494009,15218180,764712189,True,31
7601,validator_11,80443568075,True,525239997,25784300,551024297,True,2
7602,validator_30,73869327120,True,727800000,4107800,731907800,False,2
7603,validator_14,100173490973,True,766499992,2440920,768940912,True,3
7604,validator_17,96395874629,True,660839999,21469400,682309399,True,3
7605,validator_34,82363575900,True,560000000,5399450,565399450,False,2
7606,validator_1,832966277360,True,591700000,2643230,594343230,False,26
7607,validator_2,625323780406,True,612640002,66208840,678848842,True,19
7608,validator_13,74944844552,True,702500001,5641500,708141501,True,2
7609,validator_3,458065217210,True,633900000,22026900,655926900,False,14
7610,validator_30,74696456510,True,804700000,22429390,827129390,False,2
7611,validator_31,83298815630,True,597300000,38872790,636172790,False,2
7612,validator_3,458886732250,True,817700000,3815040,821515040,False,14
7613,validator_39,65153244610,True,633400000,21286000,654686000,False,2
7614,validator_39,65711487110,True,556000000,2242500,558242500,False,2
7615,validator_10,112140408574,True,861460000,20519900,881979900,True,3
7616,validator_0,1011876528671,True,670799998,19336530,690136528,True,31
7617,validator_2,626095787505,True,752353999,19653100,772007099,True,19
7618,validator_0,1012947301008,True,1040819997,29952340,1070772337,True,31
7619,validator_16,77603370787,True,934980002,37470000,972450002,True,2
7620,validator_1,833729050320,True,753700000,9072960,762772960,False,26
7621,validator_20,100049259419,True,566194000,41049680,607243680,True,3
7622,validator_4,310392729220,True,532739994,20964040,553704034,True,9
7623,validator_3,459566937630,True,677700000,2505380,680205380,False,14
7624,validator_4,311051984048,True,650399998,8854830,659254828,True,9
7625,validator_0,1013760209208,True,768360000,44548200,812908200,True,31
7626,validator_3,460206239530,True,637100000,2201900,639301900,False,14
7627,validator_24,90747402569,True,699019999,30367240,729387239,True,2
7628,validator_2,626806759146,True,665140001,45831640,710971641,True,19
7629,validator_0,1014198595386,True,436339998,2046180,438386178,True,31
7630,validator_19,94164342077,True,748199999,24151320,772351319,True,2
7631,validator_48,90473716540,True,629100000,2183800,631283800,False,2
7632,validator_2,627520995547,True,712400001,1836400,714236401,True,19
7633,validator_32,74766417480,True,623000000,6725610,629725610,False,2
7634,validator_0,1014824497518,True,615340002,10562130,625902132,True,31
7635,validator_1,834328125350,True,595900000,3175030,599075030,False,26
7636,validator_0,1015262422848,True,409654000,28271330,437925330,True,31
7637,validator_1,834820177800,True,481900000,10152450,492052450,False,26
7638,validator_40,72060247210,True,554300000,21148340,575448340,False,2
7639,validator_0,1016129470750,True,853600002,13447900,867047902,True,31
7640,validator_5,307996606840,True,615400000,2075800,617475800,False,9
7641,validator_0,1016692413852,True,534280002,28663100,562943102,True,31
7642,validator_17,97017296714,True,619100005,2322080,621422085,True,3
7643,validator_0,1017401272851,True,698339999,10519000,708858999,True,31
7644,validator_8,93563872145,True,718519994,46849400,765369394,True,2
7645,validator_45,85387431350,True,676300000,1394100,677694100,False,2
7646,validator_35,88083518300,True,635400000,17718360,653118360,False,2
7647,validator_43,67338029910,True,827900000,2948560,830848560,False,2
7648,validator_15,110651002992,True,661380001,3836640,665216641,True,3
7649,validator_3,460758303050,True,549500000,2563520,552063520,False,14
7650,validator_3,461422574440,True,643500000,20771390,664271390,False,14
7651,validator_0,1018216419570,True,813599999,1546720,815146719,True,31
7652,validator_22,121256804173,True,735979996,30077130,766057126,True,3
7653,validator_0,1018927237514,True,689540004,21277940,710817944,True,31
7654,validator_14,100784149312,True,597119999,13538340,610658339,True,3
7655,validator_0,1019778956816,True,848440002,3279300,851719302,True,31
7656,validator_1,835424245400,True,595000000,9067600,604067600,False,26
7657,validator_38,73827750390,True,530000000,19828440,549828440,False,2
7658,validator_2,627986687152,True,445800005,19891600,465691605,True,19
7659,validator_4,311595968302,True,529439994,14544260,543984254,True,9
7660,validator_0,1020458525752,True,678799996,768940,679568936,True,31
7661,validator_17,97800711227,True,768099993,15314520,783414513,True,3
7662,validator_5,308839137760,True,813700000,28830920,842530920,False,9
7663,validator_1,836051655500,True,625800000,1610100,627410100,False,26
7664,validator_38,74397870750,True,567100000,3020360,570120360,False,2
7665,validator_0,1021259264252,True,756800000,43938500,800738500,True,31
7666,validator_41,63025583710,True,481460000,22610890,504070890,False,1
7667,validator_1,836686030720,True,632640000,1735220,634375220,False,26
7668,validator_40,72563644010,True,493800000,9596800,503396800,False,2
7669,validator_14,101375078011,True,585099999,5828700,590928699,True,3
7670,validator_5,309349198740,True,507000000,3060980,510060980,False,9
7671,validator_1,837501693330,True,811900000,3762610,815662610,False,26
7672,validator_24,91314462310,True,547400001,19659740,567059741,True,2
7673,validator_39,66251407460,True,536200000,3720350,539920350,False,2
7674,validator_2,628606165444,True,602779992,16698300,619478292,True,19
7675,validator_0,1021809302045,True,509999993,40037800,550037793,True,31
7676,validator_1,838125337550,True,621400000,2244220,623644220,False,26
7677,validator_14,102071231771,True,675458000,20695760,696153760,True,3
7678,validator_11,81075331396,True,623600001,8163320,631763321,True,2
7679,validator_1,838716208480,True,589700000,1170930,590870930,False,26
7680,validator_1,839317003400,True,570100000,30694920,600794920,False,26
7681,validator_24,92193236079,True,851439999,27333770,878773769,True,2
7682,validator_26,93949108552,True,762600001,14847180,777447181,True,2
7683,validator_23,106834910188,True,639800006,1943460,641743466,True,3
7684,validator_6,221532613283,True,737299994,20468600,757768594,True,6
7685,validator_4,312179793179,True,573559997,10264880,583824877,True,9
7686,validator_1,839999882130,True,680100000,2778730,682878730,False,26
7687,validator_2,629205847873,True,590299999,9382430,599682429,True,19
7688,validator_0,1022508802126,True,675460001,24040080,699500081,True,31
7689,validator_4,312745441977,True,521179998,44468800,565648798,True,9
7690,validator_7,222446000900,True,655800000,6751100,662551100,False,6
7691,validator_17,98399203808,True,573713991,24778590,598492581,True,3
7692,validator_0,1023319081903,True,729139997,81139780,810279777,True,31
7693,validator_1,840552973270,True,543000000,10091140,553091140,False,26
7694,validator_1,841172673800,True,616500000,3200530,619700530,False,26
7695,validator_0,1024096276660,True,774499997,2694760,777194757,True,32
7696,validator_3,461980450510,True,550500000,7376070,557876070,False,14
7697,validator_4,313456560272,True,693939995,17178300,711118295,True,9
7698,validator_2,629747748148,True,538440005,3460270,541900275,True,19
7699,validator_19,95033684308,True,850720001,18622230,869342231,True,2
7700,validator_0,1024820752225,True,673439995,51035570,724475565,True,32
7701,validator_4,314189653663,True,712540001,20553390,733093391,True,9
7702,validator_9,83341284056,True,660895997,20236800,681132797,True,2
7703,validator_13,75658977381,True,711139999,2992830,714132829,True,2
7704,validator_48,90988304540,True,513000000,1588000,514588000,False,2
7705,validator_2,630562978849,True,780940001,34290700,815230701,True,19
7706,validator_0,1025362755326,True,532140001,9863100,542003101,True,32
7707,validator_4,314800776535,True,586260012,24862860,611122872,True,9
7708,validator_2,631267781626,True,698199997,6602780,704802777,True,19
7709,validator_1,841871037970,True,695600000,2764170,698364170,False,26
7710,validator_16,78305324620,True,692700003,9253830,701953833,True,2
7711,validator_3,462565578940,True,581600000,3528430,585128430,False,14
7712,validator_1,842380241090,True,507400000,1803120,509203120,False,26
7713,validator_1,842891517140,True,508900000,2376050,511276050,False,26
7714,validator_0,1026353180658,True,951600002,38825330,990425332,True,32
7715,validator_2,631783902055,True,497119999,19000430,516120429,True,19
7716,validator_5,309990617260,True,640400000,1018520,641418520,False,9
7717,validator_46,69297902410,True,805800000,2728900,808528900,False,2
7718,validator_5,310601808800,True,609000000,2191540,611191540,False,9
7719,validator_37,69470241900,True,558800000,21815600,580615600,False,2
7720,validator_5,311321409670,True,712200000,7400870,719600870,False,9
7721,validator_34,83037639680,True,671800000,2263780,674063780,False,2
7722,validator_1,843470095300,True,562260000,16318160,578578160,False,26
7723,validator_23,107468694984,True,619779996,14004800,633784796,True,3
7724,validator_33,90061815330,True,501400000,8540230,509940230,False,2
7725,validator_43,67934792010,True,595200000,1562100,596762100,False,2
7726,validator_2,632691018877,True,883040002,24076820,907116822,True,19
7727,validator_1,844039551420,True,566200000,3256120,569456120,False,26
7728,validator_2,633412344973,True,711899996,9426100,721326096,True,19
7729,validator_11,81737700784,True,645403998,16965390,662369388,True,2
7730,validator_2,634052006369,True,629859996,9801400,639661396,True,19
7731,validator_3,463102409770,True,533700000,3130830,536830830,False,14
7732,validator_1,844584419610,True,543400000,1468190,544868190,False,26
7733,validator_16,79052635810,True,727540000,19771190,747311190,True,2
7734,validator_2,634612996352,True,542418003,18571980,560989983,True,19
7735,validator_34,83759643160,True,718100000,3903480,722003480,False,2
7736,validator_14,102784849671,True,697100000,16517900,713617900,True,3
7737,validator_2,635276903177,True,631180005,32726820,663906825,True,19
7738,validator_20,100730273230,True,661240001,19773810,681013811,True,3
7739,validator_2,635876685672,True,595859995,3922500,599782495,True,19
7740,validator_9,84004151955,True,638759999,24107900,662867899,True,2
7741,validator_0,1027140211815,True,750459997,36571160,787031157,True,32
7742,validator_1,845123041540,True,537000000,1621930,538621930,False,26
7743,validator_2,636611574073,True,721840001,13048400,734888401,True,19
7744,validator_20,101440129241,True,689520011,20336000,709856011,True,3
7745,validator_15,111549220713,True,866340001,31877720,898217721,True,3
7746,validator_1,845675680920,True,543900000,8739380,552639380,False,26
7747,validator_0,1027945784616,True,784380001,21192800,805572801,True,32
7748,validator_0,1028745068696,True,794300000,4984080,799284080,True,32
7749,validator_0,1029194867740,True,419116004,30683040,449799044,True,32
7750,validator_2,637298570682,True,685600009,1396600,686996609,True,19
7751,validator_2,638209625863,True,876400001,34655180,911055181,True,19
7752,validator_0,1029762647570,True,521160000,46619830,567779830,True,32
7753,validator_26,94840854886,True,834185994,57560340,891746334,True,2
7754,validator_0,1030540780067,True,776099997,2032500,778132497,True,32
7755,validator_7,223050447230,True,601200000,3246330,604446330,False,6
7756,validator_39,66931544260,True,649500000,30636800,680136800,False,2
7757,validator_0,1031605128247,True,1040540010,23808170,1064348180,True,32
7758,validator_2,639045328572,True,826496009,9206700,835702709,True,19
7759,validator_32,75366877840,True,594200000,6260360,600460360,False,2
7760,validator_0,1032378174787,True,743574000,29472540,773046540,True,32
7761,validator_1,846240434390,True,562400000,2353470,564753470,False,26
7762,validator_0,1033078173055,True,697299998,2698270,699998268,True,32
7763,validator_34,84279399900,True,512600000,7156740,519756740,False,2
7764,validator_8,94222443826,True,650140001,8431680,658571681,True,2
7765,validator_33,90683766850,True,613500000,8451520,621951520,False,2
7766,validator_20,102128164333,True,677020002,11015090,688035092,True,3
7767,validator_1,846925439950,True,675400000,9605560,685005560,False,26
7768,validator_0,1034013245682,True,922439997,12632630,935072627,True,32
7769,validator_3,463817161810,True,711600000,3152040,714752040,False,14
7770,validator_23,108086361663,True,574619999,43046680,617666679,True,3
7771,validator_7,223549888910,True,461200000,38241680,499441680,False,6
7772,validator_45,86062455070,True,653100000,21923720,675023720,False,2
7773,validator_4,315513492599,True,700149994,12566070,712716064,True,9
7774,validator_1,847514016580,True,578600000,9976630,588576630,False,26
7775,validator_4,316162708533,True,625660004,23555930,649215934,True,9
7776,validator_0,1034739142060,True,705799998,20096380,725896378,True,32
7777,validator_2,639737302053,True,680880001,11093480,691973481,True,19
7778,validator_48,91550640280,True,558400000,3935740,562335740,False,2
7779,validator_7,224240865400,True,682700000,8276490,690976490,False,7
7780,validator_4,316867745829,True,677773996,27263300,705037296,True,9
7781,validator_16,79727138692,True,653820002,20682880,674502882,True,2
7782,validator_10,112844518170,True,702099996,2009600,704109596,True,3
7783,validator_16,80331130660,True,595939998,8051970,603991968,True,2
7784,validator_0,1035669976790,True,922400000,8434730,930834730,True,32
7785,validator_47,72923434080,True,843300000,6412290,849712290,False,2
7786,validator_41,63657448240,True,612550000,19314530,631864530,False,1
7787,validator_3,464334231050,True,513800000,3269240,517069240,False,14
7788,validator_2,640646095251,True,865293998,43499200,908793198,True,20
7789,validator_39,67532943200,True,590900000,10498940,601398940,False,2
7790,validator_0,1036470611706,True,798799996,1834920,800634916,True,32
7791,validator_3,465068270450,True,731200000,2839400,734039400,False,14
7792,validator_25,87262649742,True,571660005,22267300,593927305,True,2
7793,validator_3,465493282080,True,422500000,2511630,425011630,False,14
7794,validator_31,83808122350,True,506200000,3106720,509306720,False,2
7795,validator_20,102980758298,True,831899995,20693970,852593965,True,3
7796,validator_0,1037267360399,True,793359993,3388700,796748693,True,32
7797,validator_6,222037806885,True,493120002,12073600,505193602,True,6
7798,validator_2,641468565483,True,803759992,18710240,822470232,True,20
7799,validator_0,1037999413678,True,724299999,7753280,732053279,True,32
7800,validator_3,466085454310,True,571100000,21072230,592172230,False,14
7801,validator_1,848336661810,True,798200000,24445230,822645230,False,26
7802,validator_44,74523459110,True,620300000,10204180,630504180,False,2
7803,validator_0,1038772356135,True,765399997,7542460,772942457,True,32
7804,validator_3,466512860140,True,424900000,2505830,427405830,False,14
7805,validator_11,82443902215,True,684640001,21561430,706201431,True,2
7806,validator_0,1039665419235,True,889500000,3563100,893063100,True,32
7807,validator_1,848976264340,True,637000000,2602530,639602530,False,26
7808,validator_49,64698000500,True,616600000,3898220,620498220,False,2
7809,validator_44,74994043500,True,459200000,11384390,470584390,False,2
7810,validator_1,849586707130,True,593400000,17042790,610442790,False,26
7811,validator_24,93021250442,True,820400003,7614360,828014363,True,2
7812,validator_3,467294644930,True,778200000,3584790,781784790,False,14
7813,validator_9,84741090271,True,709239996,27698320,736938316,True,2
7814,validator_0,1040589788214,True,894907989,29460990,924368979,True,32
7815,validator_4,317476203785,True,577999996,30457960,608457956,True,9
7816,validator_7,224766188900,True,521000000,4323500,525323500,False,7
7817,validator_1,850102936030,True,512500000,3728900,516228900,False,26
7818,validator_0,1041490406618,True,880666004,19952400,900618404,True,32
7819,validator_1,850690579750,True,567600000,20043720,587643720,False,26
7820,validator_1,851334221090,True,634100000,9541340,643641340,False,26
7821,validator_1,852048006150,True,676100000,37685060,713785060,False,26
7822,validator_21,105108366553,True,1018200003,21342620,1039542623,True,3
7823,validator_5,312063705150,True,738600000,3695480,742295480,False,9
7824,validator_0,1042265440094,True,748419996,26613480,775033476,True,32
7825,validator_2,642152751086,True,672399993,11785610,684185603,True,20
7826,validator_14,103739073204,True,921200003,33023530,954223533,True,3
7827,validator_0,1043062685825,True,757040001,40205730,797245731,True,32
7828,validator_38,74974231050,True,566400000,9960300,576360300,False,2
7829,validator_16,81150833560,True,795520000,24182900,819702900,True,2
7830,validator_11,83418456634,True,945859999,28694420,974554419,True,2
7831,validator_26,95570180778,True,695380002,33945890,729325892,True,2
7832,validator_31,84590012190,True,762400000,19489840,781889840,False,2
7833,validator_3,467778843830,True,473600000,10598900,484198900,False,14
7834,validator_2,642937497257,True,777340001,7406170,784746171,True,20
7835,validator_39,68356374930,True,819100000,4331730,823431730,False,2
7836,validator_10,113582503877,True,715920007,22065700,737985707,True,3
7837,validator_1,852631043800,True,577000000,6037650,583037650,False,26
7838,validator_0,1043480214863,True,392139998,25389040,417529038,True,32
7839,validator_7,225391279440,True,615400000,9690540,625090540,False,7
7840,validator_1,853070756520,True,419600000,20112720,439712720,False,26
7841,validator_5,312628944380,True,561900000,3339230,565239230,False,9
7842,validator_36,70440076870,True,739300000,3714900,743014900,False,2
7843,validator_5,313190241060,True,557900000,3396680,561296680,False,9
7844,validator_12,80090142403,True,554300002,36738900,591038902,True,2
7845,validator_1,853562943420,True,483600000,8586900,492186900,False,26
7846,validator_0,1044219327719,True,736599996,2512860,739112856,True,32
7847,validator_3,468458504330,True,676200000,3460500,679660500,False,14
7848,validator_15,112142915564,True,552228001,41466850,593694851,True,3
7849,validator_10,114229151469,True,638160002,8487590,646647592,True,3
7850,validator_1,854243660340,True,669600000,11116920,680716920,False,26
7851,validator_20,103615477936,True,624899998,9819640,634719638,True,3
7852,validator_5,313805953190,True,612200000,3512130,615712130,False,9
7853,validator_2,643512628113,True,563879996,11250860,575130856,True,20
7854,validator_18,101472264008,True,738026004,30485630,768511634,True,3
7855,validator_2,644381189743,True,866300000,2261630,868561630,True,20
7856,validator_21,105953378585,True,824940002,20072030,845012032,True,3
7857,validator_12,80970782106,True,877700003,2939700,880639703,True,2
7858,validator_2,645242081643,True,852650000,8241900,860891900,True,20
7859,validator_0,1045197686078,True,969019999,9338360,978358359,True,32
7860,validator_39,68855727560,True,496600000,2752630,499352630,False,2
7861,validator_4,318139416780,True,652019995,11193000,663212995,True,9
7862,validator_1,854921142160,True,675700000,1781820,677481820,False,26
7863,validator_6,222757814192,True,682000007,38007300,720007307,True,6
7864,validator_0,1045776708870,True,568899992,10122800,579022792,True,32
7865,validator_47,73460640910,True,535900000,1306830,537206830,False,2
7866,validator_47,74088240280,True,625000000,2599370,627599370,False,2
7867,validator_45,86530918530,True,467000000,1463460,468463460,False,2
7868,validator_3,469273247400,True,812700000,2043070,814743070,False,14
7869,validator_28,97585884540,True,684819997,19883730,704703727,True,3
7870,validator_0,1046552572543,True,769900003,5963670,775863673,True,32
7871,validator_3,469832053850,True,557000000,1806450,558806450,False,14
7872,validator_3,470630836590,True,796700000,2082740,798782740,False,14
7873,validator_28,98377331444,True,779690004,11756900,791446904,True,3
7874,validator_1,855612895030,True,682900000,8852870,691752870,False,26
7875,validator_0,1047146158036,True,551279993,42305500,593585493,True,32
7876,validator_6,223325868803,True,547700011,20354600,568054611,True,6
7877,validator_1,856202300160,True,586550000,2855130,589405130,False,26
7878,validator_24,93769146548,True,730625996,17270110,747896106,True,2
7879,validator_0,1047893555459,True,717299993,30097430,747397423,True,32
7880,validator_0,1048703407555,True,790999996,18852100,809852096,True,32
7881,validator_23,108875894453,True,775928000,13604790,789532790,True,3
7882,validator_22,121950827908,True,641499995,52523740,694023735,True,3
7883,validator_45,87033444400,True,500800000,1725870,502525870,False,2
7884,validator_17,99179366103,True,770119995,10042300,780162295,True,3
7885,validator_2,645770326742,True,523919999,4325100,528245099,True,20
7886,validator_21,106553459177,True,576219992,23860600,600080592,True,3
7887,validator_1,856885300740,True,663700000,19300580,683000580,False,26
7888,validator_8,94842791532,True,593340006,27007700,620347706,True,2
7889,validator_48,92123367180,True,570000000,2726900,572726900,False,2
7890,validator_21,107373491762,True,784637995,35394590,820032585,True,3
7891,validator_25,88011246836,True,714619994,33977100,748597094,True,2
7892,validator_33,91222207280,True,518100000,20340430,538440430,False,2
7893,validator_15,112782387760,True,637199996,2272200,639472196,True,3
7894,validator_4,318863756298,True,717899998,6439520,724339518,True,9
7895,validator_21,108090432306,True,682540004,34400540,716940544,True,3
7896,validator_10,115162819381,True,929819992,3847920,933667912,True,3
7897,validator_2,646424545239,True,607157997,47060500,654218497,True,20
7898,validator_15,113551556483,True,768199993,968730,769168723,True,3
7899,validator_5,314619841650,True,812200000,1688460,813888460,False,9
7900,validator_0,1049452749632,True,721739997,27602080,749342077,True,32
7901,validator_21,108964277743,True,838779997,35065440,873845437,True,3
7902,validator_1,857505706850,True,618200000,2206110,620406110,False,26
7903,validator_2,647349273962,True,881759993,42968730,924728723,True,20
7904,validator_28,98950526151,True,570100007,3094700,573194707,True,3
7905,validator_3,471307534790,True,657500000,19198200,676698200,False,14
7906,validator_0,1050247105129,True,784899997,9455500,794355497,True,32
7907,validator_44,75583607220,True,585200000,4363720,589563720,False,2
7908,validator_41,64104457320,True,421400000,25609080,447009080,False,2
7909,validator_7,225946207070,True,545140000,9787630,554927630,False,7
7910,validator_17,99957487974,True,742340001,35781870,778121871,True,3
7911,validator_1,857980022820,True,454600000,19715970,474315970,False,26
7912,validator_40,73276105110,True,710100000,2361100,712461100,False,2
7913,validator_33,92000984550,True,777100000,1677270,778777270,False,2
7914,validator_2,648032885188,True,681500006,2111220,683611226,True,20
7915,validator_1,858682005140,True,700200000,1782320,701982320,False,26
7916,validator_27,88524907127,True,746759999,10455740,757215739,True,2
7917,validator_4,319665500022,True,785040004,16703720,801743724,True,9
7918,validator_2,648603974264,True,532199996,38889080,571089076,True,20
7919,validator_2,649299708060,True,684999996,10733800,695733796,True,20
7920,validator_11,84134818440,True,705500006,10861800,716361806,True,2
7921,validator_1,859154567150,True,462800000,9762010,472562010,False,26
7922,validator_20,104046429452,True,421800006,9151510,430951516,True,3
7923,validator_4,320311495789,True,641819997,4175770,645995767,True,10
7924,validator_18,102056254537,True,554040009,29950520,583990529,True,3
7925,validator_12,81846697853,True,844070007,31845740,875915747,True,2
7926,validator_2,650058727136,True,744039996,14979080,759019076,True,20
7927,validator_37,70135139830,True,662500000,2397930,664897930,False,2
7928,validator_3,471924314090,True,608500000,8279300,616779300,False,14
7929,validator_0,1050949785031,True,694196002,8483900,702679902,True,32
7930,validator_38,75624726150,True,642400000,8095100,650495100,False,2
7931,validator_16,81768610992,True,609040002,8737430,617777432,True,2
7932,validator_1,859690317290,True,529000000,6750140,535750140,False,26
7933,validator_5,315244630050,True,614900000,9888400,624788400,False,9
7934,validator_2,650542058204,True,477739998,5591070,483331068,True,20
7935,validator_25,88637840566,True,608120000,18473730,626593730,True,2
7936,validator_6,224023072626,True,673140003,24063820,697203823,True,7
7937,validator_37,70794491660,True,658700000,651830,659351830,False,2
7938,validator_4,321184355969,True,833860000,39000180,872860180,True,10
7939,validator_28,99628120053,True,674000002,3593900,677593902,True,3
7940,validator_42,83194618100,True,470400000,3700330,474100330,False,2
7941,validator_22,122734402606,True,764099998,19474700,783574698,True,3
7942,validator_3,472530983620,True,602600000,4069530,606669530,False,14
7943,validator_41,64702496300,True,596100000,1938980,598038980,False,2
7944,validator_23,109600961151,True,702379998,22686700,725066698,True,3
7945,validator_0,1051517552875,True,535670004,32097840,567767844,True,32
7946,validator_1,860368262020,True,653900000,24044730,677944730,False,26
7947,validator_11,84797220687,True,637179997,25222250,662402247,True,2
7948,validator_46,69866409750,True,565700000,2807340,568507340,False,2
7949,validator_22,123294018057,True,523216001,36399450,559615451,True,3
7950,validator_1,861042370230,True,641700000,32408210,674108210,False,26
7951,validator_1,861779269030,True,735300000,1598800,736898800,False,26
7952,validator_21,109625542545,True,639720002,21544800,661264802,True,3
7953,validator_1,862307257030,True,516600000,11388000,527988000,False,26
7954,validator_32,76214312330,True,827700000,19734490,847434490,False,2
7955,validator_25,89360728310,True,681220004,41667740,722887744,True,2
7956,validator_26,96216420383,True,644800005,1439600,646239605,True,3
7957,validator_34,84788419330,True,507800000,1219430,509019430,False,2
7958,validator_24,94734146378,True,963800000,1199830,964999830,True,2
7959,validator_3,473169492560,True,633300000,5208940,638508940,False,14
7960,validator_22,123984384044,True,666619997,23745990,690365987,True,3
7961,validator_2,651316011776,True,763446002,10507570,773953572,True,20
7962,validator_21,110301793511,True,672700006,3550960,676250966,True,3
7963,validator_5,315889680380,True,635600000,9450330,645050330,False,9
7964,validator_1,863024359630,True,714300000,2802600,717102600,False,26
7965,validator_0,1052288821206,True,768100001,3168330,771268331,True,32
7966,validator_16,82431117170,True,637797998,24708180,662506178,True,2
7967,validator_40,73860840890,True,582400000,2335780,584735780,False,2
7968,validator_1,863599586530,True,558300000,16926900,575226900,False,26
7969,validator_37,71424689080,True,609900000,20297420,630197420,False,2
7970,validator_5,316729438800,True,831300000,8458420,839758420,False,9
7971,validator_2,651832035317,True,499368001,16655540,516023541,True,20
7972,validator_6,224489933218,True,451560002,15300590,466860592,True,7
7973,validator_2,652756390856,True,912199999,12155540,924355539,True,20
7974,validator_1,864348249310,True,742200000,6462780,748662780,False,27
7975,validator_31,85176346450,True,584900000,1434260,586334260,False,2
7976,validator_46,70483069590,True,613800000,2859840,616659840,False,2
7977,validator_11,85481125480,True,652880003,31024790,683904793,True,2
7978,validator_0,1052964984325,True,673099999,3063120,676163119,True,32
7979,validator_18,102884892878,True,823040011,5598330,828638341,True,3
7980,validator_5,317214007100,True,467300000,17268300,484568300,False,9
7981,validator_5,317764836880,True,537500000,13329780,550829780,False,9
7982,validator_15,114237011614,True,639120001,46335130,685455131,True,3
7983,validator_0,1053595059129,True,617370004,12704800,630074804,True,32
7984,validator_11,86046378985,True,522559995,42693510,565253505,True,2
7985,validator_31,85745738030,True,566000000,3391580,569391580,False,2
7986,validator_1,864904170210,True,551500000,4420900,555920900,False,27
7987,validator_0,1054209182922,True,596519993,17603800,614123793,True,32
7988,validator_38,76238613870,True,612400000,1487720,613887720,False,2
7989,validator_14,104418393181,True,677199997,2119980,679319977,True,3
7990,validator_6,224996201601,True,499040003,7228380,506268383,True,7
7991,validator_6,225776417239,True,777799998,2415640,780215638,True,7
7992,validator_21,111062005779,True,752159998,8052270,760212268,True,3
7993,validator_1,865413592150,True,504400000,5021940,509421940,False,27
7994,validator_0,1054883908831,True,659479999,15245910,674725909,True,32
7995,validator_26,96949495599,True,708199996,24875220,733075216,True,3
7996,validator_4,321672793804,True,430839995,57597840,488437835,True,10
7997,validator_44,76332649400,True,747000000,2042180,749042180,False,2
7998,validator_17,100580713003,True,605239999,17985030,623225029,True,3
7999,validator_0,1055714824319,True,807459998,23455490,830915488,True,32
8000,validator_14,104926240789,True,491819998,16027610,507847608,True,3
8001,validator_17,101216972080,True,599220007,37039070,636259077,True,3
8002,validator_32,76726851900,True,512100000,439570,512539570,False,2
8003,validator_1,866180926880,True,765700000,1634730,767334730,False,27
8004,validator_36,71102728090,True,659600000,3051220,662651220,False,2
8005,validator_28,100379812844,True,713940001,37752790,751692791,True,3
8006,validator_0,1056315052016,True,565940007,34287690,600227697,True,33
8007,validator_25,90028205350,True,660600000,6877040,667477040,True,2
8008,validator_0,1056992869497,True,667699991,10117490,677817481,True,33
8009,validator_21,111703792712,True,631714003,10072930,641786933,True,3
8010,validator_8,95317520049,True,469499997,5228520,474728517,True,2
8011,validator_0,1057901916501,True,904100004,4947000,909047004,True,33
8012,validator_21,112529210623,True,793808001,31609910,825417911,True,3
8013,validator_35,88933331470,True,847800000,2013170,849813170,False,2
8014,validator_24,95264700975,True,521763997,8790600,530554597,True,2
8015,validator_40,74470346600,True,600800000,8705710,609505710,False,2
8016,validator_32,77351872800,True,621600000,3420900,625020900,False,2
8017,validator_22,124579456458,True,584124004,10948410,595072414,True,3
8018,validator_5,318481541150,True,715200000,1504270,716704270,False,9
8019,validator_0,1058669182922,True,766200001,1066420,767266421,True,33
8020,validator_36,71778546630,True,654500000,21318540,675818540,False,2
8021,validator_1,866735778250,True,553000000,1851370,554851370,False,27
8022,validator_49,65233295230,True,529500000,5794730,535294730,False,2
8023,validator_11,86774968730,True,717640005,10949740,728589745,True,2
8024,validator_0,1059354665800,True,678499998,6982880,685482878,True,33
8025,validator_30,75344885750,True,628170000,20259240,648429240,False,2
8026,validator_21,113118629129,True,583560006,5858500,589418506,True,3
8027,validator_21,113780996555,True,638314006,24053420,662367426,True,3
8028,validator_26,97604065880,True,609837991,44732290,654570281,True,3
8029,validator_7,226704953180,True,738700000,20046110,758746110,False,7
8030,validator_2,653729252249,True,948600003,24261390,972861393,True,20
8031,validator_8,95927916132,True,576328003,34068080,610396083,True,2
8032,validator_22,125334187848,True,731460000,23271390,754731390,True,3
8033,validator_21,114585467116,True,798740001,5730560,804470561,True,3
8034,validator_47,74788615720,True,674600000,25775440,700375440,False,2
8035,validator_17,101958257071,True,734400001,6884990,741284991,True,3
8036,validator_3,473986056590,True,814600000,1964030,816564030,False,14
8037,validator_40,75158375320,True,676300000,11728720,688028720,False,2
8038,validator_3,474571504130,True,565700000,19747540,585447540,False,14
8039,validator_6,226856909025,True,1060846006,19645780,1080491786,True,7
8040,validator_39,69731802960,True,855800000,20275400,876075400,False,2
8041,validator_3,475221973500,True,631200000,19269370,650469370,False,14
8042,validator_5,319098054460,True,613100000,3413310,616513310,False,9
8043,validator_0,1060064965836,True,707699996,2600040,710300036,True,33
8044,validator_10,115896913358,True,713540007,20553970,734093977,True,3
8045,validator_2,654476059895,True,730240006,16567640,746807646,True,20
8046,validator_37,72171211400,True,718600000,27922320,746522320,False,2
8047,validator_30,76022969970,True,676200000,1884220,678084220,False,2
8048,validator_2,655062636082,True,546199997,40376190,586576187,True,20
8049,validator_25,90799067524,True,744309994,26552180,770862174,True,2
8050,validator_38,76863106470,True,622000000,2492600,624492600,False,2
8051,validator_4,322426393605,True,747800001,5799800,753599801,True,10
8052,validator_0,1060911401375,True,804879999,41555540,846435539,True,33
8053,validator_5,319720193040,True,620200000,1938580,622138580,False,9
8054,validator_0,1061687921817,True,744880002,31640440,776520442,True,33
8055,validator_0,1062458343942,True,745899995,24522130,770422125,True,33
8056,validator_0,1063017531618,True,552499996,6687680,559187676,True,33
8057,validator_40,75957565820,True,797300000,1890500,799190500,False,2
8058,validator_7,227308524160,True,599700000,3870980,603570980,False,7
8059,validator_35,89436622800,True,476100000,27191330,503291330,False,2
8060,validator_2,655876269324,True,809620002,4013240,813633242,True,20
8061,validator_3,475866147730,True,625100000,19074230,644174230,False,14
8062,validator_0,1063731092125,True,687932007,25628500,713560507,True,33
8063,validator_27,89283262270,True,689080003,69275140,758355143,True,2
8064,validator_4,323211957898,True,762739993,22824300,785564293,True,10
8065,validator_0,1064377484820,True,643699995,2692700,646392695,True,33
8066,validator_26,98191492919,True,585099999,2327040,587427039,True,3
8067,validator_23,110414692485,True,770071994,43659340,813731334,True,3
8068,validator_2,656504729305,True,603300001,25159980,628459981,True,20
8069,validator_0,1065212225069,True,831799999,2940250,834740249,True,33
8070,validator_3,476705027770,True,814400000,24480040,838880040,False,14
8071,validator_9,85419639910,True,660573999,17975640,678549639,True,2
8072,validator_32,77815166640,True,456900000,6393840,463293840,False,2
8073,validator_30,76601566670,True,577700000,896700,578596700,False,2
8074,validator_3,477124435200,True,397700000,21707430,419407430,False,14
8075,validator_8,96506176831,True,559257999,19002700,578260699,True,3
8076,validator_0,1065882081892,True,668399993,1456830,669856823,True,33
8077,validator_10,116672031002,True,764710004,10407640,775117644,True,3
8078,validator_2,657006818565,True,493200000,8889260,502089260,True,20
8079,validator_5,320355777830,True,632900000,2684790,635584790,False,10
8080,validator_6,227709266945,True,811580000,40777920,852357920,True,7
8081,validator_5,320803558110,True,439200000,8580280,447780280,False,10
8082,validator_0,1066266981284,True,375459992,9439400,384899392,True,33
8083,validator_30,77352888930,True,723100000,28222260,751322260,False,2
8084,validator_0,1066872633902,True,577319998,28332620,605652618,True,33
8085,validator_2,657552803565,True,518740000,27245000,545985000,True,20
8086,validator_49,65776540850,True,541400000,1845620,543245620,False,2
8087,validator_3,477922972080,True,777200000,21336880,798536880,False,14
8088,validator_5,321352421610,True,543100000,5763500,548863500,False,10
8089,validator_3,478628012130,True,683100000,21940050,705040050,False,14
8090,validator_8,97222378764,True,713200003,3001930,716201933,True,3
8091,validator_3,478991150030,True,361500000,1637900,363137900,False,14
8092,validator_0,1067561171965,True,679399993,9138070,688538063,True,33
8093,validator_5,321991176210,True,637500000,1254600,638754600,False,10
8094,validator_13,76321075182,True,649420001,12677800,662097801,True,2
8095,validator_11,87728701466,True,940400006,13332730,953732736,True,2
8096,validator_7,227952000660,True,639600000,3876500,643476500,False,7
8097,validator_2,658309305482,True,735359997,21141920,756501917,True,20
8098,validator_0,1068085974811,True,498200006,26602840,524802846,True,33
8099,validator_1,867343984480,True,607100000,1106230,608206230,False,27
8100,validator_2,658971426870,True,635780008,26341380,662121388,True,20
8101,validator_34,85361192530,True,569300000,3473200,572773200,False,2
8102,validator_0,1068580678517,True,482140006,12563700,494703706,True,33
8103,validator_1,867958241510,True,594200000,20057030,614257030,False,27
8104,validator_31,86285444930,True,536500000,3206900,539706900,False,2
8105,validator_3,479577850970,True,583700000,3000940,586700940,False,14
8106,validator_17,102445452268,True,484299997,2895200,487195197,True,3
8107,validator_25,91412698662,True,611499998,2131140,613631138,True,2
8108,validator_4,323782727425,True,552040007,18729520,570769527,True,10
8109,validator_3,480063135920,True,475400000,9884950,485284950,False,15
8110,validator_1,868657837120,True,698200000,1395610,699595610,False,27
8111,validator_19,95655163538,True,601300000,20179230,621479230,True,2
8112,validator_3,480749430050,True,677500000,8794130,686294130,False,15
8113,validator_29,64618939040,True,623000000,8011070,631011070,False,2
8114,validator_0,1069433412419,True,818000002,34733900,852733902,True,33
8115,validator_37,72598103800,True,407680000,19212400,426892400,False,2
8116,validator_17,103151605473,True,682259995,23893210,706153205,True,3
8117,validator_15,114768794750,True,506299996,25483140,531783136,True,3
8118,validator_15,115481536383,True,692560003,20181630,712741633,True,3
8119,validator_1,869090367220,True,430200000,2330100,432530100,False,27
8120,validator_36,72511227050,True,730200000,2480420,732680420,False,2
8121,validator_0,1070144079954,True,677279995,33387540,710667535,True,33
8122,validator_45,87553399500,True,510600000,9355100,519955100,False,2
8123,validator_10,117372596298,True,665359996,35205300,700565296,True,3
8124,validator_32,78569807940,True,752200000,2441300,754641300,False,2
8125,validator_6,228389415703,True,669500008,10648750,680148758,True,7
8126,validator_0,1070715737805,True,533479991,38177860,571657851,True,33
8127,validator_5,322677922930,True,646200000,40546720,686746720,False,10
8128,validator_6,229282847571,True,848079998,45351870,893431868,True,7
8129,validator_5,323251537570,True,554500000,19114640,573614640,False,10
8130,validator_7,228725969200,True,771600000,2368540,773968540,False,7
8131,validator_2,659544232170,True,530280000,42525300,572805300,True,20
8132,validator_4,324650575686,True,864540001,3308260,867848261,True,10
8133,validator_18,103695315585,True,784339997,26082710,810422707,True,3
8134,validator_2,660108791267,True,548839997,15719100,564559097,True,20
8135,validator_0,1071537253299,True,785199994,36315500,821515494,True,33
8136,validator_6,229822183905,True,530054004,9282330,539336334,True,7
8137,validator_5,323853926310,True,599200000,3188740,602388740,False,10
8138,validator_28,101038143132,True,632019998,26310290,658330288,True,3
8139,validator_1,869522398840,True,429610000,2421620,432031620,False,27
8140,validator_46,71285933990,True,799500000,3364400,802864400,False,2
8141,validator_7,229219770530,True,491300000,2501330,493801330,False,7
8142,validator_15,116195514656,True,706995993,6982280,713978273,True,3
8143,validator_19,96491416270,True,815400002,20852730,836252732,True,3
8144,validator_28,101749613334,True,702420002,9050200,711470202,True,3
8145,validator_1,870109402140,True,573800000,13203300,587003300,False,27
8146,validator_5,324276712890,True,402300000,20486580,422786580,False,10
8147,validator_29,65135887830,True,512900000,4048790,516948790,False,2
8148,validator_1,870824161850,True,712100000,2659710,714759710,False,27
8149,validator_0,1072033646902,True,464008003,32385600,496393603,True,33
8150,validator_0,1073027752212,True,969500000,24605310,994105310,True,33
8151,validator_5,324705571900,True,424600000,4259010,428859010,False,10
8152,validator_25,92260108513,True,801124001,46285850,847409851,True,2
8153,validator_26,99003073963,True,805800004,5781040,811581044,True,3
8154,validator_2,660693491119,True,578200002,6499850,584699852,True,20
8155,validator_2,661241681824,True,527820005,20370700,548190705,True,20
8156,validator_18,104290191188,True,581380003,13495600,594875603,True,3
8157,validator_2,661895200555,True,639900001,13618730,653518731,True,20
8158,validator_34,85942549150,True,558100000,23256620,581356620,False,2
8159,validator_0,1073865653352,True,812220000,25681140,837901140,True,33
8160,validator_2,662710592144,True,805799989,9591600,815391589,True,20
8161,validator_39,70231669740,True,493000000,6866780,499866780,False,2
8162,validator_47,75363842200,True,552300000,22926480,575226480,False,2
8163,validator_0,1074390869005,True,522300003,2915650,525215653,True,33
8164,validator_2,663356437465,True,621520001,24325320,645845321,True,20
8165,validator_10,118174198187,True,779720009,21881880,801601889,True,3
8166,validator_23,111117638562,True,681539997,21406080,702946077,True,3
8167,validator_2,664264742026,True,879750001,28554560,908304561,True,20
8168,validator_2,664853641685,True,574819999,14079660,588899659,True,20
8169,validator_4,325604934984,True,917135998,37223300,954359298,True,10
8170,validator_1,871575524370,True,747700000,3662520,751362520,False,27
8171,validator_7,229883712140,True,657200000,6741610,663941610,False,7
8172,validator_7,230552148740,True,661400000,7036600,668436600,False,7
8173,validator_30,77952267930,True,598200000,1179000,599379000,False,2
8174,validator_46,71818318390,True,529700000,2684400,532384400,False,2
8175,validator_3,481348806090,True,589800000,9576040,599376040,False,15
8176,validator_28,102137686907,True,377764003,10309570,388073573,True,3
8177,validator_2,665442789618,True,556186003,32961930,589147933,True,20
8178,validator_3,481997585590,True,606800000,41979500,648779500,False,15
8179,validator_1,872174386370,True,597000000,1862000,598862000,False,27
8180,validator_14,105591095694,True,636820005,28034900,664854905,True,3
8181,validator_21,115116297720,True,504259994,26570610,530830604,True,3
8182,validator_4,326512658584,True,876596000,31127600,907723600,True,10
8183,validator_22,125835006446,True,493799998,7018600,500818598,True,3
8184,validator_30,78571139360,True,603100000,15771430,618871430,False,2
8185,validator_2,666026859638,True,535200000,48870020,584070020,True,20
8186,validator_0,1074901776872,True,479940007,30967860,510907867,True,33
8187,validator_28,102793277521,True,628020004,27570610,655590614,True,3
8188,validator_0,1075529548910,True,606299998,21472040,627772038,True,33
8189,validator_3,482669458130,True,669600000,2272540,671872540,False,15
8190,validator_8,97905724020,True,639719996,43625260,683345256,True,3
8191,validator_1,872716311910,True,539100000,2825540,541925540,False,27
8192,validator_5,325275586990,True,567900000,2115090,570015090,False,10
8193,validator_3,483336585470,True,657900000,9227340,667127340,False,15
8194,validator_0,1076057588913,True,526100003,1940000,528040003,True,33
8195,validator_15,116878505856,True,681900000,1091200,682991200,True,3
8196,validator_42,84080009820,True,882900000,2491720,885391720,False,2
8197,validator_22,126431836577,True,558680001,38150130,596830131,True,3
8198,validator_15,117562174557,True,658240001,25428700,683668701,True,3
8199,validator_27,89994836073,True,708700003,2873800,711573803,True,2
8200,validator_25,92879187440,True,610419997,8658930,619078927,True,2
8201,validator_6,230666871103,True,823239998,21447200,844687198,True,7
8202,validator_24,96006266091,True,687475996,54089120,741565116,True,3
8203,validator_32,79080600340,True,489900000,20892400,510792400,False,2
8204,validator_1,873270158650,True,550300000,3546740,553846740,False,27
8205,validator_16,83121410178,True,664680008,25613000,690293008,True,2
8206,validator_1,873828083250,True,556000000,1924600,557924600,False,27
8207,validator_48,92723173010,True,592800000,7005830,599805830,False,2
8208,validator_37,73170190900,True,551900000,20187100,572087100,False,2
8209,validator_6,231296193703,True,617300000,12022600,629322600,True,7
8210,validator_3,483915278620,True,559900000,18793150,578693150,False,15
8211,validator_1,874517735030,True,686100000,3551780,689651780,False,27
8212,validator_2,666606736465,True,558679997,21196830,579876827,True,20
8213,validator_15,118015550625,True,446619998,6756070,453376068,True,3
8214,validator_3,484670367230,True,734100000,20988610,755088610,False,15
8215,validator_26,99673031759,True,665899996,4057800,669957796,True,3
8216,validator_37,73585905080,True,414000000,1714180,415714180,False,2
8217,validator_17,103756691086,True,584640003,20445610,605085613,True,3
8218,validator_4,327092850583,True,570499999,9692000,580191999,True,10
8219,validator_12,82365919489,True,499670006,19551630,519221636,True,2
8220,validator_38,77533242740,True,662700000,7436270,670136270,False,2
8221,validator_5,325942220690,True,665200000,1433700,666633700,False,10
8222,validator_38,77963819670,True,427000000,3576930,430576930,False,2
8223,validator_23,112254588561,True,1098099999,38850000,1136949999,True,3
8224,validator_0,1076722805092,True,618367999,46848180,665216179,True,33
8225,validator_36,72934929490,True,413500000,10202440,423702440,False,2
8226,validator_38,78630765590,True,647600000,19345920,666945920,False,2
8227,validator_46,72495934810,True,675700000,1916420,677616420,False,2
8228,validator_40,76518405520,True,554500000,6339700,560839700,False,2
8229,validator_7,230944589040,True,390100000,2340300,392440300,False,7
8230,validator_3,485489375360,True,794800000,24208130,819008130,False,15
8231,validator_1,874950138230,True,418600000,13803200,432403200,False,27
8232,validator_2,667273214071,True,656359996,10117610,666477606,True,20
8233,validator_2,668062821569,True,785699998,3907500,789607498,True,20
8234,validator_24,96542571488,True,522395997,13909400,536305397,True,3
8235,validator_0,1077419961324,True,658240002,38916230,697156232,True,33
8236,validator_35,89903746700,True,455200000,11923900,467123900,False,2
8237,validator_43,68384953550,True,438530000,11631540,450161540,False,2
8238,validator_47,76028592990,True,635400000,29350790,664750790,False,2
8239,validator_0,1078106970680,True,653759996,33249360,687009356,True,33
8240,validator_3,486314622560,True,817800000,7447200,825247200,False,15
8241,validator_13,77201710615,True,839799993,40835440,880635433,True,2
8242,validator_12,82866138644,True,468440005,31779150,500219155,True,2
8243,validator_0,1078826010236,True,700499996,18539560,719039556,True,33
8244,validator_4,327873289104,True,739920001,40518520,780438521,True,10
8245,validator_17,104419010120,True,655999994,6319040,662319034,True,3
8246,validator_37,74251651080,True,663900000,1846000,665746000,False,2
8247,validator_25,93762722168,True,873139998,10394730,883534728,True,2
8248,validator_41,65061052520,True,356000000,2556220,358556220,False,2
8249,validator_2,668661555870,True,579940001,18794300,598734301,True,20
8250,validator_3,486878804960,True,559500000,4682400,564182400,False,15
8251,validator_44,76900327840,True,560500000,7178440,567678440,False,2
8252,validator_33,92507329670,True,500200000,6145120,506345120,False,2
8253,validator_47,76691970160,True,641900000,21477170,663377170,False,2
8254,validator_0,1079323256824,True,475739998,21506590,497246588,True,33
8255,validator_4,328545305600,True,655939996,16076500,672016496,True,10
8256,validator_2,669394471368,True,729819998,3095500,732915498,True,20
8257,validator_3,487464722800,True,583200000,2717840,585917840,False,15
8258,validator_41,65779752290,True,678400000,40299770,718699770,False,2
8259,validator_5,326653790090,True,690100000,21469400,711569400,False,10
8260,validator_23,112746496115,True,484540004,7367550,491907554,True,3
8261,validator_22,127154925417,True,712840000,10248840,723088840,True,3
8262,validator_1,875595061770,True,643000000,1923540,644923540,False,27
8263,validator_4,329160118170,True,610700000,4112570,614812570,True,10
8264,validator_40,77145615950,True,625300000,1910430,627210430,False,2
8265,validator_0,1080166518655,True,823520001,19741830,843261831,True,33
8266,validator_44,77591054230,True,663100000,27626390,690726390,False,2
8267,validator_5,327554183910,True,893700000,6693820,900393820,False,10
8268,validator_8,98507070609,True,590605999,10740590,601346589,True,3
8269,validator_0,1080989107806,True,791886001,30703150,822589151,True,33
8270,validator_20,104567803274,True,506820002,14553820,521373822,True,3
8271,validator_1,876132787510,True,535800000,1925740,537725740,False,27
8272,validator_2,670195855792,True,741640004,59744420,801384424,True,20
8273,validator_23,113528994675,True,770199990,12298570,782498560,True,3
8274,validator_11,88302858161,True,559013995,15142700,574156695,True,2
8275,validator_13,77889437382,True,668099997,19626770,687726767,True,2
8276,validator_26,100301656656,True,624999997,3624900,628624897,True,3
8277,validator_1,876622668870,True,488000000,1881360,489881360,False,27
8278,validator_1,877200983850,True,576700000,1614980,578314980,False,27
8279,validator_1,877805665580,True,601800000,2881730,604681730,False,27
8280,validator_33,93102916420,True,593900000,1686750,595586750,False,2
8281,validator_23,114221217599,True,665560004,26662920,692222924,True,3
8282,validator_32,79667369910,True,578600000,8169570,586769570,False,2
8283,validator_1,878357983810,True,545600000,6718230,552318230,False,27
8284,validator_3,488065423800,True,590300000,10401000,600701000,False,15
8285,validator_6,232033414907,True,716200004,21021200,737221204,True,7
8286,validator_21,115814641042,True,696800002,1543320,698343322,True,3
8287,validator_0,1081884775241,True,867864005,27803430,895667435,True,33
8288,validator_20,105232806672,True,627039998,37963400,665003398,True,3
8289,validator_2,670842444391,True,643899999,2688600,646588599,True,20
8290,validator_0,1082670688238,True,776667997,9245000,785912997,True,33
8291,validator_2,671600899658,True,732359997,26095270,758455267,True,20
8292,validator_30,79032347660,True,459900000,1308300,461208300,False,2
8293,validator_0,1083367425168,True,688500000,8236930,696736930,True,33
8294,validator_0,1084152370885,True,772640007,12305710,784945717,True,33
8295,validator_4,329925609220,True,734520000,30971050,765491050,True,10
8296,validator_19,97060639496,True,543900006,25323220,569223226,True,3
8297,validator_0,1084812040686,True,656840001,2829800,659669801,True,33
8298,validator_1,879000099340,True,623100000,19015530,642115530,False,27
8299,validator_32,80376344640,True,707600000,1374730,708974730,False,2
8300,validator_0,1085712801489,True,896400003,4360800,900760803,True,33
8301,validator_0,1086242149046,True,524859997,4487560,529347557,True,33
8302,validator_1,879518885990,True,513900000,4886650,518786650,False,27
8303,validator_48,93541616030,True,809900000,8543020,818443020,False,2
8304,validator_17,105083691519,True,649899999,14781400,664681399,True,3
8305,validator_1,880139105170,True,610600000,9619180,620219180,False,27
8306,validator_17,106202956420,True,1072879991,46384910,1119264901,True,3
8307,validator_2,672242412899,True,640000001,1513240,641513241,True,21
8308,validator_16,84077690210,True,935820002,20460030,956280032,True,2
8309,validator_1,880719515600,True,573200000,7210430,580410430,False,27
8310,validator_1,881171114620,True,449600000,1999020,451599020,False,27
8311,validator_3,488749859340,True,682200000,2235540,684435540,False,15
8312,validator_36,73548786550,True,610000000,3857060,613857060,False,2
8313,validator_4,330649565599,True,719599989,4356390,723956379,True,10
8314,validator_24,97338836168,True,785954000,10310680,796264680,True,3
8315,validator_4,331229245610,True,568160001,11520010,579680011,True,10
8316,validator_7,231551423180,True,603100000,3734140,606834140,False,7
8317,validator_1,881842292810,True,667900000,3278190,671178190,False,27
8318,validator_32,80916290380,True,533100000,6845740,539945740,False,2
8319,validator_0,1086813329022,True,568319996,2859980,571179976,True,33
8320,validator_3,489533308440,True,768200000,15249100,783449100,False,15
8321,validator_0,1087419211246,True,578460004,27422220,605882224,True,33
8322,validator_13,78660083564,True,746640002,24006180,770646182,True,2
8323,validator_8,98930992649,True,397740000,26182040,423922040,True,3
8324,validator_11,89068071763,True,741366002,23847600,765213602,True,2
8325,validator_2,672871933028,True,615299999,14220130,629520129,True,21
8326,validator_1,882462529740,True,613500000,6736930,620236930,False,27
8327,validator_7,232197090280,True,644900000,767100,645667100,False,7
8328,validator_2,673724250087,True,841299999,11017060,852317059,True,21
8329,validator_3,490148054840,True,605700000,9046400,614746400,False,15
8330,validator_34,86483463550,True,530900000,10014400,540914400,False,2
8331,validator_4,332126894829,True,876739999,20909220,897649219,True,10
8332,validator_42,84751714240,True,670600000,1104420,671704420,False,2
8333,validator_5,328358071220,True,800400000,3487310,803887310,False,10
8334,validator_28,103609490992,True,791399991,24813480,816213471,True,3
8335,validator_5,328843513640,True,484800000,642420,485442420,False,10
8336,validator_0,1088104436246,True,659270010,25954990,685225000,True,34
8337,validator_1,883092812020,True,622600000,7682280,630282280,False,27
8338,validator_29,65740429930,True,577600000,26942100,604542100,False,2
8339,validator_1,883493704680,True,398300000,2592660,400892660,False,27
8340,validator_46,73222283410,True,716100000,10248600,726348600,False,2
8341,validator_35,90550444710,True,645100000,1598010,646698010,False,2
8342,validator_0,1088772600069,True,664900003,3263820,668163823,True,34
8343,validator_43,68978085250,True,590600000,2531700,593131700,False,2
8344,validator_35,91380595000,True,829100000,1050290,830150290,False,2
8345,validator_1,884121682790,True,625600000,2378110,627978110,False,27
8346,validator_49,66345254880,True,560300000,8414030,568714030,False,2
8347,validator_4,332915999026,True,760799997,28304200,789104197,True,10
8348,validator_0,1089400254159,True,625200000,2454090,627654090,True,34
8349,validator_3,490598740760,True,448900000,1785920,450685920,False,15
8350,validator_36,74093621580,True,542600000,2235030,544835030,False,2
8351,validator_1,884719441870,True,595300000,2459080,597759080,False,27
8352,validator_38,79116491420,True,484400000,1325830,485725830,False,2
8353,validator_1,885236584350,True,515700000,1442480,517142480,False,27
8354,validator_0,1090318906484,True,893939995,24712330,918652325,True,34
8355,validator_18,104858798286,True,543919998,24687100,568607098,True,3
8356,validator_2,674387591563,True,650820006,12521470,663341476,True,21
8357,validator_1,886013786590,True,770400000,6802240,777202240,False,27
8358,validator_5,329305603180,True,460200000,1889540,462089540,False,10
8359,validator_1,886532503780,True,507600000,11117190,518717190,False,27
8360,validator_40,77903448950,True,756000000,1833000,757833000,False,2
8361,validator_30,79571451460,True,512400000,26703800,539103800,False,2
8362,validator_20,105939224966,True,683839994,22578300,706418294,True,3
8363,validator_5,329882591860,True,574700000,2288680,576988680,False,10
8364,validator_3,491271391170,True,651800000,20850410,672650410,False,15
8365,validator_3,491855450180,True,581800000,2259010,584059010,False,15
8366,validator_18,105748491828,True,864439992,25253550,889693542,True,3
8367,validator_1,887207325190,True,671300000,3521410,674821410,False,27
8368,validator_3,492570463510,True,710900000,4113330,715013330,False,15
8369,validator_0,1091069789446,True,687430002,63452960,750882962,True,34
8370,validator_43,69422142180,True,434500000,9556930,444056930,False,2
8371,validator_1,887779109740,True,548200000,23584550,571784550,False,27
8372,validator_13,79698221852,True,1032799998,5338290,1038138288,True,2
8373,validator_0,1091892053453,True,803064007,19200000,822264007,True,34
8374,validator_11,89667142144,True,590940001,8130380,599070381,True,2
8375,validator_4,333635386720,True,691319994,28067700,719387694,True,10
8376,validator_44,78351486040,True,757700000,2731810,760431810,False,2
8377,validator_6,232694129615,True,642680008,18034700,660714708,True,7
8378,validator_6,233357796313,True,629979998,33686700,663666698,True,7
8379,validator_0,1092647602682,True,727519999,28029230,755549229,True,34
8380,validator_0,1093738638322,True,1073460000,17575640,1091035640,True,34
8381,validator_0,1094324520020,True,576157998,9723700,585881698,True,34
8382,validator_3,493204979250,True,624200000,10315740,634515740,False,15
8383,validator_37,74919284720,True,664600000,3033640,667633640,False,2
8384,validator_0,1094925421738,True,593539998,7361720,600901718,True,34
8385,validator_45,88151365750,True,590600000,7366250,597966250,False,2
8386,validator_2,675234753462,True,817183999,29977900,847161899,True,21
8387,validator_2,675901081392,True,664900010,1427920,666327930,True,21
8388,validator_10,118850246611,True,656979994,19068430,676048424,True,3
8389,validator_0,1095532884636,True,604499998,2962900,607462898,True,34
8390,validator_0,1096142359540,True,576420004,33054900,609474904,True,34
8391,validator_43,69925856200,True,502400000,1314020,503714020,False,2
8392,validator_1,888436004560,True,647200000,9694820,656894820,False,27
8393,validator_0,1096804029754,True,653419994,8250220,661670214,True,34
8394,validator_0,1097711557347,True,883200003,24327590,907527593,True,34
8395,validator_37,75307351950,True,374910000,13157230,388067230,False,2
8396,validator_41,66464058120,True,681100000,3205830,684305830,False,2
8397,validator_31,86871197060,True,579100000,6652130,585752130,False,2
8398,validator_13,80284226773,True,564940001,21064920,586004921,True,2
8399,validator_3,493729003650,True,522300000,1724400,524024400,False,15
8400,validator_35,92014976070,True,631870000,2511070,634381070,False,2
8401,validator_0,1098407760999,True,685900002,10303650,696203652,True,34
8402,validator_10,119405069811,True,545820000,9003200,554823200,True,3
8403,validator_4,334105566781,True,450820001,19360060,470180061,True,10
8404,validator_40,78506339950,True,591800000,11091000,602891000,False,2
8405,validator_31,87499887990,True,624700000,3990930,628690930,False,2
8406,validator_14,106218357500,True,612259996,15001810,627261806,True,3
8407,validator_15,118458666864,True,407259999,35856240,443116239,True,3
8408,validator_33,93643444050,True,538500000,2027630,540527630,False,2
8409,validator_35,92760261800,True,736000000,9285730,745285730,False,2
8410,validator_1,888983258420,True,527900000,19353860,547253860,False,27
8411,validator_1,889852871060,True,813200000,56412640,869612640,False,27
8412,validator_44,78707011440,True,353700000,1825400,355525400,False,2
8413,validator_0,1098978233303,True,523808004,46664300,570472304,True,34
8414,validator_6,234252590512,True,881219999,13574200,894794199,True,7
8415,validator_27,90534389583,True,521740000,17813510,539553510,True,2
8416,validator_1,890462585090,True,605570000,4144030,609714030,False,27
8417,validator_36,74801727160,True,702200000,5905580,708105580,False,2
8418,validator_10,120192100165,True,748560004,38470350,787030354,True,3
8419,validator_21,116399190165,True,558480003,26069120,584549123,True,3
8420,validator_5,330542956870,True,651700000,8665010,660365010,False,10
8421,validator_32,81558723260,True,616300000,26132880,642432880,False,2
8422,validator_46,73622362420,True,394600000,5479010,400079010,False,2
8423,validator_1,890992638490,True,511100000,18953400,530053400,False,27
8424,validator_7,232896691950,True,689700000,9901670,699601670,False,7
8425,validator_0,1099632446000,True,647519997,6692700,654212697,True,34
8426,validator_25,94336089616,True,566499998,6867450,573367448,True,2
8427,validator_0,1100363327873,True,722119993,8761880,730881873,True,34
8428,validator_12,83564505442,True,689599998,8766800,698366798,True,2
8429,validator_6,234808892611,True,553699999,2602100,556302099,True,7
8430,validator_34,86938010650,True,451600000,2947100,454547100,False,2
8431,validator_26,100878498655,True,533839999,43002000,576841999,True,3
8432,validator_2,676743638991,True,821519999,21037600,842557599,True,21
8433,validator_1,891478997410,True,477200000,9158920,486358920,False,27
8434,validator_0,1101043521947,True,674099994,6094080,680194074,True,34
8435,validator_0,1101636629285,True,575919998,17187340,593107338,True,34
8436,validator_1,892197704000,True,690300000,28406590,718706590,False,27
8437,validator_3,494463981030,True,725000000,9977380,734977380,False,15
8438,validator_20,106547383914,True,577699998,30458950,608158948,True,3
8439,validator_1,892655404540,True,455100000,2600540,457700540,False,27
8440,validator_2,677562406569,True,794159998,24607580,818767578,True,21
8441,validator_1,893245312840,True,578100000,11808300,589908300,False,27
8442,validator_2,678216795980,True,623164011,31225400,654389411,True,21
8443,validator_0,1102410270482,True,735199997,38441200,773641197,True,34
8444,validator_43,70599691000,True,667100000,6734800,673834800,False,2
8445,validator_1,893945503420,True,697200000,2990580,700190580,False,27
8446,validator_0,1102994141086,True,572246004,11624600,583870604,True,34
8447,validator_2,678808545484,True,561780004,29969500,591749504,True,21
8448,validator_2,679651819659,True,815000005,28274170,843274175,True,21
8449,validator_1,894508654980,True,552400000,10751560,563151560,False,27
8450,validator_5,331112635390,True,544700000,24978520,569678520,False,10
8451,validator_0,1103679032768,True,676140002,8751680,684891682,True,34
8452,validator_16,84873149429,True,782459999,12999220,795459219,True,2
8453,validator_2,680415128859,True,752040000,11269200,763309200,True,21
8454,validator_27,91296832607,True,754000004,8443020,762443024,True,2
8455,validator_0,1104364187558,True,660188000,24966790,685154790,True,34
8456,validator_21,117292353797,True,874800012,18363620,893163632,True,3
8457,validator_5,331992980810,True,854500000,25845420,880345420,False,10
8458,validator_7,233460171650,True,562600000,879700,563479700,False,7
8459,validator_47,77305187400,True,606600000,6617240,613217240,False,2
8460,validator_2,681196373254,True,779300005,1944390,781244395,True,21
8461,validator_2,681762523886,True,545500002,20650630,566150632,True,21
8462,validator_1,895190774780,True,662000000,20119800,682119800,False,27
8463,validator_2,682271528115,True,488399999,20604230,509004229,True,21
8464,validator_40,79332485390,True,818000000,8145440,826145440,False,2
8465,validator_5,332514840730,True,520600000,1259920,521859920,False,10
8466,validator_49,66961377400,True,615000000,1122520,616122520,False,2
8467,validator_1,895914997070,True,714500000,9722290,724222290,False,27
8468,validator_1,896489891700,True,573100000,1794630,574894630,False,28
8469,validator_5,333109995330,True,586600000,8554600,595154600,False,10
8470,validator_0,1104963755936,True,590599998,8968380,599568378,True,34
8471,validator_36,75482718630,True,671600000,9391470,680991470,False,2
8472,validator_5,333547033890,True,435900000,1138560,437038560,False,10
8473,validator_19,97741062130,True,675659994,4762640,680422634,True,3
8474,validator_1,897245577850,True,745100000,10586150,755686150,False,28
8475,validator_0,1105701273368,True,720380002,17137430,737517432,True,34
8476,validator_0,1106255223169,True,498800001,55149800,553949801,True,34
8477,validator_2,682788457510,True,491897995,25031400,516929395,True,21
8478,validator_4,334793060878,True,677919997,9574100,687494097,True,10
8479,validator_30,80313734010,True,734100000,8182550,742282550,False,2
8480,validator_1,897647527120,True,398500000,3449270,401949270,False,28
8481,validator_3,495068563530,True,601000000,3582500,604582500,False,15
8482,validator_37,75856082070,True,546100000,2630120,548730120,False,2
8483,validator_2,683467309708,True,640299998,38552200,678852198,True,21
8484,validator_3,495859035850,True,788200000,2272320,790472320,False,15
8485,validator_7,234070551750,True,599600000,10780100,610380100,False,7
8486,validator_15,119239037421,True,739660007,40710550,780370557,True,3
8487,validator_1,898367068000,True,716200000,3340880,719540880,False,28
8488,validator_1,899077080830,True,709100000,912830,710012830,False,28
8489,validator_0,1106807318168,True,511679999,40415000,552094999,True,34
8490,validator_21,118058528374,True,763399997,2774580,766174577,True,3
8491,validator_24,98116022930,True,740866002,36320760,777186762,True,3
8492,validator_0,1107580830371,True,721894003,51618200,773512203,True,34
8493,validator_2,684139689993,True,642519995,29860290,672380285,True,21
8494,validator_0,1108560706805,True,970999994,8876440,979876434,True,34
8495,validator_1,899505450360,True,426700000,1669530,428369530,False,28
8496,validator_6,235650445194,True,833000003,8552580,841552583,True,7
8497,validator_1,900145810420,True,637100000,3260060,640360060,False,28
8498,validator_1,900773003220,True,606700000,20492800,627192800,False,28
8499,validator_3,496571681500,True,692600000,20045650,712645650,False,15
8500,validator_39,70891346170,True,646400000,13276430,659676430,False,2
8501,validator_2,684861052192,True,680719999,40642200,721362199,True,21
8502,validator_37,76315687260,True,456400000,3205190,459605190,False,2
8503,validator_15,119940345783,True,681140002,20168360,701308362,True,3
8504,validator_2,685623600375,True,751860003,10688180,762548183,True,21
8505,validator_8,99830239742,True,880670003,18577090,899247093,True,3
8506,validator_15,120871256722,True,911399999,19510940,930910939,True,3
8507,validator_24,98750172199,True,624939999,9209270,634149269,True,3
8508,validator_7,234664068390,True,572700000,20816640,593516640,False,7
8509,validator_42,85473475120,True,720800000,960880,721760880,False,2
8510,validator_1,901539800820,True,760300000,6497600,766797600,False,28
8511,validator_32,82365012090,True,803000000,3288830,806288830,False,2
8512,validator_2,686272358986,True,641300001,7458610,648758611,True,21
8513,validator_32,82978512730,True,604000000,9500640,613500640,False,2
8514,validator_0,1109045277509,True,476600004,7970700,484570704,True,34
8515,validator_1,902071182170,True,522600000,8781350,531381350,False,28
8516,validator_33,94267307550,True,608100000,15763500,623863500,False,2
8517,validator_4,335371457705,True,577799997,596830,578396827,True,10
8518,validator_1,902525525670,True,452400000,1943500,454343500,False,28
8519,validator_0,1109748395549,True,670700000,32418040,703118040,True,34
8520,validator_32,83618522150,True,618900000,21109420,640009420,False,2
8521,validator_6,236292842403,True,623719989,18677220,642397209,True,7
8522,validator_2,686902129066,True,610600000,19170080,629770080,True,21
8523,validator_1,903082389480,True,551100000,5763810,556863810,False,28
8524,validator_3,497133702610,True,555400000,6621110,562021110,False,15
8525,validator_0,1110303950077,True,551639998,3914530,555554528,True,34
8526,validator_1,903770922020,True,643700000,44832540,688532540,False,28
8527,validator_3,497917777530,True,780400000,3674920,784074920,False,15
8528,validator_38,79744764620,True,626200000,2073200,628273200,False,2
8529,validator_4,336361456833,True,973139998,16859130,989999128,True,10
8530,validator_0,1111042959670,True,731199993,7809600,739009593,True,34
8531,validator_15,121562791369,True,688700007,2834640,691534647,True,3
8532,validator_17,107004398245,True,774765995,26675830,801441825,True,3
8533,validator_3,498581088690,True,661700000,1611160,663311160,False,15
8534,validator_22,127874347865,True,680960008,38462440,719422448,True,3
8535,validator_2,687718699382,True,813100006,3470310,816570316,True,21
8536,validator_2,688411647407,True,667804005,25144020,692948025,True,21
8537,validator_1,904263244060,True,486600000,5722040,492322040,False,28
8538,validator_1,904934161060,True,667900000,3017000,670917000,False,28
8539,validator_2,689157959913,True,699540006,46772500,746312506,True,21
8540,validator_7,235243395800,True,573000000,6327410,579327410,False,7
8541,validator_26,101513439050,True,599039995,35900400,634940395,True,3
8542,validator_26,102123902729,True,599840009,10623670,610463679,True,3
8543,validator_46,74387662980,True,755700000,9600560,765300560,False,2
8544,validator_2,689792721990,True,594139997,40622080,634762077,True,21
8545,validator_1,905575553460,True,635400000,5992400,641392400,False,28
8546,validator_4,337126612067,True,748215994,16939240,765155234,True,10
8547,validator_0,1111910713281,True,840099991,27653620,867753611,True,34
8548,validator_31,88114922230,True,590700000,24334240,615034240,False,2
8549,validator_4,337645303192,True,509619995,9071130,518691125,True,10
8550,validator_4,338398456620,True,747099998,6053430,753153428,True,10
8551,validator_41,66993499550,True,517100000,12341430,529441430,False,2
8552,validator_4,339062577852,True,647240002,16881230,664121232,True,10
8553,validator_0,1112798125805,True,870840004,16572520,887412524,True,34
8554,validator_0,1113511783062,True,703039997,10617260,713657257,True,34
8555,validator_10,120981842263,True,768219998,21522100,789742098,True,3
8556,validator_6,236922399024,True,619300001,10256620,629556621,True,7
8557,validator_37,77002044060,True,683900000,2456800,686356800,False,2
8558,validator_1,906164509940,True,582700000,6256480,588956480,False,28
8559,validator_43,71233199930,True,627400000,6108930,633508930,False,2
8560,validator_0,1114153982486,True,619800004,22399420,642199424,True,34
8561,validator_26,102864892412,True,716646003,24343680,740989683,True,3
8562,validator_0,1114797416224,True,640619998,2813740,643433738,True,34
8563,validator_23,114751952176,True,497739997,32994580,530734577,True,3
8564,validator_6,237640595121,True,710639997,7556100,718196097,True,7
8565,validator_0,1115586955374,True,761300000,28239150,789539150,True,34
8566,validator_17,107589533156,True,560360001,24774910,585134911,True,3
8567,validator_8,100481133783,True,647920001,2974040,650894041,True,3
8568,validator_2,690696455022,True,881200002,22533030,903733032,True,21
8569,validator_16,85548334321,True,655440002,19744890,675184892,True,2
8570,validator_2,691595645127,True,892768005,6422100,899190105,True,21
8571,validator_28,104405760391,True,746560009,49709390,796269399,True,3
8572,validator_3,499386639890,True,777200000,28351200,805551200,False,15
8573,validator_29,66288943630,True,543900000,4613700,548513700,False,2
8574,validator_49,67735499250,True,765000000,9121850,774121850,False,2
8575,validator_4,339763566052,True,669864000,31124200,700988200,True,10
8576,validator_0,1116325589176,True,708899992,29733810,738633802,True,34
8577,validator_2,692482164438,True,876440011,10079300,886519311,True,21
8578,validator_44,79244694340,True,535200000,2482900,537682900,False,2
8579,validator_1,906819875970,True,648500000,6866030,655366030,False,28
8580,validator_15,122418534753,True,835300004,20443380,855743384,True,3
8581,validator_2,693273710135,True,771999997,19545700,791545697,True,21
8582,validator_2,693674576039,True,389564004,11301900,400865904,True,21
8583,validator_0,1117045670816,True,716420000,3661640,720081640,True,34
8584,validator_3,500227630320,True,839800000,1190430,840990430,False,15
8585,validator_24,99186533280,True,412240001,24121080,436361081,True,3
8586,validator_0,1117875754022,True,792239996,37843210,830083206,True,34
8587,validator_19,98446135846,True,703499996,1573720,705073716,True,3
8588,validator_2,694377293567,True,694259998,8457530,702717528,True,21
8589,validator_2,694847098949,True,430900002,38905380,469805382,True,21
8590,validator_20,107520056154,True,951480000,21192240,972672240,True,3
8591,validator_39,71652875590,True,707400000,54129420,761529420,False,2
8592,validator_0,1118413170631,True,516139999,21276610,537416609,True,34
8593,validator_7,235895175990,True,641900000,9880190,651780190,False,7
8594,validator_0,1119245535666,True,830300005,2065030,832365035,True,34
8595,validator_48,94121194260,True,577500000,2078230,579578230,False,2
8596,validator_35,93330008340,True,542600000,27146540,569746540,False,2
8597,validator_0,1119830605570,True,552820004,32249900,585069904,True,34
8598,validator_16,86292113822,True,736774001,7005500,743779501,True,2
8599,validator_1,907448985590,True,627700000,1409620,629109620,False,28
8600,validator_1,908181344130,True,722300000,10058540,732358540,False,28
8601,validator_14,106922433692,True,693279992,10796200,704076192,True,3
8602,validator_27,91877991024,True,547819997,33338420,581158417,True,2
8603,validator_2,695590056650,True,715826001,27131700,742957701,True,21
8604,validator_18,106429669835,True,665579997,15598010,681178007,True,3
8605,validator_17,108264868882,True,669099996,6235730,675335726,True,3
8606,validator_1,908673307450,True,465500000,26463320,491963320,False,28
8607,validator_5,334070779230,True,521600000,2145340,523745340,False,10
8608,validator_29,66907430400,True,590600000,27886770,618486770,False,2
8609,validator_0,1120555382400,True,706240000,18536830,724776830,True,35
8610,validator_46,74987379390,True,597600000,2116410,599716410,False,2
8611,validator_6,238228583138,True,545559987,42428030,587988017,True,7
8612,validator_0,1121208779602,True,630500002,22897200,653397202,True,35
8613,validator_41,67476516700,True,470700000,12317150,483017150,False,2
8614,validator_2,696458785594,True,839855994,28872950,868728944,True,21
8615,validator_1,909151842970,True,476100000,2435520,478535520,False,28
8616,validator_5,334540169450,True,449000000,20390220,469390220,False,10
8617,validator_5,335150314980,True,609400000,745530,610145530,False,10
8618,validator_0,1122013605905,True,755166003,49660300,804826303,True,35
8619,validator_18,107089558878,True,627620003,32269040,659889043,True,3
8620,validator_0,1122844482333,True,807539998,23336430,830876428,True,35
8621,validator_1,909895561470,True,738600000,5118500,743718500,False,28
8622,validator_32,84321847050,True,687600000,15724900,703324900,False,2
8623,validator_1,910616770190,True,698200000,23008720,721208720,False,28
8624,validator_1,911061843970,True,444100000,973780,445073780,False,28
8625,validator_3,500843204720,True,615200000,374400,615574400,False,15
8626,validator_34,87472420290,True,531400000,3009640,534409640,False,2
8627,validator_0,1123435830328,True,563885995,27462000,591347995,True,35
8628,validator_0,1124258413864,True,778594006,43989530,822583536,True,35
8629,validator_46,75756559550,True,766500000,2680160,769180160,False,2
8630,validator_1,911639520840,True,576800000,876870,577676870,False,28
8631,validator_33,94794794090,True,525500000,1986540,527486540,False,2
8632,validator_1,912514551280,True,870000000,5030440,875030440,False,28
8633,validator_14,107687227496,True,750666004,14127800,764793804,True,3
8634,validator_36,76156109390,True,670500000,2890760,673390760,False,2
8635,validator_25,94908887266,True,558440000,14357650,572797650,True,2
8636,validator_38,80453551300,True,696400000,12386680,708786680,False,2
8637,validator_0,1125053790059,True,767179995,28196200,795376195,True,35
8638,validator_38,81128649620,True,655400000,19698320,675098320,False,2
8639,validator_25,95733061667,True,815640001,8534400,824174401,True,2
8640,validator_36,76756845220,True,597700000,3035830,600735830,False,2
8641,validator_0,1126073854771,True,998540002,21524710,1020064712,True,35
8642,validator_20,108381704553,True,847940009,13708390,861648399,True,3
8643,validator_4,340376228493,True,585860001,26802440,612662441,True,10
8644,validator_2,697060378422,True,591699998,9892830,601592828,True,21
8645,validator_17,108980583776,True,701720004,13994890,715714894,True,3
8646,validator_20,108970564178,True,579099995,9759630,588859625,True,3
8647,validator_2,697828162187,True,734246005,33537760,767783765,True,21
8648,validator_1,913092244710,True,574100000,3593430,577693430,False,28
8649,validator_15,123049632778,True,621200005,9898020,631098025,True,3
8650,validator_23,115606805189,True,844200013,10653000,854853013,True,3
8651,validator_18,107886130863,True,794200005,2371980,796571985,True,3
8652,validator_5,335708693520,True,555700000,2678540,558378540,False,10
8653,validator_39,72296978390,True,615600000,28502800,644102800,False,2
8654,validator_7,236423394850,True,525500000,2718860,528218860,False,7
8655,validator_26,103400872637,True,526240005,9740220,535980225,True,3
8656,validator_0,1126922130510,True,834919999,13355740,848275739,True,35
8657,validator_21,119001271943,True,932499999,10243570,942743569,True,3
8658,validator_11,90609502445,True,912188001,30172300,942360301,True,2
8659,validator_3,501379587450,True,534700000,1682730,536382730,False,15
8660,validator_11,91313572347,True,701120002,2949900,704069902,True,2
8661,validator_46,76286505280,True,521600000,8345730,529945730,False,2
8662,validator_0,1127391281548,True,435273998,33877040,469151038,True,35
8663,validator_46,76761298940,True,453800000,20993660,474793660,False,2
8664,validator_1,913686864250,True,587200000,7419540,594619540,False,28
8665,validator_8,101110424387,True,596960004,32330600,629290604,True,3
8666,validator_35,93923908240,True,584600000,9299900,593899900,False,2
8667,validator_5,336316237850,True,580600000,26944330,607544330,False,10
8668,validator_2,698709549226,True,860199999,21187040,881387039,True,21
8669,validator_3,501998366730,True,617800000,979280,618779280,False,15
8670,validator_40,79909720590,True,539600000,37635200,577235200,False,2
8671,validator_0,1128060332643,True,587359995,81691100,669051095,True,35
8672,validator_11,91990363684,True,664679997,12111340,676791337,True,2
8673,validator_21,119793923401,True,789299998,3351460,792651458,True,3
8674,validator_0,1128555364479,True,480359996,14671840,495031836,True,35
8675,validator_23,116257476310,True,596300001,54371120,650671121,True,3
8676,validator_1,914180178680,True,485300000,8014430,493314430,False,28
8677,validator_3,502646886990,True,646400000,2120260,648520260,False,15
8678,validator_36,77432892770,True,657200000,18847550,676047550,False,2
8679,validator_12,84399556502,True,815840000,19211060,835051060,True,2
8680,validator_45,88664701590,True,509600000,3735840,513335840,False,2
8681,validator_44,79746519600,True,500000000,1825260,501825260,False,2
8682,validator_3,503405174560,True,733500000,24787570,758287570,False,15
8683,validator_2,699490815129,True,756000003,25265900,781265903,True,21
8684,validator_1,914871378470,True,680800000,10399790,691199790,False,28
8685,validator_18,108509891188,True,619400005,4360320,623760325,True,3
8686,validator_45,89205003990,True,521700000,18602400,540302400,False,2
8687,validator_37,77562407790,True,558600000,1763730,560363730,False,2
8688,validator_4,341018809672,True,600757999,41823180,642581179,True,10
8689,validator_6,238948696137,True,710159999,9953000,720112999,True,7
8690,validator_15,123769825753,True,673919995,46272980,720192975,True,3
8691,validator_2,700102254219,True,593200000,18239090,611439090,True,21
8692,validator_2,700751605178,True,612999999,36350960,649350959,True,21
8693,validator_34,87978356880,True,485500000,20436590,505936590,False,2
8694,validator_6,239590581635,True,638999998,2885500,641885498,True,7
8695,validator_22,128459717766,True,552640001,32729900,585369901,True,4
8696,validator_18,109115396799,True,556328001,49177610,605505611,True,3
8697,validator_23,117034389745,True,726740005,50173430,776913435,True,3
8698,validator_8,101855220832,True,719519995,25276450,744796445,True,3
8699,validator_16,86895213351,True,553977999,49121530,603099529,True,2
8700,validator_6,240384900433,True,746793998,47524800,794318798,True,7
8701,validator_0,1129311988466,True,720460007,36163980,756623987,True,35
8702,validator_14,108292445619,True,602399993,2818130,605218123,True,3
8703,validator_46,77506687270,True,742900000,2488330,745388330,False,2
8704,validator_25,96362411195,True,624199998,5149530,629349528,True,3
8705,validator_4,341646940399,True,613599997,14530730,628130727,True,10
8706,validator_39,73056986630,True,758500000,1508240,760008240,False,2
8707,validator_3,504099656270,True,666500000,27981710,694481710,False,15
8708,validator_18,109865179834,True,731440005,18343030,749783035,True,3
8709,validator_4,342238201425,True,581819996,9441030,591261026,True,10
8710,validator_6,241082813230,True,661299997,36612800,697912797,True,7
8711,validator_5,337012405650,True,693900000,2267800,696167800,False,10
8712,validator_1,915608558510,True,735300000,1880040,737180040,False,28
8713,validator_5,337592764550,True,576300000,4058900,580358900,False,10
8714,validator_3,504726151720,True,621400000,5095450,626495450,False,15
8715,validator_48,94785400540,True,662700000,1506280,664206280,False,2
8716,validator_5,338252076750,True,637500000,21812200,659312200,False,10
8717,validator_1,916215002950,True,603700000,2744440,606444440,False,28
8718,validator_0,1130164462999,True,772158003,80316530,852474533,True,35
8719,validator_15,124711110116,True,938500003,2784360,941284363,True,3
8720,validator_1,916907465440,True,667800000,24662490,692462490,False,28
8721,validator_2,701465805978,True,705840000,8360800,714200800,True,21
8722,validator_45,89933017690,True,722000000,6013700,728013700,False,2
8723,validator_39,73547405430,True,447300000,43118800,490418800,False,2
8724,validator_3,505413058020,True,684600000,2306300,686906300,False,15
8725,validator_3,506041188920,True,625600000,2530900,628130900,False,15
8726,validator_6,241582271130,True,498100000,1357900,499457900,True,7
8727,validator_22,129076863528,True,598636002,18509760,617145762,True,4
8728,validator_0,1130952362631,True,773000002,14899630,787899632,True,35
8729,validator_5,338879970930,True,624900000,2994180,627894180,False,10
8730,validator_2,701951799772,True,463259994,22733800,485993794,True,21
8731,validator_0,1131541403038,True,560500007,28540400,589040407,True,35
8732,validator_3,506663453420,True,620500000,1764500,622264500,False,15
8733,validator_11,92573421185,True,575240001,7817500,583057501,True,2
8734,validator_2,702520540748,True,531859996,36880980,568740976,True,21
8735,validator_4,343209287720,True,938619995,32466300,971086295,True,10
8736,validator_0,1132488062300,True,927700002,18959260,946659262,True,35
8737,validator_2,703157971483,True,623614005,13816730,637430735,True,21
8738,validator_26,104182069875,True,761159998,20037240,781197238,True,3
8739,validator_10,122083026461,True,1069439998,31744200,1101184198,True,3
8740,validator_0,1133222919640,True,729140000,5717340,734857340,True,35
8741,validator_7,237093376960,True,667300000,2682110,669982110,False,7
8742,validator_0,1133953457454,True,691139994,39397820,730537814,True,35
8743,validator_46,78186946800,True,673300000,6959530,680259530,False,2
8744,validator_41,68205957960,True,727300000,2141260,729441260,False,2
8745,validator_0,1134590690271,True,634139997,3092820,637232817,True,35
8746,validator_44,80404451100,True,655800000,2131500,657931500,False,2
8747,validator_36,77857798350,True,417300000,7605580,424905580,False,2
8748,validator_41,68871137060,True,652700000,12479100,665179100,False,2
8749,validator_4,344010275512,True,798200002,2787790,800987792,True,10
8750,validator_15,125191194821,True,478100005,1984700,480084705,True,3
8751,validator_23,117810276243,True,774399998,1486500,775886498,True,3
8752,validator_12,85174869607,True,760450005,14863100,775313105,True,2
8753,validator_38,81684721990,True,553800000,2272370,556072370,False,2
8754,validator_44,81070825890,True,659200000,7174790,666374790,False,2
8755,validator_5,339449838910,True,563400000,6467980,569867980,False,10
8756,validator_34,88619517980,True,627900000,13261100,641161100,False,2
8757,validator_16,87384045889,True,471879998,16952540,488832538,True,2
8758,validator_20,109579670011,True,588600003,20505830,609105833,True,3
8759,validator_4,344566283713,True,504540001,51468200,556008201,True,10
8760,validator_2,703900312599,True,716899996,25441120,742341116,True,21
8761,validator_39,73978620450,True,422200000,9015020,431215020,False,2
8762,validator_29,67406243530,True,496300000,2513130,498813130,False,2
8763,validator_1,917534977840,True,620200000,7312400,627512400,False,28
8764,validator_13,81010741328,True,697425995,29088560,726514555,True,2
8765,validator_29,67890646830,True,479500000,4903300,484403300,False,2
8766,validator_1,918111960740,True,575900000,1082900,576982900,False,28
8767,validator_34,89314853620,True,671600000,23735640,695335640,False,2
8768,validator_7,237763116280,True,625900000,43839320,669739320,False,7
8769,validator_8,102484738397,True,611300005,18217560,629517565,True,3
8770,validator_3,507333430990,True,657100000,12877570,669977570,False,15
8771,validator_0,1135269724505,True,675300004,3734230,679034234,True,35
8772,validator_40,80492568720,True,526500000,56348130,582848130,False,2
8773,validator_0,1135847093739,True,575900004,1469230,577369234,True,35
8774,validator_7,238536104560,True,757800000,15188280,772988280,False,7
8775,validator_5,340075021370,True,601800000,23382460,625182460,False,10
8776,validator_1,918837020680,True,720900000,4159940,725059940,False,28
8777,validator_18,110484718429,True,594919995,24618600,619538595,True,3
8778,validator_37,78127099510,True,561800000,2891720,564691720,False,2
8779,validator_5,340646888370,True,569300000,2567000,571867000,False,10
8780,validator_2,704730609404,True,822760005,7536800,830296805,True,22
8781,validator_5,341286767540,True,638400000,1479170,639879170,False,10
8782,validator_4,345440557051,True,841859998,32413340,874273338,True,10
8783,validator_12,85872817859,True,696900002,1048250,697948252,True,2
8784,validator_41,69594658290,True,721900000,1621230,723521230,False,2
8785,validator_3,508198855890,True,856100000,9324900,865424900,False,15
8786,validator_9,86257772042,True,799606002,38526130,838132132,True,2
8787,validator_23,118543242771,True,719899998,13066530,732966528,True,3
8788,validator_25,96855985360,True,472319995,21254170,493574165,True,3
8789,validator_3,508952094520,True,749900000,3338630,753238630,False,15
8790,validator_0,1136392389871,True,542500002,2796130,545296132,True,35
8791,validator_2,705497335639,True,759300005,7426230,766726235,True,22
8792,validator_0,1137297306772,True,886140001,18776900,904916901,True,35
8793,validator_6,242275444740,True,683440000,9733610,693173610,True,7
8794,validator_40,81091168960,True,596300000,2300240,598600240,False,2
8795,validator_2,706382389984,True,853060005,31994340,885054345,True,22
8796,validator_23,119092657474,True,527860003,21554700,549414703,True,3
8797,validator_30,81023916600,True,683100000,27082590,710182590,False,2
8798,validator_32,85058087650,True,734600000,1640600,736240600,False,2
8799,validator_5,341920946170,True,609300000,24878630,634178630,False,10
8800,validator_2,707226314505,True,836220001,7704520,843924521,True,22
8801,validator_0,1138046894177,True,721600005,27987400,749587405,True,35
8802,validator_35,94475808320,True,548400000,3500080,551900080,False,2
8803,validator_5,342443198170,True,517500000,4752000,522252000,False,10
8804,validator_2,707729149708,True,481700003,21135200,502835203,True,22
8805,validator_43,71957056730,True,704200000,19656800,723856800,False,2
8806,validator_3,509613495300,True,639700000,21700780,661400780,False,15
8807,validator_38,82436495980,True,744400000,7373990,751773990,False,2
8808,validator_36,78490938320,True,630800000,2339970,633139970,False,2
8809,validator_0,1138768326276,True,700899999,20532100,721432099,True,35
8810,validator_42,86020106650,True,527600000,19031530,546631530,False,2
8811,validator_18,111130550572,True,634740003,11092140,645832143,True,3
8812,validator_3,510303526690,True,687800000,2231390,690031390,False,15
8813,validator_21,120562670904,True,736564003,32183500,768747503,True,3
8814,validator_27,92596080225,True,711170001,6919200,718089201,True,2
8815,validator_6,242849116665,True,562499995,11171930,573671925,True,7
8816,validator_0,1139252699598,True,481939992,2433330,484373322,True,35
8817,validator_7,239120305700,True,581100000,3101140,584201140,False,7
8818,validator_0,1139668006206,True,405979998,9326610,415306608,True,35
8819,validator_39,74655710180,True,674500000,2589730,677089730,False,2
8820,validator_28,105034906065,True,596379994,32765680,629145674,True,3
8821,validator_42,86412764120,True,391470000,1187470,392657470,False,2
8822,validator_11,93373246696,True,778800001,21025510,799825511,True,2
8823,validator_2,708462512381,True,715159993,18202680,733362673,True,22
8824,validator_9,86783143584,True,500724002,24647540,525371542,True,2
8825,validator_3,510727713480,True,423130000,1056790,424186790,False,15
8826,validator_30,81485365700,True,458000000,3449100,461449100,False,2
8827,validator_7,239700657430,True,569900000,10451730,580351730,False,7
8828,validator_1,919479089080,True,640700000,1368400,642068400,False,28
8829,validator_8,103312866474,True,820299997,7828080,828128077,True,3
8830,validator_1,920039701160,True,558200000,2412080,560612080,False,28
8831,validator_43,72454013230,True,472500000,24456500,496956500,False,2
8832,validator_0,1140312251498,True,617160002,27085290,644245292,True,35
8833,validator_6,243544839828,True,692500003,3223160,695723163,True,7
8834,validator_6,244375929215,True,817345997,13743390,831089387,True,7
8835,validator_3,511308240120,True,578700000,1826640,580526640,False,15
8836,validator_3,511820734560,True,509000000,3494440,512494440,False,15
8837,validator_1,920643703300,True,600300000,3702140,604002140,False,28
8838,validator_32,85653351160,True,592500000,2763510,595263510,False,2
8839,validator_32,86275692190,True,621000000,1341030,622341030,False,2
8840,validator_2,709155756380,True,635999999,57244000,693243999,True,22
8841,validator_0,1140894596843,True,551850005,30495340,582345345,True,35
8842,validator_1,921254975400,True,609300000,1972100,611272100,False,28
8843,validator_1,921839216170,True,564800000,19440770,584240770,False,28
8844,validator_6,244963403798,True,573339993,14134590,587474583,True,7
8845,validator_4,346162196643,True,684074002,37565590,721639592,True,10
8846,validator_24,99850918187,True,633019997,31364910,664384907,True,3
8847,validator_18,111765639175,True,618600003,16488600,635088603,True,3
8848,validator_0,1141614347673,True,718200000,1550830,719750830,True,35
8849,validator_44,81730277310,True,639000000,20451420,659451420,False,2
8850,validator_37,78517477210,True,388920000,1457700,390377700,False,2
8851,validator_7,240200693520,True,498900000,1136090,500036090,False,7
8852,validator_13,81738678756,True,711345998,16591430,727937428,True,2
8853,validator_0,1142180821953,True,546700000,19774280,566474280,True,35
8854,validator_2,709943598542,True,785100002,2742160,787842162,True,22
8855,validator_6,245784233742,True,807300004,13529940,820829944,True,7
8856,validator_7,240735819280,True,528100000,7025760,535125760,False,7
8857,validator_1,922521468190,True,655100000,27152020,682252020,False,28
8858,validator_7,241537108450,True,780300000,20989170,801289170,False,7
8859,validator_10,123151278763,True,1025354002,42898300,1068252302,True,3
8860,validator_37,78952104290,True,432000000,2627080,434627080,False,2
8861,validator_2,710471810044,True,503040002,25171500,528211502,True,22
8862,validator_4,346648130235,True,479450002,6483590,485933592,True,10
8863,validator_3,512437507350,True,612700000,4072790,616772790,False,16
8864,validator_14,109286637297,True,992499998,1691680,994191678,True,3
8865,validator_7,241980876150,True,424300000,19467700,443767700,False,7
8866,validator_0,1143012122994,True,826000001,5301040,831301041,True,35
8867,validator_7,242540150080,True,556200000,3073930,559273930,False,7
8868,validator_8,103960631995,True,641040001,6725520,647765521,True,3
8869,validator_3,512878385210,True,422000000,18877860,440877860,False,16
8870,validator_2,711186167870,True,707839996,6517830,714357826,True,22
8871,validator_1,923134112890,True,598700000,13944700,612644700,False,28
8872,validator_4,347233757684,True,523825989,61801460,585627449,True,10
8873,validator_0,1143516449976,True,501000002,3326980,504326982,True,35
8874,validator_5,343034354710,True,587300000,3856540,591156540,False,10
8875,validator_4,347946744089,True,689896005,23090400,712986405,True,10
8876,validator_5,343566719400,True,529600000,2764690,532364690,False,10
8877,validator_2,711983389565,True,786499995,10721700,797221695,True,22
8878,validator_38,83059545370,True,620800000,2249390,623049390,False,2
8879,validator_1,923687491110,True,552900000,478220,553378220,False,28
8880,validator_25,97451490205,True,571160005,24344840,595504845,True,3
8881,validator_8,104827660997,True,857720002,9309000,867029002,True,3
8882,validator_20,110323004637,True,738899996,4434630,743334626,True,3
8883,validator_2,712661651468,True,639440003,38821900,678261903,True,22
8884,validator_35,95001705750,True,523000000,2897430,525897430,False,2
8885,validator_17,109707475162,True,713096006,13795380,726891386,True,3
8886,validator_31,88517041640,True,398900000,3219410,402119410,False,2
8887,validator_3,513361427050,True,479700000,3341840,483041840,False,16
8888,validator_5,344431283000,True,863000000,1563600,864563600,False,10
8889,validator_23,119673258750,True,536377996,44223280,580601276,True,3
8890,validator_35,95405909000,True,401500000,2703250,404203250,False,2
8891,validator_11,94141697526,True,761100000,7350830,768450830,True,2
8892,validator_14,109973551603,True,652440006,34474300,686914306,True,3
8893,validator_0,1144170320351,True,611899995,41970380,653870375,True,35
8894,validator_48,95504471440,True,695300000,23770900,719070900,False,2
8895,validator_1,924443870090,True,746700000,9678980,756378980,False,28
8896,validator_30,82274813520,True,781200000,8247820,789447820,False,2
8897,validator_8,105590326443,True,762100006,565440,762665446,True,3
8898,validator_21,121231628305,True,662958001,5999400,668957401,True,3
8899,validator_2,713347694409,True,663520001,22522940,686042941,True,22
8900,validator_1,925161400490,True,713400000,4130400,717530400,False,28
8901,validator_0,1144714555056,True,532539995,11694710,544234705,True,35
8902,validator_0,1145338315590,True,617140004,6620530,623760534,True,35
8903,validator_1,925838228270,True,673700000,3127780,676827780,False,28
8904,validator_21,121913646375,True,655700000,26318070,682018070,True,3
8905,validator_3,513906760470,True,539400000,5933420,545333420,False,16
8906,validator_1,926522511570,True,682400000,1883300,684283300,False,28
8907,validator_33,95405662230,True,605700000,5168140,610868140,False,2
8908,validator_30,82860493360,True,582700000,2979840,585679840,False,2
8909,validator_3,514561298930,True,634500000,20038460,654538460,False,16
8910,validator_49,68303551580,True,566200000,1852330,568052330,False,2
8911,validator_2,714009254878,True,652499999,9060470,661560469,True,22
8912,validator_1,927042760310,True,517300000,2948740,520248740,False,28
8913,validator_33,96075219470,True,638100000,31457240,669557240,False,3
8914,validator_3,515138731030,True,569500000,7932100,577432100,False,16
8915,validator_35,96181589330,True,773100000,2580330,775680330,False,3
8916,validator_1,927677591460,True,606500000,28331150,634831150,False,28
8917,validator_1,928326715780,True,612100000,37024320,649124320,False,29
8918,validator_0,1145955347676,True,580000006,37032080,617032086,True,35
8919,validator_0,1146448467735,True,482920009,10200050,493120059,True,35
8920,validator_2,714885410179,True,870520001,5635300,876155301,True,22
8921,validator_2,715560085914,True,642385995,32289740,674675735,True,22
8922,validator_6,246279572069,True,483859997,11478330,495338327,True,7
8923,validator_37,79545493830,True,585500000,7889540,593389540,False,2
8924,validator_0,1147163333589,True,706899994,7965860,714865854,True,35
8925,validator_2,716181797910,True,620299996,1412000,621711996,True,22
8926,validator_7,243213865900,True,668400000,5315820,673715820,False,7
8927,validator_15,126269145878,True,1053760007,24191050,1077951057,True,3
8928,validator_0,1148000374178,True,810399999,26640590,837040589,True,35
8929,validator_20,111221551637,True,881180000,17367000,898547000,True,3
8930,validator_33,96836493550,True,757400000,3874080,761274080,False,3
8931,validator_6,246927896792,True,627540003,20784720,648324723,True,7
8932,validator_19,98859069443,True,407699997,5233600,412933597,True,3
8933,validator_2,717088010690,True,902700000,3512780,906212780,True,22
8934,validator_4,348827164122,True,841340003,39080030,880420033,True,10
8935,validator_4,349468524553,True,635800001,5560430,641360431,True,10
8936,validator_0,1148676280579,True,584960001,90946400,675906401,True,35
8937,validator_20,111988845211,True,764519994,2773580,767293574,True,3
8938,validator_29,68506043700,True,612400000,2996870,615396870,False,2
8939,validator_11,94876282264,True,723963998,10620740,734584738,True,2
8940,validator_6,247626580186,True,673999994,24683400,698683394,True,7
8941,validator_1,928931377110,True,576700000,27961330,604661330,False,29
8942,validator_33,97511427740,True,673900000,1034190,674934190,False,3
8943,validator_33,98064128010,True,550600000,2100270,552700270,False,3
8944,validator_28,105789952264,True,739095999,15950200,755046199,True,3
8945,validator_24,100481463133,True,610340006,20204940,630544946,True,3
8946,validator_5,345239338430,True,806800000,1255430,808055430,False,10
8947,validator_35,96789383260,True,597100000,10693930,607793930,False,3
8948,validator_48,96197311740,True,688300000,4540300,692840300,False,3
8949,validator_34,89924880420,True,608400000,1626800,610026800,False,2
8950,validator_20,112543072951,True,528480000,25747740,554227740,True,3
8951,validator_35,97388581360,True,596800000,2398100,599198100,False,3
8952,validator_15,127011535700,True,734499992,7889830,742389822,True,3
8953,validator_1,929512807450,True,571100000,10330340,581430340,False,29
8954,validator_30,83387422060,True,506900000,20028700,526928700,False,2
8955,validator_18,112468547476,True,701600001,1308300,702908301,True,3
8956,validator_30,84056193350,True,648600000,20171290,668771290,False,2
8957,validator_22,129772915266,True,675800008,20251730,696051738,True,4
8958,validator_20,113144601691,True,576260000,25268740,601528740,True,3
8959,validator_15,127686718995,True,631565995,43617300,675183295,True,3
8960,validator_3,515705194620,True,561200000,5263590,566463590,False,16
8961,validator_2,717815417029,True,660963989,66442350,727406339,True,22
8962,validator_47,77922737500,True,609100000,8450100,617550100,False,2
8963,validator_7,244126593960,True,909500000,3228060,912728060,False,7
8964,validator_35,97967725520,True,575800000,3344160,579144160,False,3
8965,validator_5,345747989310,True,506400000,2250880,508650880,False,10
8966,validator_3,516435781320,True,726300000,4286700,730586700,False,16
8967,validator_0,1149129818676,True,436439997,17098100,453538097,True,35
8968,validator_41,70186036590,True,583900000,7478300,591378300,False,2
8969,validator_48,96858000540,True,657500000,3188800,660688800,False,3
8970,validator_23,120287831916,True,611199996,3373170,614573166,True,3
8971,validator_7,244736937450,True,606400000,3943490,610343490,False,7
8972,validator_28,106362371950,True,566600006,5819680,572419686,True,3
8973,validator_27,93336907255,True,695148000,45679030,740827030,True,2
8974,validator_44,82268936950,True,518100000,20559640,538659640,False,2
8975,validator_4,350093259550,True,576555997,48179000,624734997,True,10
8976,validator_1,930211831040,True,694400000,4623590,699023590,False,29
8977,validator_22,130417171296,True,625100000,19156030,644256030,True,4
8978,validator_0,1150093197436,True,962100000,1278760,963378760,True,35
8979,validator_24,101154958314,True,665920001,7575180,673495181,True,3
8980,validator_7,245356053650,True,584670000,34446200,619116200,False,7
8981,validator_34,90455289010,True,528400000,2008590,530408590,False,2
8982,validator_7,245944918360,True,587100000,1764710,588864710,False,7
8983,validator_6,248236551266,True,591220000,18751080,609971080,True,7
8984,validator_35,98581519300,True,611200000,2593780,613793780,False,3
8985,validator_1,930612525140,True,399300000,1394100,400694100,False,29
8986,validator_12,86541243725,True,643839996,24585870,668425866,True,2
8987,validator_0,1150911046889,True,815700003,2149450,817849453,True,35
8988,validator_19,99446283229,True,569889996,17323790,587213786,True,3
8989,validator_4,350545888650,True,428260000,24369100,452629100,True,10
8990,validator_3,516961714540,True,523900000,2033220,525933220,False,16
8991,validator_37,80179147220,True,631700000,1953390,633653390,False,2
8992,validator_1,931343609460,True,723900000,7184320,731084320,False,29
8993,validator_0,1151424531723,True,493719994,19764840,513484834,True,35
8994,validator_22,131003840517,True,559120001,27549220,586669221,True,4
8995,validator_14,110482982483,True,488540000,20890880,509430880,True,3
8996,validator_41,71014943380,True,827000000,1906790,828906790,False,2
8997,validator_24,101822119716,True,643840002,23321400,667161402,True,3
8998,validator_4,351120357347,True,563265997,11202700,574468697,True,10
8999,validator_44,82869218150,True,597800000,2481200,600281200,False,2
9000,validator_13,82340852756,True,597180000,4994000,602174000,True,2
9001,validator_6,248855875989,True,594800003,24524720,619324723,True,7
9002,validator_1,931878599790,True,532800000,2190330,534990330,False,29
9003,validator_6,249661214853,True,771100004,34238860,805338864,True,7
9004,validator_7,246686765640,True,739700000,2147280,741847280,False,7
9005,validator_15,128308143999,True,619100004,2325000,621425004,True,4
9006,validator_22,131770465138,True,750340001,16284620,766624621,True,4
9007,validator_28,107160394450,True,791260000,6762500,798022500,True,3
9008,validator_0,1151988638130,True,537800007,26306400,564106407,True,35
9009,validator_2,718516324519,True,691920000,8987490,700907490,True,22
9010,validator_4,351696497152,True,560200005,15939800,576139805,True,10
9011,validator_3,517603222050,True,632800000,8707510,641507510,False,16
9012,validator_3,518197649260,True,587900000,6527210,594427210,False,16
9013,validator_2,719294402220,True,742540001,35537700,778077701,True,22
9014,validator_0,1152728504486,True,714579996,25286360,739866356,True,36
9015,validator_2,720108141789,True,772880009,40859560,813739569,True,22
9016,validator_28,107676589918,True,493659998,22535470,516195468,True,3
9017,validator_3,518890909960,True,692500000,760700,693260700,False,16
9018,validator_25,98249103429,True,770600004,27013220,797613224,True,3
9019,validator_15,128920832099,True,597180000,15508100,612688100,True,4
9020,validator_32,86798908210,True,521000000,2216020,523216020,False,2
9021,validator_33,98435246970,True,368300000,2818960,371118960,False,3
9022,validator_0,1153437659057,True,690140001,19014570,709154571,True,36
9023,validator_1,932473504800,True,591600000,3305010,594905010,False,29
9024,validator_4,352338212749,True,630199997,11515600,641715597,True,11
9025,validator_5,346411053990,True,643100000,19964680,663064680,False,10
9026,validator_34,91188213410,True,713100000,19824400,732924400,False,2
9027,validator_42,87001340760,True,585200000,3376640,588576640,False,2
9028,validator_4,352818382355,True,458078006,22091600,480169606,True,11
9029,validator_1,933144921100,True,669900000,1516300,671416300,False,29
9030,validator_7,247435641140,True,747200000,1675500,748875500,False,7
9031,validator_1,933741703670,True,588300000,8482570,596782570,False,29
9032,validator_2,720907965009,True,774500000,25323220,799823220,True,22
9033,validator_3,519587415540,True,693100000,3405580,696505580,False,16
9034,validator_35,99272668730,True,688700000,2449430,691149430,False,3
9035,validator_0,1154162219076,True,711159999,13400020,724560019,True,36
9036,validator_43,72916990590,True,460600000,2377360,462977360,False,2
9037,validator_1,934398118370,True,652900000,3514700,656414700,False,29
9038,validator_1,934963547550,True,557400000,8029180,565429180,False,29
9039,validator_1,935537613970,True,571600000,2466420,574066420,False,29
9040,validator_20,113696567296,True,544600005,7365600,551965605,True,3
9041,validator_4,353725929558,True,901300003,6247200,907547203,True,11
9042,validator_19,99983855418,True,505339999,32232190,537572189,True,3
9043,validator_48,97285185640,True,408700000,18485100,427185100,False,3
9044,validator_15,129543998168,True,600299999,22866070,623166069,True,4
9045,validator_11,95455485051,True,572259997,6942790,579202787,True,2
9046,validator_3,520224457800,True,630400000,6642260,637042260,False,16
9047,validator_47,78681909080,True,753000000,6171580,759171580,False,2
9048,validator_13,83175119092,True,759659996,74606340,834266336,True,2
9049,validator_0,1155022155501,True,844669995,15266430,859936425,True,36
9050,validator_7,247903929140,True,465200000,3088000,468288000,False,7
9051,validator_3,520847290380,True,620500000,2332580,622832580,False,16
9052,validator_5,346932855850,True,520700000,1101860,521801860,False,10
9053,validator_0,1155692863097,True,657899996,12807600,670707596,True,36
9054,validator_37,80694820620,True,496300000,19373400,515673400,False,2
9055,validator_42,87553806690,True,548100000,4365930,552465930,False,2
9056,validator_0,1156278817468,True,526780001,59174370,585954371,True,36
9057,validator_1,936135504910,True,589100000,8790940,597890940,False,29
9058,validator_0,1156905950400,True,625500002,1632930,627132932,True,36
9059,validator_1,936791052360,True,652500000,3047450,655547450,False,29
9060,validator_0,1157469757343,True,538840013,24966930,563806943,True,36
9061,validator_21,122542780712,True,619665997,9468340,629134337,True,3
9062,validator_0,1158429101268,True,938819995,20523930,959343925,True,36
9063,validator_0,1159149210067,True,711999999,8108800,720108799,True,36
9064,validator_46,78708648300,True,520620000,1081500,521701500,False,2
9065,validator_0,1159887361595,True,720519998,17631530,738151528,True,36
9066,validator_1,937371841860,True,577400000,3389500,580789500,False,29
9067,validator_1,937765563440,True,390600000,3121580,393721580,False,29
9068,validator_14,111239516342,True,735959999,20573860,756533859,True,3
9069,validator_2,721759746248,True,826899999,24881240,851781239,True,22
9070,validator_5,347485173050,True,542200000,10117200,552317200,False,10
9071,validator_0,1160717099460,True,828399995,1337870,829737865,True,36
9072,validator_36,79145281610,True,652000000,2343290,654343290,False,2
9073,validator_38,83816673810,True,753600000,3528440,757128440,False,2
9074,validator_6,250251807070,True,588200007,2392210,590592217,True,7
9075,validator_0,1161417374038,True,644479998,55794580,700274578,True,36
9076,validator_1,938291317460,True,516600000,9154020,525754020,False,29
9077,validator_41,71599890280,True,546700000,38246900,584946900,False,2
9078,validator_36,79844582230,True,679200000,20100620,699300620,False,2
9079,validator_1,938959133560,True,656300000,11516100,667816100,False,29
9080,validator_37,81201019560,True,499000000,7198940,506198940,False,2
9081,validator_7,248609516890,True,702400000,3187750,705587750,False,7
9082,validator_1,939578352340,True,613000000,6218780,619218780,False,29
9083,validator_15,130299666131,True,738959993,16707970,755667963,True,4
9084,validator_14,111797447480,True,537139998,20791140,557931138,True,3
9085,validator_1,940191514990,True,610900000,2262650,613162650,False,29
9086,validator_25,98944062929,True,687900000,7059500,694959500,True,3
9087,validator_5,348241886180,True,746800000,9913130,756713130,False,10
9088,validator_2,722706886676,True,918279988,28860440,947140428,True,22
9089,validator_1,940696712080,True,499000000,6197090,505197090,False,29
9090,validator_36,80603761730,True,728400000,30779500,759179500,False,2
9091,validator_2,723370790777,True,645170001,18734100,663904101,True,22
9092,validator_3,521458139110,True,590400000,20448730,610848730,False,16
9093,validator_1,941298579990,True,601100000,767910,601867910,False,29
9094,validator_0,1161988859036,True,547079998,24405000,571484998,True,36
9095,validator_2,724004055280,True,613100003,20164500,633264503,True,22
9096,validator_2,724623833581,True,556580001,63198300,619778301,True,22
9097,validator_7,249249201890,True,636800000,2885000,639685000,False,7
9098,validator_4,354363874167,True,623013999,14930610,637944609,True,11
9099,validator_28,108372903819,True,657226001,39087900,696313901,True,3
9100,validator_3,521941365190,True,481200000,2026080,483226080,False,16
9101,validator_1,941839884320,True,537400000,3904330,541304330,False,29
9102,validator_30,84644207970,True,586500000,1514620,588014620,False,2
9103,validator_4,355153933266,True,746719999,43339100,790059099,True,11
9104,validator_7,249846424590,True,594300000,2922700,597222700,False,7
9105,validator_0,1162757828402,True,746799996,22169370,768969366,True,36
9106,validator_17,110298864464,True,589760002,1629300,591389302,True,3
9107,validator_2,725283526683,True,653300002,6393100,659693102,True,22
9108,validator_1,942530155650,True,680700000,9571330,690271330,False,29
9109,validator_7,250366967530,True,499500000,21042940,520542940,False,7
9110,validator_35,100035357290,True,761000000,1688560,762688560,False,3
9111,validator_1,943100922270,True,568200000,2566620,570766620,False,29
9112,validator_2,725968649344,True,640176001,44946660,685122661,True,22
9113,validator_21,123395158588,True,850899996,1477880,852377876,True,3
9114,validator_14,112301860799,True,497019999,7393320,504413319,True,3
9115,validator_0,1163290062381,True,504263999,27969980,532233979,True,36
9116,validator_5,348721707830,True,477200000,2621650,479821650,False,10
9117,validator_18,113215168818,True,718568002,28053340,746621342,True,3
9118,validator_20,114498858196,True,752641990,49648910,802290900,True,3
9119,validator_0,1164035529295,True,717419994,28046920,745466914,True,36
9120,validator_48,97836665360,True,542100000,9379720,551479720,False,3
9121,validator_6,250973520839,True,703939989,17773780,721713769,True,7
9122,validator_2,726498005442,True,518779998,10576100,529356098,True,22
9123,validator_0,1164829179954,True,760679999,32970660,793650659,True,36
9124,validator_45,90534984180,True,600300000,1666490,601966490,False,2
9125,validator_5,349317184420,True,553700000,41776590,595476590,False,10
9126,validator_18,113961491911,True,735199993,11123100,746323093,True,3
9127,validator_42,88277668190,True,722700000,1161500,723861500,False,2
9128,validator_0,1165501499930,True,662419996,9899980,672319976,True,36
9129,validator_1,943593171970,True,489500000,2749700,492249700,False,29
9130,validator_5,349871976160,True,551200000,3591740,554791740,False,10
9131,validator_4,355988053284,True,820205998,13914020,834120018,True,11
9132,validator_21,124374771083,True,946953995,32658500,979612495,True,3
9133,validator_0,1166091219629,True,579699999,10019700,589719699,True,36
9134,validator_1,944020177850,True,425900000,1105880,427005880,False,29
9135,validator_17,111029618264,True,711200000,19553800,730753800,True,3
9136,validator_1,944565877750,True,528900000,16799900,545699900,False,29
9137,validator_0,1166689056275,True,582659996,15176650,597836646,True,36
9138,validator_12,87151426823,True,571439998,38743100,610183098,True,2
9139,validator_7,251048077330,True,677500000,3609800,681109800,False,7
9140,validator_25,99949792554,True,1003699995,2029630,1005729625,True,3
9141,validator_44,83420423490,True,549600000,1605340,551205340,False,2
9142,validator_2,727101661868,True,583849996,19806430,603656426,True,22
9143,validator_46,79415354860,True,693900000,12806560,706706560,False,2
9144,validator_32,87410442150,True,602600000,8933940,611533940,False,2
9145,validator_20,115105599094,True,598239998,8500900,606740898,True,3
9146,validator_1,945330158750,True,752600000,11681000,764281000,False,29
9147,validator_43,73453290940,True,529200000,7100350,536300350,False,2
9148,validator_34,91750060810,True,559700000,2147400,561847400,False,2
9149,validator_4,356596564770,True,570836006,37675480,608511486,True,11
9150,validator_26,104861835955,True,663200000,16566080,679766080,True,3
9151,validator_1,945796559270,True,464700000,1700520,466400520,False,29
9152,validator_1,946575233950,True,758400000,20274680,778674680,False,29
9153,validator_17,111674166399,True,640100005,4448130,644548135,True,3
9154,validator_5,350460246890,True,551500000,36770730,588270730,False,10
9155,validator_40,81578739500,True,474000000,13570540,487570540,False,2
9156,validator_24,102517093400,True,630599994,64373690,694973684,True,3
9157,validator_1,947168984570,True,591000000,2750620,593750620,False,29
9158,validator_2,727762754350,True,637600002,23492480,661092482,True,22
9159,validator_1,947884339180,True,707400000,7954610,715354610,False,29
9160,validator_11,96262646443,True,785940002,21221390,807161392,True,3
9161,validator_7,251653777100,True,599000000,6699770,605699770,False,7
9162,validator_14,113038696798,True,724039999,12796000,736835999,True,3
9163,validator_14,113840954815,True,790459997,11798020,802258017,True,3
9164,validator_10,123919983338,True,717539995,51164580,768704575,True,3
9165,validator_14,114603036355,True,748140000,13941540,762081540,True,3
9166,validator_0,1167485559356,True,759980001,36523080,796503081,True,36
9167,validator_35,100679031520,True,636300000,7374230,643674230,False,3
9168,validator_2,728532419424,True,756179994,13485080,769665074,True,22
9169,validator_27,93839134950,True,457160005,45067690,502227695,True,2
9170,validator_3,522587683390,True,644500000,1818200,646318200,False,16
9171,validator_1,948560753320,True,674800000,1614140,676414140,False,29
9172,validator_1,949162780820,True,565000000,37027500,602027500,False,29
9173,validator_2,729174253044,True,608500000,33333620,641833620,True,22
9174,validator_32,88002158570,True,586200000,5516420,591716420,False,2
9175,validator_13,83859141385,True,674000003,10022290,684022293,True,2
9176,validator_0,1168202591488,True,706870002,10162130,717032132,True,36
9177,validator_22,132772478032,True,965319994,36692900,1002012894,True,4
9178,validator_48,98492033840,True,645200000,10168480,655368480,False,3
9179,validator_4,357229617177,True,630000007,3052400,633052407,True,11
9180,validator_0,1169107160832,True,874560004,30009340,904569344,True,36
9181,validator_9,87556764813,True,746940009,26681220,773621229,True,2
9182,validator_8,106326199546,True,714080003,21793100,735873103,True,3
9183,validator_0,1169829084532,True,702400000,19523700,721923700,True,36
9184,validator_1,949725734920,True,553500000,9454100,562954100,False,29
9185,validator_5,351129679640,True,667400000,2032750,669432750,False,10
9186,validator_0,1170345098412,True,507900000,8113880,516013880,True,36
9187,validator_2,729664369067,True,463274003,26842020,490116023,True,22
9188,validator_8,107210610890,True,881200004,3211340,884411344,True,3
9189,validator_22,133408446672,True,632040000,3928640,635968640,True,4
9190,validator_37,81705310190,True,502400000,1890630,504290630,False,2
9191,validator_0,1171000342761,True,646759999,8484350,655244349,True,36
9192,validator_29,69082430900,True,568800000,7587200,576387200,False,2
9193,validator_1,950176683390,True,448000000,2948470,450948470,False,29
9194,validator_1,950637879850,True,458500000,2696460,461196460,False,29
9195,validator_15,131129228312,True,800140001,29422180,829562181,True,4
9196,validator_2,730200885467,True,519480000,17036400,536516400,True,22
9197,validator_1,951258443330,True,611700000,8863480,620563480,False,29
9198,validator_43,74000604300,True,526400000,20913360,547313360,False,2
9199,validator_35,101182977990,True,501600000,2346470,503946470,False,3
9200,validator_0,1171537387247,True,498219996,38824490,537044486,True,36
9201,validator_2,730908184903,True,678236006,29063430,707299436,True,22
9202,validator_1,951648611730,True,384700000,5468400,390168400,False,29
9203,validator_2,731517023517,True,583500014,25338600,608838614,True,22
9204,validator_32,88636644170,True,632400000,2085600,634485600,False,2
9205,validator_44,84021568190,True,597500000,3644700,601144700,False,2
9206,validator_3,523053704420,True,460400000,5621030,466021030,False,16
9207,validator_7,252216677480,True,559800000,3100380,562900380,False,7
9208,validator_29,69584219100,True,481000000,20788200,501788200,False,2
9209,validator_0,1172146402107,True,570180000,38834860,609014860,True,36
9210,validator_16,88161935975,True,762946006,14944080,777890086,True,2
9211,validator_4,358074708967,True,808820000,36271790,845091790,True,11
9212,validator_4,358664871852,True,551659995,38502890,590162885,True,11
9213,validator_20,115742029434,True,617140000,19290340,636430340,True,3
9214,validator_6,251718161920,True,727680001,16961080,744641081,True,7
9215,validator_1,952173281730,True,504910000,19760000,524670000,False,29
9216,validator_4,359364984086,True,662646004,37466230,700112234,True,11
9217,validator_0,1173021280065,True,846819998,28057960,874877958,True,36
9218,validator_34,92409586470,True,658200000,1325660,659525660,False,2
9219,validator_4,360052452889,True,656560003,30908800,687468803,True,11
9220,validator_0,1173734387889,True,688196004,24911820,713107824,True,36
9221,validator_20,116252850737,True,507720003,3101300,510821303,True,3
9222,validator_14,115311165788,True,690860003,17269430,708129433,True,3
9223,validator_14,115877162000,True,539860012,26136200,565996212,True,3
9224,validator_3,523743899280,True,680900000,9294860,690194860,False,16
9225,validator_22,134156006709,True,718060007,29500030,747560037,True,4
9226,validator_6,252402079400,True,647740010,36177470,683917480,True,7
9227,validator_20,117058229937,True,790420000,14959200,805379200,True,3
9228,validator_31,89068073440,True,541700000,9331800,551031800,False,2
9229,validator_0,1174525492492,True,739020003,52084600,791104603,True,36
9230,validator_8,107828464687,True,579099997,38753800,617853797,True,3
9231,validator_8,108482246745,True,645099998,8682060,653782058,True,3
9232,validator_0,1175328452527,True,744654005,58306030,802960035,True,36
9233,validator_44,84551715080,True,506900000,23246890,530146890,False,2
9234,validator_44,85137322290,True,584300000,1307210,585607210,False,2
9235,validator_0,1176301718171,True,917900004,55365640,973265644,True,36
9236,validator_6,253265015799,True,853639999,9296400,862936399,True,7
9237,validator_2,732081757252,True,536220005,28513730,564733735,True,22
9238,validator_6,253787571508,True,499000009,23555700,522555709,True,7
9239,validator_7,252825639480,True,588500000,20462000,608962000,False,7
9240,validator_14,116723202438,True,824039998,22000440,846040438,True,3
9241,validator_0,1177113162836,True,793260005,18184660,811444665,True,36
9242,validator_1,952714578030,True,539400000,1896300,541296300,False,29
9243,validator_6,254303972285,True,511599997,4800780,516400777,True,7
9244,validator_6,255077552592,True,762740007,10840300,773580307,True,7
9245,validator_0,1177929104376,True,807960000,7981540,815941540,True,36
9246,validator_0,1178546583962,True,594020006,23459580,617479586,True,36
9247,validator_1,953161167560,True,443680000,2909530,446589530,False,29
9248,validator_0,1179069602620,True,507389998,15628660,523018658,True,36
9249,validator_20,117766786906,True,687499999,21056970,708556969,True,3
9250,validator_48,99123607240,True,621600000,9973400,631573400,False,3
9251,validator_1,953872244850,True,691000000,20077290,711077290,False,29
9252,validator_33,99037016700,True,590500000,11269730,601769730,False,3
9253,validator_2,732762510200,True,652459998,28292950,680752948,True,22
9254,validator_48,99980169040,True,835500000,21061800,856561800,False,3
9255,validator_24,103103686290,True,558739990,27852900,586592890,True,3
9256,validator_3,524326493820,True,580400000,2194540,582594540,False,16
9257,validator_10,124726466419,True,804200001,2283080,806483081,True,3
9258,validator_11,96921640627,True,631460004,27534180,658994184,True,3
9259,validator_1,954421202950,True,539700000,9258100,548958100,False,29
9260,validator_1,954983583290,True,560000000,2380340,562380340,False,29
9261,validator_0,1179729722590,True,616740000,43379970,660119970,True,36
9262,validator_2,733516313390,True,733540000,20263190,753803190,True,22
9263,validator_26,105718640314,True,800499999,56304360,856804359,True,3
9264,validator_42,88700855190,True,420600000,2587000,423187000,False,2
9265,validator_14,117360440936,True,615945998,21292500,637238498,True,3
9266,validator_1,955565429580,True,579500000,2346290,581846290,False,29
9267,validator_1,956058463280,True,470700000,22333700,493033700,False,29
9268,validator_0,1180517907086,True,784899996,3284500,788184496,True,36
9269,validator_21,125045147181,True,650499998,19876100,670376098,True,3
9270,validator_25,100661981750,True,669475996,42713200,712189196,True,3
9271,validator_33,99629597990,True,585000000,7581290,592581290,False,3
9272,validator_14,117996419124,True,632599998,3378190,635978188,True,3
9273,validator_22,134944393129,True,780720000,7666420,788386420,True,4
9274,validator_15,132085641944,True,914760002,41653630,956413632,True,4
9275,validator_28,108890642125,True,514710006,3028300,517738306,True,3
9276,validator_15,132699134745,True,568420001,45072800,613492801,True,4
9277,validator_2,734106735818,True,551319998,39102430,590422428,True,22
9278,validator_1,956743412670,True,680400000,4549390,684949390,False,29
9279,validator_12,87529383625,True,372540002,5416800,377956802,True,2
9280,validator_10,125518267417,True,753999998,37801000,791800998,True,3
9281,validator_1,957329606200,True,576800000,9393530,586193530,False,29
9282,validator_0,1181425223686,True,878700000,28616600,907316600,True,36
9283,validator_28,109724275128,True,815900003,17733000,833633003,True,3
9284,validator_7,253411450640,True,558800000,27011160,585811160,False,7
9285,validator_3,524992343040,True,639300000,26549220,665849220,False,16
9286,validator_47,79185589820,True,501700000,1980740,503680740,False,2
9287,validator_1,957895208730,True,539200000,26402530,565602530,False,29
9288,validator_29,70174859630,True,574100000,16540530,590640530,False,2
9289,validator_15,133261758674,True,555839999,6783930,562623929,True,4
9290,validator_3,525665789730,True,654200000,19246690,673446690,False,16
9291,validator_6,255795812739,True,706120007,12140140,718260147,True,7
9292,validator_4,360816384108,True,722439999,41491220,763931219,True,11
9293,validator_7,253932602010,True,501800000,19351370,521151370,False,7
9294,validator_0,1182073701477,True,642700001,5777790,648477791,True,36
9295,validator_7,254554693910,True,616300000,5791900,622091900,False,7
9296,validator_2,734871529962,True,758100004,6694140,764794144,True,22
9297,validator_9,88201750843,True,625420000,19566030,644986030,True,2
9298,validator_3,526373777570,True,706500000,1487840,707987840,False,16
9299,validator_0,1182979012960,True,884454003,20857480,905311483,True,36
9300,validator_0,1183765208203,True,764900003,21295240,786195243,True,36
9301,validator_4,361455912937,True,621699999,17828830,639528829,True,11
9302,validator_1,958498231630,True,594200000,8822900,603022900,False,29
9303,validator_29,70741758470,True,565500000,1398840,566898840,False,2
9304,validator_28,110335868826,True,579640008,31953690,611593698,True,3
9305,validator_14,118970349299,True,953600005,20330170,973930175,True,3
9306,validator_1,959435968930,True,936600000,1137300,937737300,False,29
9307,validator_0,1184400446901,True,625769998,9468700,635238698,True,37
9308,validator_0,1184910865407,True,454636006,55782500,510418506,True,37
9309,validator_2,735456590556,True,554699994,30360600,585060594,True,22
9310,validator_2,736197691460,True,715340004,25760900,741100904,True,23
9311,validator_15,133755405864,True,488239990,5407200,493647190,True,4
9312,validator_4,362031799740,True,564440003,11446800,575886803,True,11
9313,validator_3,526967789100,True,592800000,1211530,594011530,False,16
9314,validator_25,101376411082,True,694160002,20269330,714429332,True,3
9315,validator_6,256307257643,True,496820004,14624900,511444904,True,8
9316,validator_22,135942967808,True,964369999,34204680,998574679,True,4
9317,validator_24,103855124561,True,723899991,27538280,751438271,True,3
9318,validator_0,1185664529231,True,699679994,53983830,753663824,True,37
9319,validator_7,255248628870,True,686000000,7934960,693934960,False,7
9320,validator_1,959912680430,True,476000000,711500,476711500,False,29
9321,validator_1,960671948250,True,734100000,25167820,759267820,False,30
9322,validator_20,118321949347,True,530240001,24922440,555162441,True,3
9323,validator_1,961290707200,True,614800000,3958950,618758950,False,30
9324,validator_2,736807682370,True,584514000,25476910,609990910,True,23
9325,validator_47,79868633830,True,681300000,1744010,683044010,False,2
9326,validator_36,81033430430,True,427500000,2168700,429668700,False,2
9327,validator_2,737600889062,True,773840002,19366690,793206692,True,23
9328,validator_2,738426389612,True,794020000,31480550,825500550,True,23
9329,validator_13,84605293520,True,718019995,28132140,746152135,True,2
9330,validator_16,88855862271,True,684919996,9006300,693926296,True,2
9331,validator_37,82351373370,True,610200000,35863180,646063180,False,2
9332,validator_4,362659232365,True,602440005,24992620,627432625,True,11
9333,validator_5,351786947640,True,651200000,6068000,657268000,False,10
9334,validator_0,1186089753252,True,404040001,21184020,425224021,True,37
9335,validator_3,527771480800,True,802100000,1591700,803691700,False,16
9336,validator_3,528447683970,True,675300000,903170,676203170,False,16
9337,validator_15,134616886700,True,818819996,42660840,861480836,True,4
9338,validator_9,88850829606,True,642600003,6478760,649078763,True,2
9339,validator_0,1186856618790,True,738559998,28305540,766865538,True,37
9340,validator_19,100664603266,True,656039988,24707860,680747848,True,3
9341,validator_0,1187655553984,True,789799994,9135200,798935194,True,37
9342,validator_5,352390413240,True,596700000,6765600,603465600,False,11
9343,validator_17,112195227404,True,515300005,5761000,521061005,True,3
9344,validator_1,961680957750,True,382400000,7850550,390250550,False,30
9345,validator_3,529198033350,True,748300000,2049380,750349380,False,16
9346,validator_10,126034617886,True,477699999,38650470,516350469,True,3
9347,validator_3,529893356300,True,671000000,24322950,695322950,False,16
9348,validator_18,114785205917,True,806980006,16734000,823714006,True,3
9349,validator_5,352849476340,True,454200000,4863100,459063100,False,11
9350,validator_38,84355798840,True,530600000,8525030,539125030,False,2
9351,validator_48,100431361500,True,430100000,21092460,451192460,False,3
9352,validator_9,89725225874,True,854939998,19456270,874396268,True,2
9353,validator_1,962347404240,True,656400000,10046490,666446490,False,30
9354,validator_33,100302288070,True,670400000,2290080,672690080,False,3
9355,validator_27,94476169497,True,569855997,67178550,637034547,True,2
9356,validator_4,363424083258,True,763099993,1750900,764850893,True,11
9357,validator_6,257123838623,True,776400000,40180980,816580980,True,8
9358,validator_37,82929040070,True,574700000,2966700,577666700,False,2
9359,validator_24,104504376263,True,624940002,24311700,649251702,True,3
9360,validator_1,962907586270,True,558700000,1482030,560182030,False,30
9361,validator_3,530498522700,True,584200000,20966400,605166400,False,16
9362,validator_1,963571146830,True,660900000,2660560,663560560,False,30
9363,validator_24,105323194629,True,815999996,2818370,818818366,True,3
9364,validator_34,93048179900,True,637600000,993430,638593430,False,2
9365,validator_2,739059314107,True,606211995,26712500,632924495,True,23
9366,validator_29,71615965290,True,870100000,4106820,874206820,False,2
9367,validator_21,125962327981,True,905300000,11880800,917180800,True,3
9368,validator_24,106003850945,True,678099996,2556320,680656316,True,3
9369,validator_2,739877037304,True,796385997,21337200,817723197,True,23
9370,validator_0,1188326008981,True,668299997,2155000,670454997,True,37
9371,validator_23,120938479753,True,626499997,24147840,650647837,True,3
9372,validator_7,255952938480,True,698500000,5809610,704309610,False,7
9373,validator_0,1188927346369,True,580619998,20717390,601337388,True,37
9374,validator_1,964268963250,True,695200000,2616420,697816420,False,30
9375,validator_27,95152956402,True,674000005,2786900,676786905,True,2
9376,validator_2,740433357195,True,527440001,28879890,556319891,True,23
9377,validator_15,135120356004,True,495020004,8449300,503469304,True,4
9378,validator_25,102064909976,True,650840004,37658890,688498894,True,3
9379,validator_0,1189635811768,True,679279999,29185400,708465399,True,37
9380,validator_0,1190299852931,True,657220003,6821160,664041163,True,37
9381,validator_18,115508710151,True,690746004,32758230,723504234,True,3
9382,validator_0,1191132850955,True,830599994,2398030,832998024,True,37
9383,validator_13,85294441438,True,685899998,3247920,689147918,True,2
9384,validator_14,119779347820,True,785920001,23078520,808998521,True,3
9385,validator_0,1191950278385,True,791980000,25447430,817427430,True,37
9386,validator_0,1192420966874,True,435279999,35408490,470688489,True,37
9387,validator_49,69038094760,True,732100000,2443180,734543180,False,2
9388,validator_0,1193043207397,True,591786003,30454520,622240523,True,37
9389,validator_0,1193601625992,True,531587995,26830600,558418595,True,37
9390,validator_0,1194316697219,True,676639997,38431230,715071227,True,37
9391,validator_2,741093562391,True,639899996,20305200,660205196,True,23
9392,validator_20,119086396452,True,728048005,36399100,764447105,True,3
9393,validator_0,1194985983130,True,646919991,22365920,669285911,True,37
9394,validator_3,531048211100,True,546400000,3288400,549688400,False,16
9395,validator_19,101460416860,True,782799994,13013600,795813594,True,3
9396,validator_6,257827819622,True,672079999,31901000,703980999,True,8
9397,validator_20,119846544018,True,750019996,10127570,760147566,True,3
9398,validator_1,964867169670,True,567500000,30706420,598206420,False,30
9399,validator_7,256481293180,True,519000000,9354700,528354700,False,8
9400,validator_29,72096761000,True,479000000,1795710,480795710,False,2
9401,validator_1,965418439670,True,539900000,11370000,551270000,False,30
9402,validator_49,69780669180,True,739200000,3374420,742574420,False,2
9403,validator_6,258789262711,True,915893989,45549100,961443089,True,8
9404,validator_0,1195594460755,True,547407995,61069630,608477625,True,37
9405,validator_28,110958430702,True,570039996,52521880,622561876,True,3
9406,validator_18,116264258540,True,739139999,16408390,755548389,True,3
9407,validator_3,531502572400,True,450000000,4361300,454361300,False,16
9408,validator_5,353466024370,True,615100000,1448030,616548030,False,11
9409,validator_6,259487343546,True,674200005,23880830,698080835,True,8
9410,validator_8,109385080071,True,895659996,7173330,902833326,True,3
9411,validator_3,532225137810,True,712610000,9955410,722565410,False,16
9412,validator_2,741729818295,True,568419994,67835910,636255904,True,23
9413,validator_7,257002670420,True,519000000,2377240,521377240,False,8
9414,validator_0,1196441275535,True,792180000,54634780,846814780,True,37
9415,validator_5,354165912840,True,684300000,15588470,699888470,False,11
9416,validator_3,532886299450,True,634500000,26661640,661161640,False,16
9417,validator_24,106827859338,True,787040003,36968390,824008393,True,3
9418,validator_0,1196952080318,True,502719993,8084790,510804783,True,37
9419,validator_0,1197399468649,True,446200001,1188330,447388331,True,37
9420,validator_1,965869782730,True,442200000,9143060,451343060,False,30
9421,validator_36,81767102030,True,713600000,20071600,733671600,False,2
9422,validator_1,966449752460,True,576200000,3769730,579969730,False,30
9423,validator_11,97558507329,True,614970002,21896700,636866702,True,3
9424,validator_33,100858029290,True,549530000,6211220,555741220,False,3
9425,validator_12,88239180330,True,666760005,43036700,709796705,True,2
9426,validator_0,1198018181582,True,580140003,38572930,618712933,True,37
9427,validator_0,1198608902278,True,577939996,12780700,590720696,True,37
9428,validator_1,966878805780,True,409600000,19453320,429053320,False,30
9429,validator_35,101710234020,True,513700000,13556030,527256030,False,3
9430,validator_2,742332328013,True,595739998,6769720,602509718,True,23
9431,validator_0,1199397529633,True,762939995,25687360,788627355,True,37
9432,validator_12,88897343525,True,655399995,2763200,658163195,True,2
9433,validator_28,111667769657,True,683679995,25658960,709338955,True,3
9434,validator_15,135715467909,True,543880005,51231900,595111905,True,4
9435,validator_37,83400139050,True,467400000,3698980,471098980,False,2
9436,validator_3,533546193930,True,641000000,18894480,659894480,False,16
9437,validator_1,967429975520,True,540500000,10669740,551169740,False,30
9438,validator_11,98200555117,True,629899998,12147790,642047788,True,3
9439,validator_0,1200055897669,True,631419996,26948040,658368036,True,37
9440,validator_2,743137205910,True,794553997,10323900,804877897,True,23
9441,validator_32,89247703980,True,609200000,1859810,611059810,False,2
9442,validator_13,86061792708,True,757700000,9651270,767351270,True,2
9443,validator_0,1200691512304,True,599080005,36534630,635614635,True,37
9444,validator_48,101058953660,True,621400000,6192160,627592160,False,3
9445,validator_0,1201450807841,True,756000007,3295530,759295537,True,37
9446,validator_35,102485939400,True,774100000,1605380,775705380,False,3
9447,validator_44,85621226090,True,480600000,3303800,483903800,False,2
9448,validator_5,354797813270,True,631100000,800430,631900430,False,11
9449,validator_19,102180003761,True,717400001,2186900,719586901,True,3
9450,validator_2,743997853536,True,791539996,69107630,860647626,True,23
9451,validator_4,364112505595,True,674799997,13622340,688422337,True,11
9452,validator_0,1202434057841,True,957519990,25730010,983250000,True,37
9453,validator_3,534164585230,True,609000000,9391300,618391300,False,16
9454,validator_1,968120532020,True,687200000,3356500,690556500,False,30
9455,validator_4,364650744050,True,535330005,2908450,538238455,True,11
9456,validator_34,93683447320,True,614300000,20967420,635267420,False,2
9457,validator_5,355418383380,True,601200000,19370110,620570110,False,11
9458,validator_5,355990951500,True,557800000,14768120,572568120,False,11
9459,validator_41,72072312580,True,470500000,1922300,472422300,False,2
9460,validator_11,98919436106,True,708259999,10620990,718880989,True,3
9461,validator_0,1203147854980,True,636775999,77021140,713797139,True,37
9462,validator_40,82269477560,True,689500000,1238060,690738060,False,2
9463,validator_7,257545709910,True,522100000,20939490,543039490,False,8
9464,validator_24,107489802465,True,652139997,9803130,661943127,True,3
9465,validator_7,257989439340,True,440100000,3629430,443729430,False,8
9466,validator_3,534865866830,True,655300000,45981600,701281600,False,16
9467,validator_1,968671748650,True,548100000,3116630,551216630,False,30
9468,validator_16,89506660274,True,644000003,6798000,650798003,True,2
9469,validator_15,136346483355,True,621160006,9855440,631015446,True,4
9470,validator_4,365631263066,True,971539996,8979020,980519016,True,11
9471,validator_0,1203979523798,True,801637998,30030820,831668818,True,37
9472,validator_23,121680673108,True,709840005,32353350,742193355,True,3
9473,validator_20,120362456554,True,483397996,32514540,515912536,True,3
9474,validator_33,101448704410,True,583800000,6875120,590675120,False,3
9475,validator_0,1204596869830,True,610920002,6426030,617346032,True,37
9476,validator_2,744600327780,True,587600004,14874240,602474244,True,23
9477,validator_1,969193749420,True,514900000,7100770,522000770,False,30
9478,validator_2,745612983129,True,996885999,15769350,1012655349,True,23
9479,validator_3,535551270760,True,668400000,17003930,685403930,False,16
9480,validator_5,356644663790,True,650600000,3112290,653712290,False,11
9481,validator_3,536055892780,True,502000000,2622020,504622020,False,16
9482,validator_3,536673614240,True,614700000,3021460,617721460,False,16
9483,validator_39,75245110870,True,586900000,2500690,589400690,False,2
9484,validator_0,1205325240810,True,719620000,8750980,728370980,True,37
9485,validator_1,969988130000,True,792700000,1680580,794380580,False,30
9486,validator_1,970626347390,True,628400000,9817390,638217390,False,30
9487,validator_39,76001591200,True,740190000,16290330,756480330,False,2
9488,validator_5,357264907710,True,617000000,3243920,620243920,False,11
9489,validator_4,366411211862,True,770139996,9808800,779948796,True,11
9490,validator_28,112275513956,True,575589999,32154300,607744299,True,3
9491,validator_2,746180871968,True,560839999,7048840,567888839,True,23
9492,validator_26,106286350514,True,540960000,26750200,567710200,True,3
9493,validator_0,1206096185710,True,743720000,27224900,770944900,True,37
9494,validator_18,117160273492,True,845420012,50594940,896014952,True,3
9495,validator_35,103006931580,True,518800000,2192180,520992180,False,3
9496,validator_0,1206855325979,True,748739999,10400270,759140269,True,37
9497,validator_1,971289207730,True,642800000,20060340,662860340,False,30
9498,validator_45,90909498880,True,365500000,9014700,374514700,False,2
9499,validator_1,972145324350,True,836200000,19916620,856116620,False,30
9500,validator_2,746711753672,True,486806004,44075700,530881704,True,23
9501,validator_33,102181031240,True,711100000,21226830,732326830,False,3
9502,validator_7,258497261610,True,503900000,3922270,507822270,False,8
9503,validator_43,74618735430,True,602000000,16131130,618131130,False,2
9504,validator_0,1207665126910,True,806340001,3460930,809800931,True,37
9505,validator_2,747497773717,True,771860005,14160040,786020045,True,23
9506,validator_22,136750931209,True,802920001,5043400,807963401,True,4
9507,validator_2,748182874421,True,672700004,12400700,685100704,True,23
9508,validator_0,1208249085379,True,567479999,16478470,583958469,True,37
9509,validator_5,357690391900,True,402700000,22784190,425484190,False,11
9510,validator_11,99556437311,True,622740005,14261200,637001205,True,3
9511,validator_2,749163200451,True,944928000,35398030,980326030,True,23
9512,validator_6,260072223343,True,565273997,19605800,584879797,True,8
9513,validator_2,749724905483,True,550800002,10905030,561705032,True,23
9514,validator_6,261048767070,True,965920007,10623720,976543727,True,8
9515,validator_21,126544798887,True,573020006,9450900,582470906,True,3
9516,validator_8,110096796242,True,682026001,29690170,711716171,True,3
9517,validator_4,367127473978,True,714099996,2162120,716262116,True,11
9518,validator_6,261764585109,True,685765999,30052040,715818039,True,8
9519,validator_42,89315721540,True,613300000,1566350,614866350,False,2
9520,validator_0,1208751580624,True,463809995,38685250,502495245,True,37
9521,validator_1,972888821530,True,741900000,1597180,743497180,False,30
9522,validator_5,358284492630,True,591400000,2700730,594100730,False,11
9523,validator_28,112969998036,True,692000000,2484080,694484080,True,3
9524,validator_0,1209375792240,True,621999996,2211620,624211616,True,37
9525,validator_5,358871864950,True,586400000,972320,587372320,False,11
9526,validator_8,110591272141,True,490499999,3975900,494475899,True,3
9527,validator_3,537192235710,True,517600000,1021470,518621470,False,16
9528,validator_2,750703467949,True,962939996,15622470,978562466,True,23
9529,validator_33,102946633730,True,762600000,3002490,765602490,False,3
9530,validator_7,259138345780,True,620500000,20584170,641084170,False,8
9531,validator_0,1210214558775,True,819700005,19066530,838766535,True,37
9532,validator_3,537633647550,True,433000000,8411840,441411840,False,16
9533,validator_0,1210856039976,True,613220001,28261200,641481201,True,37
9534,validator_36,82350321230,True,581200000,2019200,583219200,False,2
9535,validator_1,973635626070,True,728000000,18804540,746804540,False,30
9536,validator_5,359632201250,True,756800000,3536300,760336300,False,11
9537,validator_4,367909526010,True,751459992,30592040,782052032,True,11
9538,validator_2,751435868823,True,716699994,15700880,732400874,True,23
9539,validator_40,82884891780,True,613500000,1914220,615414220,False,2
9540,validator_12,89406702624,True,492719999,16639100,509359099,True,2
9541,validator_0,1211378132162,True,486719996,35372190,522092186,True,37
9542,validator_0,1211895715369,True,511068007,6515200,517583207,True,37
9543,validator_2,752333338423,True,873900000,23569600,897469600,True,23
9544,validator_15,137190673229,True,806360014,37829860,844189874,True,4
9545,validator_2,753062711142,True,705439999,23932720,729372719,True,23
9546,validator_0,1212876089273,True,966300004,14073900,980373904,True,37
9547,validator_43,75298188700,True,671600000,7853270,679453270,False,2
9548,validator_3,538203473800,True,567700000,2126250,569826250,False,16
9549,validator_7,259726667580,True,586500000,1821800,588321800,False,8
9550,validator_21,127234679421,True,679280004,10600530,689880534,True,3
9551,validator_35,103630408410,True,620900000,2576830,623476830,False,3
9552,validator_8,111391948872,True,771720001,28956730,800676731,True,3
9553,validator_26,107078318253,True,764899999,27067740,791967739,True,3
9554,validator_21,127993046541,True,737040000,21327120,758367120,True,3
9555,validator_18,117739377492,True,559940000,19164000,579104000,True,3
9556,validator_6,262469559408,True,673039999,31934300,704974299,True,8
9557,validator_7,260383166980,True,637100000,19399400,656499400,False,8
9558,validator_4,368765387569,True,832385999,23475560,855861559,True,11
9559,validator_48,101672997800,True,610300000,3744140,614044140,False,3
9560,validator_1,974211976650,True,575400000,950580,576350580,False,30
9561,validator_3,538813941800,True,606700000,3768000,610468000,False,16
9562,validator_0,1213579268709,True,683500006,19679430,703179436,True,37
9563,validator_39,76506682430,True,497100000,7991230,505091230,False,2
9564,validator_14,120643428719,True,840179999,23900900,864080899,True,3
9565,validator_5,360293747020,True,658400000,3145770,661545770,False,11
9566,validator_34,94409692650,True,717900000,8345330,726245330,False,2
9567,validator_12,90204455790,True,787957996,9795170,797753166,True,2
9568,validator_22,137385953310,True,632440001,2582100,635022101,True,4
9569,validator_1,974971366990,True,756300000,3090340,759390340,False,30
9570,validator_7,261137164180,True,721200000,32797200,753997200,False,8
9571,validator_2,753630651643,True,543740001,24200500,567940501,True,23
9572,validator_23,122305442784,True,615799996,8969680,624769676,True,3
9573,validator_1,975679187230,True,701800000,6020240,707820240,False,30
9574,validator_3,539530168220,True,710000000,6226420,716226420,False,16
9575,validator_18,118499612491,True,739919999,20315000,760234999,True,3
9576,validator_0,1214579367071,True,980400002,19698360,1000098362,True,37
9577,validator_5,360841225200,True,544100000,3378180,547478180,False,11
9578,validator_1,976326835490,True,627600000,20048260,647648260,False,30
9579,validator_23,123088625865,True,776300001,6883080,783183081,True,3
9580,validator_1,977009592470,True,660900000,21856980,682756980,False,30
9581,validator_0,1215427108659,True,815700008,32041580,847741588,True,37
9582,validator_1,977568322680,True,549700000,9030210,558730210,False,30
9583,validator_7,261694598180,True,544200000,13234000,557434000,False,8
9584,validator_1,978418278310,True,843700000,6255630,849955630,False,30
9585,validator_25,102729414708,True,652870002,11634730,664504732,True,3
9586,validator_6,263065746844,True,560159996,36027440,596187436,True,8
9587,validator_0,1216177200582,True,746800003,3291920,750091923,True,38
9588,validator_0,1217123884117,True,894760005,51923530,946683535,True,38
9589,validator_4,369411902856,True,619259997,27255290,646515287,True,11
9590,validator_0,1217926888590,True,759624003,43380470,803004473,True,38
9591,validator_12,90808820187,True,592699997,11664400,604364397,True,2
9592,validator_47,80452255160,True,581800000,1821330,583621330,False,2
9593,validator_44,86207927790,True,558800000,27901700,586701700,False,2
9594,validator_26,107905924483,True,806440000,21166230,827606230,True,3
9595,validator_14,121328052465,True,671680006,12943740,684623746,True,3
9596,validator_5,361504682900,True,659900000,3557700,663457700,False,11
9597,validator_3,540207314470,True,675500000,1646250,677146250,False,16
9598,validator_21,128604669583,True,598300002,13323040,611623042,True,4
9599,validator_2,754377494662,True,711273999,35569020,746843019,True,23
9600,validator_16,90370999168,True,857439994,6898900,864338894,True,2
9601,validator_6,263649339923,True,567537999,16055080,583593079,True,8
9602,validator_1,979134073040,True,706400000,9394730,715794730,False,30
9603,validator_0,1218762103946,True,824539996,10675360,835215356,True,38
9604,validator_8,112270174976,True,795696004,82530100,878226104,True,3
9605,validator_1,979516511140,True,380700000,1738100,382438100,False,30
9606,validator_1,980075077250,True,556200000,2366110,558566110,False,30
9607,validator_0,1219327183248,True,557400002,7679300,565079302,True,38
9608,validator_1,980532228330,True,455400000,1751080,457151080,False,30
9609,validator_0,1219962912658,True,603406010,32323400,635729410,True,38
9610,validator_3,540749717570,True,541000000,1403100,542403100,False,16
9611,validator_6,264389100317,True,730019994,9740400,739760394,True,8
9612,validator_7,262321187610,True,624000000,2589430,626589430,False,8
9613,validator_1,981037702240,True,504700000,773910,505473910,False,30
9614,validator_3,541307701540,True,552010000,5973970,557983970,False,16
9615,validator_2,754815722760,True,431140008,7088090,438228098,True,23
9616,validator_45,91358860140,True,441240000,8121260,449361260,False,2
9617,validator_2,755396445681,True,560200001,20522920,580722921,True,23
9618,validator_3,541701715140,True,391800000,2213600,394013600,False,16
9619,validator_0,1220822187152,True,836000004,23274490,859274494,True,38
9620,validator_22,138092170902,True,680020002,26197590,706217592,True,4
9621,validator_2,756070458583,True,653020002,20992900,674012902,True,23
9622,validator_0,1221540157961,True,709299999,8670810,717970809,True,38
9623,validator_19,102817272796,True,583520005,53749030,637269035,True,3
9624,validator_0,1222270349255,True,684459994,45731300,730191294,True,38
9625,validator_2,756867712603,True,770540000,26714020,797254020,True,23
9626,validator_28,113644539335,True,624159999,50381300,674541299,True,3
9627,validator_22,138595021028,True,438808006,64042120,502850126,True,4
9628,validator_3,542239990760,True,537000000,1275620,538275620,False,16
9629,validator_3,543076585540,True,834000000,2594780,836594780,False,16
9630,validator_44,87015440690,True,806300000,1212900,807512900,False,2
9631,validator_37,83997719520,True,596000000,1580470,597580470,False,2
9632,validator_1,981821060510,True,780600000,2758270,783358270,False,30
9633,validator_48,102165088300,True,489200000,2890500,492090500,False,3
9634,validator_7,262934682020,True,602900000,10594410,613494410,False,8
9635,validator_41,72555596710,True,482500000,784130,483284130,False,2
9636,validator_49,70506081760,True,702000000,23412580,725412580,False,2
9637,validator_21,129536981003,True,922700000,9611420,932311420,True,4
9638,validator_0,1222915504281,True,624140006,21015020,645155026,True,38
9639,validator_35,104303966640,True,664700000,8858230,673558230,False,3
9640,validator_39,77041467650,True,533200000,1585220,534785220,False,2
9641,validator_2,757545605633,True,646080000,31813030,677893030,True,23
9642,validator_49,71145336850,True,636800000,2455090,639255090,False,2
9643,validator_2,758305331085,True,750520002,9205450,759725452,True,23
9644,validator_7,263431676560,True,491500000,5494540,496994540,False,8
9645,validator_0,1223629044075,True,700066004,13473790,713539794,True,38
9646,validator_1,982416543210,True,591600000,3882700,595482700,False,30
9647,validator_0,1224352278505,True,716180000,7054430,723234430,True,38
9648,validator_6,265110478175,True,718399998,2977860,721377858,True,8
9649,validator_0,1225028093247,True,674100002,1714740,675814742,True,38
9650,validator_0,1225638118810,True,598960003,11065560,610025563,True,38
9651,validator_16,90963467264,True,582160006,10308090,592468096,True,2
9652,validator_18,119374865789,True,870619998,4633300,875253298,True,3
9653,validator_2,759302211678,True,954564003,42316590,996880593,True,23
9654,validator_2,760241061846,True,913419998,25430170,938850168,True,23
9655,validator_36,83006814800,True,653300000,3193570,656493570,False,2
9656,validator_43,75945694200,True,626500000,21005500,647505500,False,2
9657,validator_0,1226485684494,True,827439994,20125690,847565684,True,38
9658,validator_6,265840457483,True,723400008,6579300,729979308,True,8
9659,validator_0,1227022398146,True,530199992,6513660,536713652,True,38
9660,validator_31,89562861940,True,485800000,8988500,494788500,False,2
9661,validator_3,543630965160,True,539200000,15179620,554379620,False,16
9662,validator_4,370004791075,True,582257999,10630220,592888219,True,11
9663,validator_0,1227645435611,True,619900005,3137460,623037465,True,38
9664,validator_7,264042270860,True,586400000,24194300,610594300,False,8
9665,validator_12,91416639201,True,566960004,40859010,607819014,True,2
9666,validator_3,544359764890,True,725400000,3399730,728799730,False,17
9667,validator_3,544869160660,True,485900000,23495770,509395770,False,17
9668,validator_2,761079744039,True,832600003,6082190,838682193,True,23
9669,validator_45,92028447100,True,666500000,3086960,669586960,False,2
9670,validator_26,108472663961,True,486839998,79899480,566739478,True,3
9671,validator_32,89833342220,True,565800000,19838240,585638240,False,2
9672,validator_23,123845339153,True,727420008,29293280,756713288,True,3
9673,validator_5,362112163900,True,605900000,1581000,607481000,False,11
9674,validator_1,982981411530,True,555700000,9168320,564868320,False,30
9675,validator_0,1228292985137,True,616479996,31069530,647549526,True,38
9676,validator_0,1229202485062,True,865340005,44159920,909499925,True,38
9677,validator_2,762079371622,True,978900003,20727580,999627583,True,23
9678,validator_1,983630944240,True,642600000,6932710,649532710,False,30
9679,validator_1,984197771390,True,565000000,1827150,566827150,False,30
9680,validator_8,113127155712,True,815359996,41620740,856980736,True,3
9681,validator_16,91551430039,True,562119995,25842780,587962775,True,2
9682,validator_22,139185373563,True,569119995,21232540,590352535,True,4
9683,validator_3,545438324060,True,568000000,1163400,569163400,False,17
9684,validator_2,762868736327,True,786400005,2964700,789364705,True,23
9685,validator_33,103540184830,True,591110000,2441100,593551100,False,3
9686,validator_2,763542064322,True,625979995,47348000,673327995,True,23
9687,validator_30,85150753910,True,505400000,1145940,506545940,False,2
9688,validator_29,72906013600,True,805600000,3652600,809252600,False,2
9689,validator_36,83468820270,True,459200000,2805470,462005470,False,2
9690,validator_2,764365983801,True,787919999,35999480,823919479,True,23
9691,validator_3,545861470060,True,420100000,3046000,423146000,False,17
9692,validator_3,546468053040,True,603700000,2882980,606582980,False,17
9693,validator_1,984687774710,True,478700000,11303320,490003320,False,30
9694,validator_0,1230014122564,True,771640002,39997500,811637502,True,38
9695,validator_23,124590768852,True,733339999,12089700,745429699,True,3
9696,validator_5,362626614180,True,509500000,4950280,514450280,False,11
9697,validator_34,95050032430,True,630900000,9439780,640339780,False,2
9698,validator_25,103342646441,True,611400003,1831730,613231733,True,3
9699,validator_6,266432140901,True,589799998,1883420,591683418,True,8
9700,validator_3,547071595400,True,599000000,4542360,603542360,False,17
9701,validator_22,140010656623,True,818040000,7243060,825283060,True,4
9702,validator_2,765090463109,True,718000008,6479300,724479308,True,23
9703,validator_34,95611065230,True,559800000,1232800,561032800,False,2
9704,validator_0,1230813438065,True,784080001,15235500,799315501,True,38
9705,validator_4,370597923172,True,591799997,1332100,593132097,True,11
9706,validator_0,1231453571954,True,632140009,7993880,640133889,True,38
9707,validator_25,103932300287,True,580019996,9633850,589653846,True,3
9708,validator_0,1232100398986,True,627799992,19027040,646827032,True,38
9709,validator_0,1232874349098,True,770400002,3550110,773950112,True,38
9710,validator_7,264604590700,True,555200000,7119840,562319840,False,8
9711,validator_39,77620206190,True,574000000,4738540,578738540,False,2
9712,validator_1,985338360230,True,647600000,2985520,650585520,False,30
9713,validator_3,547530607390,True,454500000,4511990,459011990,False,17
9714,validator_22,140809006022,True,772619999,25729400,798349399,True,4
9715,validator_9,90519225104,True,792800000,1199230,793999230,True,2
9716,validator_2,765987192516,True,855780007,40949400,896729407,True,23
9717,validator_0,1233616635095,True,699639997,42646000,742285997,True,38
9718,validator_30,85721506980,True,567400000,3353070,570753070,False,2
9719,validator_11,100377544724,True,812920003,8187410,821107413,True,3
9720,validator_3,548257929410,True,707600000,19722020,727322020,False,17
9721,validator_17,112896271671,True,681839997,19204270,701044267,True,3
9722,validator_29,73441131440,True,511500000,23617840,535117840,False,2
9723,validator_28,114301532509,True,612580004,44413170,656993174,True,3
9724,validator_31,90270754040,True,703400000,4492100,707892100,False,2
9725,validator_18,119963077709,True,563300000,24911920,588211920,True,3
9726,validator_3,548729310620,True,470900000,481210,471381210,False,17
9727,validator_2,766815171949,True,790060003,37919430,827979433,True,23
9728,validator_41,73263946630,True,699800000,8549920,708349920,False,2
9729,validator_38,84975438530,True,599600000,20039690,619639690,False,2
9730,validator_3,549319058360,True,587300000,2447740,589747740,False,17
9731,validator_7,265422224100,True,815300000,2333400,817633400,False,8
9732,validator_17,113503564665,True,581667994,25625000,607292994,True,3
9733,validator_33,104193385300,True,650500000,2700470,653200470,False,3
9734,validator_0,1234589887790,True,945271995,27980700,973252695,True,38
9735,validator_21,130335401784,True,785220001,13200780,798420781,True,4
9736,validator_0,1235239957193,True,589240003,60829400,650069403,True,38
9737,validator_0,1235961894191,True,689957998,31979000,721936998,True,38
9738,validator_33,104916136000,True,697600000,25150700,722750700,False,3
9739,validator_0,1236331366994,True,364940003,4532800,369472803,True,38
9740,validator_1,985739723100,True,396700000,4662870,401362870,False,30
9741,validator_0,1236887911796,True,550770002,5774800,556544802,True,38
9742,validator_16,92266511739,True,701510000,13571700,715081700,True,2
9743,validator_33,105646366150,True,711920000,18310150,730230150,False,3
9744,validator_14,122016284866,True,674140001,14092400,688232401,True,3
9745,validator_26,109227758092,True,746180001,8914130,755094131,True,3
9746,validator_9,91219590935,True,689640001,10725830,700365831,True,2
9747,validator_15,138162359154,True,952139995,19545930,971685925,True,4
9748,validator_0,1237498396278,True,582360002,28124480,610484482,True,38
9749,validator_18,120670500097,True,701799998,5622390,707422388,True,3
9750,validator_2,767367075844,True,541695995,10207900,551903895,True,23
9751,validator_44,87679194450,True,662100000,1653760,663753760,False,2
9752,validator_5,363186596860,True,554100000,5882680,559982680,False,11
9753,validator_2,768046242657,True,668960003,10206810,679166813,True,24
9754,validator_3,549827144290,True,506300000,1785930,508085930,False,17
9755,validator_3,550422945320,True,592100000,3701030,595801030,False,17
9756,validator_1,986479153290,True,729900000,9530190,739430190,False,30
9757,validator_7,266016525630,True,592800000,1501530,594301530,False,8
9758,validator_9,91786077578,True,532200003,34286640,566486643,True,2
9759,validator_1,987166291520,True,683300000,3838230,687138230,False,30
9760,validator_26,109957748857,True,715539995,14450770,729990765,True,3
9761,validator_32,90546026810,True,697000000,15684590,712684590,False,2
9762,validator_0,1238231557454,True,677885996,55275180,733161176,True,38
9763,validator_8,113847483400,True,687937998,32389690,720327688,True,3
9764,validator_5,364010654760,True,816000000,8057900,824057900,False,11
9765,validator_6,267375897710,True,894600009,49156800,943756809,True,8
9766,validator_1,987804444650,True,636300000,1853130,638153130,False,30
9767,validator_30,86398572760,True,668900000,8165780,677065780,False,2
9768,validator_2,768618819127,True,530884000,41692470,572576470,True,24
9769,validator_1,988322833090,True,515850000,2538440,518388440,False,30
9770,validator_17,114167122764,True,661319999,2238100,663558099,True,3
9771,validator_22,141767477044,True,923840002,34631020,958471022,True,4
9772,validator_14,122628273223,True,582019997,29968360,611988357,True,3
9773,validator_4,371460107275,True,829700003,32484100,862184103,True,11
9774,validator_1,988986885890,True,662700000,1352800,664052800,False,30
9775,validator_7,266718963890,True,699300000,3138260,702438260,False,8
9776,validator_1,989562303790,True,573700000,1717900,575417900,False,30
9777,validator_4,372096707821,True,635800006,800540,636600546,True,11
9778,validator_46,80096737160,True,678600000,2782300,681382300,False,2
9779,validator_2,769423287735,True,791419998,13048610,804468608,True,24
9780,validator_0,1239033090796,True,781300002,20233340,801533342,True,38
9781,validator_3,551108095920,True,665300000,19850600,685150600,False,17
9782,validator_47,81028140490,True,555800000,20085330,575885330,False,2
9783,validator_26,110510823198,True,543600001,9474340,553074341,True,3
9784,validator_40,83555456580,True,667800000,2764800,670564800,False,2
9785,validator_47,81478501880,True,448200000,2161390,450361390,False,2
9786,validator_41,73865859360,True,582400000,19512730,601912730,False,2
9787,validator_11,100977703787,True,583620003,16539060,600159063,True,3
9788,validator_10,126758995411,True,715180005,9197520,724377525,True,3
9789,validator_26,111304278671,True,783819993,9635480,793455473,True,3
9790,validator_3,551714926990,True,605200000,1631070,606831070,False,17
9791,validator_2,770137074667,True,690599992,23186940,713786932,True,24
9792,validator_3,552323424120,True,605200000,3297130,608497130,False,17
9793,validator_0,1239682520995,True,638639999,10790200,649430199,True,38
9794,validator_5,364535236700,True,523400000,1181940,524581940,False,11
9795,validator_6,268046573778,True,667199988,3476080,670676068,True,8
9796,validator_38,85721851560,True,742500000,3913030,746413030,False,2
9797,validator_0,1240427554792,True,734539997,10493800,745033797,True,38
9798,validator_5,365079371830,True,542800000,1335130,544135130,False,11
9799,validator_14,123299934060,True,650193997,21466840,671660837,True,3
9800,validator_46,80745524860,True,646800000,1987700,648787700,False,2
9801,validator_3,552941088300,True,608600000,9064180,617664180,False,17
9802,validator_33,106186388240,True,536300000,3722090,540022090,False,3
9803,validator_3,553708304940,True,747300000,19916640,767216640,False,17
9804,validator_0,1241047549304,True,605800012,14194500,619994512,True,38
9805,validator_18,121286666023,True,600999996,15165930,616165926,True,3
9806,validator_18,121969038250,True,619839997,62532230,682372227,True,3
9807,validator_7,267439604310,True,719000000,1640420,720640420,False,8
9808,validator_1,990208114570,True,626700000,19110780,645810780,False,30
9809,validator_17,114779694366,True,589260002,23311600,612571602,True,3
9810,validator_2,771025728681,True,842560004,46094010,888654014,True,24
9811,validator_29,73999476230,True,556500000,1844790,558344790,False,2
9812,validator_1,991007433250,True,782200000,17118680,799318680,False,30
9813,validator_1,991563586290,True,554400000,1753040,556153040,False,30
9814,validator_1,992265115530,True,700000000,1529240,701529240,False,31
9815,validator_0,1241772443701,True,714239997,10654400,724894397,True,38
9816,validator_43,76414547940,True,466300000,2553740,468853740,False,2
9817,validator_14,123854007055,True,544505995,9567000,554072995,True,3
9818,validator_1,992903633160,True,634600000,3917630,638517630,False,31
9819,validator_0,1242362117529,True,561739998,27933830,589673828,True,38
9820,validator_24,108315788120,True,779039995,46945660,825985655,True,3
9821,validator_39,78106700820,True,484500000,1994630,486494630,False,2
9822,validator_1,993423467190,True,517740000,2094030,519834030,False,31
9823,validator_5,365912109350,True,832100000,637520,832737520,False,11
9824,validator_3,554235077980,True,523770000,3003040,526773040,False,17
9825,validator_0,1243035459115,True,656898006,16443580,673341586,True,38
9826,validator_11,101607335189,True,601100002,28531400,629631402,True,3
9827,validator_14,124731771444,True,850479999,27284390,877764389,True,3
9828,validator_3,554772752910,True,518400000,19274930,537674930,False,17
9829,validator_24,108994783216,True,669839996,9155100,678995096,True,3
9830,validator_0,1243860287508,True,800700003,24128390,824828393,True,38
9831,validator_15,138864426261,True,669000007,33067100,702067107,True,4
9832,validator_0,1244592374873,True,686799995,45287370,732087365,True,38
9833,validator_4,372692526642,True,567180001,28638820,595818821,True,11
9834,validator_4,373392984827,True,672114005,28344180,700458185,True,11
9835,validator_27,95723135996,True,567299994,2879600,570179594,True,2
9836,validator_21,131179783417,True,816220003,28161630,844381633,True,4
9837,validator_2,771594037315,True,548799994,19508640,568308634,True,24
9838,validator_29,74878457750,True,859800000,19181520,878981520,False,2
9839,validator_21,131861604316,True,671235999,10584900,681820899,True,4
9840,validator_26,112008091065,True,701000004,2812390,703812394,True,3
9841,validator_7,267943630910,True,501600000,2426600,504026600,False,8
9842,validator_40,84082623730,True,506100000,21067150,527167150,False,2
9843,validator_23,125218456471,True,614079999,13607620,627687619,True,3
9844,validator_0,1245269871646,True,651180003,26316770,677496773,True,38
9845,validator_26,112851581293,True,823519998,19970230,843490228,True,3
9846,validator_13,86767355650,True,678459992,27102950,705562942,True,2
9847,validator_48,102732248390,True,553200000,13960090,567160090,False,3
9848,validator_44,88458723780,True,759400000,20129330,779529330,False,2
9849,validator_7,268526390540,True,580000000,2759630,582759630,False,8
9850,validator_40,84751485810,True,664400000,4462080,668862080,False,2
9851,validator_43,77025316560,True,608800000,1968620,610768620,False,2
9852,validator_25,104614524791,True,674584004,7640500,682224504,True,3
9853,validator_1,994031715120,True,600200000,8047930,608247930,False,31
9854,validator_0,1245941283110,True,632200004,39211460,671411464,True,38
9855,validator_5,366389637150,True,471200000,6327800,477527800,False,11
9856,validator_19,103446502596,True,582200000,47029800,629229800,True,3
9857,validator_1,994658938260,True,614000000,13223140,627223140,False,31
9858,validator_0,1246790513932,True,804410002,44820820,849230822,True,38
9859,validator_1,995255143170,True,594000000,2204910,596204910,False,31
9860,validator_1,995747148960,True,482900000,9105790,492005790,False,31
9861,validator_1,996391283040,True,641300000,2834080,644134080,False,31
9862,validator_1,996988992220,True,596600000,1109180,597709180,False,31
9863,validator_23,125820713270,True,563563999,38692800,602256799,True,3
9864,validator_22,142267860433,True,488960009,11423380,500383389,True,4
9865,validator_5,367097902220,True,707400000,865070,708265070,False,11
9866,validator_0,1247524152927,True,711629995,22009000,733638995,True,38
9867,validator_41,74361020460,True,491600000,3561100,495161100,False,2
9868,validator_3,555330019440,True,555200000,2066530,557266530,False,17
9869,validator_0,1248241991470,True,695240003,22598540,717838543,True,39
9870,validator_32,90961761890,True,406600000,9135080,415735080,False,2
9871,validator_15,139717390367,True,827100006,25864100,852964106,True,4
9872,validator_48,103259992890,True,526510000,1234500,527744500,False,3
9873,validator_6,268630415679,True,571440001,12401900,583841901,True,8
9874,validator_3,555887138440,True,554000000,3119000,557119000,False,17
9875,validator_1,997698996870,True,700600000,9404650,710004650,False,31
9876,validator_34,96070837300,True,450300000,9472070,459772070,False,3
9877,validator_3,556551393710,True,626700000,37555270,664255270,False,17
9878,validator_3,557012334650,True,456900000,4040940,460940940,False,17
9879,validator_0,1249061114967,True,763607997,55515500,819123497,True,39
9880,validator_39,78654585860,True,544900000,2985040,547885040,False,2
9881,validator_0,1249796524469,True,709260002,26149500,735409502,True,39
9882,validator_0,1250367442865,True,542660006,28258390,570918396,True,39
9883,validator_10,127410179908,True,643400007,7784490,651184497,True,3
9884,validator_17,115573299970,True,789800004,3805600,793605604,True,3
9885,validator_28,115020365622,True,663400003,55433110,718833113,True,3
9886,validator_1,998345304550,True,643100000,3207680,646307680,False,31
9887,validator_1,999042237590,True,692200000,4733040,696933040,False,31
9888,validator_12,91989120639,True,554539998,17941440,572481438,True,2
9889,validator_12,92792407735,True,782110006,21177090,803287096,True,2
9890,validator_46,81450120510,True,691500000,13095650,704595650,False,2
9891,validator_1,999504994790,True,452200000,10557200,462757200,False,31
9892,validator_5,367650965820,True,543500000,9563600,553063600,False,11
9893,validator_1,1000085339600,True,577400000,2944810,580344810,False,31
9894,validator_0,1251240055663,True,851179998,21432800,872612798,True,39
9895,validator_1,1000545908500,True,455700000,4868900,460568900,False,31
9896,validator_7,269083132740,True,550100000,6642200,556742200,False,8
9897,validator_33,106706802340,True,516800000,3614100,520414100,False,3
9898,validator_1,1001018623300,True,453400000,19314800,472714800,False,31
9899,validator_4,374326668658,True,890374001,43309830,933683831,True,11
9900,validator_5,368215748430,True,562700000,2082610,564782610,False,11
9901,validator_0,1252110458870,True,814623997,55779210,870403207,True,39
9902,validator_34,96730378790,True,630100000,29441490,659541490,False,3
9903,validator_0,1252831465888,True,705039998,15967020,721007018,True,39
9904,validator_21,132607168758,True,744800002,764440,745564442,True,4
9905,validator_1,1001565432150,True,545600000,1208850,546808850,False,31
9906,validator_0,1253412099371,True,554500003,26133480,580633483,True,39
9907,validator_6,269761207048,True,1091439999,39351370,1130791369,True,8
9908,validator_14,125317932169,True,563180005,22980720,586160725,True,3
9909,validator_1,1002047702550,True,480200000,2070400,482270400,False,31
9910,validator_19,104088422000,True,591360004,50559400,641919404,True,3
9911,validator_2,772272286403,True,658920008,19329080,678249088,True,24
9912,validator_3,557642596990,True,628100000,2162340,630262340,False,17
9913,validator_21,133506795356,True,879719998,19906600,899626598,True,4
9914,validator_28,115690553158,True,640499996,29687540,670187536,True,3
9915,validator_1,1002718978680,True,669600000,1676130,671276130,False,31
9916,validator_14,125947005714,True,591200005,37873540,629073545,True,3
9917,validator_0,1253883890547,True,451639996,20151180,471791176,True,39
9918,validator_9,92500513209,True,677960001,36475630,714435631,True,2
9919,validator_9,93456038793,True,937559994,17965590,955525584,True,2
9920,validator_3,558271291050,True,617600000,11094060,628694060,False,17
9921,validator_2,772937465544,True,635040001,30139140,665179141,True,24
9922,validator_3,558843740760,True,570100000,2349710,572449710,False,17
9923,validator_12,93537782871,True,721539996,23835140,745375136,True,2
9924,validator_16,93147738435,True,853719996,27506700,881226696,True,2
9925,validator_2,773660078382,True,704999998,17612840,722612838,True,24
9926,validator_4,375129600487,True,787459999,15471830,802931829,True,11
9927,validator_21,134005883402,True,497100006,1988040,499088046,True,4
9928,validator_16,93742422862,True,584639997,10044430,594684427,True,2
9929,validator_26,113562921487,True,700640004,10700190,711340194,True,3
9930,validator_0,1254701212543,True,775799996,41522000,817321996,True,39
9931,validator_11,102237117048,True,607379999,22401860,629781859,True,3
9932,validator_2,774317590783,True,650000001,7512400,657512401,True,24
9933,validator_4,375716683767,True,569364000,17719280,587083280,True,11
9934,validator_0,1255488648433,True,768259990,19175900,787435890,True,39
9935,validator_0,1256256499825,True,710859992,56991400,767851392,True,39
9936,validator_3,559497496150,True,607700000,46055390,653755390,False,17
9937,validator_45,92690391190,True,660900000,1044090,661944090,False,2
9938,validator_6,270237366738,True,444486000,31673690,476159690,True,8
9939,validator_1,1003203349100,True,480670000,3700420,484370420,False,31
9940,validator_1,1003801822280,True,595100000,3373180,598473180,False,31
9941,validator_43,77707614740,True,680000000,2298180,682298180,False,2
9942,validator_9,94268908571,True,771599998,41269780,812869778,True,2
9943,validator_15,140448064165,True,722399998,8273800,730673798,True,4
9944,validator_4,376432272500,True,688584003,27004730,715588733,True,11
9945,validator_2,775196856503,True,875900000,3365720,879265720,True,24
9946,validator_24,109614593175,True,605899999,13909960,619809959,True,3
9947,validator_6,271323994865,True,1084299997,2328130,1086628127,True,8
9948,validator_2,775745768649,True,545520006,3392140,548912146,True,24
9949,validator_2,776287879366,True,535499997,6610720,542110717,True,24
9950,validator_16,94321763361,True,535079999,44260500,579340499,True,2
9951,validator_2,777114724047,True,810020001,16824680,826844681,True,24
9952,validator_4,376989691842,True,553600002,3819340,557419342,True,11
9953,validator_2,777639304825,True,506099998,18480780,524580778,True,24
9954,validator_0,1257012217312,True,731131997,24585490,755717487,True,39
9955,validator_0,1257704885838,True,683600006,9068520,692668526,True,39
9956,validator_0,1258282429147,True,550339999,27203310,577543309,True,39
9957,validator_2,778472105460,True,809200005,23600630,832800635,True,24
9958,validator_22,142856434873,True,558520000,30054440,588574440,True,4
9959,validator_33,107298439580,True,573400000,18237240,591637240,False,3
9960,validator_4,377575258782,True,582200010,3366930,585566940,True,11
9961,validator_17,116018403874,True,425420004,19683900,445103904,True,3
9962,validator_2,779046679881,True,547000001,27574420,574574421,True,24
9963,validator_26,114164686092,True,587040005,14724600,601764605,True,3
9964,validator_0,1258982655150,True,684860003,15366000,700226003,True,39
9965,validator_0,1259601732153,True,609040003,10037000,619077003,True,39
9966,validator_4,378319589717,True,735299995,9030940,744330935,True,11
9967,validator_1,1004515499710,True,711300000,2377430,713677430,False,31
9968,validator_17,116678990803,True,644165999,16420930,660586929,True,3
9969,validator_18,122810665855,True,824099995,17527610,841627605,True,3
9970,validator_3,560251520650,True,752600000,1424500,754024500,False,17
9971,validator_3,560947977150,True,676200000,20256500,696456500,False,17
9972,validator_0,1260162467630,True,549279997,11455480,560735477,True,39
9973,validator_29,75485921390,True,604700000,2763640,607463640,False,2
9974,validator_0,1260957716999,True,750839999,44409370,795249369,True,39
9975,validator_3,561789203580,True,837800000,3426430,841226430,False,17
9976,validator_1,1005236297010,True,699500000,21297300,720797300,False,31
9977,validator_3,562442639760,True,651400000,2036180,653436180,False,17
9978,validator_5,368791891670,True,539500000,36643240,576143240,False,11
9979,validator_43,78397632330,True,668700000,21317590,690017590,False,2
9980,validator_0,1261621111993,True,648559994,14835000,663394994,True,39
9981,validator_26,114751002225,True,562640003,23676130,586316133,True,3
9982,validator_6,271925728206,True,596000001,5733340,601733341,True,8
9983,validator_0,1262218150395,True,543040002,53998400,597038402,True,39
9984,validator_0,1263018114932,True,755169997,44794540,799964537,True,39
9985,validator_11,102818794989,True,560400001,21277940,581677941,True,3
9986,validator_33,107894211450,True,586700000,9071870,595771870,False,3
9987,validator_2,779985361050,True,929339999,9341170,938681169,True,24
9988,validator_2,780820465455,True,789684005,45420400,835104405,True,24
9989,validator_2,781573168093,True,741540008,11162630,752702638,True,24
9990,validator_0,1264083764255,True,1044340003,21309320,1065649323,True,39
9991,validator_2,782470278984,True,870620001,26490890,897110891,True,24
9992,validator_47,81948057510,True,467100000,2455630,469555630,False,2
9993,validator_13,87535717030,True,716200010,52161370,768361380,True,2
9994,validator_1,1005825856710,True,586800000,2759700,589559700,False,31
9995,validator_1,1006417799850,True,575200000,16743140,591943140,False,31
9996,validator_3,563016159040,True,571300000,2219280,573519280,False,17
9997,validator_1,1007066538750,True,645800000,2938900,648738900,False,31
9998,validator_1,1007794507750,True,725000000,2969000,727969000,False,31
9999,validator_0,1264847148679,True,732884004,30500420,763384424,True,39
