block_num,validator_id,validator_stake,total_gas_fee,total_mev_available,block_reward,validator_reinvestment_factor,validator_validator_count
0,validator_2,160000000000,45477000,5180,45482180,True,5
1,validator_18,32000000000,98698000,3126930,101824930,True,1
2,validator_17,32000000000,3180000,4320000,7500000,False,1
3,validator_2,160000000000,32690000,195000,32885000,True,5
4,validator_6,160000000000,3620000,0,3620000,True,5
5,validator_17,32000000000,10172000,441700,10613700,False,1
6,validator_3,160000000000,10463000,27900,10490900,True,5
7,validator_8,320000000000,17710000,34700,17744700,False,10
8,validator_14,480000000000,5610000,0,5610000,True,15
9,validator_7,480000000000,55633000,18438200,74071200,True,15
10,validator_10,320000000000,10812000,369000,11181000,True,10
11,validator_6,160000000000,8750000,286800,9036800,True,5
12,validator_13,32000000000,33547000,89500,33636500,False,1
13,validator_8,320000000000,18683000,525140,19208140,False,10
14,validator_11,320000000000,14200000,117900,14317900,True,10
15,validator_10,320000000000,7970000,6390,7976390,True,10
16,validator_8,320000000000,749000,66200,815200,False,10
17,validator_4,64000000000,4500000,0,4500000,False,2
18,validator_12,480000000000,10990000,35100,11025100,True,15
19,validator_12,480000000000,13472000,802620,14274620,True,15
20,validator_12,480000000000,120000,0,120000,True,15
21,validator_12,480000000000,390000,23500,413500,True,15
22,validator_19,32000000000,4300000,0,4300000,False,1
23,validator_5,32000000000,73885000,378500,74263500,False,1
24,validator_13,32000000000,39362000,665200,40027200,False,1
25,validator_14,480000000000,8502000,265000,8767000,True,15
26,validator_8,320000000000,7970000,0,7970000,False,10
27,validator_16,32000000000,2300000,0,2300000,True,1
28,validator_12,480000000000,5840000,100000,5940000,True,15
29,validator_5,32000000000,570000,0,570000,False,1
30,validator_10,320000000000,6460000,109900,6569900,True,10
31,validator_4,64000000000,75791000,89700,75880700,False,2
32,validator_14,480000000000,39580000,0,39580000,True,15
33,validator_14,480000000000,79272000,254700,79526700,True,15
34,validator_8,320000000000,10230000,12800,10242800,False,10
35,validator_17,32000000000,5330000,0,5330000,False,1
36,validator_9,64000000000,5060000,100000,5160000,True,2
37,validator_18,32000000000,514000,17000,531000,True,1
38,validator_9,64000000000,36388000,17861680,54249680,True,2
39,validator_3,160000000000,240000,0,240000,True,5
40,validator_8,320000000000,910000,19700,929700,False,10
41,validator_0,160000000000,1790000,0,1790000,True,5
42,validator_5,32000000000,1018000,73100,1091100,False,1
43,validator_18,32000000000,31780000,24700,31804700,True,1
44,validator_8,320000000000,345000,0,345000,False,10
45,validator_7,480000000000,2000000,0,2000000,True,15
46,validator_18,32000000000,24940000,11200,24951200,True,1
47,validator_5,32000000000,9187000,136520,9323520,False,1
48,validator_0,160000000000,236000,49100,285100,True,5
49,validator_13,32000000000,37337000,279300,37616300,False,1
50,validator_16,32000000000,42209000,0,42209000,True,1
51,validator_7,480000000000,29770000,35600,29805600,True,15
52,validator_4,64000000000,15030000,63410,15093410,False,2
53,validator_0,160000000000,32554000,744400,33298400,True,5
54,validator_11,320000000000,13140000,365430,13505430,True,10
55,validator_11,320000000000,9130000,621600,9751600,True,10
56,validator_12,480000000000,1080000,959000,2039000,True,15
57,validator_19,32000000000,3200000,0,3200000,False,1
58,validator_2,160000000000,8268000,0,8268000,True,5
59,validator_9,64000000000,44380000,7956000,52336000,True,2
60,validator_15,160000000000,84539000,217800,84756800,True,5
61,validator_8,320000000000,38977000,239240,39216240,False,10
62,validator_3,160000000000,19980000,180100,20160100,True,5
63,validator_2,160000000000,8970000,68500,9038500,True,5
64,validator_0,160000000000,6810000,0,6810000,True,5
65,validator_15,160000000000,1000000,14200,1014200,True,5
66,validator_16,32000000000,63312000,558900,63870900,True,1
67,validator_2,160000000000,84000,0,84000,True,5
68,validator_15,160000000000,13884000,244800,14128800,True,5
69,validator_13,32000000000,8740000,0,8740000,False,1
70,validator_11,320000000000,54266000,437930,54703930,True,10
71,validator_19,32000000000,77583000,1610640,79193640,False,1
72,validator_17,32000000000,27221000,244900,27465900,False,1
73,validator_17,32000000000,14795000,82700,14877700,False,1
74,validator_15,160000000000,12170000,0,12170000,True,5
75,validator_1,64000000000,7782000,0,7782000,True,2
76,validator_5,32000000000,19370000,0,19370000,False,1
77,validator_6,160000000000,9889000,231000,10120000,True,5
78,validator_11,320000000000,530000,545000,1075000,True,10
79,validator_0,160000000000,3890000,381000,4271000,True,5
80,validator_12,480000000000,160000,410000,570000,True,15
81,validator_15,160000000000,3160000,64600,3224600,True,5
82,validator_11,320000000000,8410000,160800,8570800,True,10
83,validator_8,320000000000,65922000,388100,66310100,False,10
84,validator_19,32000000000,25360000,329300,25689300,False,1
85,validator_18,32000000000,1150000,155000,1305000,True,1
86,validator_11,320000000000,31179000,285000,31464000,True,10
87,validator_10,320000000000,2020000,0,2020000,True,10
88,validator_12,480000000000,2363000,17700000,20063000,True,15
89,validator_10,320000000000,73000,0,73000,True,10
90,validator_7,480000000000,8310000,0,8310000,True,15
91,validator_3,160000000000,530000,0,530000,True,5
92,validator_19,32000000000,110000,0,110000,False,1
93,validator_9,64000000000,10710000,63100,10773100,True,2
94,validator_8,320000000000,39737000,349100,40086100,False,10
95,validator_12,480000000000,5973000,839330,6812330,True,15
96,validator_8,320000000000,56547000,294580,56841580,False,10
97,validator_8,320000000000,2467000,13900,2480900,False,10
98,validator_14,480000000000,98350000,2148300,100498300,True,15
99,validator_12,480000000000,1633000,30200,1663200,True,15
100,validator_15,160000000000,420000,0,420000,True,5
101,validator_1,64000000000,6100000,0,6100000,True,2
102,validator_9,64000000000,5654000,69780,5723780,True,2
103,validator_7,480000000000,5930000,17996000,23926000,True,15
104,validator_19,32000000000,55530000,35600,55565600,False,1
105,validator_8,320000000000,15182000,7368500,22550500,False,10
106,validator_3,160000000000,93037000,2628980,95665980,True,5
107,validator_9,64000000000,60605000,540640,61145640,True,2
108,validator_11,320000000000,545000,49100,594100,True,10
109,validator_18,32000000000,4500000,0,4500000,True,1
110,validator_9,64000000000,45370000,173120,45543120,True,2
111,validator_17,32000000000,11920000,0,11920000,False,1
112,validator_19,32000000000,17740000,814980,18554980,False,1
113,validator_5,32000000000,9999000,15700,10014700,False,1
114,validator_11,320000000000,11300000,67900,11367900,True,10
115,validator_17,32000000000,180095000,18142100,198237100,False,1
116,validator_4,64000000000,4320000,0,4320000,False,2
117,validator_7,480000000000,10937000,350000,11287000,True,15
118,validator_3,160000000000,9203000,4721200,13924200,True,5
119,validator_14,480000000000,10560000,16400,10576400,True,15
120,validator_2,160000000000,44370000,360700,44730700,True,5
121,validator_12,480000000000,98490000,1007140,99497140,True,15
122,validator_3,160000000000,3930000,34700,3964700,True,5
123,validator_17,32000000000,910000,0,910000,False,1
124,validator_14,480000000000,98000,0,98000,True,15
125,validator_10,320000000000,3250000,0,3250000,True,10
126,validator_11,320000000000,45092000,1149000,46241000,True,10
127,validator_4,64000000000,2970000,154300,3124300,False,2
128,validator_6,160000000000,5594000,865540,6459540,True,5
129,validator_8,320000000000,16294000,0,16294000,False,10
130,validator_0,160000000000,120000,46500,166500,True,5
131,validator_7,480000000000,32651000,0,32651000,True,15
132,validator_12,480000000000,860000,67900,927900,True,15
133,validator_12,480000000000,4020000,128000,4148000,True,15
134,validator_10,320000000000,345000,15100,360100,True,10
135,validator_2,160000000000,32370000,0,32370000,True,5
136,validator_11,320000000000,9010000,811500,9821500,True,10
137,validator_3,160000000000,6643000,12300,6655300,True,5
138,validator_8,320000000000,4100000,47700,4147700,False,10
139,validator_18,32000000000,1650000,342500,1992500,True,1
140,validator_5,32000000000,632000,172300,804300,False,1
141,validator_1,64000000000,7980000,7265000,15245000,True,2
142,validator_10,320000000000,68919000,1666090,70585090,True,10
143,validator_8,320000000000,16020000,29200,16049200,False,10
144,validator_17,32000000000,2000000,0,2000000,False,1
145,validator_18,32000000000,28625000,290700,28915700,True,1
146,validator_6,160000000000,5610000,156300,5766300,True,5
147,validator_9,64000000000,13920000,418600,14338600,True,2
148,validator_16,32000000000,19260000,75000,19335000,True,1
149,validator_7,480000000000,4910000,154100,5064100,True,15
150,validator_11,320000000000,46190000,335400,46525400,True,10
151,validator_11,320000000000,7060000,0,7060000,True,10
152,validator_4,64000000000,7130000,998400,8128400,False,2
153,validator_15,160000000000,11498000,43600,11541600,True,5
154,validator_18,32000000000,1697000,0,1697000,True,1
155,validator_11,320000000000,1530000,33100,1563100,True,10
156,validator_13,32000000000,7445000,21800,7466800,False,1
157,validator_11,320000000000,2320000,13800,2333800,True,10
158,validator_13,32000000000,18213000,838300,19051300,False,1
159,validator_15,160000000000,50563000,91920,50654920,True,5
160,validator_3,160000000000,15230000,640500,15870500,True,5
161,validator_8,320000000000,770000,0,770000,False,10
162,validator_7,480000000000,14290000,99000,14389000,True,15
163,validator_10,320000000000,37399000,43000,37442000,True,10
164,validator_12,480000000000,36197000,600900,36797900,True,15
165,validator_14,480000000000,2550000,0,2550000,True,15
166,validator_11,320000000000,3150000,195000,3345000,True,10
167,validator_7,480000000000,20161000,816700,20977700,True,15
168,validator_12,480000000000,100000,5640,105640,True,15
169,validator_11,320000000000,3232000,425100,3657100,True,10
170,validator_7,480000000000,4551000,13900,4564900,True,15
171,validator_10,320000000000,35083000,11200,35094200,True,10
172,validator_2,160000000000,10320000,451200,10771200,True,5
173,validator_0,160000000000,1475000,36800,1511800,True,5
174,validator_2,160000000000,1920000,43600,1963600,True,5
175,validator_12,480000000000,32160000,64600,32224600,True,15
176,validator_7,480000000000,8010000,0,8010000,True,15
177,validator_12,480000000000,45690000,320640,46010640,True,15
178,validator_9,64000000000,17430000,23500,17453500,True,2
179,validator_14,480000000000,1330000,0,1330000,True,15
180,validator_6,160000000000,11658000,374700,12032700,True,5
181,validator_19,32000000000,5000000,121000,5121000,False,1
182,validator_6,160000000000,9090000,320700,9410700,True,5
183,validator_11,320000000000,6214000,34700,6248700,True,10
184,validator_10,320000000000,5867000,959000,6826000,True,10
185,validator_7,480000000000,7489000,498900,7987900,True,15
186,validator_0,160000000000,32663000,0,32663000,True,5
187,validator_12,480000000000,35342000,97900,35439900,True,15
188,validator_8,320000000000,4600000,128000,4728000,False,10
189,validator_6,160000000000,10807000,118700,10925700,True,5
190,validator_10,320000000000,39218000,832500,40050500,True,10
191,validator_4,64000000000,6503000,0,6503000,False,2
192,validator_9,64000000000,23959000,365100,24324100,True,2
193,validator_15,160000000000,20057000,0,20057000,True,5
194,validator_18,32000000000,640000,215000,855000,True,1
195,validator_7,480000000000,4742000,1255500,5997500,True,15
196,validator_14,480000000000,28293000,0,28293000,True,15
197,validator_14,480000000000,23352000,132700,23484700,True,15
198,validator_19,32000000000,15920000,196500,16116500,False,1
199,validator_3,160000000000,39610000,30200,39640200,True,5
200,validator_2,160000000000,2110000,30200,2140200,True,5
201,validator_12,480000000000,1670000,0,1670000,True,15
202,validator_7,480000000000,17677000,801500,18478500,True,15
203,validator_12,480000000000,1970000,73100,2043100,True,15
204,validator_4,64000000000,43000000,128000,43128000,False,2
205,validator_12,480000000000,10040000,6390,10046390,True,15
206,validator_0,160000000000,5000000,4320000,9320000,True,5
207,validator_19,32000000000,70000,39400,109400,False,1
208,validator_13,32000000000,54474000,133900,54607900,False,1
209,validator_7,480000000000,3998000,4341800,8339800,True,15
210,validator_8,320000000000,1468000,146000,1614000,False,10
211,validator_19,32000000000,1553000,13900,1566900,False,1
212,validator_17,32000000000,2287000,0,2287000,False,1
213,validator_12,480000000000,630000,12300,642300,True,15
214,validator_11,320000000000,98000,0,98000,True,10
215,validator_4,64000000000,1700000,0,1700000,False,2
216,validator_3,160000000000,6378000,399800,6777800,True,5
217,validator_1,64000000000,18400000,175600,18575600,True,2
218,validator_6,160000000000,37426000,322000,37748000,True,5
219,validator_15,160000000000,2500000,0,2500000,True,5
220,validator_8,320000000000,2387000,769000,3156000,False,10
221,validator_0,160000000000,23863000,5180,23868180,True,5
222,validator_9,64000000000,11030000,545000,11575000,True,2
223,validator_9,64000000000,29030000,49100,29079100,True,2
224,validator_12,480000000000,1340000,322000,1662000,True,15
225,validator_8,320000000000,8410000,193500,8603500,False,10
226,validator_16,32000000000,29290000,139000,29429000,True,1
227,validator_7,480000000000,8244000,36800,8280800,True,15
228,validator_17,32000000000,14347000,975000,15322000,False,1
229,validator_0,160000000000,45235000,24700,45259700,True,5
230,validator_11,320000000000,1083000,15100,1098100,True,10
231,validator_4,64000000000,64810000,1251840,66061840,False,2
232,validator_12,480000000000,31370000,769900,32139900,True,15
233,validator_19,32000000000,43000000,0,43000000,False,1
234,validator_8,320000000000,11020000,0,11020000,False,10
235,validator_4,64000000000,2170000,5180,2175180,False,2
236,validator_5,32000000000,420000,410000,830000,False,1
237,validator_12,480000000000,2400000,0,2400000,True,15
238,validator_12,480000000000,1000000,0,1000000,True,15
239,validator_9,64000000000,75100000,0,75100000,True,2
240,validator_11,320000000000,7461000,0,7461000,True,10
241,validator_19,32000000000,127913000,190200,128103200,False,1
242,validator_15,160000000000,1082000,0,1082000,True,5
243,validator_0,160000000000,51390000,19024000,70414000,True,5
244,validator_18,32000000000,3965000,171620,4136620,True,1
245,validator_3,160000000000,234000,769000,1003000,True,5
246,validator_5,32000000000,150000,0,150000,False,1
247,validator_18,32000000000,6017000,0,6017000,True,1
248,validator_2,160000000000,7659000,118100,7777100,True,5
249,validator_14,480000000000,183000,0,183000,True,15
250,validator_9,64000000000,28250000,818100,29068100,True,2
251,validator_15,160000000000,56483000,701390,57184390,True,5
252,validator_12,480000000000,13587000,0,13587000,True,15
253,validator_11,320000000000,5693000,707300,6400300,True,10
254,validator_15,160000000000,7585000,115100,7700100,True,5
255,validator_6,160000000000,16154000,64100,16218100,True,5
256,validator_6,160000000000,2594000,44640,2638640,True,5
257,validator_7,480000000000,2500000,705000,3205000,True,15
258,validator_15,160000000000,52452000,109640,52561640,True,5
259,validator_5,32000000000,2447000,0,2447000,False,1
260,validator_17,32000000000,1760000,0,1760000,False,1
261,validator_18,32000000000,4659000,66100,4725100,True,1
262,validator_16,32000000000,4040000,146000,4186000,True,1
263,validator_3,160000000000,62907000,455540,63362540,True,5
264,validator_16,32000000000,28823000,1873000,30696000,True,1
265,validator_12,480000000000,7360000,594000,7954000,True,15
266,validator_11,320000000000,24510000,17700000,42210000,True,10
267,validator_12,480000000000,3190000,410000,3600000,True,15
268,validator_15,160000000000,6300000,0,6300000,True,5
269,validator_12,480000000000,153082000,11966940,165048940,True,15
270,validator_14,480000000000,49602000,395440,49997440,True,15
271,validator_7,480000000000,6105000,186700,6291700,True,15
272,validator_11,320000000000,5170000,0,5170000,True,10
273,validator_0,160000000000,82148000,75000,82223000,True,5
274,validator_10,320000000000,10613000,17739400,28352400,True,10
275,validator_7,480000000000,66478000,21330,66499330,True,15
276,validator_19,32000000000,2690000,13900,2703900,False,1
277,validator_3,160000000000,7064000,0,7064000,True,5
278,validator_8,320000000000,28460000,354800,28814800,False,10
279,validator_9,64000000000,1292000,296000,1588000,True,2
280,validator_4,64000000000,3968000,0,3968000,False,2
281,validator_4,64000000000,910000,0,910000,False,2
282,validator_11,320000000000,2500000,5630,2505630,True,10
283,validator_10,320000000000,17300000,143700,17443700,True,10
284,validator_14,480000000000,24010000,587540,24597540,True,15
285,validator_3,160000000000,2600000,49100,2649100,True,5
286,validator_2,160000000000,6060000,0,6060000,True,5
287,validator_10,320000000000,4076000,0,4076000,True,10
288,validator_3,160000000000,31273000,0,31273000,True,5
289,validator_14,480000000000,8780000,777520,9557520,True,15
290,validator_11,320000000000,62601000,1067400,63668400,True,10
291,validator_7,480000000000,60614000,7916500,68530500,True,15
292,validator_17,32000000000,27084000,0,27084000,False,1
293,validator_7,480000000000,7660000,0,7660000,True,15
294,validator_14,480000000000,9947000,623200,10570200,True,15
295,validator_1,64000000000,9220000,46500,9266500,True,2
296,validator_18,32000000000,1640000,0,1640000,True,1
297,validator_7,480000000000,1304000,732000,2036000,True,15
298,validator_14,480000000000,2055000,0,2055000,True,15
299,validator_17,32000000000,319000,0,319000,False,1
300,validator_16,32000000000,160000,18600,178600,True,1
301,validator_10,320000000000,42526000,7421000,49947000,True,10
302,validator_10,320000000000,24708000,410000,25118000,True,10
303,validator_15,160000000000,6600000,0,6600000,True,5
304,validator_7,480000000000,7640000,330700,7970700,True,15
305,validator_16,32000000000,1550000,0,1550000,True,1
306,validator_16,32000000000,4174000,0,4174000,True,1
307,validator_3,160000000000,81500000,2274600,83774600,True,5
308,validator_2,160000000000,5200000,0,5200000,True,5
309,validator_4,64000000000,5093000,964630,6057630,False,2
310,validator_11,320000000000,320000,0,320000,True,10
311,validator_2,160000000000,16179000,114400,16293400,True,5
312,validator_12,480000000000,5280000,0,5280000,True,15
313,validator_4,64000000000,137311000,1293240,138604240,False,2
314,validator_0,160000000000,3560000,0,3560000,True,5
315,validator_5,32000000000,50002000,22940,50024940,False,1
316,validator_5,32000000000,9500000,0,9500000,False,1
317,validator_13,32000000000,7500000,0,7500000,False,1
318,validator_13,32000000000,3810000,0,3810000,False,1
319,validator_15,160000000000,9951000,18600,9969600,True,5
320,validator_7,480000000000,2635000,38600,2673600,True,15
321,validator_13,32000000000,64634000,7391700,72025700,False,1
322,validator_12,480000000000,53380000,3130,53383130,True,15
323,validator_19,32000000000,420000,0,420000,False,1
324,validator_6,160000000000,6300000,0,6300000,True,5
325,validator_7,480000000000,5558000,128000,5686000,True,15
326,validator_7,480000000000,2407000,0,2407000,True,15
327,validator_10,320000000000,2300000,0,2300000,True,10
328,validator_14,480000000000,14538000,106700,14644700,True,15
329,validator_7,480000000000,10610000,410000,11020000,True,15
330,validator_8,320000000000,1960000,68100,2028100,False,10
331,validator_16,32000000000,9670000,67500,9737500,True,1
332,validator_19,32000000000,1930000,21800,1951800,False,1
333,validator_6,160000000000,8100000,0,8100000,True,5
334,validator_6,160000000000,33693000,7840,33700840,True,5
335,validator_1,64000000000,31270000,103900,31373900,True,2
336,validator_18,32000000000,33540000,0,33540000,True,1
337,validator_11,320000000000,25290000,22040,25312040,True,10
338,validator_3,160000000000,1500000,0,1500000,True,5
339,validator_17,32000000000,8716000,393800,9109800,False,1
340,validator_0,160000000000,3040000,5630,3045630,True,5
341,validator_12,480000000000,19553000,4502600,24055600,True,15
342,validator_11,320000000000,19668000,561400,20229400,True,10
343,validator_8,320000000000,8765000,393800,9158800,False,10
344,validator_16,32000000000,4740000,15300,4755300,True,1
345,validator_7,480000000000,31233000,1198730,32431730,True,15
346,validator_2,160000000000,8983000,984000,9967000,True,5
347,validator_19,32000000000,31694000,16400,31710400,False,1
348,validator_8,320000000000,34523000,673130,35196130,False,10
349,validator_10,320000000000,14940000,68100,15008100,True,10
350,validator_19,32000000000,2160000,1100000,3260000,False,1
351,validator_1,64000000000,7720000,34830,7754830,True,2
352,validator_9,64000000000,1200000,0,1200000,True,2
353,validator_3,160000000000,9310000,0,9310000,True,5
354,validator_3,160000000000,15110000,377700,15487700,True,5
355,validator_18,32000000000,1200000,0,1200000,True,1
356,validator_11,320000000000,13300000,17000,13317000,True,10
357,validator_6,160000000000,15436000,344100,15780100,True,5
358,validator_5,32000000000,34174000,32780,34206780,False,1
359,validator_13,32000000000,13210000,4386100,17596100,False,1
360,validator_12,480000000000,120000,0,120000,True,15
361,validator_19,32000000000,12473000,66100,12539100,False,1
362,validator_12,480000000000,166929000,1164100,168093100,True,15
363,validator_15,160000000000,2340000,0,2340000,True,5
364,validator_17,32000000000,11080000,421500,11501500,False,1
365,validator_4,64000000000,8607000,0,8607000,False,2
366,validator_4,64000000000,45674000,66330,45740330,False,2
367,validator_1,64000000000,44920000,0,44920000,True,2
368,validator_7,480000000000,94642000,18668160,113310160,True,15
369,validator_12,480000000000,102969000,16167750,119136750,True,15
370,validator_6,160000000000,1078000,47700,1125700,True,5
371,validator_3,160000000000,83000,0,83000,True,5
372,validator_12,480000000000,12960000,67500,13027500,True,15
373,validator_8,320000000000,11200000,0,11200000,False,10
374,validator_1,64000000000,74341000,215000,74556000,True,2
375,validator_4,64000000000,1900000,0,1900000,False,2
376,validator_10,320000000000,32209000,232900,32441900,True,10
377,validator_10,320000000000,460000,0,460000,True,10
378,validator_11,320000000000,8413000,0,8413000,True,10
379,validator_10,320000000000,17060000,128000,17188000,True,10
380,validator_4,64000000000,38440000,1072900,39512900,False,2
381,validator_0,160000000000,7112000,312200,7424200,True,5
382,validator_10,320000000000,7380000,100000,7480000,True,10
383,validator_11,320000000000,2590000,31700,2621700,True,10
384,validator_16,32000000000,5550000,19700,5569700,True,1
385,validator_14,480000000000,39714000,143600,39857600,True,15
386,validator_12,480000000000,79787000,17787880,97574880,True,15
387,validator_2,160000000000,26335000,412600,26747600,True,5
388,validator_13,32000000000,54523000,4348100,58871100,False,1
389,validator_17,32000000000,530000,73100,603100,False,1
390,validator_1,64000000000,6597000,17000,6614000,True,2
391,validator_18,32000000000,6834000,261000,7095000,True,1
392,validator_13,32000000000,13778000,325600,14103600,False,1
393,validator_17,32000000000,5040000,0,5040000,False,1
394,validator_8,320000000000,13580000,769000,14349000,False,10
395,validator_3,160000000000,5087000,7473000,12560000,True,5
396,validator_12,480000000000,28690000,578400,29268400,True,15
397,validator_6,160000000000,1400000,0,1400000,True,5
398,validator_5,32000000000,13365000,15300,13380300,False,1
399,validator_8,320000000000,17200000,421200,17621200,False,10
400,validator_8,320000000000,920000,0,920000,False,10
401,validator_12,480000000000,10430000,86700,10516700,True,15
402,validator_10,320000000000,6150000,47700,6197700,True,10
403,validator_14,480000000000,27370000,0,27370000,True,15
404,validator_3,160000000000,11314000,0,11314000,True,5
405,validator_14,480000000000,30003000,1216200,31219200,True,15
406,validator_3,160000000000,28055000,340090,28395090,True,5
407,validator_0,160000000000,120000,13900,133900,True,5
408,validator_9,64000000000,1237000,84100,1321100,True,2
409,validator_4,64000000000,33782000,7190000,40972000,False,2
410,validator_7,480000000000,1273000,0,1273000,True,15
411,validator_11,320000000000,6200000,0,6200000,True,10
412,validator_4,64000000000,1800000,0,1800000,False,2
413,validator_4,64000000000,11100000,0,11100000,False,2
414,validator_19,32000000000,1900000,0,1900000,False,1
415,validator_18,32000000000,70000,33300,103300,True,1
416,validator_1,64000000000,90018000,553940,90571940,True,2
417,validator_8,320000000000,26990000,511600,27501600,False,10
418,validator_7,480000000000,24005000,4337480,28342480,True,15
419,validator_14,480000000000,78073000,305100,78378100,True,15
420,validator_15,160000000000,1870000,0,1870000,True,5
421,validator_6,160000000000,15323000,5180,15328180,True,5
422,validator_10,320000000000,1350000,0,1350000,True,10
423,validator_3,160000000000,185615000,330040,185945040,True,5
424,validator_4,64000000000,6170000,0,6170000,False,2
425,validator_4,64000000000,65775000,18600,65793600,False,2
426,validator_7,480000000000,61330000,7713800,69043800,True,15
427,validator_8,320000000000,31899000,381000,32280000,False,10
428,validator_4,64000000000,49525000,35100,49560100,False,2
429,validator_12,480000000000,4854000,146000,5000000,True,15
430,validator_5,32000000000,11160000,0,11160000,False,1
431,validator_0,160000000000,20650000,426400,21076400,True,5
432,validator_14,480000000000,19668000,198700,19866700,True,15
433,validator_0,160000000000,1810000,0,1810000,True,5
434,validator_9,64000000000,1900000,0,1900000,True,2
435,validator_2,160000000000,8040000,36800,8076800,True,5
436,validator_17,32000000000,73473000,729600,74202600,False,1
437,validator_0,160000000000,32080000,782900,32862900,True,5
438,validator_15,160000000000,42313000,20414000,62727000,True,5
439,validator_6,160000000000,22905000,1325040,24230040,True,5
440,validator_17,32000000000,4500000,15300,4515300,False,1
441,validator_19,32000000000,44670000,289100,44959100,False,1
442,validator_13,32000000000,37180000,31700,37211700,False,1
443,validator_10,320000000000,3440000,1148000,4588000,True,10
444,validator_10,320000000000,5933000,818400,6751400,True,10
445,validator_14,480000000000,5150000,0,5150000,True,15
446,validator_15,160000000000,970000,34700,1004700,True,5
447,validator_14,480000000000,48939000,0,48939000,True,15
448,validator_15,160000000000,14870000,13020,14883020,True,5
449,validator_15,160000000000,8275000,51420,8326420,True,5
450,validator_15,160000000000,14090000,87800,14177800,True,5
451,validator_18,32000000000,5415000,33300,5448300,True,1
452,validator_12,480000000000,10070000,57640,10127640,True,15
453,validator_0,160000000000,107892000,173800,108065800,True,5
454,validator_3,160000000000,11372000,6390,11378390,True,5
455,validator_16,32000000000,13320000,464900,13784900,True,1
456,validator_7,480000000000,320000,0,320000,True,15
457,validator_5,32000000000,119165000,564540,119729540,False,1
458,validator_4,64000000000,23910000,154700,24064700,False,2
459,validator_0,160000000000,540000,256000,796000,True,5
460,validator_2,160000000000,17658000,179030,17837030,True,5
461,validator_7,480000000000,5833000,121000,5954000,True,15
462,validator_2,160000000000,77000,10700,87700,True,5
463,validator_13,32000000000,2850000,16400,2866400,False,1
464,validator_19,32000000000,8847000,75000,8922000,False,1
465,validator_12,480000000000,84830000,1230400,86060400,True,15
466,validator_19,32000000000,14856000,17839300,32695300,False,1
467,validator_4,64000000000,57964000,291840,58255840,False,2
468,validator_7,480000000000,50415000,867900,51282900,True,15
469,validator_12,480000000000,7000000,7190000,14190000,True,15
470,validator_6,160000000000,2900000,0,2900000,True,5
471,validator_12,480000000000,4520000,30200,4550200,True,15
472,validator_18,32000000000,54090000,7190000,61280000,True,1
473,validator_16,32000000000,25920000,0,25920000,True,1
474,validator_1,64000000000,280000,0,280000,True,2
475,validator_14,480000000000,1172000,300300,1472300,True,15
476,validator_1,64000000000,46754000,7744540,54498540,True,2
477,validator_11,320000000000,10593000,523200,11116200,True,10
478,validator_15,160000000000,1020000,0,1020000,True,5
479,validator_8,320000000000,4090000,0,4090000,False,10
480,validator_12,480000000000,23636000,47700,23683700,True,15
481,validator_2,160000000000,82046000,312200,82358200,True,5
482,validator_17,32000000000,46820000,88100,46908100,False,1
483,validator_16,32000000000,53857000,708200,54565200,True,1
484,validator_9,64000000000,1660000,15700,1675700,True,2
485,validator_13,32000000000,2230000,0,2230000,False,1
486,validator_9,64000000000,51690000,122320,51812320,True,2
487,validator_2,160000000000,34288000,18095200,52383200,True,5
488,validator_2,160000000000,3820000,0,3820000,True,5
489,validator_8,320000000000,7360000,152000,7512000,False,10
490,validator_1,64000000000,5390000,0,5390000,True,2
491,validator_5,32000000000,85000,0,85000,False,1
492,validator_7,480000000000,31329000,155000,31484000,True,15
493,validator_15,160000000000,4335000,231000,4566000,True,5
494,validator_0,160000000000,90602000,497280,91099280,True,5
495,validator_7,480000000000,2470000,7203900,9673900,True,15
496,validator_10,320000000000,5823000,0,5823000,True,10
497,validator_12,480000000000,220000,0,220000,True,15
498,validator_15,160000000000,91060000,834690,91894690,True,5
499,validator_8,320000000000,8217000,0,8217000,False,10
500,validator_12,480000000000,21709000,215000,21924000,True,15
501,validator_4,64000000000,6180000,546600,6726600,False,2
502,validator_11,320000000000,26508000,167500,26675500,True,10
503,validator_7,480000000000,7790000,0,7790000,True,15
504,validator_9,64000000000,13425000,769000,14194000,True,2
505,validator_14,480000000000,82000,0,82000,True,15
506,validator_10,320000000000,480000,5640,485640,True,10
507,validator_12,480000000000,1120000,0,1120000,True,15
508,validator_3,160000000000,2080000,0,2080000,True,5
509,validator_12,480000000000,20492000,24700,20516700,True,15
510,validator_12,480000000000,580000,0,580000,True,15
511,validator_14,480000000000,10757000,504900,11261900,True,15
512,validator_8,320000000000,423000,160800,583800,False,10
513,validator_14,480000000000,19730000,872600,20602600,True,15
514,validator_15,160000000000,9480000,133900,9613900,True,5
515,validator_19,32000000000,8990000,256000,9246000,False,1
516,validator_17,32000000000,16379000,47700,16426700,False,1
517,validator_12,480000000000,5270000,67500,5337500,True,15
518,validator_3,160000000000,41235000,27800,41262800,True,5
519,validator_11,320000000000,35489000,6390,35495390,True,10
520,validator_3,160000000000,98000,19700,117700,True,5
521,validator_17,32000000000,93791000,229540,94020540,False,1
522,validator_10,320000000000,35155000,53800,35208800,True,10
523,validator_8,320000000000,460000,21800,481800,False,10
524,validator_14,480000000000,1600000,0,1600000,True,15
525,validator_14,480000000000,304000,75340,379340,True,15
526,validator_3,160000000000,1340000,0,1340000,True,5
527,validator_5,32000000000,44840000,73100,44913100,False,1
528,validator_13,32000000000,9260000,0,9260000,False,1
529,validator_11,320000000000,7277000,348000,7625000,True,10
530,validator_0,160000000000,21230000,914700,22144700,True,5
531,validator_5,32000000000,103653000,1997680,105650680,False,1
532,validator_6,160000000000,1700000,0,1700000,True,5
533,validator_16,32000000000,310000,0,310000,True,1
534,validator_7,480000000000,5460000,0,5460000,True,15
535,validator_15,160000000000,12785000,2375790,15160790,True,5
536,validator_2,160000000000,64859000,2117480,66976480,True,5
537,validator_5,32000000000,112368000,1370000,113738000,False,1
538,validator_7,480000000000,70475000,856200,71331200,True,15
539,validator_15,160000000000,2920000,0,2920000,True,5
540,validator_12,480000000000,23788000,4935840,28723840,True,15
541,validator_5,32000000000,4080000,0,4080000,False,1
542,validator_5,32000000000,3584000,0,3584000,False,1
543,validator_0,160000000000,9990000,327640,10317640,True,5
544,validator_14,480000000000,1973000,24700,1997700,True,15
545,validator_12,480000000000,21835000,0,21835000,True,15
546,validator_17,32000000000,7500000,0,7500000,False,1
547,validator_11,320000000000,12834000,4914000,17748000,True,10
548,validator_14,480000000000,48630000,0,48630000,True,15
549,validator_4,64000000000,3756000,631800,4387800,False,2
550,validator_12,480000000000,490000,0,490000,True,15
551,validator_11,320000000000,730000,5630,735630,True,10
552,validator_8,320000000000,11550000,247900,11797900,False,10
553,validator_11,320000000000,1780000,0,1780000,True,10
554,validator_6,160000000000,16498000,36800,16534800,True,5
555,validator_13,32000000000,8133000,55300,8188300,False,1
556,validator_7,480000000000,5027000,0,5027000,True,15
557,validator_2,160000000000,8430000,16400,8446400,True,5
558,validator_15,160000000000,6867000,1116400,7983400,True,5
559,validator_2,160000000000,22080000,630600,22710600,True,5
560,validator_8,320000000000,32757000,5630,32762630,False,10
561,validator_2,160000000000,41570000,380400,41950400,True,5
562,validator_10,320000000000,10030000,925000,10955000,True,10
563,validator_4,64000000000,11187000,24700,11211700,False,2
564,validator_9,64000000000,70697000,15100,70712100,True,2
565,validator_7,480000000000,13860000,80940,13940940,True,15
566,validator_8,320000000000,150000,0,150000,False,10
567,validator_11,320000000000,5595000,17736000,23331000,True,10
568,validator_13,32000000000,3774000,7840,3781840,False,1
569,validator_9,64000000000,520000,119900,639900,True,2
570,validator_16,32000000000,6070000,0,6070000,True,1
571,validator_10,320000000000,3250000,155000,3405000,True,10
572,validator_3,160000000000,610000,0,610000,True,5
573,validator_7,480000000000,3409000,0,3409000,True,15
574,validator_12,480000000000,32062000,1184800,33246800,True,15
575,validator_8,320000000000,7473000,17767900,25240900,False,10
576,validator_8,320000000000,7685000,100000,7785000,False,10
577,validator_0,160000000000,7810000,97900,7907900,True,5
578,validator_13,32000000000,13208000,511200,13719200,False,1
579,validator_8,320000000000,9000000,0,9000000,False,10
580,validator_7,480000000000,58010000,556800,58566800,True,15
581,validator_10,320000000000,134991000,692350,135683350,True,10
582,validator_4,64000000000,50940000,599700,51539700,False,2
583,validator_0,160000000000,34874000,869300,35743300,True,5
584,validator_12,480000000000,95147000,155840,95302840,True,15
585,validator_10,320000000000,2600000,0,2600000,True,10
586,validator_12,480000000000,10610000,17700000,28310000,True,15
587,validator_12,480000000000,150000,36800,186800,True,15
588,validator_6,160000000000,17677000,121000,17798000,True,5
589,validator_5,32000000000,6600000,128000,6728000,False,1
590,validator_16,32000000000,110000,13900,123900,True,1
591,validator_7,480000000000,12660000,0,12660000,True,15
592,validator_0,160000000000,6953000,0,6953000,True,5
593,validator_16,32000000000,9970000,327640,10297640,True,1
594,validator_11,320000000000,910000,0,910000,True,10
595,validator_7,480000000000,114333000,155600,114488600,True,15
596,validator_4,64000000000,5962000,1100000,7062000,False,2
597,validator_7,480000000000,15050000,4461100,19511100,True,15
598,validator_14,480000000000,11300000,0,11300000,True,15
599,validator_13,32000000000,3280000,890000,4170000,False,1
600,validator_16,32000000000,4397000,0,4397000,True,1
601,validator_4,64000000000,3950000,17000,3967000,False,2
602,validator_2,160000000000,13990000,0,13990000,True,5
603,validator_4,64000000000,128645000,1374610,130019610,False,2
604,validator_13,32000000000,15541000,66100,15607100,False,1
605,validator_5,32000000000,410000,0,410000,False,1
606,validator_0,160000000000,130000,0,130000,True,5
607,validator_14,480000000000,760000,0,760000,True,15
608,validator_12,480000000000,6100000,0,6100000,True,15
609,validator_19,32000000000,31118000,70000,31188000,False,1
610,validator_1,64000000000,54266000,125200,54391200,True,2
611,validator_18,32000000000,53670000,0,53670000,True,1
612,validator_16,32000000000,7399000,4320000,11719000,True,1
613,validator_4,64000000000,2770000,0,2770000,False,2
614,validator_3,160000000000,48479000,1180890,49659890,True,5
615,validator_13,32000000000,45250000,61900,45311900,False,1
616,validator_3,160000000000,3400000,13800,3413800,True,5
617,validator_1,64000000000,3520000,15700,3535700,True,2
618,validator_12,480000000000,1070000,0,1070000,True,15
619,validator_13,32000000000,8170000,0,8170000,False,1
620,validator_19,32000000000,1270000,0,1270000,False,1
621,validator_9,64000000000,910000,0,910000,True,2
622,validator_11,320000000000,6870000,1257440,8127440,True,10
623,validator_4,64000000000,6610000,146000,6756000,False,2
624,validator_6,160000000000,7913000,510000,8423000,True,5
625,validator_13,32000000000,24050000,57800,24107800,False,1
626,validator_9,64000000000,500000,7840,507840,True,2
627,validator_19,32000000000,23424000,0,23424000,False,1
628,validator_17,32000000000,82737000,8940200,91677200,False,1
629,validator_5,32000000000,14602000,1560330,16162330,False,1
630,validator_6,160000000000,2120000,0,2120000,True,5
631,validator_11,320000000000,13997000,0,13997000,True,10
632,validator_14,480000000000,6142000,302700,6444700,True,15
633,validator_11,320000000000,4443000,10700,4453700,True,10
634,validator_12,480000000000,42190000,228000,42418000,True,15
635,validator_2,160000000000,27180000,42000,27222000,True,5
636,validator_11,320000000000,4460000,0,4460000,True,10
637,validator_3,160000000000,6000000,0,6000000,True,5
638,validator_7,480000000000,41990000,8206200,50196200,True,15
639,validator_11,320000000000,54945000,1100000,56045000,True,10
640,validator_14,480000000000,33916000,45400,33961400,True,15
641,validator_16,32000000000,8273000,195000,8468000,True,1
642,validator_14,480000000000,7800000,0,7800000,True,15
643,validator_15,160000000000,26440000,1096000,27536000,True,5
644,validator_3,160000000000,9592000,545100,10137100,True,5
645,validator_14,480000000000,5879000,21800,5900800,True,15
646,validator_12,480000000000,64890000,21800,64911800,True,15
647,validator_12,480000000000,7773000,17700000,25473000,True,15
648,validator_9,64000000000,65180000,49100,65229100,True,2
649,validator_7,480000000000,4688000,60400,4748400,True,15
650,validator_0,160000000000,23640000,529680,24169680,True,5
651,validator_7,480000000000,420000,15100,435100,True,15
652,validator_18,32000000000,5870000,0,5870000,True,1
653,validator_9,64000000000,9300000,16400,9316400,True,2
654,validator_18,32000000000,6250000,0,6250000,True,1
655,validator_17,32000000000,3430000,296000,3726000,False,1
656,validator_5,32000000000,14310000,17779900,32089900,False,1
657,validator_12,480000000000,3887000,0,3887000,True,15
658,validator_12,480000000000,13031000,146000,13177000,True,15
659,validator_0,160000000000,6320000,12300,6332300,True,5
660,validator_6,160000000000,620000,0,620000,True,5
661,validator_15,160000000000,1070000,39400,1109400,True,5
662,validator_9,64000000000,24340000,7239100,31579100,True,2
663,validator_10,320000000000,6820000,0,6820000,True,10
664,validator_10,320000000000,2380000,334800,2714800,True,10
665,validator_16,32000000000,820000,231000,1051000,True,1
666,validator_3,160000000000,150000,0,150000,True,5
667,validator_19,32000000000,31400000,15700,31415700,False,1
668,validator_10,320000000000,11932000,760000,12692000,True,10
669,validator_0,160000000000,16243000,99700,16342700,True,5
670,validator_16,32000000000,320000,0,320000,True,1
671,validator_12,480000000000,1990000,0,1990000,True,15
672,validator_17,32000000000,7600000,0,7600000,False,1
673,validator_11,320000000000,5140000,0,5140000,True,10
674,validator_19,32000000000,1579000,943000,2522000,False,1
675,validator_14,480000000000,15340000,639000,15979000,True,15
676,validator_14,480000000000,3600000,31700,3631700,True,15
677,validator_10,320000000000,10730000,285000,11015000,True,10
678,validator_6,160000000000,13070000,1131700,14201700,True,5
679,validator_10,320000000000,9190000,235040,9425040,True,10
680,validator_10,320000000000,10337000,7700000,18037000,True,10
681,validator_5,32000000000,5060000,0,5060000,False,1
682,validator_15,160000000000,25227000,710200,25937200,True,5
683,validator_7,480000000000,45130000,0,45130000,True,15
684,validator_11,320000000000,36000000,410900,36410900,True,10
685,validator_19,32000000000,5962000,155000,6117000,False,1
686,validator_17,32000000000,7584000,66100,7650100,False,1
687,validator_4,64000000000,46680000,245400,46925400,False,2
688,validator_13,32000000000,18590000,350000,18940000,False,1
689,validator_11,320000000000,7721000,39780,7760780,True,10
690,validator_7,480000000000,4390000,15700,4405700,True,15
691,validator_11,320000000000,21225000,1082810,22307810,True,10
692,validator_5,32000000000,2793000,0,2793000,False,1
693,validator_11,320000000000,85000,0,85000,True,10
694,validator_15,160000000000,82922000,322330,83244330,True,5
695,validator_14,480000000000,127745000,2333800,130078800,True,15
696,validator_0,160000000000,3820000,31700,3851700,True,5
697,validator_5,32000000000,13140000,118600,13258600,False,1
698,validator_8,320000000000,6907000,0,6907000,False,10
699,validator_10,320000000000,30430000,31090,30461090,True,10
700,validator_12,480000000000,289645000,4142440,293787440,True,15
701,validator_18,32000000000,6210000,0,6210000,True,1
702,validator_3,160000000000,35590000,828100,36418100,True,5
703,validator_5,32000000000,14237000,1743300,15980300,False,1
704,validator_1,64000000000,2000000,0,2000000,True,2
705,validator_1,64000000000,53988000,987100,54975100,True,2
706,validator_19,32000000000,86391000,19231690,105622690,False,1
707,validator_2,160000000000,170000,0,170000,True,5
708,validator_8,320000000000,44947000,8378100,53325100,False,10
709,validator_13,32000000000,640000,33100,673100,False,1
710,validator_8,320000000000,9933000,0,9933000,False,10
711,validator_1,64000000000,5000000,0,5000000,True,2
712,validator_10,320000000000,80000,0,80000,True,10
713,validator_18,32000000000,12592000,47700,12639700,True,1
714,validator_6,160000000000,2514000,10700,2524700,True,5
715,validator_12,480000000000,11078000,0,11078000,True,15
716,validator_8,320000000000,10840000,44090,10884090,False,10
717,validator_16,32000000000,38758000,0,38758000,True,1
718,validator_7,480000000000,9300000,0,9300000,True,15
719,validator_10,320000000000,749000,0,749000,True,10
720,validator_10,320000000000,2107000,5640,2112640,True,10
721,validator_8,320000000000,1440000,0,1440000,False,10
722,validator_3,160000000000,36545000,149400,36694400,True,5
723,validator_10,320000000000,95232000,1218500,96450500,True,10
724,validator_0,160000000000,87000,0,87000,True,5
725,validator_8,320000000000,160000,35100,195100,False,10
726,validator_1,64000000000,2200000,0,2200000,True,2
727,validator_4,64000000000,9420000,0,9420000,False,2
728,validator_14,480000000000,6350000,46500,6396500,True,15
729,validator_14,480000000000,8670000,87900,8757900,True,15
730,validator_16,32000000000,7420000,0,7420000,True,1
731,validator_4,64000000000,2150000,60700,2210700,False,2
732,validator_11,320000000000,38498000,64600,38562600,True,10
733,validator_0,160000000000,2470000,410000,2880000,True,5
734,validator_2,160000000000,48974000,18369600,67343600,True,5
735,validator_10,320000000000,9787000,0,9787000,True,10
736,validator_11,320000000000,12712000,168900,12880900,True,10
737,validator_16,32000000000,34668000,20640,34688640,True,1
738,validator_16,32000000000,20122000,170100,20292100,True,1
739,validator_1,64000000000,24170000,15100,24185100,True,2
740,validator_0,160000000000,108935000,1360300,110295300,True,5
741,validator_8,320000000000,5480000,21800,5501800,False,10
742,validator_4,64000000000,130000,43600,173600,False,2
743,validator_0,160000000000,5950000,0,5950000,True,5
744,validator_4,64000000000,20007000,117490,20124490,False,2
745,validator_0,160000000000,21721000,104600,21825600,True,5
746,validator_0,160000000000,1645000,0,1645000,True,5
747,validator_0,160000000000,4500000,0,4500000,True,5
748,validator_13,32000000000,32587000,4570000,37157000,False,1
749,validator_7,480000000000,20230000,271300,20501300,True,15
750,validator_3,160000000000,6119000,349000,6468000,True,5
751,validator_15,160000000000,7820000,185400,8005400,True,5
752,validator_8,320000000000,14467000,406500,14873500,False,10
753,validator_2,160000000000,1940000,369000,2309000,True,5
754,validator_12,480000000000,43430000,0,43430000,True,15
755,validator_17,32000000000,22457000,808200,23265200,False,1
756,validator_5,32000000000,44500000,0,44500000,False,1
757,validator_2,160000000000,14607000,0,14607000,True,5
758,validator_14,480000000000,34390000,194300,34584300,True,15
759,validator_1,64000000000,1240000,0,1240000,True,2
760,validator_10,320000000000,1120000,68100,1188100,True,10
761,validator_1,64000000000,43000000,0,43000000,True,2
762,validator_19,32000000000,34830000,1224500,36054500,False,1
763,validator_12,480000000000,58274000,59930,58333930,True,15
764,validator_7,480000000000,2830000,7840,2837840,True,15
765,validator_19,32000000000,17290000,0,17290000,False,1
766,validator_19,32000000000,3147000,67500,3214500,False,1
767,validator_11,320000000000,2170000,0,2170000,True,10
768,validator_10,320000000000,11922000,825200,12747200,True,10
769,validator_4,64000000000,860000,545000,1405000,False,2
770,validator_8,320000000000,127892000,104500,127996500,False,10
771,validator_8,320000000000,630000,0,630000,False,10
772,validator_11,320000000000,760000,0,760000,True,10
773,validator_4,64000000000,1480000,5640,1485640,False,2
774,validator_13,32000000000,890000,0,890000,False,1
775,validator_17,32000000000,2749000,12300,2761300,False,1
776,validator_7,480000000000,5400000,0,5400000,True,15
777,validator_0,160000000000,2300000,181000,2481000,True,5
778,validator_3,160000000000,3380000,0,3380000,True,5
779,validator_6,160000000000,4190000,0,4190000,True,5
780,validator_1,64000000000,107543000,196700,107739700,True,2
781,validator_3,160000000000,1896000,13900,1909900,True,5
782,validator_1,64000000000,2610000,0,2610000,True,2
783,validator_10,320000000000,195000,0,195000,True,10
784,validator_7,480000000000,370000,0,370000,True,15
785,validator_7,480000000000,22436000,350000,22786000,True,15
786,validator_7,480000000000,9252000,217300,9469300,True,15
787,validator_16,32000000000,74920000,257980,75177980,True,1
788,validator_16,32000000000,23030000,0,23030000,True,1
789,validator_10,320000000000,18597000,63600,18660600,True,10
790,validator_13,32000000000,73343000,350000,73693000,False,1
791,validator_8,320000000000,7068000,0,7068000,False,10
792,validator_0,160000000000,42754000,711680,43465680,True,5
793,validator_1,64000000000,63198000,7242100,70440100,True,2
794,validator_14,480000000000,734000,0,734000,True,15
795,validator_12,480000000000,33732000,47490,33779490,True,15
796,validator_15,160000000000,9952000,921900,10873900,True,5
797,validator_12,480000000000,9240000,41500,9281500,True,15
798,validator_1,64000000000,2200000,322000,2522000,True,2
799,validator_14,480000000000,10038000,769000,10807000,True,15
800,validator_1,64000000000,11520000,322000,11842000,True,2
801,validator_14,480000000000,79811000,385400,80196400,True,15
802,validator_7,480000000000,11800000,182800,11982800,True,15
803,validator_15,160000000000,45853000,316300,46169300,True,5
804,validator_0,160000000000,86357000,161000,86518000,True,5
805,validator_7,480000000000,20129000,318200,20447200,True,15
806,validator_5,32000000000,12003000,7257900,19260900,False,1
807,validator_11,320000000000,56195000,865800,57060800,True,10
808,validator_12,480000000000,20500000,18600,20518600,True,15
809,validator_6,160000000000,152405000,1127880,153532880,True,5
810,validator_14,480000000000,60662000,1999740,62661740,True,15
811,validator_17,32000000000,53861000,3562000,57423000,False,1
812,validator_18,32000000000,106968000,7590590,114558590,True,1
813,validator_14,480000000000,112031000,895990,112926990,True,15
814,validator_15,160000000000,64887000,953280,65840280,True,5
815,validator_9,64000000000,93315000,4575700,97890700,True,2
816,validator_3,160000000000,22473000,984300,23457300,True,5
817,validator_9,64000000000,5234000,549300,5783300,True,2
818,validator_2,160000000000,54235000,26440,54261440,True,5
819,validator_10,320000000000,47730000,265100,47995100,True,10
820,validator_12,480000000000,64521000,1441470,65962470,True,15
821,validator_14,480000000000,152280000,1241390,153521390,True,15
822,validator_8,320000000000,25815000,1854840,27669840,False,10
823,validator_7,480000000000,90637000,1522120,92159120,True,15
824,validator_11,320000000000,13383000,617000,14000000,True,10
825,validator_8,320000000000,4740000,56200,4796200,False,10
826,validator_2,160000000000,49060000,29500,49089500,True,5
827,validator_18,32000000000,71670000,6836100,78506100,True,1
828,validator_14,480000000000,66775000,266400,67041400,True,15
829,validator_6,160000000000,22313000,556200,22869200,True,5
830,validator_15,160000000000,128590000,1347220,129937220,True,5
831,validator_10,320000000000,470000,0,470000,True,10
832,validator_15,160000000000,58979000,1713340,60692340,True,5
833,validator_4,64000000000,1400000,0,1400000,False,2
834,validator_8,320000000000,10840000,40280,10880280,False,10
835,validator_6,160000000000,14450000,0,14450000,True,5
836,validator_17,32000000000,97988000,355520,98343520,False,1
837,validator_14,480000000000,8460000,0,8460000,True,15
838,validator_5,32000000000,112292000,35000,112327000,False,1
839,validator_0,160000000000,58600000,1043700,59643700,True,5
840,validator_14,480000000000,58174000,1361400,59535400,True,15
841,validator_12,480000000000,7650000,0,7650000,True,15
842,validator_1,64000000000,24929000,144840,25073840,True,2
843,validator_2,160000000000,57110000,447700,57557700,True,5
844,validator_14,480000000000,6720000,841600,7561600,True,15
845,validator_4,64000000000,96240000,13900,96253900,False,2
846,validator_12,480000000000,74937000,723430,75660430,True,15
847,validator_13,32000000000,5640000,384700,6024700,False,1
848,validator_3,160000000000,53372000,62300,53434300,True,5
849,validator_13,32000000000,237408000,1149800,238557800,False,1
850,validator_10,320000000000,51410000,5630,51415630,True,10
851,validator_0,160000000000,16462000,434200,16896200,True,5
852,validator_12,480000000000,12814000,384700,13198700,True,15
853,validator_6,160000000000,88603000,2365900,90968900,True,5
854,validator_12,480000000000,120657000,8278000,128935000,True,15
855,validator_19,32000000000,73171000,717000,73888000,False,1
856,validator_8,320000000000,72267000,464500,72731500,False,10
857,validator_14,480000000000,66369000,2239700,68608700,True,15
858,validator_14,480000000000,48809000,456300,49265300,True,15
859,validator_10,320000000000,39073000,220800,39293800,True,10
860,validator_19,32000000000,47080000,640770,47720770,False,1
861,validator_18,32000000000,96107000,276900,96383900,True,1
862,validator_11,320000000000,62681000,1120390,63801390,True,10
863,validator_14,480000000000,121460000,1163240,122623240,True,15
864,validator_4,64000000000,61621000,383680,62004680,False,2
865,validator_4,64000000000,116266000,1692240,117958240,False,2
866,validator_18,32000000000,40459000,522920,40981920,True,1
867,validator_7,480000000000,11970000,104200,12074200,True,15
868,validator_14,480000000000,49960000,355800,50315800,True,15
869,validator_17,32000000000,81908000,1274540,83182540,False,1
870,validator_3,160000000000,104118000,19105500,123223500,True,5
871,validator_11,320000000000,2545000,27430,2572430,True,10
872,validator_3,160000000000,25649000,401300,26050300,True,5
873,validator_9,64000000000,28940000,437300,29377300,True,2
874,validator_18,32000000000,17307000,653100,17960100,True,1
875,validator_7,480000000000,75727000,18055030,93782030,True,15
876,validator_14,480000000000,12474000,49900,12523900,True,15
877,validator_17,32000000000,1009000,56200,1065200,False,1
878,validator_2,160000000000,65025000,18159400,83184400,True,5
879,validator_14,480000000000,57987000,214100,58201100,True,15
880,validator_18,32000000000,42344000,2213200,44557200,True,1
881,validator_7,480000000000,53687000,900500,54587500,True,15
882,validator_8,320000000000,94947000,17850600,112797600,False,10
883,validator_13,32000000000,18540000,699500,19239500,False,1
884,validator_5,32000000000,41099000,12800,41111800,False,1
885,validator_7,480000000000,19213000,329840,19542840,True,15
886,validator_4,64000000000,30132000,683100,30815100,False,2
887,validator_7,480000000000,171022000,3643400,174665400,True,15
888,validator_3,160000000000,97422000,26025120,123447120,True,5
889,validator_6,160000000000,89806000,2226400,92032400,True,5
890,validator_10,320000000000,53767000,5832920,59599920,True,10
891,validator_1,64000000000,105846000,1394400,107240400,True,2
892,validator_16,32000000000,54438000,885200,55323200,True,1
893,validator_13,32000000000,40798000,459500,41257500,False,1
894,validator_6,160000000000,193043000,1798940,194841940,True,5
895,validator_11,320000000000,7005000,0,7005000,True,10
896,validator_17,32000000000,29034000,97100,29131100,False,1
897,validator_0,160000000000,129391000,220020,129611020,True,5
898,validator_7,480000000000,53019000,6048200,59067200,True,15
899,validator_4,64000000000,40432000,305640,40737640,False,2
900,validator_14,480000000000,1950000,6390,1956390,True,15
901,validator_8,320000000000,35760000,7253100,43013100,False,10
902,validator_15,160000000000,54218000,713900,54931900,True,5
903,validator_19,32000000000,38692000,911680,39603680,False,1
904,validator_19,32000000000,108829000,6230500,115059500,False,1
905,validator_2,160000000000,51880000,5433070,57313070,True,5
906,validator_9,64000000000,5770000,0,5770000,True,2
907,validator_9,64000000000,1727000,661900,2388900,True,2
908,validator_16,32000000000,62412000,868520,63280520,True,1
909,validator_7,480000000000,10658000,42500,10700500,True,15
910,validator_15,160000000000,44275000,1991540,46266540,True,5
911,validator_6,160000000000,24389000,118200,24507200,True,5
912,validator_8,320000000000,70623000,345310,70968310,False,10
913,validator_16,32000000000,111248000,819400,112067400,True,1
914,validator_15,160000000000,98834000,614420,99448420,True,5
915,validator_0,160000000000,54620000,828000,55448000,True,5
916,validator_0,160000000000,33665000,800570,34465570,True,5
917,validator_7,480000000000,14383000,289200,14672200,True,15
918,validator_14,480000000000,59668000,100000,59768000,True,15
919,validator_1,64000000000,15825000,128400,15953400,True,2
920,validator_3,160000000000,2829000,0,2829000,True,5
921,validator_7,480000000000,88036000,25313500,113349500,True,15
922,validator_2,160000000000,174088000,1622000,175710000,True,5
923,validator_14,480000000000,141284000,1282720,142566720,True,15
924,validator_2,160000000000,42477000,0,42477000,True,5
925,validator_7,480000000000,106498000,327800,106825800,True,15
926,validator_7,480000000000,3780000,29200,3809200,True,15
927,validator_7,480000000000,126051000,104180,126155180,True,15
928,validator_4,64000000000,27117000,959000,28076000,False,2
929,validator_12,480000000000,88376000,10625800,99001800,True,15
930,validator_3,160000000000,54347000,286170,54633170,True,5
931,validator_4,64000000000,84503000,641000,85144000,False,2
932,validator_6,160000000000,1100000,0,1100000,True,5
933,validator_19,32000000000,124491000,575600,125066600,False,1
934,validator_0,160000000000,53646000,630600,54276600,True,5
935,validator_3,160000000000,10310000,63800,10373800,True,5
936,validator_2,160000000000,1585000,0,1585000,True,5
937,validator_12,480000000000,244286000,10310360,254596360,True,15
938,validator_12,480000000000,117520000,18687330,136207330,True,15
939,validator_18,32000000000,97190000,594500,97784500,True,1
940,validator_1,64000000000,39160000,269900,39429900,True,2
941,validator_2,160000000000,62460000,1032020,63492020,True,5
942,validator_13,32000000000,54574000,4884100,59458100,False,1
943,validator_8,320000000000,174804000,1171800,175975800,False,10
944,validator_3,160000000000,209140000,3610080,212750080,True,5
945,validator_19,32000000000,20084000,717940,20801940,False,1
946,validator_14,480000000000,30147000,959000,31106000,True,15
947,validator_8,320000000000,120809000,10283700,131092700,False,10
948,validator_15,160000000000,75554000,760780,76314780,True,5
949,validator_8,320000000000,43496000,1350380,44846380,False,10
950,validator_14,480000000000,62851000,18053200,80904200,True,15
951,validator_11,320000000000,40914000,25818100,66732100,True,10
952,validator_3,160000000000,21348000,517840,21865840,True,5
953,validator_12,480000000000,16480000,651200,17131200,True,15
954,validator_1,64000000000,16643000,613200,17256200,True,2
955,validator_19,32000000000,19119000,353700,19472700,False,1
956,validator_6,160000000000,32941000,1226100,34167100,True,5
957,validator_0,160000000000,58820000,407600,59227600,True,5
958,validator_11,320000000000,85345000,832900,86177900,True,10
959,validator_15,160000000000,21942000,884600,22826600,True,5
960,validator_7,480000000000,1040000,0,1040000,True,15
961,validator_10,320000000000,17450000,126800,17576800,True,10
962,validator_0,160000000000,92416000,1711000,94127000,True,5
963,validator_16,32000000000,39346000,38540,39384540,True,1
964,validator_0,160000000000,23183000,335700,23518700,True,5
965,validator_9,64000000000,82920000,707040,83627040,True,2
966,validator_8,320000000000,84847000,573200,85420200,False,10
967,validator_10,320000000000,38830000,435840,39265840,True,10
968,validator_14,480000000000,26913000,471000,27384000,True,15
969,validator_12,480000000000,190870000,664990,191534990,True,15
970,validator_19,32000000000,119599000,18531410,138130410,False,1
971,validator_13,32000000000,42839000,645830,43484830,False,1
972,validator_19,32000000000,104288000,5517600,109805600,False,1
973,validator_12,480000000000,55354000,428900,55782900,True,15
974,validator_19,32000000000,43463000,629200,44092200,False,1
975,validator_15,160000000000,50687000,1160100,51847100,True,5
976,validator_19,32000000000,70978000,283000,71261000,False,1
977,validator_7,480000000000,38394000,835000,39229000,True,15
978,validator_19,32000000000,63615000,18335500,81950500,False,1
979,validator_17,32000000000,30001000,477720,30478720,False,1
980,validator_2,160000000000,32534000,4472200,37006200,True,5
981,validator_15,160000000000,71148000,236000,71384000,True,5
982,validator_10,320000000000,69976000,739000,70715000,True,10
983,validator_0,160000000000,63648000,1580000,65228000,True,5
984,validator_18,32000000000,64784000,272980,65056980,True,1
985,validator_12,480000000000,20372000,696240,21068240,True,15
986,validator_6,160000000000,160000,0,160000,True,5
987,validator_8,320000000000,5083000,22040,5105040,False,10
988,validator_0,160000000000,1130000,0,1130000,True,5
989,validator_16,32000000000,1870000,0,1870000,True,1
990,validator_16,32000000000,245650000,1967520,247617520,True,1
991,validator_12,480000000000,16793000,32900,16825900,True,15
992,validator_9,64000000000,51443000,215000,51658000,True,2
993,validator_2,160000000000,15950000,570700,16520700,True,5
994,validator_7,480000000000,118229000,1004780,119233780,True,15
995,validator_13,32000000000,155700000,18084880,173784880,False,1
996,validator_12,480000000000,85091000,19315420,104406420,True,15
997,validator_1,64000000000,112400000,253600,112653600,True,2
998,validator_7,480000000000,85337000,888400,86225400,True,15
999,validator_7,480000000000,72439000,804300,73243300,True,15
